GEO_CODE,GEO_LABEL,GEO_TYPE,GEO_TYP2,Postcode_Area,Age : Total\ Age - Sex : Total\ Sex - Unit : Persons,Age : Total\ Age - Sex : Males - Unit : Persons,Age : Total\ Age - Sex : Females - Unit : Persons,Age : Age 18 to 55 - Sex : Males - Unit : Persons,Age : Age 18 to 55 - Sex : Females - Unit : Persons
E02000001,City of London 001,Middle Super Output Areas and Intermediate Zones,MSOAIZ,WC,7375,4091,3284,2395,1677
E02000002,Barking and Dagenham 001,Middle Super Output Areas and Intermediate Zones,MSOAIZ,RM,6775,3156,3619,1187,1442
E02000003,Barking and Dagenham 002,Middle Super Output Areas and Intermediate Zones,MSOAIZ,RM,10045,4844,5201,2086,2300
E02000004,Barking and Dagenham 003,Middle Super Output Areas and Intermediate Zones,MSOAIZ,RM,6182,2950,3232,1208,1265
E02000005,Barking and Dagenham 004,Middle Super Output Areas and Intermediate Zones,MSOAIZ,RM,8562,4134,4428,1708,1966
E02000007,Barking and Dagenham 006,Middle Super Output Areas and Intermediate Zones,MSOAIZ,RM,8791,4099,4692,1594,1961
E02000008,Barking and Dagenham 007,Middle Super Output Areas and Intermediate Zones,MSOAIZ,RM,11569,5450,6119,2293,2671
E02000009,Barking and Dagenham 008,Middle Super Output Areas and Intermediate Zones,MSOAIZ,RM,8395,4080,4315,1805,1976
E02000010,Barking and Dagenham 009,Middle Super Output Areas and Intermediate Zones,MSOAIZ,RM,8615,4085,4530,1710,2003
E02000011,Barking and Dagenham 010,Middle Super Output Areas and Intermediate Zones,MSOAIZ,RM,6187,3046,3141,1254,1301
E02000012,Barking and Dagenham 011,Middle Super Output Areas and Intermediate Zones,MSOAIZ,IG,9888,4797,5091,2050,2081
E02000013,Barking and Dagenham 012,Middle Super Output Areas and Intermediate Zones,MSOAIZ,RM,8402,4033,4369,1629,1899
E02000014,Barking and Dagenham 013,Middle Super Output Areas and Intermediate Zones,MSOAIZ,RM,9402,4413,4989,1801,2118
E02000015,Barking and Dagenham 014,Middle Super Output Areas and Intermediate Zones,MSOAIZ,RM,7563,3635,3928,1547,1698
E02000016,Barking and Dagenham 015,Middle Super Output Areas and Intermediate Zones,MSOAIZ,IG,7676,4032,3644,2089,1886
E02000017,Barking and Dagenham 016,Middle Super Output Areas and Intermediate Zones,MSOAIZ,IG,8498,4524,3974,2236,1823
E02000018,Barking and Dagenham 017,Middle Super Output Areas and Intermediate Zones,MSOAIZ,RM,8890,4308,4582,1780,1992
E02000019,Barking and Dagenham 018,Middle Super Output Areas and Intermediate Zones,MSOAIZ,RM,8276,3997,4279,1685,1917
E02000020,Barking and Dagenham 019,Middle Super Output Areas and Intermediate Zones,MSOAIZ,IG,9276,4635,4641,2036,2032
E02000021,Barking and Dagenham 020,Middle Super Output Areas and Intermediate Zones,MSOAIZ,RM,7904,3797,4107,1599,1821
E02000022,Barking and Dagenham 021,Middle Super Output Areas and Intermediate Zones,MSOAIZ,IG,8777,4409,4368,1981,2091
E02000023,Barking and Dagenham 022,Middle Super Output Areas and Intermediate Zones,MSOAIZ,RM,6482,3160,3322,1410,1487
E02000024,Barnet 001,Middle Super Output Areas and Intermediate Zones,MSOAIZ,EN,10156,4854,5302,2104,2181
E02000025,Barnet 002,Middle Super Output Areas and Intermediate Zones,MSOAIZ,EN,7956,3823,4133,1766,1907
E02000026,Barnet 003,Middle Super Output Areas and Intermediate Zones,MSOAIZ,N,6313,3102,3211,1293,1390
E02000027,Barnet 004,Middle Super Output Areas and Intermediate Zones,MSOAIZ,EN,9598,4548,5050,1773,2136
E02000028,Barnet 005,Middle Super Output Areas and Intermediate Zones,MSOAIZ,N,6166,3034,3132,1339,1387
E02000029,Barnet 006,Middle Super Output Areas and Intermediate Zones,MSOAIZ,N,8517,4137,4380,1840,2025
E02000030,Barnet 007,Middle Super Output Areas and Intermediate Zones,MSOAIZ,WD,9130,4332,4798,1602,1869
E02000031,Barnet 008,Middle Super Output Areas and Intermediate Zones,MSOAIZ,N,7294,3503,3791,1505,1565
E02000032,Barnet 009,Middle Super Output Areas and Intermediate Zones,MSOAIZ,N,7857,3813,4044,1529,1672
E02000033,Barnet 010,Middle Super Output Areas and Intermediate Zones,MSOAIZ,N,8537,4140,4397,1837,2028
E02000034,Barnet 011,Middle Super Output Areas and Intermediate Zones,MSOAIZ,N,8508,4059,4449,1746,2036
E02000035,Barnet 012,Middle Super Output Areas and Intermediate Zones,MSOAIZ,N,7965,3795,4170,1859,1949
E02000036,Barnet 013,Middle Super Output Areas and Intermediate Zones,MSOAIZ,NW,10743,5215,5528,2170,2402
E02000037,Barnet 014,Middle Super Output Areas and Intermediate Zones,MSOAIZ,HA,9741,4689,5052,1661,1960
E02000038,Barnet 015,Middle Super Output Areas and Intermediate Zones,MSOAIZ,N,10514,5220,5294,2485,2449
E02000039,Barnet 016,Middle Super Output Areas and Intermediate Zones,MSOAIZ,NW,6675,3258,3417,1402,1492
E02000040,Barnet 017,Middle Super Output Areas and Intermediate Zones,MSOAIZ,NW,7197,3410,3787,1355,1611
E02000041,Barnet 018,Middle Super Output Areas and Intermediate Zones,MSOAIZ,HA,8811,4346,4465,1773,1901
E02000042,Barnet 019,Middle Super Output Areas and Intermediate Zones,MSOAIZ,N,10639,5241,5398,2674,2653
E02000043,Barnet 020,Middle Super Output Areas and Intermediate Zones,MSOAIZ,N,7696,3728,3968,1702,1782
E02000044,Barnet 021,Middle Super Output Areas and Intermediate Zones,MSOAIZ,NW,8071,3772,4299,1650,1988
E02000045,Barnet 022,Middle Super Output Areas and Intermediate Zones,MSOAIZ,N,10237,5002,5235,2452,2692
E02000046,Barnet 023,Middle Super Output Areas and Intermediate Zones,MSOAIZ,N,7063,3445,3618,1906,1902
E02000047,Barnet 024,Middle Super Output Areas and Intermediate Zones,MSOAIZ,NW,11373,5436,5937,2448,2759
E02000048,Barnet 025,Middle Super Output Areas and Intermediate Zones,MSOAIZ,NW,9817,4713,5104,2152,2274
E02000049,Barnet 026,Middle Super Output Areas and Intermediate Zones,MSOAIZ,NW,8503,4002,4501,1655,2060
E02000050,Barnet 027,Middle Super Output Areas and Intermediate Zones,MSOAIZ,N,10064,4863,5201,2298,2426
E02000051,Barnet 028,Middle Super Output Areas and Intermediate Zones,MSOAIZ,N,8647,4168,4479,1930,1902
E02000052,Barnet 029,Middle Super Output Areas and Intermediate Zones,MSOAIZ,N,9698,4695,5003,2467,2630
E02000053,Barnet 030,Middle Super Output Areas and Intermediate Zones,MSOAIZ,NW,8697,4420,4277,2206,2071
E02000054,Barnet 031,Middle Super Output Areas and Intermediate Zones,MSOAIZ,NW,7206,3552,3654,1691,1786
E02000055,Barnet 032,Middle Super Output Areas and Intermediate Zones,MSOAIZ,NW,11130,5514,5616,2512,2422
E02000056,Barnet 033,Middle Super Output Areas and Intermediate Zones,MSOAIZ,NW,9212,4319,4893,1771,2072
E02000057,Barnet 034,Middle Super Output Areas and Intermediate Zones,MSOAIZ,NW,7484,3697,3787,1618,1629
E02000058,Barnet 035,Middle Super Output Areas and Intermediate Zones,MSOAIZ,NW,10220,4805,5415,2111,2311
E02000059,Barnet 036,Middle Super Output Areas and Intermediate Zones,MSOAIZ,NW,10459,5189,5270,2627,2487
E02000060,Barnet 037,Middle Super Output Areas and Intermediate Zones,MSOAIZ,NW,10920,5364,5556,2198,2123
E02000061,Barnet 038,Middle Super Output Areas and Intermediate Zones,MSOAIZ,NW,8013,3918,4095,1962,1900
E02000062,Barnet 039,Middle Super Output Areas and Intermediate Zones,MSOAIZ,NW,6340,3091,3249,1415,1563
E02000063,Barnet 040,Middle Super Output Areas and Intermediate Zones,MSOAIZ,NW,6971,3450,3521,1617,1660
E02000064,Barnet 041,Middle Super Output Areas and Intermediate Zones,MSOAIZ,NW,6248,3014,3234,1445,1518
E02000065,Bexley 001,Middle Super Output Areas and Intermediate Zones,MSOAIZ,SE,7666,3708,3958,1683,1860
E02000066,Bexley 002,Middle Super Output Areas and Intermediate Zones,MSOAIZ,SE,9641,4593,5048,1948,2188
E02000067,Bexley 003,Middle Super Output Areas and Intermediate Zones,MSOAIZ,DA,8750,4206,4544,1824,2086
E02000068,Bexley 004,Middle Super Output Areas and Intermediate Zones,MSOAIZ,DA,7388,3598,3790,1620,1755
E02000069,Bexley 005,Middle Super Output Areas and Intermediate Zones,MSOAIZ,DA,6194,2991,3203,1218,1250
E02000070,Bexley 006,Middle Super Output Areas and Intermediate Zones,MSOAIZ,SE,7875,3788,4087,1491,1630
E02000071,Bexley 007,Middle Super Output Areas and Intermediate Zones,MSOAIZ,DA,7300,3531,3769,1430,1571
E02000072,Bexley 008,Middle Super Output Areas and Intermediate Zones,MSOAIZ,DA,11734,5620,6114,2342,2685
E02000073,Bexley 009,Middle Super Output Areas and Intermediate Zones,MSOAIZ,DA,10724,5203,5521,2050,2153
E02000074,Bexley 010,Middle Super Output Areas and Intermediate Zones,MSOAIZ,DA,7655,3576,4079,1431,1689
E02000075,Bexley 011,Middle Super Output Areas and Intermediate Zones,MSOAIZ,DA,7948,3865,4083,1475,1526
E02000077,Bexley 013,Middle Super Output Areas and Intermediate Zones,MSOAIZ,DA,7823,3748,4075,1494,1704
E02000078,Bexley 014,Middle Super Output Areas and Intermediate Zones,MSOAIZ,DA,7665,3718,3947,1545,1626
E02000079,Bexley 015,Middle Super Output Areas and Intermediate Zones,MSOAIZ,DA,7865,3728,4137,1569,1629
E02000080,Bexley 016,Middle Super Output Areas and Intermediate Zones,MSOAIZ,DA,9430,4546,4884,1832,1941
E02000081,Bexley 017,Middle Super Output Areas and Intermediate Zones,MSOAIZ,DA,7513,3653,3860,1431,1477
E02000082,Bexley 018,Middle Super Output Areas and Intermediate Zones,MSOAIZ,SE,8876,4338,4538,1839,1858
E02000083,Bexley 019,Middle Super Output Areas and Intermediate Zones,MSOAIZ,DA,9771,4783,4988,2034,2097
E02000084,Bexley 020,Middle Super Output Areas and Intermediate Zones,MSOAIZ,DA,10641,5257,5384,2103,2145
E02000085,Bexley 021,Middle Super Output Areas and Intermediate Zones,MSOAIZ,DA,7893,3765,4128,1553,1659
E02000086,Bexley 022,Middle Super Output Areas and Intermediate Zones,MSOAIZ,DA,7328,3584,3744,1444,1536
E02000087,Bexley 023,Middle Super Output Areas and Intermediate Zones,MSOAIZ,DA,7579,3716,3863,1472,1442
E02000088,Bexley 024,Middle Super Output Areas and Intermediate Zones,MSOAIZ,DA,7737,3790,3947,1502,1582
E02000089,Bexley 025,Middle Super Output Areas and Intermediate Zones,MSOAIZ,SE,7783,3737,4046,1422,1564
E02000090,Bexley 026,Middle Super Output Areas and Intermediate Zones,MSOAIZ,DA,8726,4021,4705,1738,1801
E02000091,Bexley 027,Middle Super Output Areas and Intermediate Zones,MSOAIZ,DA,9682,4540,5142,1734,1862
E02000092,Bexley 028,Middle Super Output Areas and Intermediate Zones,MSOAIZ,DA,6426,3000,3426,1196,1424
E02000093,Brent 001,Middle Super Output Areas and Intermediate Zones,MSOAIZ,NW,10883,5404,5479,2460,2489
E02000094,Brent 002,Middle Super Output Areas and Intermediate Zones,MSOAIZ,NW,8746,4388,4358,1994,1963
E02000095,Brent 003,Middle Super Output Areas and Intermediate Zones,MSOAIZ,NW,9921,4945,4976,2197,2150
E02000096,Brent 004,Middle Super Output Areas and Intermediate Zones,MSOAIZ,HA,7598,3745,3853,1571,1544
E02000097,Brent 005,Middle Super Output Areas and Intermediate Zones,MSOAIZ,NW,8958,4559,4399,2020,1948
E02000098,Brent 006,Middle Super Output Areas and Intermediate Zones,MSOAIZ,NW,7944,4040,3904,1780,1714
E02000099,Brent 007,Middle Super Output Areas and Intermediate Zones,MSOAIZ,HA,8707,4289,4418,2068,2042
E02000100,Brent 008,Middle Super Output Areas and Intermediate Zones,MSOAIZ,HA,8388,4092,4296,1695,1849
E02000101,Brent 009,Middle Super Output Areas and Intermediate Zones,MSOAIZ,NW,9332,4641,4691,2101,2123
E02000102,Brent 010,Middle Super Output Areas and Intermediate Zones,MSOAIZ,NW,7787,3812,3975,1684,1785
E02000103,Brent 011,Middle Super Output Areas and Intermediate Zones,MSOAIZ,NW,8723,4311,4412,1846,1941
E02000104,Brent 012,Middle Super Output Areas and Intermediate Zones,MSOAIZ,HA,6767,3431,3336,1565,1456
E02000105,Brent 013,Middle Super Output Areas and Intermediate Zones,MSOAIZ,HA,9202,4809,4393,2410,2127
E02000106,Brent 014,Middle Super Output Areas and Intermediate Zones,MSOAIZ,NW,10217,5126,5091,2454,2333
E02000107,Brent 015,Middle Super Output Areas and Intermediate Zones,MSOAIZ,NW,10692,5509,5183,3000,2748
E02000108,Brent 016,Middle Super Output Areas and Intermediate Zones,MSOAIZ,HA,6584,3389,3195,1653,1444
E02000109,Brent 017,Middle Super Output Areas and Intermediate Zones,MSOAIZ,HA,9864,5185,4679,2591,2234
E02000110,Brent 018,Middle Super Output Areas and Intermediate Zones,MSOAIZ,NW,8087,4114,3973,2120,1997
E02000111,Brent 019,Middle Super Output Areas and Intermediate Zones,MSOAIZ,NW,9782,5059,4723,2542,2254
E02000112,Brent 020,Middle Super Output Areas and Intermediate Zones,MSOAIZ,NW,9432,5017,4415,2482,2107
E02000113,Brent 021,Middle Super Output Areas and Intermediate Zones,MSOAIZ,NW,9655,4615,5040,1776,2170
E02000114,Brent 022,Middle Super Output Areas and Intermediate Zones,MSOAIZ,NW,9010,4519,4491,2528,2436
E02000115,Brent 023,Middle Super Output Areas and Intermediate Zones,MSOAIZ,NW,8340,4278,4062,2441,2269
E02000116,Brent 024,Middle Super Output Areas and Intermediate Zones,MSOAIZ,NW,8153,4087,4066,2077,2142
E02000117,Brent 025,Middle Super Output Areas and Intermediate Zones,MSOAIZ,NW,12013,5839,6174,2563,2794
E02000118,Brent 026,Middle Super Output Areas and Intermediate Zones,MSOAIZ,NW,9425,4923,4502,2405,2128
E02000119,Brent 027,Middle Super Output Areas and Intermediate Zones,MSOAIZ,NW,7248,3558,3690,1456,1604
E02000120,Brent 028,Middle Super Output Areas and Intermediate Zones,MSOAIZ,NW,9214,4541,4673,2741,2744
E02000121,Brent 029,Middle Super Output Areas and Intermediate Zones,MSOAIZ,UB,8933,4584,4349,2314,2099
E02000122,Brent 030,Middle Super Output Areas and Intermediate Zones,MSOAIZ,NW,8079,3901,4178,1900,2031
E02000123,Brent 031,Middle Super Output Areas and Intermediate Zones,MSOAIZ,NW,14719,7453,7266,3769,3665
E02000124,Brent 032,Middle Super Output Areas and Intermediate Zones,MSOAIZ,W,10222,5088,5134,2973,2897
E02000125,Brent 033,Middle Super Output Areas and Intermediate Zones,MSOAIZ,NW,10815,5320,5495,2884,2888
E02000126,Brent 034,Middle Super Output Areas and Intermediate Zones,MSOAIZ,W,7775,3897,3878,1883,1947
E02000127,Bromley 001,Middle Super Output Areas and Intermediate Zones,MSOAIZ,SE,8483,3915,4568,1614,1965
E02000128,Bromley 002,Middle Super Output Areas and Intermediate Zones,MSOAIZ,SE,7294,3494,3800,1498,1667
E02000130,Bromley 004,Middle Super Output Areas and Intermediate Zones,MSOAIZ,SE,7914,3819,4095,1831,2047
E02000131,Bromley 005,Middle Super Output Areas and Intermediate Zones,MSOAIZ,SE,8954,4413,4541,2663,2612
E02000132,Bromley 006,Middle Super Output Areas and Intermediate Zones,MSOAIZ,SE,8567,4163,4404,2310,2267
E02000133,Bromley 007,Middle Super Output Areas and Intermediate Zones,MSOAIZ,BR,9606,4600,5006,1893,1963
E02000134,Bromley 008,Middle Super Output Areas and Intermediate Zones,MSOAIZ,BR,10773,5170,5603,2782,2706
E02000135,Bromley 009,Middle Super Output Areas and Intermediate Zones,MSOAIZ,SE,9734,4688,5046,2228,2463
E02000136,Bromley 010,Middle Super Output Areas and Intermediate Zones,MSOAIZ,DA,5728,2724,3004,960,1066
E02000137,Bromley 011,Middle Super Output Areas and Intermediate Zones,MSOAIZ,BR,7826,3725,4101,1751,1778
E02000138,Bromley 012,Middle Super Output Areas and Intermediate Zones,MSOAIZ,BR,7936,3838,4098,1825,1782
E02000139,Bromley 013,Middle Super Output Areas and Intermediate Zones,MSOAIZ,SE,7284,3468,3816,1747,1949
E02000140,Bromley 014,Middle Super Output Areas and Intermediate Zones,MSOAIZ,DA,8041,3751,4290,1453,1747
E02000141,Bromley 015,Middle Super Output Areas and Intermediate Zones,MSOAIZ,SE,6940,3348,3592,1672,1767
E02000142,Bromley 016,Middle Super Output Areas and Intermediate Zones,MSOAIZ,BR,8285,3961,4324,1747,1800
E02000144,Bromley 018,Middle Super Output Areas and Intermediate Zones,MSOAIZ,BR,8681,4238,4443,2140,2068
E02000145,Bromley 019,Middle Super Output Areas and Intermediate Zones,MSOAIZ,DA,8086,3756,4330,1504,1775
E02000146,Bromley 020,Middle Super Output Areas and Intermediate Zones,MSOAIZ,BR,8324,3988,4336,1868,1951
E02000147,Bromley 021,Middle Super Output Areas and Intermediate Zones,MSOAIZ,BR,7969,3912,4057,1432,1511
E02000148,Bromley 022,Middle Super Output Areas and Intermediate Zones,MSOAIZ,BR,6585,3161,3424,1242,1304
E02000149,Bromley 023,Middle Super Output Areas and Intermediate Zones,MSOAIZ,BR,7708,3687,4021,1509,1690
E02000150,Bromley 024,Middle Super Output Areas and Intermediate Zones,MSOAIZ,BR,8351,3991,4360,1650,1773
E02000151,Bromley 025,Middle Super Output Areas and Intermediate Zones,MSOAIZ,BR,7574,3628,3946,1359,1479
E02000152,Bromley 026,Middle Super Output Areas and Intermediate Zones,MSOAIZ,BR,6572,3128,3444,1211,1428
E02000153,Bromley 027,Middle Super Output Areas and Intermediate Zones,MSOAIZ,BR,7755,3750,4005,1403,1562
E02000154,Bromley 028,Middle Super Output Areas and Intermediate Zones,MSOAIZ,BR,7959,3876,4083,1603,1610
E02000155,Bromley 029,Middle Super Output Areas and Intermediate Zones,MSOAIZ,BR,6905,3338,3567,1273,1308
E02000156,Bromley 030,Middle Super Output Areas and Intermediate Zones,MSOAIZ,CR,12094,5817,6277,2092,2299
E02000157,Bromley 031,Middle Super Output Areas and Intermediate Zones,MSOAIZ,BR,7964,3826,4138,1414,1483
E02000158,Bromley 032,Middle Super Output Areas and Intermediate Zones,MSOAIZ,BR,7364,3525,3839,1238,1386
E02000159,Bromley 033,Middle Super Output Areas and Intermediate Zones,MSOAIZ,BR,6812,3278,3534,1178,1280
E02000160,Bromley 034,Middle Super Output Areas and Intermediate Zones,MSOAIZ,BR,7856,3816,4040,1418,1566
E02000161,Bromley 035,Middle Super Output Areas and Intermediate Zones,MSOAIZ,BR,8410,4066,4344,1658,1748
E02000162,Bromley 036,Middle Super Output Areas and Intermediate Zones,MSOAIZ,TN,6693,3116,3577,1140,1318
E02000163,Bromley 037,Middle Super Output Areas and Intermediate Zones,MSOAIZ,TN,7650,3749,3901,1404,1511
E02000165,Bromley 039,Middle Super Output Areas and Intermediate Zones,MSOAIZ,TN,7045,3466,3579,1438,1515
E02000166,Camden 001,Middle Super Output Areas and Intermediate Zones,MSOAIZ,NW,7924,3689,4235,1635,1976
E02000167,Camden 002,Middle Super Output Areas and Intermediate Zones,MSOAIZ,NW,7944,3880,4064,1932,1937
E02000168,Camden 003,Middle Super Output Areas and Intermediate Zones,MSOAIZ,NW,8172,3928,4244,2038,2185
E02000169,Camden 004,Middle Super Output Areas and Intermediate Zones,MSOAIZ,NW,7637,3665,3972,1660,1682
E02000170,Camden 005,Middle Super Output Areas and Intermediate Zones,MSOAIZ,NW,8338,4134,4204,2388,2318
E02000171,Camden 006,Middle Super Output Areas and Intermediate Zones,MSOAIZ,NW,7818,3791,4027,1972,2083
E02000172,Camden 007,Middle Super Output Areas and Intermediate Zones,MSOAIZ,NW,10147,4892,5255,2270,2364
E02000173,Camden 008,Middle Super Output Areas and Intermediate Zones,MSOAIZ,NW,7675,3759,3916,2119,2132
E02000174,Camden 009,Middle Super Output Areas and Intermediate Zones,MSOAIZ,NW,8714,4108,4606,2186,2403
E02000175,Camden 010,Middle Super Output Areas and Intermediate Zones,MSOAIZ,NW,8848,4272,4576,2677,2818
E02000176,Camden 011,Middle Super Output Areas and Intermediate Zones,MSOAIZ,NW,6373,3111,3262,1874,1938
E02000177,Camden 012,Middle Super Output Areas and Intermediate Zones,MSOAIZ,NW,8948,4242,4706,2016,2307
E02000178,Camden 013,Middle Super Output Areas and Intermediate Zones,MSOAIZ,NW,8857,4403,4454,2570,2453
E02000179,Camden 014,Middle Super Output Areas and Intermediate Zones,MSOAIZ,NW,6329,2980,3349,1501,1665
E02000180,Camden 015,Middle Super Output Areas and Intermediate Zones,MSOAIZ,NW,8202,4066,4136,1981,1937
E02000181,Camden 016,Middle Super Output Areas and Intermediate Zones,MSOAIZ,NW,7708,3657,4051,2292,2455
E02000182,Camden 017,Middle Super Output Areas and Intermediate Zones,MSOAIZ,NW,6697,3100,3597,1552,1781
E02000183,Camden 018,Middle Super Output Areas and Intermediate Zones,MSOAIZ,NW,7913,3864,4049,2023,2054
E02000184,Camden 019,Middle Super Output Areas and Intermediate Zones,MSOAIZ,NW,8882,4342,4540,2231,2074
E02000185,Camden 020,Middle Super Output Areas and Intermediate Zones,MSOAIZ,W,8290,3902,4388,1941,2105
E02000186,Camden 021,Middle Super Output Areas and Intermediate Zones,MSOAIZ,NW,6687,3449,3238,1975,1607
E02000187,Camden 022,Middle Super Output Areas and Intermediate Zones,MSOAIZ,NW,8155,3881,4274,1611,1728
E02000188,Camden 023,Middle Super Output Areas and Intermediate Zones,MSOAIZ,NW,8322,4250,4072,1595,1614
E02000189,Camden 024,Middle Super Output Areas and Intermediate Zones,MSOAIZ,WC,5944,2986,2958,1270,1248
E02000190,Camden 025,Middle Super Output Areas and Intermediate Zones,MSOAIZ,WC,7530,3738,3792,1601,1422
E02000191,Camden 026,Middle Super Output Areas and Intermediate Zones,MSOAIZ,WC,7497,4008,3489,1675,1272
E02000192,Camden 027,Middle Super Output Areas and Intermediate Zones,MSOAIZ,WC,7157,3771,3386,2038,1632
E02000193,Camden 028,Middle Super Output Areas and Intermediate Zones,MSOAIZ,WC,7630,4017,3613,2207,1678
E02000194,Croydon 001,Middle Super Output Areas and Intermediate Zones,MSOAIZ,SE,8696,4249,4447,2273,2302
E02000195,Croydon 002,Middle Super Output Areas and Intermediate Zones,MSOAIZ,SW,9152,4505,4647,1951,2005
E02000196,Croydon 003,Middle Super Output Areas and Intermediate Zones,MSOAIZ,SW,7403,3628,3775,1547,1620
E02000197,Croydon 004,Middle Super Output Areas and Intermediate Zones,MSOAIZ,SW,9094,4382,4712,1914,2088
E02000198,Croydon 005,Middle Super Output Areas and Intermediate Zones,MSOAIZ,SE,8070,3870,4200,1727,2008
E02000199,Croydon 006,Middle Super Output Areas and Intermediate Zones,MSOAIZ,SE,8430,3966,4464,1694,2039
E02000200,Croydon 007,Middle Super Output Areas and Intermediate Zones,MSOAIZ,SE,8294,4045,4249,1998,2140
E02000201,Croydon 008,Middle Super Output Areas and Intermediate Zones,MSOAIZ,SE,8281,3995,4286,1870,2069
E02000202,Croydon 009,Middle Super Output Areas and Intermediate Zones,MSOAIZ,SW,8548,4216,4332,1875,1856
E02000203,Croydon 010,Middle Super Output Areas and Intermediate Zones,MSOAIZ,SE,7539,3649,3890,1695,1807
E02000204,Croydon 011,Middle Super Output Areas and Intermediate Zones,MSOAIZ,SW,9407,4528,4879,1904,2091
E02000206,Croydon 013,Middle Super Output Areas and Intermediate Zones,MSOAIZ,SE,9539,4631,4908,2096,2289
E02000207,Croydon 014,Middle Super Output Areas and Intermediate Zones,MSOAIZ,SE,8999,4319,4680,1917,2212
E02000208,Croydon 015,Middle Super Output Areas and Intermediate Zones,MSOAIZ,CR,9790,4740,5050,2261,2381
E02000209,Croydon 016,Middle Super Output Areas and Intermediate Zones,MSOAIZ,CR,8414,4104,4310,1842,2009
E02000210,Croydon 017,Middle Super Output Areas and Intermediate Zones,MSOAIZ,SE,8310,3980,4330,1963,2144
E02000211,Croydon 018,Middle Super Output Areas and Intermediate Zones,MSOAIZ,CR,8000,3851,4149,1488,1626
E02000212,Croydon 019,Middle Super Output Areas and Intermediate Zones,MSOAIZ,CR,8523,4202,4321,1936,2064
E02000213,Croydon 020,Middle Super Output Areas and Intermediate Zones,MSOAIZ,CR,9551,4780,4771,2528,2289
E02000214,Croydon 021,Middle Super Output Areas and Intermediate Zones,MSOAIZ,CR,6236,3116,3120,1273,1326
E02000215,Croydon 022,Middle Super Output Areas and Intermediate Zones,MSOAIZ,CR,10518,5425,5093,3043,2682
E02000216,Croydon 023,Middle Super Output Areas and Intermediate Zones,MSOAIZ,CR,6738,3332,3406,1613,1457
E02000217,Croydon 024,Middle Super Output Areas and Intermediate Zones,MSOAIZ,CR,9688,4776,4912,2597,2446
E02000218,Croydon 025,Middle Super Output Areas and Intermediate Zones,MSOAIZ,CR,6640,3098,3542,1096,1420
E02000219,Croydon 026,Middle Super Output Areas and Intermediate Zones,MSOAIZ,CR,7686,3649,4037,1324,1440
E02000220,Croydon 027,Middle Super Output Areas and Intermediate Zones,MSOAIZ,CR,9881,5075,4806,3059,2518
E02000221,Croydon 028,Middle Super Output Areas and Intermediate Zones,MSOAIZ,CR,9820,4649,5171,2053,2328
E02000222,Croydon 029,Middle Super Output Areas and Intermediate Zones,MSOAIZ,CR,7891,3919,3972,2065,1951
E02000223,Croydon 030,Middle Super Output Areas and Intermediate Zones,MSOAIZ,CR,8371,3725,4646,1262,1857
E02000224,Croydon 031,Middle Super Output Areas and Intermediate Zones,MSOAIZ,CR,7684,3813,3871,1970,1903
E02000225,Croydon 032,Middle Super Output Areas and Intermediate Zones,MSOAIZ,CR,7535,3543,3992,1291,1659
E02000226,Croydon 033,Middle Super Output Areas and Intermediate Zones,MSOAIZ,CR,7539,3740,3799,1374,1438
E02000227,Croydon 034,Middle Super Output Areas and Intermediate Zones,MSOAIZ,CR,11411,5380,6031,2279,2491
E02000228,Croydon 035,Middle Super Output Areas and Intermediate Zones,MSOAIZ,CR,7609,3704,3905,1365,1411
E02000229,Croydon 036,Middle Super Output Areas and Intermediate Zones,MSOAIZ,CR,6374,2990,3384,1098,1338
E02000230,Croydon 037,Middle Super Output Areas and Intermediate Zones,MSOAIZ,CR,10045,4929,5116,2217,2209
E02000231,Croydon 038,Middle Super Output Areas and Intermediate Zones,MSOAIZ,CR,7685,3795,3890,1422,1486
E02000232,Croydon 039,Middle Super Output Areas and Intermediate Zones,MSOAIZ,CR,6207,2983,3224,1081,1217
E02000233,Croydon 040,Middle Super Output Areas and Intermediate Zones,MSOAIZ,CR,6135,2955,3180,1269,1414
E02000234,Croydon 041,Middle Super Output Areas and Intermediate Zones,MSOAIZ,CR,8023,3897,4126,1639,1733
E02000235,Croydon 042,Middle Super Output Areas and Intermediate Zones,MSOAIZ,CR,6968,3354,3614,1395,1535
E02000236,Croydon 043,Middle Super Output Areas and Intermediate Zones,MSOAIZ,CR,7659,3743,3916,1500,1623
E02000237,Croydon 044,Middle Super Output Areas and Intermediate Zones,MSOAIZ,CR,7475,3556,3919,1326,1423
E02000238,Ealing 001,Middle Super Output Areas and Intermediate Zones,MSOAIZ,UB,9500,4865,4635,2384,2187
E02000239,Ealing 002,Middle Super Output Areas and Intermediate Zones,MSOAIZ,UB,9000,4563,4437,2236,1960
E02000240,Ealing 003,Middle Super Output Areas and Intermediate Zones,MSOAIZ,UB,10265,4954,5311,2134,2451
E02000241,Ealing 004,Middle Super Output Areas and Intermediate Zones,MSOAIZ,UB,6639,3288,3351,1613,1512
E02000242,Ealing 005,Middle Super Output Areas and Intermediate Zones,MSOAIZ,UB,6763,3527,3236,1696,1497
E02000243,Ealing 006,Middle Super Output Areas and Intermediate Zones,MSOAIZ,UB,8509,4286,4223,2048,1942
E02000244,Ealing 007,Middle Super Output Areas and Intermediate Zones,MSOAIZ,UB,7172,3667,3505,1868,1680
E02000245,Ealing 008,Middle Super Output Areas and Intermediate Zones,MSOAIZ,UB,8156,3927,4229,1743,1938
E02000246,Ealing 009,Middle Super Output Areas and Intermediate Zones,MSOAIZ,UB,8748,4293,4455,1719,1954
E02000247,Ealing 010,Middle Super Output Areas and Intermediate Zones,MSOAIZ,UB,10308,4952,5356,2207,2458
E02000248,Ealing 011,Middle Super Output Areas and Intermediate Zones,MSOAIZ,W,7334,3643,3691,1912,1817
E02000249,Ealing 012,Middle Super Output Areas and Intermediate Zones,MSOAIZ,UB,7721,3842,3879,1791,1762
E02000250,Ealing 013,Middle Super Output Areas and Intermediate Zones,MSOAIZ,W,6487,3093,3394,1375,1470
E02000251,Ealing 014,Middle Super Output Areas and Intermediate Zones,MSOAIZ,UB,7944,4008,3936,1796,1737
E02000252,Ealing 015,Middle Super Output Areas and Intermediate Zones,MSOAIZ,W,9706,5073,4633,2811,2318
E02000253,Ealing 016,Middle Super Output Areas and Intermediate Zones,MSOAIZ,W,9632,4615,5017,1970,2237
E02000254,Ealing 017,Middle Super Output Areas and Intermediate Zones,MSOAIZ,UB,8949,4542,4407,2091,1953
E02000255,Ealing 018,Middle Super Output Areas and Intermediate Zones,MSOAIZ,W,9465,4583,4882,2091,2257
E02000256,Ealing 019,Middle Super Output Areas and Intermediate Zones,MSOAIZ,W,8861,4381,4480,2423,2285
E02000257,Ealing 020,Middle Super Output Areas and Intermediate Zones,MSOAIZ,W,13509,6703,6806,3730,3695
E02000258,Ealing 021,Middle Super Output Areas and Intermediate Zones,MSOAIZ,W,6730,3413,3317,1656,1624
E02000259,Ealing 022,Middle Super Output Areas and Intermediate Zones,MSOAIZ,W,6276,3045,3231,1428,1538
E02000260,Ealing 023,Middle Super Output Areas and Intermediate Zones,MSOAIZ,UB,8710,4500,4210,2039,1847
E02000261,Ealing 024,Middle Super Output Areas and Intermediate Zones,MSOAIZ,W,10766,5272,5494,2571,2663
E02000262,Ealing 025,Middle Super Output Areas and Intermediate Zones,MSOAIZ,W,8925,4456,4469,2457,2318
E02000263,Ealing 026,Middle Super Output Areas and Intermediate Zones,MSOAIZ,UB,11637,6173,5464,2861,2381
E02000264,Ealing 027,Middle Super Output Areas and Intermediate Zones,MSOAIZ,W,8103,4040,4063,2111,2021
E02000265,Ealing 028,Middle Super Output Areas and Intermediate Zones,MSOAIZ,W,11119,5542,5577,3073,2983
E02000266,Ealing 029,Middle Super Output Areas and Intermediate Zones,MSOAIZ,W,12331,6141,6190,2755,2748
E02000267,Ealing 030,Middle Super Output Areas and Intermediate Zones,MSOAIZ,W,6926,3403,3523,1783,1831
E02000268,Ealing 031,Middle Super Output Areas and Intermediate Zones,MSOAIZ,W,9358,4666,4692,2420,2373
E02000269,Ealing 032,Middle Super Output Areas and Intermediate Zones,MSOAIZ,W,8078,3947,4131,2122,2155
E02000270,Ealing 033,Middle Super Output Areas and Intermediate Zones,MSOAIZ,W,8043,3883,4160,1789,2011
E02000271,Ealing 034,Middle Super Output Areas and Intermediate Zones,MSOAIZ,W,6763,3331,3432,1728,1729
E02000272,Ealing 035,Middle Super Output Areas and Intermediate Zones,MSOAIZ,W,6748,3318,3430,1582,1600
E02000274,Ealing 037,Middle Super Output Areas and Intermediate Zones,MSOAIZ,UB,12733,6846,5887,3150,2650
E02000275,Ealing 038,Middle Super Output Areas and Intermediate Zones,MSOAIZ,UB,7102,3631,3471,1622,1497
E02000276,Ealing 039,Middle Super Output Areas and Intermediate Zones,MSOAIZ,W,6722,3449,3273,1886,1794
E02000277,Enfield 001,Middle Super Output Areas and Intermediate Zones,MSOAIZ,EN,7081,3391,3690,1386,1635
E02000278,Enfield 002,Middle Super Output Areas and Intermediate Zones,MSOAIZ,EN,8837,4175,4662,1596,1996
E02000279,Enfield 003,Middle Super Output Areas and Intermediate Zones,MSOAIZ,EN,11292,5328,5964,2380,2802
E02000280,Enfield 004,Middle Super Output Areas and Intermediate Zones,MSOAIZ,EN,8515,4023,4492,1710,1967
E02000281,Enfield 005,Middle Super Output Areas and Intermediate Zones,MSOAIZ,EN,8835,4200,4635,1883,2113
E02000282,Enfield 006,Middle Super Output Areas and Intermediate Zones,MSOAIZ,EN,9115,4245,4870,1779,2146
E02000283,Enfield 007,Middle Super Output Areas and Intermediate Zones,MSOAIZ,EN,8424,4022,4402,1566,1926
E02000284,Enfield 008,Middle Super Output Areas and Intermediate Zones,MSOAIZ,EN,8200,3980,4220,1853,1987
E02000285,Enfield 009,Middle Super Output Areas and Intermediate Zones,MSOAIZ,EN,6597,3204,3393,1286,1375
E02000286,Enfield 010,Middle Super Output Areas and Intermediate Zones,MSOAIZ,EN,8158,4011,4147,2002,1829
E02000287,Enfield 011,Middle Super Output Areas and Intermediate Zones,MSOAIZ,N,6823,3293,3530,1231,1270
E02000288,Enfield 012,Middle Super Output Areas and Intermediate Zones,MSOAIZ,N,10490,5090,5400,2155,2414
E02000289,Enfield 013,Middle Super Output Areas and Intermediate Zones,MSOAIZ,N,6569,3145,3424,1169,1298
E02000290,Enfield 014,Middle Super Output Areas and Intermediate Zones,MSOAIZ,EN,7242,3472,3770,1505,1713
E02000291,Enfield 015,Middle Super Output Areas and Intermediate Zones,MSOAIZ,EN,8924,4374,4550,2086,2091
E02000292,Enfield 016,Middle Super Output Areas and Intermediate Zones,MSOAIZ,N,9518,4577,4941,1931,2225
E02000293,Enfield 017,Middle Super Output Areas and Intermediate Zones,MSOAIZ,N,6307,3146,3161,1189,1197
E02000294,Enfield 018,Middle Super Output Areas and Intermediate Zones,MSOAIZ,N,8879,4240,4639,1650,1949
E02000295,Enfield 019,Middle Super Output Areas and Intermediate Zones,MSOAIZ,N,8374,4008,4366,1811,1953
E02000296,Enfield 020,Middle Super Output Areas and Intermediate Zones,MSOAIZ,N,9535,4511,5024,2115,2252
E02000297,Enfield 021,Middle Super Output Areas and Intermediate Zones,MSOAIZ,N,9298,4532,4766,1843,1902
E02000298,Enfield 022,Middle Super Output Areas and Intermediate Zones,MSOAIZ,N,7976,3978,3998,1765,1776
E02000299,Enfield 023,Middle Super Output Areas and Intermediate Zones,MSOAIZ,N,9312,4494,4818,1855,2162
E02000300,Enfield 024,Middle Super Output Areas and Intermediate Zones,MSOAIZ,N,8157,3933,4224,1716,1890
E02000301,Enfield 025,Middle Super Output Areas and Intermediate Zones,MSOAIZ,N,10070,4787,5283,2016,2386
E02000302,Enfield 026,Middle Super Output Areas and Intermediate Zones,MSOAIZ,N,8326,4031,4295,1732,1809
E02000303,Enfield 027,Middle Super Output Areas and Intermediate Zones,MSOAIZ,N,8390,3967,4423,1594,1843
E02000304,Enfield 028,Middle Super Output Areas and Intermediate Zones,MSOAIZ,N,8089,3936,4153,1651,1741
E02000305,Enfield 029,Middle Super Output Areas and Intermediate Zones,MSOAIZ,N,8633,4310,4323,2210,2137
E02000306,Enfield 030,Middle Super Output Areas and Intermediate Zones,MSOAIZ,N,9149,4287,4862,1801,2214
E02000307,Enfield 031,Middle Super Output Areas and Intermediate Zones,MSOAIZ,N,9873,4774,5099,1937,2249
E02000308,Enfield 032,Middle Super Output Areas and Intermediate Zones,MSOAIZ,N,7736,3881,3855,1922,1814
E02000309,Enfield 033,Middle Super Output Areas and Intermediate Zones,MSOAIZ,N,10489,5126,5363,2235,2421
E02000311,Enfield 035,Middle Super Output Areas and Intermediate Zones,MSOAIZ,N,9872,4777,5095,2168,2344
E02000312,Enfield 036,Middle Super Output Areas and Intermediate Zones,MSOAIZ,N,10473,5259,5214,2833,2610
E02000313,Greenwich 001,Middle Super Output Areas and Intermediate Zones,MSOAIZ,SE,6566,3290,3276,1531,1556
E02000314,Greenwich 002,Middle Super Output Areas and Intermediate Zones,MSOAIZ,SE,13164,6745,6419,3349,3299
E02000315,Greenwich 003,Middle Super Output Areas and Intermediate Zones,MSOAIZ,SE,9080,4331,4749,1755,2073
E02000316,Greenwich 004,Middle Super Output Areas and Intermediate Zones,MSOAIZ,SE,10750,5559,5191,3168,2799
E02000317,Greenwich 005,Middle Super Output Areas and Intermediate Zones,MSOAIZ,SE,8370,4134,4236,1775,1883
E02000318,Greenwich 006,Middle Super Output Areas and Intermediate Zones,MSOAIZ,SE,9842,5058,4784,2395,2215
E02000319,Greenwich 007,Middle Super Output Areas and Intermediate Zones,MSOAIZ,SE,10971,5668,5303,3061,2616
E02000320,Greenwich 008,Middle Super Output Areas and Intermediate Zones,MSOAIZ,SE,6624,3207,3417,1382,1538
E02000321,Greenwich 009,Middle Super Output Areas and Intermediate Zones,MSOAIZ,SE,7200,3535,3665,1624,1683
E02000323,Greenwich 011,Middle Super Output Areas and Intermediate Zones,MSOAIZ,SE,10674,5454,5220,2534,2495
E02000324,Greenwich 012,Middle Super Output Areas and Intermediate Zones,MSOAIZ,SE,7315,3523,3792,1557,1655
E02000326,Greenwich 014,Middle Super Output Areas and Intermediate Zones,MSOAIZ,SE,7070,3409,3661,1756,1861
E02000327,Greenwich 015,Middle Super Output Areas and Intermediate Zones,MSOAIZ,SE,6825,3539,3286,1550,1540
E02000328,Greenwich 016,Middle Super Output Areas and Intermediate Zones,MSOAIZ,SE,6606,3232,3374,1650,1630
E02000329,Greenwich 017,Middle Super Output Areas and Intermediate Zones,MSOAIZ,SE,6180,3102,3078,1380,1379
E02000331,Greenwich 019,Middle Super Output Areas and Intermediate Zones,MSOAIZ,SE,7831,3805,4026,1794,1849
E02000332,Greenwich 020,Middle Super Output Areas and Intermediate Zones,MSOAIZ,SE,7253,3604,3649,1656,1688
E02000333,Greenwich 021,Middle Super Output Areas and Intermediate Zones,MSOAIZ,SE,6269,3087,3182,1672,1598
E02000334,Greenwich 022,Middle Super Output Areas and Intermediate Zones,MSOAIZ,SE,6469,3179,3290,1438,1480
E02000335,Greenwich 023,Middle Super Output Areas and Intermediate Zones,MSOAIZ,SE,6549,3229,3320,1362,1436
E02000337,Greenwich 025,Middle Super Output Areas and Intermediate Zones,MSOAIZ,SE,7906,3821,4085,1648,1831
E02000339,Greenwich 027,Middle Super Output Areas and Intermediate Zones,MSOAIZ,SE,5970,2926,3044,1183,1204
E02000340,Greenwich 028,Middle Super Output Areas and Intermediate Zones,MSOAIZ,SE,6088,2977,3111,1282,1209
E02000341,Greenwich 029,Middle Super Output Areas and Intermediate Zones,MSOAIZ,SE,7683,3656,4027,1492,1732
E02000342,Greenwich 030,Middle Super Output Areas and Intermediate Zones,MSOAIZ,SE,6453,3020,3433,1084,1210
E02000343,Greenwich 031,Middle Super Output Areas and Intermediate Zones,MSOAIZ,SE,6675,3272,3403,1310,1331
E02000344,Greenwich 032,Middle Super Output Areas and Intermediate Zones,MSOAIZ,SE,6387,3150,3237,1326,1273
E02000345,Hackney 001,Middle Super Output Areas and Intermediate Zones,MSOAIZ,N,8838,4448,4390,1645,1594
E02000346,Hackney 002,Middle Super Output Areas and Intermediate Zones,MSOAIZ,N,6092,3016,3076,1476,1458
E02000347,Hackney 003,Middle Super Output Areas and Intermediate Zones,MSOAIZ,N,7956,3960,3996,1666,1580
E02000348,Hackney 004,Middle Super Output Areas and Intermediate Zones,MSOAIZ,N,8120,4031,4089,1636,1745
E02000350,Hackney 006,Middle Super Output Areas and Intermediate Zones,MSOAIZ,N,9502,4716,4786,2642,2644
E02000351,Hackney 007,Middle Super Output Areas and Intermediate Zones,MSOAIZ,N,8523,4303,4220,2719,2561
E02000352,Hackney 008,Middle Super Output Areas and Intermediate Zones,MSOAIZ,N,6883,3225,3658,1623,1820
E02000353,Hackney 009,Middle Super Output Areas and Intermediate Zones,MSOAIZ,N,7786,3751,4035,2238,2312
E02000354,Hackney 010,Middle Super Output Areas and Intermediate Zones,MSOAIZ,N,9502,4765,4737,2606,2472
E02000355,Hackney 011,Middle Super Output Areas and Intermediate Zones,MSOAIZ,E,8485,4202,4283,2381,2250
E02000356,Hackney 012,Middle Super Output Areas and Intermediate Zones,MSOAIZ,N,7346,3633,3713,2211,2187
E02000357,Hackney 013,Middle Super Output Areas and Intermediate Zones,MSOAIZ,E,6339,3019,3320,1178,1431
E02000358,Hackney 014,Middle Super Output Areas and Intermediate Zones,MSOAIZ,N,11058,5509,5549,3221,3182
E02000359,Hackney 015,Middle Super Output Areas and Intermediate Zones,MSOAIZ,E,6581,3179,3402,1623,1708
E02000360,Hackney 016,Middle Super Output Areas and Intermediate Zones,MSOAIZ,N,11292,5492,5800,2836,3051
E02000361,Hackney 017,Middle Super Output Areas and Intermediate Zones,MSOAIZ,E,7640,3808,3832,2202,2226
E02000362,Hackney 018,Middle Super Output Areas and Intermediate Zones,MSOAIZ,E,6363,3165,3198,1664,1651
E02000363,Hackney 019,Middle Super Output Areas and Intermediate Zones,MSOAIZ,E,10845,5305,5540,2454,2694
E02000364,Hackney 020,Middle Super Output Areas and Intermediate Zones,MSOAIZ,E,8867,4399,4468,2574,2510
E02000365,Hackney 021,Middle Super Output Areas and Intermediate Zones,MSOAIZ,N,12764,6457,6307,3979,3663
E02000366,Hackney 022,Middle Super Output Areas and Intermediate Zones,MSOAIZ,E,8514,4141,4373,2043,2144
E02000367,Hackney 023,Middle Super Output Areas and Intermediate Zones,MSOAIZ,E,9741,4699,5042,2855,3016
E02000368,Hackney 024,Middle Super Output Areas and Intermediate Zones,MSOAIZ,E,9614,4697,4917,2409,2523
E02000369,Hackney 025,Middle Super Output Areas and Intermediate Zones,MSOAIZ,N,11594,5889,5705,3347,3050
E02000370,Hackney 026,Middle Super Output Areas and Intermediate Zones,MSOAIZ,N,8301,4262,4039,2316,2154
E02000371,Hackney 027,Middle Super Output Areas and Intermediate Zones,MSOAIZ,N,12369,6510,5859,4066,3079
E02000372,Hammersmith and Fulham 001,Middle Super Output Areas and Intermediate Zones,MSOAIZ,W,9175,4350,4825,2181,2391
E02000373,Hammersmith and Fulham 002,Middle Super Output Areas and Intermediate Zones,MSOAIZ,WC,6658,3099,3559,1308,1615
E02000374,Hammersmith and Fulham 003,Middle Super Output Areas and Intermediate Zones,MSOAIZ,W,6731,3218,3513,1616,1748
E02000375,Hammersmith and Fulham 004,Middle Super Output Areas and Intermediate Zones,MSOAIZ,W,7028,3422,3606,1969,1926
E02000376,Hammersmith and Fulham 005,Middle Super Output Areas and Intermediate Zones,MSOAIZ,W,6915,3523,3392,2138,2003
E02000377,Hammersmith and Fulham 006,Middle Super Output Areas and Intermediate Zones,MSOAIZ,W,8169,4098,4071,2254,2196
E02000378,Hammersmith and Fulham 007,Middle Super Output Areas and Intermediate Zones,MSOAIZ,W,6534,3177,3357,2011,2002
E02000379,Hammersmith and Fulham 008,Middle Super Output Areas and Intermediate Zones,MSOAIZ,W,7581,3771,3810,2034,1980
E02000380,Hammersmith and Fulham 009,Middle Super Output Areas and Intermediate Zones,MSOAIZ,W,5863,2972,2891,1537,1567
E02000381,Hammersmith and Fulham 010,Middle Super Output Areas and Intermediate Zones,MSOAIZ,W,7768,3710,4058,2143,2281
E02000382,Hammersmith and Fulham 011,Middle Super Output Areas and Intermediate Zones,MSOAIZ,W,6167,3119,3048,1681,1656
E02000383,Hammersmith and Fulham 012,Middle Super Output Areas and Intermediate Zones,MSOAIZ,W,9432,4600,4832,2608,2624
E02000384,Hammersmith and Fulham 013,Middle Super Output Areas and Intermediate Zones,MSOAIZ,W,7320,3605,3715,1889,1908
E02000385,Hammersmith and Fulham 014,Middle Super Output Areas and Intermediate Zones,MSOAIZ,W,6162,3123,3039,2070,1939
E02000386,Hammersmith and Fulham 015,Middle Super Output Areas and Intermediate Zones,MSOAIZ,W,8136,4046,4090,2031,2128
E02000387,Hammersmith and Fulham 016,Middle Super Output Areas and Intermediate Zones,MSOAIZ,W,6272,3095,3177,1653,1634
E02000388,Hammersmith and Fulham 017,Middle Super Output Areas and Intermediate Zones,MSOAIZ,SW,8202,3965,4237,2294,2385
E02000389,Hammersmith and Fulham 018,Middle Super Output Areas and Intermediate Zones,MSOAIZ,W,8255,3954,4301,2064,2219
E02000390,Hammersmith and Fulham 019,Middle Super Output Areas and Intermediate Zones,MSOAIZ,SW,6448,3160,3288,1712,1802
E02000391,Hammersmith and Fulham 020,Middle Super Output Areas and Intermediate Zones,MSOAIZ,SW,7729,3802,3927,1968,2073
E02000392,Hammersmith and Fulham 021,Middle Super Output Areas and Intermediate Zones,MSOAIZ,SW,9578,4498,5080,2604,2874
E02000393,Hammersmith and Fulham 022,Middle Super Output Areas and Intermediate Zones,MSOAIZ,SW,6031,2839,3192,1686,1867
E02000394,Hammersmith and Fulham 023,Middle Super Output Areas and Intermediate Zones,MSOAIZ,SW,7755,3680,4075,1938,2210
E02000395,Hammersmith and Fulham 024,Middle Super Output Areas and Intermediate Zones,MSOAIZ,SW,5951,2862,3089,1568,1588
E02000396,Hammersmith and Fulham 025,Middle Super Output Areas and Intermediate Zones,MSOAIZ,SW,6633,3226,3407,1629,1795
E02000397,Haringey 001,Middle Super Output Areas and Intermediate Zones,MSOAIZ,N,7815,3896,3919,2204,2120
E02000398,Haringey 002,Middle Super Output Areas and Intermediate Zones,MSOAIZ,N,7123,3629,3494,1622,1605
E02000400,Haringey 004,Middle Super Output Areas and Intermediate Zones,MSOAIZ,N,7668,3757,3911,1835,1909
E02000401,Haringey 005,Middle Super Output Areas and Intermediate Zones,MSOAIZ,N,6734,3151,3583,1314,1588
E02000402,Haringey 006,Middle Super Output Areas and Intermediate Zones,MSOAIZ,N,6697,3080,3617,1274,1678
E02000403,Haringey 007,Middle Super Output Areas and Intermediate Zones,MSOAIZ,N,7199,3600,3599,2065,1963
E02000404,Haringey 008,Middle Super Output Areas and Intermediate Zones,MSOAIZ,N,7315,3621,3694,1758,1768
E02000405,Haringey 009,Middle Super Output Areas and Intermediate Zones,MSOAIZ,N,6548,3237,3311,1612,1681
E02000406,Haringey 010,Middle Super Output Areas and Intermediate Zones,MSOAIZ,N,7025,3380,3645,1707,1830
E02000407,Haringey 011,Middle Super Output Areas and Intermediate Zones,MSOAIZ,N,7312,3624,3688,1740,1776
E02000408,Haringey 012,Middle Super Output Areas and Intermediate Zones,MSOAIZ,N,7612,3721,3891,1535,1737
E02000409,Haringey 013,Middle Super Output Areas and Intermediate Zones,MSOAIZ,N,6527,3239,3288,1436,1542
E02000410,Haringey 014,Middle Super Output Areas and Intermediate Zones,MSOAIZ,N,6693,3240,3453,1723,1786
E02000411,Haringey 015,Middle Super Output Areas and Intermediate Zones,MSOAIZ,N,7452,3762,3690,1676,1696
E02000412,Haringey 016,Middle Super Output Areas and Intermediate Zones,MSOAIZ,N,6914,3404,3510,1867,1741
E02000413,Haringey 017,Middle Super Output Areas and Intermediate Zones,MSOAIZ,N,7500,3524,3976,1637,1861
E02000414,Haringey 018,Middle Super Output Areas and Intermediate Zones,MSOAIZ,N,7171,3652,3519,1898,1754
E02000415,Haringey 019,Middle Super Output Areas and Intermediate Zones,MSOAIZ,N,6845,3494,3351,1973,1648
E02000416,Haringey 020,Middle Super Output Areas and Intermediate Zones,MSOAIZ,N,7490,3671,3819,2042,2035
E02000417,Haringey 021,Middle Super Output Areas and Intermediate Zones,MSOAIZ,N,6676,3250,3426,1722,1802
E02000418,Haringey 022,Middle Super Output Areas and Intermediate Zones,MSOAIZ,N,5509,2603,2906,1272,1375
E02000419,Haringey 023,Middle Super Output Areas and Intermediate Zones,MSOAIZ,N,8108,4151,3957,2524,2101
E02000420,Haringey 024,Middle Super Output Areas and Intermediate Zones,MSOAIZ,N,7432,3689,3743,1903,1847
E02000421,Haringey 025,Middle Super Output Areas and Intermediate Zones,MSOAIZ,N,7148,3482,3666,1804,1837
E02000422,Haringey 026,Middle Super Output Areas and Intermediate Zones,MSOAIZ,N,7825,4008,3817,2119,1856
E02000423,Haringey 027,Middle Super Output Areas and Intermediate Zones,MSOAIZ,N,6813,3527,3286,2066,1756
E02000424,Haringey 028,Middle Super Output Areas and Intermediate Zones,MSOAIZ,N,7198,3556,3642,1995,2055
E02000425,Haringey 029,Middle Super Output Areas and Intermediate Zones,MSOAIZ,N,7256,3652,3604,1482,1495
E02000426,Haringey 030,Middle Super Output Areas and Intermediate Zones,MSOAIZ,N,6731,3278,3453,1664,1741
E02000427,Haringey 031,Middle Super Output Areas and Intermediate Zones,MSOAIZ,N,6854,3548,3306,2186,1899
E02000428,Haringey 032,Middle Super Output Areas and Intermediate Zones,MSOAIZ,N,7022,3526,3496,1746,1760
E02000429,Haringey 033,Middle Super Output Areas and Intermediate Zones,MSOAIZ,N,6852,3404,3448,1960,1890
E02000430,Haringey 034,Middle Super Output Areas and Intermediate Zones,MSOAIZ,N,7417,3733,3684,2393,2289
E02000431,Haringey 035,Middle Super Output Areas and Intermediate Zones,MSOAIZ,N,6685,3356,3329,2104,1942
E02000432,Haringey 036,Middle Super Output Areas and Intermediate Zones,MSOAIZ,N,6454,3221,3233,1982,1949
E02000433,Harrow 001,Middle Super Output Areas and Intermediate Zones,MSOAIZ,WD,7686,3530,4156,1377,1523
E02000434,Harrow 002,Middle Super Output Areas and Intermediate Zones,MSOAIZ,HA,8588,4170,4418,1726,1771
E02000435,Harrow 003,Middle Super Output Areas and Intermediate Zones,MSOAIZ,HA,7426,3594,3832,1395,1545
E02000436,Harrow 004,Middle Super Output Areas and Intermediate Zones,MSOAIZ,HA,5782,2812,2970,994,1086
E02000437,Harrow 005,Middle Super Output Areas and Intermediate Zones,MSOAIZ,HA,8377,4025,4352,1609,1795
E02000438,Harrow 006,Middle Super Output Areas and Intermediate Zones,MSOAIZ,HA,7910,3733,4177,1515,1695
E02000439,Harrow 007,Middle Super Output Areas and Intermediate Zones,MSOAIZ,HA,8206,4077,4129,1897,1846
E02000440,Harrow 008,Middle Super Output Areas and Intermediate Zones,MSOAIZ,HA,9569,4744,4825,1912,2067
E02000441,Harrow 009,Middle Super Output Areas and Intermediate Zones,MSOAIZ,HA,6714,3193,3521,1286,1454
E02000442,Harrow 010,Middle Super Output Areas and Intermediate Zones,MSOAIZ,HA,8706,4380,4326,2009,1975
E02000443,Harrow 011,Middle Super Output Areas and Intermediate Zones,MSOAIZ,HA,9470,4650,4820,2110,2108
E02000444,Harrow 012,Middle Super Output Areas and Intermediate Zones,MSOAIZ,HA,8499,4184,4315,1806,1882
E02000445,Harrow 013,Middle Super Output Areas and Intermediate Zones,MSOAIZ,HA,10250,5189,5061,2405,2398
E02000447,Harrow 015,Middle Super Output Areas and Intermediate Zones,MSOAIZ,HA,7058,3456,3602,1387,1533
E02000448,Harrow 016,Middle Super Output Areas and Intermediate Zones,MSOAIZ,HA,6641,3171,3470,1292,1362
E02000449,Harrow 017,Middle Super Output Areas and Intermediate Zones,MSOAIZ,NW,8137,4072,4065,1823,1836
E02000451,Harrow 019,Middle Super Output Areas and Intermediate Zones,MSOAIZ,HA,6550,3213,3337,1314,1375
E02000452,Harrow 020,Middle Super Output Areas and Intermediate Zones,MSOAIZ,HA,8218,4262,3956,2330,2043
E02000453,Harrow 021,Middle Super Output Areas and Intermediate Zones,MSOAIZ,HA,7620,3782,3838,1823,1825
E02000454,Harrow 022,Middle Super Output Areas and Intermediate Zones,MSOAIZ,HA,7082,3456,3626,1366,1472
E02000455,Harrow 023,Middle Super Output Areas and Intermediate Zones,MSOAIZ,HA,8135,4068,4067,2108,2005
E02000456,Harrow 024,Middle Super Output Areas and Intermediate Zones,MSOAIZ,HA,7059,3483,3576,1602,1675
E02000457,Harrow 025,Middle Super Output Areas and Intermediate Zones,MSOAIZ,HA,6314,3146,3168,1297,1305
E02000459,Harrow 027,Middle Super Output Areas and Intermediate Zones,MSOAIZ,HA,8235,4079,4156,1868,1935
E02000460,Harrow 028,Middle Super Output Areas and Intermediate Zones,MSOAIZ,HA,6518,3200,3318,1387,1485
E02000461,Harrow 029,Middle Super Output Areas and Intermediate Zones,MSOAIZ,UB,6947,3824,3123,1611,1563
E02000462,Harrow 030,Middle Super Output Areas and Intermediate Zones,MSOAIZ,UB,6632,3320,3312,1531,1434
E02000463,Harrow 031,Middle Super Output Areas and Intermediate Zones,MSOAIZ,UB,8429,4161,4268,1760,1892
E02000464,Havering 001,Middle Super Output Areas and Intermediate Zones,MSOAIZ,RM,6451,3071,3380,1171,1304
E02000465,Havering 002,Middle Super Output Areas and Intermediate Zones,MSOAIZ,RM,7930,3838,4092,1598,1731
E02000466,Havering 003,Middle Super Output Areas and Intermediate Zones,MSOAIZ,RM,8287,3905,4382,1494,1765
E02000467,Havering 004,Middle Super Output Areas and Intermediate Zones,MSOAIZ,RM,9643,4600,5043,1909,2135
E02000468,Havering 005,Middle Super Output Areas and Intermediate Zones,MSOAIZ,RM,7782,3691,4091,1432,1588
E02000469,Havering 006,Middle Super Output Areas and Intermediate Zones,MSOAIZ,RM,6443,3036,3407,1240,1377
E02000470,Havering 007,Middle Super Output Areas and Intermediate Zones,MSOAIZ,RM,7887,3842,4045,1585,1615
E02000471,Havering 008,Middle Super Output Areas and Intermediate Zones,MSOAIZ,RM,7457,3581,3876,1301,1387
E02000472,Havering 009,Middle Super Output Areas and Intermediate Zones,MSOAIZ,RM,8989,4345,4644,1742,1837
E02000473,Havering 010,Middle Super Output Areas and Intermediate Zones,MSOAIZ,RM,9588,4608,4980,1926,2022
E02000474,Havering 011,Middle Super Output Areas and Intermediate Zones,MSOAIZ,RM,8343,3961,4382,1700,1851
E02000475,Havering 012,Middle Super Output Areas and Intermediate Zones,MSOAIZ,RM,9196,4414,4782,1895,1933
E02000476,Havering 013,Middle Super Output Areas and Intermediate Zones,MSOAIZ,RM,8414,4130,4284,2073,1948
E02000477,Havering 014,Middle Super Output Areas and Intermediate Zones,MSOAIZ,RM,9360,4550,4810,1850,1873
E02000478,Havering 015,Middle Super Output Areas and Intermediate Zones,MSOAIZ,RM,5885,2901,2984,996,1021
E02000479,Havering 016,Middle Super Output Areas and Intermediate Zones,MSOAIZ,RM,8134,3871,4263,1895,1941
E02000480,Havering 017,Middle Super Output Areas and Intermediate Zones,MSOAIZ,RM,9795,4765,5030,2105,2182
E02000481,Havering 018,Middle Super Output Areas and Intermediate Zones,MSOAIZ,RM,7793,3637,4156,1340,1443
E02000482,Havering 019,Middle Super Output Areas and Intermediate Zones,MSOAIZ,RM,6396,3127,3269,1123,1124
E02000483,Havering 020,Middle Super Output Areas and Intermediate Zones,MSOAIZ,RM,7614,3606,4008,1479,1496
E02000484,Havering 021,Middle Super Output Areas and Intermediate Zones,MSOAIZ,RM,8199,4041,4158,1651,1734
E02000485,Havering 022,Middle Super Output Areas and Intermediate Zones,MSOAIZ,RM,7986,3792,4194,1628,1677
E02000486,Havering 023,Middle Super Output Areas and Intermediate Zones,MSOAIZ,RM,7366,3580,3786,1421,1500
E02000487,Havering 024,Middle Super Output Areas and Intermediate Zones,MSOAIZ,RM,7843,3771,4072,1323,1411
E02000488,Havering 025,Middle Super Output Areas and Intermediate Zones,MSOAIZ,RM,7431,3601,3830,1397,1436
E02000489,Havering 026,Middle Super Output Areas and Intermediate Zones,MSOAIZ,RM,7884,3792,4092,1507,1641
E02000490,Havering 027,Middle Super Output Areas and Intermediate Zones,MSOAIZ,RM,7828,3728,4100,1400,1529
E02000491,Havering 028,Middle Super Output Areas and Intermediate Zones,MSOAIZ,RM,8826,4406,4420,1728,1795
E02000492,Havering 029,Middle Super Output Areas and Intermediate Zones,MSOAIZ,RM,6272,3076,3196,1114,1124
E02000493,Havering 030,Middle Super Output Areas and Intermediate Zones,MSOAIZ,RM,6210,2943,3267,1250,1437
E02000494,Hillingdon 001,Middle Super Output Areas and Intermediate Zones,MSOAIZ,WD,7479,3559,3920,1396,1566
E02000495,Hillingdon 002,Middle Super Output Areas and Intermediate Zones,MSOAIZ,UB,9473,4514,4959,2040,2157
E02000496,Hillingdon 003,Middle Super Output Areas and Intermediate Zones,MSOAIZ,WD,7399,3565,3834,1545,1667
E02000497,Hillingdon 004,Middle Super Output Areas and Intermediate Zones,MSOAIZ,TW,8529,4082,4447,1731,1873
E02000498,Hillingdon 005,Middle Super Output Areas and Intermediate Zones,MSOAIZ,UB,6020,2919,3101,1138,1292
E02000499,Hillingdon 006,Middle Super Output Areas and Intermediate Zones,MSOAIZ,HA,7765,3774,3991,1491,1543
E02000500,Hillingdon 007,Middle Super Output Areas and Intermediate Zones,MSOAIZ,HA,7714,3829,3885,1560,1544
E02000501,Hillingdon 008,Middle Super Output Areas and Intermediate Zones,MSOAIZ,HA,8247,3944,4303,1692,1837
E02000502,Hillingdon 009,Middle Super Output Areas and Intermediate Zones,MSOAIZ,UB,7613,3650,3963,1726,1745
E02000503,Hillingdon 010,Middle Super Output Areas and Intermediate Zones,MSOAIZ,HA,8986,4558,4428,2166,2075
E02000504,Hillingdon 011,Middle Super Output Areas and Intermediate Zones,MSOAIZ,UB,7382,3601,3781,1406,1460
E02000506,Hillingdon 013,Middle Super Output Areas and Intermediate Zones,MSOAIZ,UB,7541,3692,3849,1448,1457
E02000507,Hillingdon 014,Middle Super Output Areas and Intermediate Zones,MSOAIZ,UB,7943,3942,4001,1649,1715
E02000508,Hillingdon 015,Middle Super Output Areas and Intermediate Zones,MSOAIZ,UB,9184,4882,4302,1848,1615
E02000509,Hillingdon 016,Middle Super Output Areas and Intermediate Zones,MSOAIZ,UB,9823,4926,4897,1929,1759
E02000510,Hillingdon 017,Middle Super Output Areas and Intermediate Zones,MSOAIZ,UB,8634,4267,4367,1796,1809
E02000511,Hillingdon 018,Middle Super Output Areas and Intermediate Zones,MSOAIZ,UB,9426,4717,4709,1907,1997
E02000512,Hillingdon 019,Middle Super Output Areas and Intermediate Zones,MSOAIZ,UB,8001,4004,3997,1659,1744
E02000513,Hillingdon 020,Middle Super Output Areas and Intermediate Zones,MSOAIZ,UB,8980,4347,4633,1923,2098
E02000514,Hillingdon 021,Middle Super Output Areas and Intermediate Zones,MSOAIZ,UB,9820,5031,4789,2213,2158
E02000515,Hillingdon 022,Middle Super Output Areas and Intermediate Zones,MSOAIZ,UB,10439,5271,5168,2426,2363
E02000516,Hillingdon 023,Middle Super Output Areas and Intermediate Zones,MSOAIZ,UB,8269,4123,4146,1879,2001
E02000517,Hillingdon 024,Middle Super Output Areas and Intermediate Zones,MSOAIZ,UB,8626,4194,4432,1733,1903
E02000518,Hillingdon 025,Middle Super Output Areas and Intermediate Zones,MSOAIZ,UB,8606,4225,4381,1823,1880
E02000519,Hillingdon 026,Middle Super Output Areas and Intermediate Zones,MSOAIZ,UB,8658,4376,4282,1817,1933
E02000520,Hillingdon 027,Middle Super Output Areas and Intermediate Zones,MSOAIZ,UB,11251,5717,5534,2552,2460
E02000521,Hillingdon 028,Middle Super Output Areas and Intermediate Zones,MSOAIZ,UB,9912,4874,5038,2160,2262
E02000522,Hillingdon 029,Middle Super Output Areas and Intermediate Zones,MSOAIZ,UB,8653,4235,4418,1812,1943
E02000523,Hillingdon 030,Middle Super Output Areas and Intermediate Zones,MSOAIZ,UB,9636,4866,4770,2229,2147
E02000524,Hillingdon 031,Middle Super Output Areas and Intermediate Zones,MSOAIZ,UB,6663,3596,3067,1879,1420
E02000525,Hillingdon 032,Middle Super Output Areas and Intermediate Zones,MSOAIZ,UB,8826,4449,4377,2111,2089
E02000526,Hounslow 001,Middle Super Output Areas and Intermediate Zones,MSOAIZ,W,8378,4029,4349,2160,2217
E02000528,Hounslow 003,Middle Super Output Areas and Intermediate Zones,MSOAIZ,W,10614,5187,5427,2632,2754
E02000529,Hounslow 004,Middle Super Output Areas and Intermediate Zones,MSOAIZ,UB,8448,4299,4149,1941,1851
E02000530,Hounslow 005,Middle Super Output Areas and Intermediate Zones,MSOAIZ,UB,6837,3358,3479,1461,1487
E02000531,Hounslow 006,Middle Super Output Areas and Intermediate Zones,MSOAIZ,W,10337,5062,5275,2542,2511
E02000532,Hounslow 007,Middle Super Output Areas and Intermediate Zones,MSOAIZ,W,9160,4523,4637,2206,2220
E02000533,Hounslow 008,Middle Super Output Areas and Intermediate Zones,MSOAIZ,W,8406,4216,4190,2125,2111
E02000534,Hounslow 009,Middle Super Output Areas and Intermediate Zones,MSOAIZ,TW,8044,4112,3932,2089,1867
E02000535,Hounslow 010,Middle Super Output Areas and Intermediate Zones,MSOAIZ,TW,9291,4779,4512,2205,2020
E02000536,Hounslow 011,Middle Super Output Areas and Intermediate Zones,MSOAIZ,TW,9269,4726,4543,2144,2079
E02000537,Hounslow 012,Middle Super Output Areas and Intermediate Zones,MSOAIZ,TW,8620,4542,4078,2304,1986
E02000538,Hounslow 013,Middle Super Output Areas and Intermediate Zones,MSOAIZ,TW,8680,4496,4184,2072,1903
E02000539,Hounslow 014,Middle Super Output Areas and Intermediate Zones,MSOAIZ,TW,10752,5191,5561,2735,2903
E02000540,Hounslow 015,Middle Super Output Areas and Intermediate Zones,MSOAIZ,TW,9246,4807,4439,2491,2071
E02000541,Hounslow 016,Middle Super Output Areas and Intermediate Zones,MSOAIZ,TW,8875,4511,4364,2177,2012
E02000542,Hounslow 017,Middle Super Output Areas and Intermediate Zones,MSOAIZ,TW,9396,4825,4571,2455,2173
E02000543,Hounslow 018,Middle Super Output Areas and Intermediate Zones,MSOAIZ,TW,11713,6109,5604,3378,2933
E02000544,Hounslow 019,Middle Super Output Areas and Intermediate Zones,MSOAIZ,TW,8199,4093,4106,1844,1852
E02000545,Hounslow 020,Middle Super Output Areas and Intermediate Zones,MSOAIZ,TW,8181,3947,4234,1861,1999
E02000546,Hounslow 021,Middle Super Output Areas and Intermediate Zones,MSOAIZ,TW,9750,5004,4746,2366,2246
E02000547,Hounslow 022,Middle Super Output Areas and Intermediate Zones,MSOAIZ,TW,9360,4648,4712,2100,2143
E02000548,Hounslow 023,Middle Super Output Areas and Intermediate Zones,MSOAIZ,TW,9103,4468,4635,2029,2108
E02000549,Hounslow 024,Middle Super Output Areas and Intermediate Zones,MSOAIZ,TW,11017,5484,5533,2497,2367
E02000550,Hounslow 025,Middle Super Output Areas and Intermediate Zones,MSOAIZ,TW,10403,5117,5286,2495,2646
E02000551,Hounslow 026,Middle Super Output Areas and Intermediate Zones,MSOAIZ,TW,8614,4246,4368,1765,1995
E02000552,Hounslow 027,Middle Super Output Areas and Intermediate Zones,MSOAIZ,TW,8266,4222,4044,2075,1999
E02000553,Hounslow 028,Middle Super Output Areas and Intermediate Zones,MSOAIZ,TW,6605,3230,3375,1406,1478
E02000554,Islington 001,Middle Super Output Areas and Intermediate Zones,MSOAIZ,N,9182,4387,4795,2302,2537
E02000555,Islington 002,Middle Super Output Areas and Intermediate Zones,MSOAIZ,N,9408,4449,4959,2287,2491
E02000556,Islington 003,Middle Super Output Areas and Intermediate Zones,MSOAIZ,N,10008,4922,5086,2832,2850
E02000557,Islington 004,Middle Super Output Areas and Intermediate Zones,MSOAIZ,NW,8124,3878,4246,2156,2227
E02000558,Islington 005,Middle Super Output Areas and Intermediate Zones,MSOAIZ,N,8870,4363,4507,2119,2102
E02000559,Islington 006,Middle Super Output Areas and Intermediate Zones,MSOAIZ,N,8778,4496,4282,2694,2498
E02000560,Islington 007,Middle Super Output Areas and Intermediate Zones,MSOAIZ,N,7076,3614,3462,2126,1879
E02000561,Islington 008,Middle Super Output Areas and Intermediate Zones,MSOAIZ,N,7746,3780,3966,2022,2099
E02000562,Islington 009,Middle Super Output Areas and Intermediate Zones,MSOAIZ,N,7934,3834,4100,2052,2190
E02000563,Islington 010,Middle Super Output Areas and Intermediate Zones,MSOAIZ,N,8486,4075,4411,2077,2299
E02000564,Islington 011,Middle Super Output Areas and Intermediate Zones,MSOAIZ,N,10488,5184,5304,3242,3093
E02000565,Islington 012,Middle Super Output Areas and Intermediate Zones,MSOAIZ,N,8187,3904,4283,2034,2323
E02000566,Islington 013,Middle Super Output Areas and Intermediate Zones,MSOAIZ,N,8164,3992,4172,2331,2371
E02000567,Islington 014,Middle Super Output Areas and Intermediate Zones,MSOAIZ,N,10358,4888,5470,2859,3173
E02000568,Islington 015,Middle Super Output Areas and Intermediate Zones,MSOAIZ,N,9625,4945,4680,2466,2158
E02000569,Islington 016,Middle Super Output Areas and Intermediate Zones,MSOAIZ,N,10022,4769,5253,2568,2807
E02000570,Islington 017,Middle Super Output Areas and Intermediate Zones,MSOAIZ,N,8615,4303,4312,2494,2507
E02000571,Islington 018,Middle Super Output Areas and Intermediate Zones,MSOAIZ,N,8031,3948,4083,2137,2147
E02000572,Islington 019,Middle Super Output Areas and Intermediate Zones,MSOAIZ,N,8571,4071,4500,1769,1943
E02000573,Islington 020,Middle Super Output Areas and Intermediate Zones,MSOAIZ,N,8674,4368,4306,2624,2458
E02000574,Islington 021,Middle Super Output Areas and Intermediate Zones,MSOAIZ,WC,8501,4198,4303,2420,2203
E02000575,Islington 022,Middle Super Output Areas and Intermediate Zones,MSOAIZ,WC,11889,6226,5663,3332,2809
E02000576,Islington 023,Middle Super Output Areas and Intermediate Zones,MSOAIZ,N,9388,4811,4577,2467,2143
E02000577,Kensington and Chelsea 001,Middle Super Output Areas and Intermediate Zones,MSOAIZ,W,7199,3523,3676,1602,1796
E02000578,Kensington and Chelsea 002,Middle Super Output Areas and Intermediate Zones,MSOAIZ,W,5798,2752,3046,1158,1463
E02000579,Kensington and Chelsea 003,Middle Super Output Areas and Intermediate Zones,MSOAIZ,W,8616,4091,4525,2044,2368
E02000580,Kensington and Chelsea 004,Middle Super Output Areas and Intermediate Zones,MSOAIZ,W,8655,4246,4409,2423,2489
E02000581,Kensington and Chelsea 005,Middle Super Output Areas and Intermediate Zones,MSOAIZ,W,7298,3415,3883,1472,1749
E02000582,Kensington and Chelsea 006,Middle Super Output Areas and Intermediate Zones,MSOAIZ,W,7659,3758,3901,2152,2189
E02000583,Kensington and Chelsea 007,Middle Super Output Areas and Intermediate Zones,MSOAIZ,W,7303,3485,3818,1854,2006
E02000584,Kensington and Chelsea 008,Middle Super Output Areas and Intermediate Zones,MSOAIZ,W,8178,3972,4206,2161,2166
E02000585,Kensington and Chelsea 009,Middle Super Output Areas and Intermediate Zones,MSOAIZ,W,8384,4094,4290,2182,2235
E02000586,Kensington and Chelsea 010,Middle Super Output Areas and Intermediate Zones,MSOAIZ,W,7769,3912,3857,2085,2026
E02000587,Kensington and Chelsea 011,Middle Super Output Areas and Intermediate Zones,MSOAIZ,W,7523,3743,3780,1974,1842
E02000588,Kensington and Chelsea 012,Middle Super Output Areas and Intermediate Zones,MSOAIZ,SW,8159,4225,3934,2329,2047
E02000589,Kensington and Chelsea 013,Middle Super Output Areas and Intermediate Zones,MSOAIZ,W,8444,4520,3924,2634,2063
E02000590,Kensington and Chelsea 014,Middle Super Output Areas and Intermediate Zones,MSOAIZ,SW,7015,3330,3685,1658,1783
E02000591,Kensington and Chelsea 015,Middle Super Output Areas and Intermediate Zones,MSOAIZ,W,6769,3477,3292,2099,1723
E02000592,Kensington and Chelsea 016,Middle Super Output Areas and Intermediate Zones,MSOAIZ,SW,6761,3369,3392,1960,1832
E02000593,Kensington and Chelsea 017,Middle Super Output Areas and Intermediate Zones,MSOAIZ,SW,7624,3908,3716,2419,2080
E02000594,Kensington and Chelsea 018,Middle Super Output Areas and Intermediate Zones,MSOAIZ,SW,7252,3625,3627,1696,1719
E02000595,Kensington and Chelsea 019,Middle Super Output Areas and Intermediate Zones,MSOAIZ,SW,7331,3472,3859,1821,1836
E02000596,Kensington and Chelsea 020,Middle Super Output Areas and Intermediate Zones,MSOAIZ,SW,7782,3900,3882,1982,2045
E02000597,Kensington and Chelsea 021,Middle Super Output Areas and Intermediate Zones,MSOAIZ,SW,7130,3377,3753,1625,1843
E02000598,Kingston upon Thames 001,Middle Super Output Areas and Intermediate Zones,MSOAIZ,TW,7837,3752,4085,1595,1806
E02000599,Kingston upon Thames 002,Middle Super Output Areas and Intermediate Zones,MSOAIZ,SW,7270,3480,3790,1272,1326
E02000600,Kingston upon Thames 003,Middle Super Output Areas and Intermediate Zones,MSOAIZ,KT,8225,3960,4265,1852,1963
E02000601,Kingston upon Thames 004,Middle Super Output Areas and Intermediate Zones,MSOAIZ,KT,10409,5156,5253,2557,2584
E02000602,Kingston upon Thames 005,Middle Super Output Areas and Intermediate Zones,MSOAIZ,KT,9390,4602,4788,2209,2068
E02000603,Kingston upon Thames 006,Middle Super Output Areas and Intermediate Zones,MSOAIZ,KT,7860,3750,4110,1623,1766
E02000604,Kingston upon Thames 007,Middle Super Output Areas and Intermediate Zones,MSOAIZ,KT,8586,4168,4418,1960,1978
E02000605,Kingston upon Thames 008,Middle Super Output Areas and Intermediate Zones,MSOAIZ,KT,7863,3784,4079,1680,1722
E02000606,Kingston upon Thames 009,Middle Super Output Areas and Intermediate Zones,MSOAIZ,KT,10107,5132,4975,2798,2378
E02000607,Kingston upon Thames 010,Middle Super Output Areas and Intermediate Zones,MSOAIZ,KT,6829,3331,3498,1416,1412
E02000608,Kingston upon Thames 011,Middle Super Output Areas and Intermediate Zones,MSOAIZ,KT,6993,3483,3510,2027,1816
E02000609,Kingston upon Thames 012,Middle Super Output Areas and Intermediate Zones,MSOAIZ,KT,7437,3598,3839,1432,1527
E02000610,Kingston upon Thames 013,Middle Super Output Areas and Intermediate Zones,MSOAIZ,KT,7629,3789,3840,2042,1915
E02000611,Kingston upon Thames 014,Middle Super Output Areas and Intermediate Zones,MSOAIZ,KT,7313,3662,3651,1382,1432
E02000612,Kingston upon Thames 015,Middle Super Output Areas and Intermediate Zones,MSOAIZ,KT,8028,3909,4119,1628,1678
E02000613,Kingston upon Thames 016,Middle Super Output Areas and Intermediate Zones,MSOAIZ,KT,7841,3733,4108,1830,1905
E02000614,Kingston upon Thames 017,Middle Super Output Areas and Intermediate Zones,MSOAIZ,KT,8404,4117,4287,1807,1870
E02000615,Kingston upon Thames 018,Middle Super Output Areas and Intermediate Zones,MSOAIZ,KT,7471,3642,3829,1639,1632
E02000616,Kingston upon Thames 019,Middle Super Output Areas and Intermediate Zones,MSOAIZ,KT,6031,2973,3058,1340,1400
E02000617,Kingston upon Thames 020,Middle Super Output Areas and Intermediate Zones,MSOAIZ,KT,8537,4082,4455,1716,1925
E02000619,Lambeth 002,Middle Super Output Areas and Intermediate Zones,MSOAIZ,SE,8054,4069,3985,2132,1939
E02000620,Lambeth 003,Middle Super Output Areas and Intermediate Zones,MSOAIZ,SE,9370,4895,4475,2912,2408
E02000621,Lambeth 004,Middle Super Output Areas and Intermediate Zones,MSOAIZ,SW,10429,5649,4780,3529,2680
E02000622,Lambeth 005,Middle Super Output Areas and Intermediate Zones,MSOAIZ,SW,8094,4277,3817,2555,2115
E02000623,Lambeth 006,Middle Super Output Areas and Intermediate Zones,MSOAIZ,SW,7990,4049,3941,2135,2071
E02000624,Lambeth 007,Middle Super Output Areas and Intermediate Zones,MSOAIZ,SW,7976,4025,3951,2239,2088
E02000625,Lambeth 008,Middle Super Output Areas and Intermediate Zones,MSOAIZ,SW,8361,4239,4122,2202,2164
E02000626,Lambeth 009,Middle Super Output Areas and Intermediate Zones,MSOAIZ,SW,8301,4067,4234,2075,2031
E02000627,Lambeth 010,Middle Super Output Areas and Intermediate Zones,MSOAIZ,SW,9571,4837,4734,2774,2625
E02000628,Lambeth 011,Middle Super Output Areas and Intermediate Zones,MSOAIZ,SW,9731,4874,4857,2523,2463
E02000629,Lambeth 012,Middle Super Output Areas and Intermediate Zones,MSOAIZ,SW,9033,4570,4463,2935,2643
E02000630,Lambeth 013,Middle Super Output Areas and Intermediate Zones,MSOAIZ,SW,7266,3609,3657,2266,2122
E02000631,Lambeth 014,Middle Super Output Areas and Intermediate Zones,MSOAIZ,SW,8832,4290,4542,2378,2433
E02000632,Lambeth 015,Middle Super Output Areas and Intermediate Zones,MSOAIZ,SW,9516,4829,4687,3259,2947
E02000633,Lambeth 016,Middle Super Output Areas and Intermediate Zones,MSOAIZ,SW,8642,4286,4356,2468,2444
E02000634,Lambeth 017,Middle Super Output Areas and Intermediate Zones,MSOAIZ,SW,6846,3392,3454,1921,1898
E02000635,Lambeth 018,Middle Super Output Areas and Intermediate Zones,MSOAIZ,SW,9157,4568,4589,2732,2712
E02000636,Lambeth 019,Middle Super Output Areas and Intermediate Zones,MSOAIZ,SW,7639,3829,3810,2355,2274
E02000637,Lambeth 020,Middle Super Output Areas and Intermediate Zones,MSOAIZ,SW,8687,4427,4260,2788,2626
E02000638,Lambeth 021,Middle Super Output Areas and Intermediate Zones,MSOAIZ,SW,9898,4959,4939,2906,2789
E02000639,Lambeth 022,Middle Super Output Areas and Intermediate Zones,MSOAIZ,SW,8119,3925,4194,1971,2208
E02000640,Lambeth 023,Middle Super Output Areas and Intermediate Zones,MSOAIZ,SW,9123,4336,4787,2499,2705
E02000641,Lambeth 024,Middle Super Output Areas and Intermediate Zones,MSOAIZ,SW,8779,4138,4641,1928,2374
E02000642,Lambeth 025,Middle Super Output Areas and Intermediate Zones,MSOAIZ,SW,9628,4692,4936,2451,2586
E02000643,Lambeth 026,Middle Super Output Areas and Intermediate Zones,MSOAIZ,SW,8369,4014,4355,2267,2437
E02000644,Lambeth 027,Middle Super Output Areas and Intermediate Zones,MSOAIZ,SW,8620,4213,4407,2300,2382
E02000645,Lambeth 028,Middle Super Output Areas and Intermediate Zones,MSOAIZ,SE,9020,4424,4596,2431,2555
E02000646,Lambeth 029,Middle Super Output Areas and Intermediate Zones,MSOAIZ,SW,9121,4511,4610,2689,2597
E02000647,Lambeth 030,Middle Super Output Areas and Intermediate Zones,MSOAIZ,SW,8483,4179,4304,2073,2093
E02000648,Lambeth 031,Middle Super Output Areas and Intermediate Zones,MSOAIZ,SW,7791,3579,4212,1565,2030
E02000649,Lambeth 032,Middle Super Output Areas and Intermediate Zones,MSOAIZ,SW,11181,5567,5614,3206,3226
E02000650,Lambeth 033,Middle Super Output Areas and Intermediate Zones,MSOAIZ,SE,7424,3472,3952,1809,2055
E02000651,Lambeth 034,Middle Super Output Areas and Intermediate Zones,MSOAIZ,SW,8591,4260,4331,2173,2215
E02000652,Lambeth 035,Middle Super Output Areas and Intermediate Zones,MSOAIZ,SW,7363,3633,3730,1654,1717
E02000653,Lewisham 001,Middle Super Output Areas and Intermediate Zones,MSOAIZ,SE,8544,4308,4236,2200,2186
E02000654,Lewisham 002,Middle Super Output Areas and Intermediate Zones,MSOAIZ,SE,8059,3856,4203,1837,2052
E02000655,Lewisham 003,Middle Super Output Areas and Intermediate Zones,MSOAIZ,SE,8208,4069,4139,2166,2079
E02000657,Lewisham 005,Middle Super Output Areas and Intermediate Zones,MSOAIZ,SE,9078,4540,4538,2391,2235
E02000658,Lewisham 006,Middle Super Output Areas and Intermediate Zones,MSOAIZ,SE,8314,4310,4004,2311,1997
E02000659,Lewisham 007,Middle Super Output Areas and Intermediate Zones,MSOAIZ,SE,7697,3674,4023,1937,2051
E02000660,Lewisham 008,Middle Super Output Areas and Intermediate Zones,MSOAIZ,SE,8078,4018,4060,2497,2348
E02000661,Lewisham 009,Middle Super Output Areas and Intermediate Zones,MSOAIZ,SE,6342,3116,3226,1794,1738
E02000662,Lewisham 010,Middle Super Output Areas and Intermediate Zones,MSOAIZ,SE,8100,3859,4241,2170,2119
E02000663,Lewisham 011,Middle Super Output Areas and Intermediate Zones,MSOAIZ,SE,7194,3761,3433,2091,1784
E02000664,Lewisham 012,Middle Super Output Areas and Intermediate Zones,MSOAIZ,SE,9928,5062,4866,2785,2595
E02000665,Lewisham 013,Middle Super Output Areas and Intermediate Zones,MSOAIZ,SE,7916,3950,3966,2093,2059
E02000666,Lewisham 014,Middle Super Output Areas and Intermediate Zones,MSOAIZ,SE,7321,3423,3898,1749,1875
E02000667,Lewisham 015,Middle Super Output Areas and Intermediate Zones,MSOAIZ,SE,6534,3101,3433,1701,1729
E02000668,Lewisham 016,Middle Super Output Areas and Intermediate Zones,MSOAIZ,SE,6657,3309,3348,1588,1651
E02000669,Lewisham 017,Middle Super Output Areas and Intermediate Zones,MSOAIZ,SE,7518,3771,3747,2117,2044
E02000670,Lewisham 018,Middle Super Output Areas and Intermediate Zones,MSOAIZ,SE,6539,3143,3396,1522,1661
E02000671,Lewisham 019,Middle Super Output Areas and Intermediate Zones,MSOAIZ,SE,8403,4098,4305,2207,2305
E02000672,Lewisham 020,Middle Super Output Areas and Intermediate Zones,MSOAIZ,SE,8377,4313,4064,2204,2091
E02000673,Lewisham 021,Middle Super Output Areas and Intermediate Zones,MSOAIZ,SE,8007,4060,3947,2149,2116
E02000674,Lewisham 022,Middle Super Output Areas and Intermediate Zones,MSOAIZ,SE,8015,3773,4242,1696,1979
E02000675,Lewisham 023,Middle Super Output Areas and Intermediate Zones,MSOAIZ,SE,8204,3953,4251,1779,1978
E02000676,Lewisham 024,Middle Super Output Areas and Intermediate Zones,MSOAIZ,SE,7713,3774,3939,2045,2109
E02000677,Lewisham 025,Middle Super Output Areas and Intermediate Zones,MSOAIZ,SE,7199,3561,3638,1540,1629
E02000678,Lewisham 026,Middle Super Output Areas and Intermediate Zones,MSOAIZ,SE,6087,2840,3247,1187,1501
E02000679,Lewisham 027,Middle Super Output Areas and Intermediate Zones,MSOAIZ,SE,7905,3931,3974,1960,1952
E02000680,Lewisham 028,Middle Super Output Areas and Intermediate Zones,MSOAIZ,SE,6847,3380,3467,1719,1650
E02000681,Lewisham 029,Middle Super Output Areas and Intermediate Zones,MSOAIZ,SE,8094,3853,4241,1628,1937
E02000682,Lewisham 030,Middle Super Output Areas and Intermediate Zones,MSOAIZ,SE,8162,3856,4306,1587,1848
E02000683,Lewisham 031,Middle Super Output Areas and Intermediate Zones,MSOAIZ,SE,6444,3023,3421,1287,1535
E02000685,Lewisham 033,Middle Super Output Areas and Intermediate Zones,MSOAIZ,SE,7679,3627,4052,1767,1923
E02000686,Lewisham 034,Middle Super Output Areas and Intermediate Zones,MSOAIZ,SE,6681,3132,3549,1344,1688
E02000687,Lewisham 035,Middle Super Output Areas and Intermediate Zones,MSOAIZ,SE,7926,3966,3960,2017,1950
E02000689,Merton 001,Middle Super Output Areas and Intermediate Zones,MSOAIZ,SW,8258,4035,4223,2167,2219
E02000690,Merton 002,Middle Super Output Areas and Intermediate Zones,MSOAIZ,SW,5656,2780,2876,1094,1128
E02000691,Merton 003,Middle Super Output Areas and Intermediate Zones,MSOAIZ,SW,7334,3663,3671,2112,2029
E02000692,Merton 004,Middle Super Output Areas and Intermediate Zones,MSOAIZ,SW,7662,3720,3942,2143,2053
E02000693,Merton 005,Middle Super Output Areas and Intermediate Zones,MSOAIZ,SW,9173,4710,4463,2902,2695
E02000694,Merton 006,Middle Super Output Areas and Intermediate Zones,MSOAIZ,SW,8730,4273,4457,2584,2586
E02000695,Merton 007,Middle Super Output Areas and Intermediate Zones,MSOAIZ,SW,8287,4337,3950,2208,1850
E02000696,Merton 008,Middle Super Output Areas and Intermediate Zones,MSOAIZ,SW,8072,4059,4013,2268,2184
E02000697,Merton 009,Middle Super Output Areas and Intermediate Zones,MSOAIZ,SW,8217,4127,4090,2656,2503
E02000698,Merton 010,Middle Super Output Areas and Intermediate Zones,MSOAIZ,SW,7816,3764,4052,1692,1869
E02000699,Merton 011,Middle Super Output Areas and Intermediate Zones,MSOAIZ,SW,7689,3757,3932,2094,2174
E02000700,Merton 012,Middle Super Output Areas and Intermediate Zones,MSOAIZ,SW,8290,4006,4284,2134,2203
E02000701,Merton 013,Middle Super Output Areas and Intermediate Zones,MSOAIZ,CR,8416,4147,4269,1937,1974
E02000702,Merton 014,Middle Super Output Areas and Intermediate Zones,MSOAIZ,SW,7638,3705,3933,1701,1836
E02000703,Merton 015,Middle Super Output Areas and Intermediate Zones,MSOAIZ,SW,7825,3926,3899,1692,1697
E02000704,Merton 016,Middle Super Output Areas and Intermediate Zones,MSOAIZ,SW,7742,3799,3943,2086,2098
E02000705,Merton 017,Middle Super Output Areas and Intermediate Zones,MSOAIZ,SW,8124,3954,4170,1705,1825
E02000706,Merton 018,Middle Super Output Areas and Intermediate Zones,MSOAIZ,SW,8605,4126,4479,1901,2067
E02000707,Merton 019,Middle Super Output Areas and Intermediate Zones,MSOAIZ,CR,7486,3597,3889,1472,1690
E02000708,Merton 020,Middle Super Output Areas and Intermediate Zones,MSOAIZ,SW,8286,4085,4201,1866,1938
E02000709,Merton 021,Middle Super Output Areas and Intermediate Zones,MSOAIZ,SW,7701,3798,3903,1625,1616
E02000710,Merton 022,Middle Super Output Areas and Intermediate Zones,MSOAIZ,SW,8329,4073,4256,1816,1840
E02000711,Merton 023,Middle Super Output Areas and Intermediate Zones,MSOAIZ,SW,8158,4073,4085,1959,1967
E02000712,Merton 024,Middle Super Output Areas and Intermediate Zones,MSOAIZ,SM,8709,4280,4429,1880,1940
E02000713,Merton 025,Middle Super Output Areas and Intermediate Zones,MSOAIZ,SW,7490,3721,3769,1555,1643
E02000714,Newham 001,Middle Super Output Areas and Intermediate Zones,MSOAIZ,E,8133,4164,3969,2140,1889
E02000715,Newham 002,Middle Super Output Areas and Intermediate Zones,MSOAIZ,E,7381,3829,3552,1782,1490
E02000716,Newham 003,Middle Super Output Areas and Intermediate Zones,MSOAIZ,E,7354,3912,3442,1918,1602
E02000717,Newham 004,Middle Super Output Areas and Intermediate Zones,MSOAIZ,E,8101,4305,3796,2096,1668
E02000718,Newham 005,Middle Super Output Areas and Intermediate Zones,MSOAIZ,E,6844,3429,3415,1439,1473
E02000719,Newham 006,Middle Super Output Areas and Intermediate Zones,MSOAIZ,E,8216,4243,3973,2226,1906
E02000720,Newham 007,Middle Super Output Areas and Intermediate Zones,MSOAIZ,E,7483,4104,3379,1974,1573
E02000721,Newham 008,Middle Super Output Areas and Intermediate Zones,MSOAIZ,E,9665,5243,4422,2568,1901
E02000722,Newham 009,Middle Super Output Areas and Intermediate Zones,MSOAIZ,E,8226,4255,3971,2361,2074
E02000723,Newham 010,Middle Super Output Areas and Intermediate Zones,MSOAIZ,E,10600,5779,4821,2851,2143
E02000724,Newham 011,Middle Super Output Areas and Intermediate Zones,MSOAIZ,E,9415,5203,4212,2494,1816
E02000725,Newham 012,Middle Super Output Areas and Intermediate Zones,MSOAIZ,E,8876,4512,4364,2589,2269
E02000726,Newham 013,Middle Super Output Areas and Intermediate Zones,MSOAIZ,E,8892,4739,4153,2780,2241
E02000727,Newham 014,Middle Super Output Areas and Intermediate Zones,MSOAIZ,E,8305,4710,3595,2426,1657
E02000728,Newham 015,Middle Super Output Areas and Intermediate Zones,MSOAIZ,E,8227,4440,3787,2251,1730
E02000729,Newham 016,Middle Super Output Areas and Intermediate Zones,MSOAIZ,E,7080,3712,3368,1891,1562
E02000730,Newham 017,Middle Super Output Areas and Intermediate Zones,MSOAIZ,E,8992,5026,3966,2472,1781
E02000731,Newham 018,Middle Super Output Areas and Intermediate Zones,MSOAIZ,E,10073,5718,4355,2986,1978
E02000732,Newham 019,Middle Super Output Areas and Intermediate Zones,MSOAIZ,E,7566,4052,3514,1932,1505
E02000733,Newham 020,Middle Super Output Areas and Intermediate Zones,MSOAIZ,E,9754,4899,4855,2430,2275
E02000734,Newham 021,Middle Super Output Areas and Intermediate Zones,MSOAIZ,E,7642,3932,3710,1921,1777
E02000735,Newham 022,Middle Super Output Areas and Intermediate Zones,MSOAIZ,E,7582,4089,3493,1990,1535
E02000736,Newham 023,Middle Super Output Areas and Intermediate Zones,MSOAIZ,IG,8571,4392,4179,1992,1873
E02000737,Newham 024,Middle Super Output Areas and Intermediate Zones,MSOAIZ,E,9434,4763,4671,2192,2115
E02000738,Newham 025,Middle Super Output Areas and Intermediate Zones,MSOAIZ,E,8467,4405,4062,2130,1883
E02000739,Newham 026,Middle Super Output Areas and Intermediate Zones,MSOAIZ,E,6894,3529,3365,1725,1616
E02000740,Newham 027,Middle Super Output Areas and Intermediate Zones,MSOAIZ,E,6779,3345,3434,1660,1685
E02000741,Newham 028,Middle Super Output Areas and Intermediate Zones,MSOAIZ,E,8261,4183,4078,1900,1899
E02000742,Newham 029,Middle Super Output Areas and Intermediate Zones,MSOAIZ,E,8005,4002,4003,1787,1822
E02000743,Newham 030,Middle Super Output Areas and Intermediate Zones,MSOAIZ,E,7866,3926,3940,1804,1813
E02000744,Newham 031,Middle Super Output Areas and Intermediate Zones,MSOAIZ,E,8029,3951,4078,1939,1890
E02000745,Newham 032,Middle Super Output Areas and Intermediate Zones,MSOAIZ,E,8141,3961,4180,1906,2063
E02000746,Newham 033,Middle Super Output Areas and Intermediate Zones,MSOAIZ,IG,7382,3512,3870,1663,1869
E02000747,Newham 034,Middle Super Output Areas and Intermediate Zones,MSOAIZ,N,10646,5554,5092,3151,2659
E02000748,Newham 035,Middle Super Output Areas and Intermediate Zones,MSOAIZ,E,6240,3056,3184,1506,1624
E02000749,Newham 036,Middle Super Output Areas and Intermediate Zones,MSOAIZ,E,8183,3957,4226,1709,1944
E02000750,Newham 037,Middle Super Output Areas and Intermediate Zones,MSOAIZ,E,10679,5505,5174,3251,2817
E02000751,Redbridge 001,Middle Super Output Areas and Intermediate Zones,MSOAIZ,IG,10422,5065,5357,2034,2126
E02000752,Redbridge 002,Middle Super Output Areas and Intermediate Zones,MSOAIZ,RM,6815,3215,3600,1324,1536
E02000753,Redbridge 003,Middle Super Output Areas and Intermediate Zones,MSOAIZ,IG,6138,2897,3241,1228,1412
E02000754,Redbridge 004,Middle Super Output Areas and Intermediate Zones,MSOAIZ,IG,6440,3159,3281,1471,1507
E02000755,Redbridge 005,Middle Super Output Areas and Intermediate Zones,MSOAIZ,IG,5218,2538,2680,1081,1177
E02000756,Redbridge 006,Middle Super Output Areas and Intermediate Zones,MSOAIZ,IG,12630,6169,6461,2649,2912
E02000757,Redbridge 007,Middle Super Output Areas and Intermediate Zones,MSOAIZ,IG,11516,5687,5829,2951,2868
E02000758,Redbridge 008,Middle Super Output Areas and Intermediate Zones,MSOAIZ,IG,5953,2905,3048,1122,1233
E02000759,Redbridge 009,Middle Super Output Areas and Intermediate Zones,MSOAIZ,IG,12044,5894,6150,2808,2935
E02000760,Redbridge 010,Middle Super Output Areas and Intermediate Zones,MSOAIZ,IG,6957,3320,3637,1378,1506
E02000762,Redbridge 012,Middle Super Output Areas and Intermediate Zones,MSOAIZ,IG,6290,3179,3111,1274,1270
E02000763,Redbridge 013,Middle Super Output Areas and Intermediate Zones,MSOAIZ,RM,6928,3339,3589,1446,1544
E02000764,Redbridge 014,Middle Super Output Areas and Intermediate Zones,MSOAIZ,E,11865,5586,6279,2852,2979
E02000765,Redbridge 015,Middle Super Output Areas and Intermediate Zones,MSOAIZ,IG,6319,3124,3195,1326,1406
E02000767,Redbridge 017,Middle Super Output Areas and Intermediate Zones,MSOAIZ,IG,7616,3745,3871,1612,1703
E02000768,Redbridge 018,Middle Super Output Areas and Intermediate Zones,MSOAIZ,E,5660,2738,2922,1199,1279
E02000769,Redbridge 019,Middle Super Output Areas and Intermediate Zones,MSOAIZ,RM,14257,6868,7389,3036,3320
E02000770,Redbridge 020,Middle Super Output Areas and Intermediate Zones,MSOAIZ,IG,7562,3760,3802,1614,1620
E02000772,Redbridge 022,Middle Super Output Areas and Intermediate Zones,MSOAIZ,RM,7946,4033,3913,1824,1742
E02000773,Redbridge 023,Middle Super Output Areas and Intermediate Zones,MSOAIZ,IG,9198,4590,4608,2023,2124
E02000774,Redbridge 024,Middle Super Output Areas and Intermediate Zones,MSOAIZ,IG,7218,3735,3483,1628,1512
E02000776,Redbridge 026,Middle Super Output Areas and Intermediate Zones,MSOAIZ,IG,6372,3151,3221,1435,1404
E02000777,Redbridge 027,Middle Super Output Areas and Intermediate Zones,MSOAIZ,E,5883,2822,3061,1206,1304
E02000779,Redbridge 029,Middle Super Output Areas and Intermediate Zones,MSOAIZ,IG,7751,4088,3663,1990,1751
E02000780,Redbridge 030,Middle Super Output Areas and Intermediate Zones,MSOAIZ,IG,14666,7523,7143,3389,3162
E02000781,Redbridge 031,Middle Super Output Areas and Intermediate Zones,MSOAIZ,IG,13672,6844,6828,2871,2909
E02000782,Redbridge 032,Middle Super Output Areas and Intermediate Zones,MSOAIZ,IG,9289,4700,4589,2174,2118
E02000783,Redbridge 033,Middle Super Output Areas and Intermediate Zones,MSOAIZ,IG,7255,3630,3625,1510,1582
E02000784,Richmond upon Thames 001,Middle Super Output Areas and Intermediate Zones,MSOAIZ,SW,10299,4980,5319,2242,2423
E02000785,Richmond upon Thames 002,Middle Super Output Areas and Intermediate Zones,MSOAIZ,TW,9695,4724,4971,2412,2369
E02000786,Richmond upon Thames 003,Middle Super Output Areas and Intermediate Zones,MSOAIZ,SW,10919,5215,5704,2742,2928
E02000787,Richmond upon Thames 004,Middle Super Output Areas and Intermediate Zones,MSOAIZ,TW,10768,5225,5543,2751,2824
E02000788,Richmond upon Thames 005,Middle Super Output Areas and Intermediate Zones,MSOAIZ,TW,8692,4206,4486,2064,2146
E02000789,Richmond upon Thames 006,Middle Super Output Areas and Intermediate Zones,MSOAIZ,TW,6196,3005,3191,1615,1593
E02000790,Richmond upon Thames 007,Middle Super Output Areas and Intermediate Zones,MSOAIZ,TW,6193,3110,3083,1625,1680
E02000791,Richmond upon Thames 008,Middle Super Output Areas and Intermediate Zones,MSOAIZ,TW,6137,3071,3066,1676,1563
E02000792,Richmond upon Thames 009,Middle Super Output Areas and Intermediate Zones,MSOAIZ,TW,6989,3444,3545,1795,1761
E02000793,Richmond upon Thames 010,Middle Super Output Areas and Intermediate Zones,MSOAIZ,TW,8122,4003,4119,1723,1744
E02000794,Richmond upon Thames 011,Middle Super Output Areas and Intermediate Zones,MSOAIZ,TW,6609,3278,3331,1567,1614
E02000795,Richmond upon Thames 012,Middle Super Output Areas and Intermediate Zones,MSOAIZ,TW,6898,3462,3436,1437,1335
E02000796,Richmond upon Thames 013,Middle Super Output Areas and Intermediate Zones,MSOAIZ,UB,10313,5079,5234,2137,2112
E02000797,Richmond upon Thames 014,Middle Super Output Areas and Intermediate Zones,MSOAIZ,TW,6979,3483,3496,2026,1914
E02000798,Richmond upon Thames 015,Middle Super Output Areas and Intermediate Zones,MSOAIZ,TW,10528,5115,5413,2426,2579
E02000799,Richmond upon Thames 016,Middle Super Output Areas and Intermediate Zones,MSOAIZ,TW,6415,3105,3310,1326,1341
E02000800,Richmond upon Thames 017,Middle Super Output Areas and Intermediate Zones,MSOAIZ,TW,5184,2509,2675,1094,1140
E02000801,Richmond upon Thames 018,Middle Super Output Areas and Intermediate Zones,MSOAIZ,TW,6608,3170,3438,1568,1650
E02000802,Richmond upon Thames 019,Middle Super Output Areas and Intermediate Zones,MSOAIZ,TW,6747,3255,3492,1481,1612
E02000803,Richmond upon Thames 020,Middle Super Output Areas and Intermediate Zones,MSOAIZ,TW,9387,4503,4884,1853,2119
E02000804,Richmond upon Thames 021,Middle Super Output Areas and Intermediate Zones,MSOAIZ,TW,7106,3439,3667,1653,1732
E02000805,Richmond upon Thames 022,Middle Super Output Areas and Intermediate Zones,MSOAIZ,TW,10221,4974,5247,2290,2338
E02000806,Richmond upon Thames 023,Middle Super Output Areas and Intermediate Zones,MSOAIZ,TW,9985,4794,5191,2022,2241
E02000807,Southwark 001,Middle Super Output Areas and Intermediate Zones,MSOAIZ,SE,8313,4278,4035,2790,2495
E02000808,Southwark 002,Middle Super Output Areas and Intermediate Zones,MSOAIZ,SE,9102,4712,4390,2865,2316
E02000809,Southwark 003,Middle Super Output Areas and Intermediate Zones,MSOAIZ,SE,11711,6450,5261,4614,3490
E02000810,Southwark 004,Middle Super Output Areas and Intermediate Zones,MSOAIZ,SE,9144,4452,4692,2477,2472
E02000812,Southwark 006,Middle Super Output Areas and Intermediate Zones,MSOAIZ,SE,10290,5077,5213,2858,2618
E02000813,Southwark 007,Middle Super Output Areas and Intermediate Zones,MSOAIZ,SE,8591,4162,4429,2180,2232
E02000814,Southwark 008,Middle Super Output Areas and Intermediate Zones,MSOAIZ,SE,8652,4397,4255,2784,2618
E02000815,Southwark 009,Middle Super Output Areas and Intermediate Zones,MSOAIZ,SE,6497,3342,3155,1901,1585
E02000816,Southwark 010,Middle Super Output Areas and Intermediate Zones,MSOAIZ,SE,9043,4379,4664,2329,2361
E02000817,Southwark 011,Middle Super Output Areas and Intermediate Zones,MSOAIZ,SE,6494,3153,3341,1453,1575
E02000818,Southwark 012,Middle Super Output Areas and Intermediate Zones,MSOAIZ,SE,7534,3758,3776,1959,1774
E02000819,Southwark 013,Middle Super Output Areas and Intermediate Zones,MSOAIZ,SE,8315,4182,4133,2009,2025
E02000820,Southwark 014,Middle Super Output Areas and Intermediate Zones,MSOAIZ,SE,8503,4395,4108,2571,2108
E02000821,Southwark 015,Middle Super Output Areas and Intermediate Zones,MSOAIZ,SE,8386,4131,4255,1924,2012
E02000822,Southwark 016,Middle Super Output Areas and Intermediate Zones,MSOAIZ,SE,8111,4005,4106,2116,1959
E02000823,Southwark 017,Middle Super Output Areas and Intermediate Zones,MSOAIZ,SE,7733,3801,3932,1938,1978
E02000824,Southwark 018,Middle Super Output Areas and Intermediate Zones,MSOAIZ,SE,9568,4609,4959,2154,2309
E02000825,Southwark 019,Middle Super Output Areas and Intermediate Zones,MSOAIZ,SE,9649,4702,4947,2210,2498
E02000826,Southwark 020,Middle Super Output Areas and Intermediate Zones,MSOAIZ,SE,8888,4288,4600,2150,2282
E02000827,Southwark 021,Middle Super Output Areas and Intermediate Zones,MSOAIZ,SE,10359,5209,5150,2673,2639
E02000828,Southwark 022,Middle Super Output Areas and Intermediate Zones,MSOAIZ,SE,8383,4145,4238,2039,2100
E02000829,Southwark 023,Middle Super Output Areas and Intermediate Zones,MSOAIZ,SE,10389,5303,5086,2912,2511
E02000830,Southwark 024,Middle Super Output Areas and Intermediate Zones,MSOAIZ,SE,8870,4335,4535,2446,2423
E02000831,Southwark 025,Middle Super Output Areas and Intermediate Zones,MSOAIZ,SE,9378,4591,4787,2616,2624
E02000832,Southwark 026,Middle Super Output Areas and Intermediate Zones,MSOAIZ,SE,9960,4759,5201,2305,2585
E02000833,Southwark 027,Middle Super Output Areas and Intermediate Zones,MSOAIZ,SE,7755,3575,4180,1772,2142
E02000834,Southwark 028,Middle Super Output Areas and Intermediate Zones,MSOAIZ,SE,9199,4380,4819,2683,2887
E02000835,Southwark 029,Middle Super Output Areas and Intermediate Zones,MSOAIZ,SE,7236,3469,3767,1789,1966
E02000836,Southwark 030,Middle Super Output Areas and Intermediate Zones,MSOAIZ,SE,8240,3985,4255,2224,2371
E02000837,Southwark 031,Middle Super Output Areas and Intermediate Zones,MSOAIZ,SE,9085,4390,4695,2001,2254
E02000838,Southwark 032,Middle Super Output Areas and Intermediate Zones,MSOAIZ,SE,9180,4317,4863,2338,2600
E02000839,Southwark 033,Middle Super Output Areas and Intermediate Zones,MSOAIZ,SE,8036,3927,4109,1791,2046
E02000840,Sutton 001,Middle Super Output Areas and Intermediate Zones,MSOAIZ,SM,8171,3873,4298,1728,1993
E02000841,Sutton 002,Middle Super Output Areas and Intermediate Zones,MSOAIZ,SM,8721,4203,4518,1852,2120
E02000842,Sutton 003,Middle Super Output Areas and Intermediate Zones,MSOAIZ,SM,7666,3763,3903,1553,1610
E02000843,Sutton 004,Middle Super Output Areas and Intermediate Zones,MSOAIZ,SM,7495,3662,3833,1841,1866
E02000844,Sutton 005,Middle Super Output Areas and Intermediate Zones,MSOAIZ,SM,7779,3758,4021,1647,1841
E02000845,Sutton 006,Middle Super Output Areas and Intermediate Zones,MSOAIZ,KT,8867,4336,4531,2087,2241
E02000846,Sutton 007,Middle Super Output Areas and Intermediate Zones,MSOAIZ,SM,7053,3423,3630,1428,1490
E02000847,Sutton 008,Middle Super Output Areas and Intermediate Zones,MSOAIZ,SM,8798,4331,4467,1786,1770
E02000848,Sutton 009,Middle Super Output Areas and Intermediate Zones,MSOAIZ,SM,7889,3884,4005,1647,1712
E02000849,Sutton 010,Middle Super Output Areas and Intermediate Zones,MSOAIZ,SM,7485,3589,3896,1635,1753
E02000850,Sutton 011,Middle Super Output Areas and Intermediate Zones,MSOAIZ,SM,10309,5101,5208,2195,2309
E02000851,Sutton 012,Middle Super Output Areas and Intermediate Zones,MSOAIZ,SM,8330,4107,4223,2148,2001
E02000852,Sutton 013,Middle Super Output Areas and Intermediate Zones,MSOAIZ,SM,7434,3631,3803,1770,1844
E02000853,Sutton 014,Middle Super Output Areas and Intermediate Zones,MSOAIZ,SM,7592,3696,3896,1762,1869
E02000854,Sutton 015,Middle Super Output Areas and Intermediate Zones,MSOAIZ,SM,7101,3484,3617,1583,1648
E02000855,Sutton 016,Middle Super Output Areas and Intermediate Zones,MSOAIZ,SM,7787,3797,3990,1578,1639
E02000856,Sutton 017,Middle Super Output Areas and Intermediate Zones,MSOAIZ,SM,8176,4021,4155,1819,1819
E02000857,Sutton 018,Middle Super Output Areas and Intermediate Zones,MSOAIZ,SM,7905,3800,4105,2126,2003
E02000858,Sutton 019,Middle Super Output Areas and Intermediate Zones,MSOAIZ,SM,7691,3603,4088,1520,1797
E02000859,Sutton 020,Middle Super Output Areas and Intermediate Zones,MSOAIZ,SM,8165,3839,4326,1614,1701
E02000860,Sutton 021,Middle Super Output Areas and Intermediate Zones,MSOAIZ,SM,7598,3737,3861,2036,1906
E02000861,Sutton 022,Middle Super Output Areas and Intermediate Zones,MSOAIZ,SM,7497,3687,3810,1389,1481
E02000863,Sutton 024,Middle Super Output Areas and Intermediate Zones,MSOAIZ,SM,6367,3115,3252,1133,1286
E02000864,Tower Hamlets 001,Middle Super Output Areas and Intermediate Zones,MSOAIZ,E,8297,4020,4277,1923,2040
E02000865,Tower Hamlets 002,Middle Super Output Areas and Intermediate Zones,MSOAIZ,E,7051,3474,3577,1782,1760
E02000866,Tower Hamlets 003,Middle Super Output Areas and Intermediate Zones,MSOAIZ,E,9662,4778,4884,2486,2438
E02000867,Tower Hamlets 004,Middle Super Output Areas and Intermediate Zones,MSOAIZ,E,9761,4900,4861,2897,2613
E02000868,Tower Hamlets 005,Middle Super Output Areas and Intermediate Zones,MSOAIZ,W,6632,3341,3291,1912,1733
E02000869,Tower Hamlets 006,Middle Super Output Areas and Intermediate Zones,MSOAIZ,E,5705,2956,2749,1670,1424
E02000870,Tower Hamlets 007,Middle Super Output Areas and Intermediate Zones,MSOAIZ,E,6477,3242,3235,1630,1631
E02000871,Tower Hamlets 008,Middle Super Output Areas and Intermediate Zones,MSOAIZ,E,8591,4379,4212,2124,1889
E02000872,Tower Hamlets 009,Middle Super Output Areas and Intermediate Zones,MSOAIZ,E,7501,3901,3600,2282,1867
E02000873,Tower Hamlets 010,Middle Super Output Areas and Intermediate Zones,MSOAIZ,E,8713,4315,4398,1882,1701
E02000874,Tower Hamlets 011,Middle Super Output Areas and Intermediate Zones,MSOAIZ,E,7129,3632,3497,1690,1554
E02000875,Tower Hamlets 012,Middle Super Output Areas and Intermediate Zones,MSOAIZ,E,9440,4781,4659,2291,2112
E02000876,Tower Hamlets 013,Middle Super Output Areas and Intermediate Zones,MSOAIZ,E,7037,3748,3289,2014,1630
E02000877,Tower Hamlets 014,Middle Super Output Areas and Intermediate Zones,MSOAIZ,E,9803,4969,4834,2349,2121
E02000878,Tower Hamlets 015,Middle Super Output Areas and Intermediate Zones,MSOAIZ,EC,10286,5492,4794,3193,2380
E02000879,Tower Hamlets 016,Middle Super Output Areas and Intermediate Zones,MSOAIZ,E,7634,3839,3795,1733,1581
E02000880,Tower Hamlets 017,Middle Super Output Areas and Intermediate Zones,MSOAIZ,E,5776,3022,2754,1562,1252
E02000881,Tower Hamlets 018,Middle Super Output Areas and Intermediate Zones,MSOAIZ,E,6909,3448,3461,1475,1549
E02000882,Tower Hamlets 019,Middle Super Output Areas and Intermediate Zones,MSOAIZ,E,8604,4340,4264,1983,1893
E02000883,Tower Hamlets 020,Middle Super Output Areas and Intermediate Zones,MSOAIZ,E,7950,3977,3973,1773,1701
E02000884,Tower Hamlets 021,Middle Super Output Areas and Intermediate Zones,MSOAIZ,E,9086,5060,4026,3060,2125
E02000885,Tower Hamlets 022,Middle Super Output Areas and Intermediate Zones,MSOAIZ,E,6895,3502,3393,1697,1466
E02000886,Tower Hamlets 023,Middle Super Output Areas and Intermediate Zones,MSOAIZ,E,7326,3931,3395,2327,1869
E02000887,Tower Hamlets 024,Middle Super Output Areas and Intermediate Zones,MSOAIZ,E,8660,4359,4301,2090,1967
E02000888,Tower Hamlets 025,Middle Super Output Areas and Intermediate Zones,MSOAIZ,E,8215,4361,3854,2545,2016
E02000889,Tower Hamlets 026,Middle Super Output Areas and Intermediate Zones,MSOAIZ,EC,6616,3607,3009,2182,1659
E02000890,Tower Hamlets 027,Middle Super Output Areas and Intermediate Zones,MSOAIZ,EC,5795,3152,2643,2145,1655
E02000891,Tower Hamlets 028,Middle Super Output Areas and Intermediate Zones,MSOAIZ,E,12678,6719,5959,4247,3474
E02000893,Tower Hamlets 030,Middle Super Output Areas and Intermediate Zones,MSOAIZ,E,6783,3410,3373,1860,1738
E02000894,Tower Hamlets 031,Middle Super Output Areas and Intermediate Zones,MSOAIZ,E,10137,5320,4817,3374,2927
E02000895,Waltham Forest 001,Middle Super Output Areas and Intermediate Zones,MSOAIZ,E,7979,3804,4175,1357,1580
E02000896,Waltham Forest 002,Middle Super Output Areas and Intermediate Zones,MSOAIZ,E,8814,4261,4553,1830,1860
E02000897,Waltham Forest 003,Middle Super Output Areas and Intermediate Zones,MSOAIZ,IG,8077,3812,4265,1546,1798
E02000898,Waltham Forest 004,Middle Super Output Areas and Intermediate Zones,MSOAIZ,E,7750,3750,4000,1487,1654
E02000899,Waltham Forest 005,Middle Super Output Areas and Intermediate Zones,MSOAIZ,E,7920,3809,4111,1567,1682
E02000900,Waltham Forest 006,Middle Super Output Areas and Intermediate Zones,MSOAIZ,E,8088,3894,4194,1589,1834
E02000901,Waltham Forest 007,Middle Super Output Areas and Intermediate Zones,MSOAIZ,IG,9371,4499,4872,1900,2145
E02000902,Waltham Forest 008,Middle Super Output Areas and Intermediate Zones,MSOAIZ,E,8231,4053,4178,1750,1898
E02000903,Waltham Forest 009,Middle Super Output Areas and Intermediate Zones,MSOAIZ,E,9043,4423,4620,1897,2100
E02000904,Waltham Forest 010,Middle Super Output Areas and Intermediate Zones,MSOAIZ,IG,8228,4105,4123,1957,1956
E02000905,Waltham Forest 011,Middle Super Output Areas and Intermediate Zones,MSOAIZ,E,9589,4806,4783,2350,2354
E02000906,Waltham Forest 012,Middle Super Output Areas and Intermediate Zones,MSOAIZ,E,9248,4564,4684,2432,2393
E02000907,Waltham Forest 013,Middle Super Output Areas and Intermediate Zones,MSOAIZ,E,9998,4873,5125,2237,2355
E02000908,Waltham Forest 014,Middle Super Output Areas and Intermediate Zones,MSOAIZ,N,10516,5557,4959,3391,2585
E02000909,Waltham Forest 015,Middle Super Output Areas and Intermediate Zones,MSOAIZ,E,8640,4188,4452,2192,2224
E02000910,Waltham Forest 016,Middle Super Output Areas and Intermediate Zones,MSOAIZ,E,10698,5438,5260,3010,2733
E02000911,Waltham Forest 017,Middle Super Output Areas and Intermediate Zones,MSOAIZ,E,10872,5527,5345,2962,2767
E02000912,Waltham Forest 018,Middle Super Output Areas and Intermediate Zones,MSOAIZ,E,9238,4582,4656,2128,2169
E02000913,Waltham Forest 019,Middle Super Output Areas and Intermediate Zones,MSOAIZ,E,8706,4466,4240,2115,1878
E02000914,Waltham Forest 020,Middle Super Output Areas and Intermediate Zones,MSOAIZ,E,10594,5336,5258,2719,2401
E02000915,Waltham Forest 021,Middle Super Output Areas and Intermediate Zones,MSOAIZ,E,8643,4530,4113,2357,2082
E02000916,Waltham Forest 022,Middle Super Output Areas and Intermediate Zones,MSOAIZ,E,9485,4747,4738,2378,2338
E02000917,Waltham Forest 023,Middle Super Output Areas and Intermediate Zones,MSOAIZ,E,9171,4588,4583,2469,2328
E02000918,Waltham Forest 024,Middle Super Output Areas and Intermediate Zones,MSOAIZ,E,9126,4727,4399,2623,2266
E02000919,Waltham Forest 025,Middle Super Output Areas and Intermediate Zones,MSOAIZ,E,9221,4696,4525,2673,2272
E02000920,Waltham Forest 026,Middle Super Output Areas and Intermediate Zones,MSOAIZ,E,9479,4786,4693,2424,2264
E02000921,Waltham Forest 027,Middle Super Output Areas and Intermediate Zones,MSOAIZ,E,11001,5521,5480,2714,2653
E02000922,Waltham Forest 028,Middle Super Output Areas and Intermediate Zones,MSOAIZ,E,10523,5628,4895,2669,2400
E02000923,Wandsworth 001,Middle Super Output Areas and Intermediate Zones,MSOAIZ,SW,7474,3721,3753,2180,2039
E02000924,Wandsworth 002,Middle Super Output Areas and Intermediate Zones,MSOAIZ,SW,11131,5446,5685,3211,3154
E02000925,Wandsworth 003,Middle Super Output Areas and Intermediate Zones,MSOAIZ,SW,7848,3709,4139,1888,2137
E02000926,Wandsworth 004,Middle Super Output Areas and Intermediate Zones,MSOAIZ,SW,8936,4523,4413,2842,2645
E02000927,Wandsworth 005,Middle Super Output Areas and Intermediate Zones,MSOAIZ,SW,6790,3257,3533,1930,1985
E02000928,Wandsworth 006,Middle Super Output Areas and Intermediate Zones,MSOAIZ,SW,8458,4017,4441,2297,2473
E02000929,Wandsworth 007,Middle Super Output Areas and Intermediate Zones,MSOAIZ,SW,7277,3370,3907,1590,1927
E02000930,Wandsworth 008,Middle Super Output Areas and Intermediate Zones,MSOAIZ,SW,9676,4679,4997,3175,3264
E02000931,Wandsworth 009,Middle Super Output Areas and Intermediate Zones,MSOAIZ,SW,8474,4177,4297,2688,2708
E02000932,Wandsworth 010,Middle Super Output Areas and Intermediate Zones,MSOAIZ,SW,10296,5096,5200,3511,3441
E02000933,Wandsworth 011,Middle Super Output Areas and Intermediate Zones,MSOAIZ,SW,8781,4225,4556,2293,2407
E02000934,Wandsworth 012,Middle Super Output Areas and Intermediate Zones,MSOAIZ,SW,9105,4484,4621,3059,3000
E02000935,Wandsworth 013,Middle Super Output Areas and Intermediate Zones,MSOAIZ,SW,6850,3078,3772,1207,1394
E02000936,Wandsworth 014,Middle Super Output Areas and Intermediate Zones,MSOAIZ,SW,8330,3952,4378,2515,2619
E02000937,Wandsworth 015,Middle Super Output Areas and Intermediate Zones,MSOAIZ,SW,7724,3791,3933,2203,2283
E02000938,Wandsworth 016,Middle Super Output Areas and Intermediate Zones,MSOAIZ,SW,9546,4390,5156,2076,2385
E02000939,Wandsworth 017,Middle Super Output Areas and Intermediate Zones,MSOAIZ,SW,7968,3890,4078,2014,2044
E02000940,Wandsworth 018,Middle Super Output Areas and Intermediate Zones,MSOAIZ,SW,7835,3800,4035,2253,2335
E02000941,Wandsworth 019,Middle Super Output Areas and Intermediate Zones,MSOAIZ,SW,9941,4860,5081,2855,2948
E02000942,Wandsworth 020,Middle Super Output Areas and Intermediate Zones,MSOAIZ,SW,9665,4707,4958,2510,2644
E02000943,Wandsworth 021,Middle Super Output Areas and Intermediate Zones,MSOAIZ,SW,8402,4192,4210,2631,2585
E02000944,Wandsworth 022,Middle Super Output Areas and Intermediate Zones,MSOAIZ,SW,7206,3389,3817,1798,2009
E02000945,Wandsworth 023,Middle Super Output Areas and Intermediate Zones,MSOAIZ,SW,7620,3535,4085,1581,1573
E02000946,Wandsworth 024,Middle Super Output Areas and Intermediate Zones,MSOAIZ,SW,8795,4810,3985,3134,2295
E02000947,Wandsworth 025,Middle Super Output Areas and Intermediate Zones,MSOAIZ,SW,8675,4130,4545,2566,2788
E02000948,Wandsworth 026,Middle Super Output Areas and Intermediate Zones,MSOAIZ,SW,9877,4790,5087,3244,3263
E02000949,Wandsworth 027,Middle Super Output Areas and Intermediate Zones,MSOAIZ,SW,9805,4778,5027,2784,2953
E02000950,Wandsworth 028,Middle Super Output Areas and Intermediate Zones,MSOAIZ,SW,7578,3656,3922,2066,2139
E02000951,Wandsworth 029,Middle Super Output Areas and Intermediate Zones,MSOAIZ,SW,6650,3199,3451,1929,2009
E02000952,Wandsworth 030,Middle Super Output Areas and Intermediate Zones,MSOAIZ,SW,6257,3061,3196,1820,1829
E02000953,Wandsworth 031,Middle Super Output Areas and Intermediate Zones,MSOAIZ,SW,7084,3254,3830,1992,2286
E02000954,Wandsworth 032,Middle Super Output Areas and Intermediate Zones,MSOAIZ,SW,6429,3117,3312,1614,1697
E02000955,Wandsworth 033,Middle Super Output Areas and Intermediate Zones,MSOAIZ,SW,6714,3232,3482,1524,1683
E02000956,Wandsworth 034,Middle Super Output Areas and Intermediate Zones,MSOAIZ,SW,7705,3639,4066,1867,2042
E02000957,Wandsworth 035,Middle Super Output Areas and Intermediate Zones,MSOAIZ,SW,10589,5164,5425,2988,2966
E02000958,Wandsworth 036,Middle Super Output Areas and Intermediate Zones,MSOAIZ,SW,8271,3974,4297,1775,1872
E02000959,Wandsworth 037,Middle Super Output Areas and Intermediate Zones,MSOAIZ,SW,7233,3554,3679,1842,1935
E02000960,Westminster 001,Middle Super Output Areas and Intermediate Zones,MSOAIZ,NW,6620,3113,3507,1515,1669
E02000961,Westminster 002,Middle Super Output Areas and Intermediate Zones,MSOAIZ,W,9442,4484,4958,2202,2534
E02000962,Westminster 003,Middle Super Output Areas and Intermediate Zones,MSOAIZ,W,8624,4201,4423,2073,2109
E02000963,Westminster 004,Middle Super Output Areas and Intermediate Zones,MSOAIZ,W,10363,4867,5496,2235,2581
E02000964,Westminster 005,Middle Super Output Areas and Intermediate Zones,MSOAIZ,W,12549,6063,6486,3298,3498
E02000965,Westminster 006,Middle Super Output Areas and Intermediate Zones,MSOAIZ,W,8627,4283,4344,2714,2680
E02000966,Westminster 007,Middle Super Output Areas and Intermediate Zones,MSOAIZ,W,9708,4839,4869,2872,2804
E02000967,Westminster 008,Middle Super Output Areas and Intermediate Zones,MSOAIZ,W,7289,3759,3530,2221,1814
E02000968,Westminster 009,Middle Super Output Areas and Intermediate Zones,MSOAIZ,W,14358,6993,7365,3079,3197
E02000969,Westminster 010,Middle Super Output Areas and Intermediate Zones,MSOAIZ,WC,9329,4540,4789,2166,2313
E02000970,Westminster 011,Middle Super Output Areas and Intermediate Zones,MSOAIZ,W,8983,4764,4219,2809,2304
E02000971,Westminster 012,Middle Super Output Areas and Intermediate Zones,MSOAIZ,W,8408,4523,3885,2678,2091
E02000972,Westminster 013,Middle Super Output Areas and Intermediate Zones,MSOAIZ,WC,8333,4708,3625,2985,1949
E02000973,Westminster 014,Middle Super Output Areas and Intermediate Zones,MSOAIZ,W,10090,5074,5016,3184,2964
E02000974,Westminster 015,Middle Super Output Areas and Intermediate Zones,MSOAIZ,W,8794,4871,3923,2653,1902
E02000975,Westminster 016,Middle Super Output Areas and Intermediate Zones,MSOAIZ,W,8757,4631,4126,3152,2538
E02000976,Westminster 017,Middle Super Output Areas and Intermediate Zones,MSOAIZ,W,9946,5156,4790,3195,2783
E02000977,Westminster 018,Middle Super Output Areas and Intermediate Zones,MSOAIZ,WC,7490,4297,3193,2446,1543
E02000978,Westminster 019,Middle Super Output Areas and Intermediate Zones,MSOAIZ,W,9270,4949,4321,2140,1876
E02000979,Westminster 020,Middle Super Output Areas and Intermediate Zones,MSOAIZ,WC,8081,4364,3717,2355,1796
E02000980,Westminster 021,Middle Super Output Areas and Intermediate Zones,MSOAIZ,SW,8684,4368,4316,2307,2187
E02000981,Westminster 022,Middle Super Output Areas and Intermediate Zones,MSOAIZ,WC,8991,4546,4445,2850,2573
E02000982,Westminster 023,Middle Super Output Areas and Intermediate Zones,MSOAIZ,SW,8226,4011,4215,2037,2005
E02000983,Westminster 024,Middle Super Output Areas and Intermediate Zones,MSOAIZ,SW,8434,4144,4290,2203,2105
E02000984,Bolton 001,Middle Super Output Areas and Intermediate Zones,MSOAIZ,BL,7782,3882,3900,1531,1627
E02000985,Bolton 002,Middle Super Output Areas and Intermediate Zones,MSOAIZ,BL,7569,3674,3895,1328,1407
E02000986,Bolton 003,Middle Super Output Areas and Intermediate Zones,MSOAIZ,BL,8365,4104,4261,1724,1724
E02000987,Bolton 004,Middle Super Output Areas and Intermediate Zones,MSOAIZ,BL,7195,3416,3779,1407,1542
E02000988,Bolton 005,Middle Super Output Areas and Intermediate Zones,MSOAIZ,BL,8407,4136,4271,1779,1804
E02000989,Bolton 006,Middle Super Output Areas and Intermediate Zones,MSOAIZ,BL,8242,3962,4280,1424,1499
E02000990,Bolton 007,Middle Super Output Areas and Intermediate Zones,MSOAIZ,BL,7636,3790,3846,1635,1712
E02000991,Bolton 008,Middle Super Output Areas and Intermediate Zones,MSOAIZ,BL,7682,3780,3902,1630,1643
E02000992,Bolton 009,Middle Super Output Areas and Intermediate Zones,MSOAIZ,WN,5781,2854,2927,1137,1157
E02000993,Bolton 010,Middle Super Output Areas and Intermediate Zones,MSOAIZ,BL,7142,3431,3711,1383,1586
E02000994,Bolton 011,Middle Super Output Areas and Intermediate Zones,MSOAIZ,BL,7914,3942,3972,1654,1620
E02000995,Bolton 012,Middle Super Output Areas and Intermediate Zones,MSOAIZ,BL,8163,3952,4211,1486,1606
E02000996,Bolton 013,Middle Super Output Areas and Intermediate Zones,MSOAIZ,BL,7869,3775,4094,1476,1603
E02000997,Bolton 014,Middle Super Output Areas and Intermediate Zones,MSOAIZ,WN,5676,2791,2885,1081,1097
E02000998,Bolton 015,Middle Super Output Areas and Intermediate Zones,MSOAIZ,BL,8613,4410,4203,1915,1741
E02000999,Bolton 016,Middle Super Output Areas and Intermediate Zones,MSOAIZ,BL,7435,3903,3532,1655,1320
E02001000,Bolton 017,Middle Super Output Areas and Intermediate Zones,MSOAIZ,BL,9145,4555,4590,1899,1856
E02001001,Bolton 018,Middle Super Output Areas and Intermediate Zones,MSOAIZ,BL,8101,4068,4033,1678,1668
E02001002,Bolton 019,Middle Super Output Areas and Intermediate Zones,MSOAIZ,BL,9445,4558,4887,1820,2005
E02001003,Bolton 020,Middle Super Output Areas and Intermediate Zones,MSOAIZ,BL,7277,3628,3649,1323,1328
E02001004,Bolton 021,Middle Super Output Areas and Intermediate Zones,MSOAIZ,BL,8240,4275,3965,1818,1643
E02001005,Bolton 022,Middle Super Output Areas and Intermediate Zones,MSOAIZ,BL,7937,4056,3881,1766,1549
E02001006,Bolton 023,Middle Super Output Areas and Intermediate Zones,MSOAIZ,BL,7709,3921,3788,1659,1583
E02001007,Bolton 024,Middle Super Output Areas and Intermediate Zones,MSOAIZ,M,10271,5048,5223,1925,2010
E02001008,Bolton 025,Middle Super Output Areas and Intermediate Zones,MSOAIZ,BL,8140,3979,4161,1570,1651
E02001009,Bolton 026,Middle Super Output Areas and Intermediate Zones,MSOAIZ,M,6689,3271,3418,1316,1397
E02001010,Bolton 027,Middle Super Output Areas and Intermediate Zones,MSOAIZ,BL,5867,2915,2952,1225,1260
E02001011,Bolton 028,Middle Super Output Areas and Intermediate Zones,MSOAIZ,BL,9855,4925,4930,2084,2137
E02001012,Bolton 029,Middle Super Output Areas and Intermediate Zones,MSOAIZ,BL,7833,3831,4002,1450,1578
E02001013,Bolton 030,Middle Super Output Areas and Intermediate Zones,MSOAIZ,M,6029,2925,3104,1143,1219
E02001014,Bolton 031,Middle Super Output Areas and Intermediate Zones,MSOAIZ,WN,8168,4009,4159,1734,1835
E02001015,Bolton 032,Middle Super Output Areas and Intermediate Zones,MSOAIZ,BL,7913,3861,4052,1577,1569
E02001016,Bolton 033,Middle Super Output Areas and Intermediate Zones,MSOAIZ,BL,8243,3998,4245,1580,1737
E02001017,Bolton 034,Middle Super Output Areas and Intermediate Zones,MSOAIZ,M,10849,5295,5554,2266,2416
E02001018,Bolton 035,Middle Super Output Areas and Intermediate Zones,MSOAIZ,WN,7604,3740,3864,1630,1791
E02001019,Bury 001,Middle Super Output Areas and Intermediate Zones,MSOAIZ,BL,8967,4510,4457,1911,1960
E02001020,Bury 002,Middle Super Output Areas and Intermediate Zones,MSOAIZ,BL,5933,2830,3103,954,1035
E02001021,Bury 003,Middle Super Output Areas and Intermediate Zones,MSOAIZ,BL,7806,3811,3995,1596,1729
E02001022,Bury 004,Middle Super Output Areas and Intermediate Zones,MSOAIZ,BL,7860,3822,4038,1507,1523
E02001023,Bury 005,Middle Super Output Areas and Intermediate Zones,MSOAIZ,BL,5833,2819,3014,1059,1200
E02001024,Bury 006,Middle Super Output Areas and Intermediate Zones,MSOAIZ,BL,8083,3984,4099,1606,1771
E02001025,Bury 007,Middle Super Output Areas and Intermediate Zones,MSOAIZ,BL,7608,3735,3873,1521,1566
E02001026,Bury 008,Middle Super Output Areas and Intermediate Zones,MSOAIZ,BL,8964,4536,4428,2049,1986
E02001027,Bury 009,Middle Super Output Areas and Intermediate Zones,MSOAIZ,M,6787,3330,3457,1569,1589
E02001028,Bury 010,Middle Super Output Areas and Intermediate Zones,MSOAIZ,BL,7430,3602,3828,1218,1318
E02001029,Bury 011,Middle Super Output Areas and Intermediate Zones,MSOAIZ,BL,6974,3492,3482,1457,1503
E02001030,Bury 012,Middle Super Output Areas and Intermediate Zones,MSOAIZ,M,5817,2835,2982,1134,1285
E02001031,Bury 013,Middle Super Output Areas and Intermediate Zones,MSOAIZ,M,6464,3160,3304,1323,1404
E02001032,Bury 014,Middle Super Output Areas and Intermediate Zones,MSOAIZ,M,7552,3683,3869,1439,1574
E02001033,Bury 015,Middle Super Output Areas and Intermediate Zones,MSOAIZ,M,5613,2741,2872,1197,1215
E02001034,Bury 016,Middle Super Output Areas and Intermediate Zones,MSOAIZ,M,7766,3828,3938,1705,1647
E02001035,Bury 017,Middle Super Output Areas and Intermediate Zones,MSOAIZ,M,7200,3541,3659,1345,1356
E02001036,Bury 018,Middle Super Output Areas and Intermediate Zones,MSOAIZ,M,7253,3548,3705,1498,1637
E02001037,Bury 019,Middle Super Output Areas and Intermediate Zones,MSOAIZ,M,7118,3425,3693,1311,1381
E02001038,Bury 020,Middle Super Output Areas and Intermediate Zones,MSOAIZ,M,5568,2620,2948,1187,1266
E02001039,Bury 021,Middle Super Output Areas and Intermediate Zones,MSOAIZ,M,8174,3880,4294,1626,1845
E02001040,Bury 022,Middle Super Output Areas and Intermediate Zones,MSOAIZ,M,6020,3006,3014,1252,1227
E02001041,Bury 023,Middle Super Output Areas and Intermediate Zones,MSOAIZ,M,7616,3686,3930,1586,1814
E02001042,Bury 024,Middle Super Output Areas and Intermediate Zones,MSOAIZ,M,6193,3135,3058,1417,1283
E02001043,Bury 025,Middle Super Output Areas and Intermediate Zones,MSOAIZ,M,5468,2561,2907,1127,1217
E02001044,Bury 026,Middle Super Output Areas and Intermediate Zones,MSOAIZ,M,8993,4468,4525,1668,1697
E02001045,Manchester 001,Middle Super Output Areas and Intermediate Zones,MSOAIZ,M,7927,3663,4264,1400,1729
E02001046,Manchester 002,Middle Super Output Areas and Intermediate Zones,MSOAIZ,M,9390,4546,4844,1942,2114
E02001047,Manchester 003,Middle Super Output Areas and Intermediate Zones,MSOAIZ,OL,9870,4831,5039,2023,2172
E02001048,Manchester 004,Middle Super Output Areas and Intermediate Zones,MSOAIZ,M,8473,4247,4226,1921,1745
E02001049,Manchester 005,Middle Super Output Areas and Intermediate Zones,MSOAIZ,M,9633,4609,5024,1891,2111
E02001050,Manchester 006,Middle Super Output Areas and Intermediate Zones,MSOAIZ,M,7166,3673,3493,1780,1598
E02001051,Manchester 007,Middle Super Output Areas and Intermediate Zones,MSOAIZ,M,8038,3947,4091,1729,1788
E02001052,Manchester 008,Middle Super Output Areas and Intermediate Zones,MSOAIZ,M,12771,6618,6153,2969,2623
E02001053,Manchester 009,Middle Super Output Areas and Intermediate Zones,MSOAIZ,M,10042,5035,5007,2232,2115
E02001055,Manchester 011,Middle Super Output Areas and Intermediate Zones,MSOAIZ,M,8601,4176,4425,1696,1899
E02001056,Manchester 012,Middle Super Output Areas and Intermediate Zones,MSOAIZ,M,8169,3906,4263,1478,1734
E02001057,Manchester 013,Middle Super Output Areas and Intermediate Zones,MSOAIZ,M,8107,4347,3760,2266,1732
E02001059,Manchester 015,Middle Super Output Areas and Intermediate Zones,MSOAIZ,M,9802,4926,4876,2261,2208
E02001061,Manchester 017,Middle Super Output Areas and Intermediate Zones,MSOAIZ,M,9002,4415,4587,1788,1928
E02001062,Manchester 018,Middle Super Output Areas and Intermediate Zones,MSOAIZ,M,9958,5172,4786,2144,1866
E02001063,Manchester 019,Middle Super Output Areas and Intermediate Zones,MSOAIZ,M,10560,5480,5080,2405,1861
E02001064,Manchester 020,Middle Super Output Areas and Intermediate Zones,MSOAIZ,M,9127,4552,4575,1915,2019
E02001065,Manchester 021,Middle Super Output Areas and Intermediate Zones,MSOAIZ,M,8679,4356,4323,1983,1924
E02001066,Manchester 022,Middle Super Output Areas and Intermediate Zones,MSOAIZ,M,11925,6225,5700,2283,1756
E02001067,Manchester 023,Middle Super Output Areas and Intermediate Zones,MSOAIZ,M,9514,4696,4818,1913,2078
E02001068,Manchester 024,Middle Super Output Areas and Intermediate Zones,MSOAIZ,M,9667,4599,5068,1770,2104
E02001069,Manchester 025,Middle Super Output Areas and Intermediate Zones,MSOAIZ,M,10996,5852,5144,2384,1973
E02001070,Manchester 026,Middle Super Output Areas and Intermediate Zones,MSOAIZ,M,11895,5986,5909,1951,1564
E02001071,Manchester 027,Middle Super Output Areas and Intermediate Zones,MSOAIZ,M,13251,6866,6385,3202,2772
E02001072,Manchester 028,Middle Super Output Areas and Intermediate Zones,MSOAIZ,M,8606,4487,4119,2579,2289
E02001073,Manchester 029,Middle Super Output Areas and Intermediate Zones,MSOAIZ,M,9688,4946,4742,2816,2553
E02001074,Manchester 030,Middle Super Output Areas and Intermediate Zones,MSOAIZ,M,11579,5692,5887,2519,2626
E02001075,Manchester 031,Middle Super Output Areas and Intermediate Zones,MSOAIZ,M,8272,4283,3989,2170,1955
E02001076,Manchester 032,Middle Super Output Areas and Intermediate Zones,MSOAIZ,M,11579,5732,5847,1314,1039
E02001077,Manchester 033,Middle Super Output Areas and Intermediate Zones,MSOAIZ,M,7750,3739,4011,1958,2109
E02001078,Manchester 034,Middle Super Output Areas and Intermediate Zones,MSOAIZ,M,10474,5148,5326,2191,2224
E02001079,Manchester 035,Middle Super Output Areas and Intermediate Zones,MSOAIZ,M,8982,4359,4623,1628,1834
E02001080,Manchester 036,Middle Super Output Areas and Intermediate Zones,MSOAIZ,M,9532,4749,4783,1408,1199
E02001081,Manchester 037,Middle Super Output Areas and Intermediate Zones,MSOAIZ,M,6213,2926,3287,1559,1797
E02001082,Manchester 038,Middle Super Output Areas and Intermediate Zones,MSOAIZ,M,6792,3491,3301,1818,1616
E02001083,Manchester 039,Middle Super Output Areas and Intermediate Zones,MSOAIZ,M,7924,4020,3904,2652,2348
E02001084,Manchester 040,Middle Super Output Areas and Intermediate Zones,MSOAIZ,M,8620,4423,4197,1876,1695
E02001085,Manchester 041,Middle Super Output Areas and Intermediate Zones,MSOAIZ,SK,8241,3849,4392,1480,1919
E02001086,Manchester 042,Middle Super Output Areas and Intermediate Zones,MSOAIZ,M,6594,3196,3398,1678,1725
E02001087,Manchester 043,Middle Super Output Areas and Intermediate Zones,MSOAIZ,M,9467,4663,4804,2571,2464
E02001088,Manchester 044,Middle Super Output Areas and Intermediate Zones,MSOAIZ,M,8891,4305,4586,1858,2058
E02001089,Manchester 045,Middle Super Output Areas and Intermediate Zones,MSOAIZ,M,8017,3960,4057,1750,1762
E02001090,Manchester 046,Middle Super Output Areas and Intermediate Zones,MSOAIZ,M,6686,3297,3389,1598,1580
E02001091,Manchester 047,Middle Super Output Areas and Intermediate Zones,MSOAIZ,WA,8157,3906,4251,1809,1830
E02001092,Manchester 048,Middle Super Output Areas and Intermediate Zones,MSOAIZ,M,8506,4210,4296,1804,1903
E02001093,Manchester 049,Middle Super Output Areas and Intermediate Zones,MSOAIZ,M,9207,4450,4757,2003,2182
E02001094,Manchester 050,Middle Super Output Areas and Intermediate Zones,MSOAIZ,M,9001,4197,4804,1712,1960
E02001095,Manchester 051,Middle Super Output Areas and Intermediate Zones,MSOAIZ,M,8303,3946,4357,1603,1954
E02001096,Manchester 052,Middle Super Output Areas and Intermediate Zones,MSOAIZ,M,7395,3590,3805,1522,1615
E02001097,Manchester 053,Middle Super Output Areas and Intermediate Zones,MSOAIZ,WA,8054,3869,4185,1648,1824
E02001098,Oldham 001,Middle Super Output Areas and Intermediate Zones,MSOAIZ,OL,6063,2920,3143,1054,1121
E02001099,Oldham 002,Middle Super Output Areas and Intermediate Zones,MSOAIZ,OL,6041,2881,3160,1232,1308
E02001100,Oldham 003,Middle Super Output Areas and Intermediate Zones,MSOAIZ,OL,6115,2946,3169,1146,1188
E02001101,Oldham 004,Middle Super Output Areas and Intermediate Zones,MSOAIZ,OL,5976,2919,3057,1077,1193
E02001102,Oldham 005,Middle Super Output Areas and Intermediate Zones,MSOAIZ,OL,6114,3023,3091,1316,1359
E02001103,Oldham 006,Middle Super Output Areas and Intermediate Zones,MSOAIZ,OL,5541,2737,2804,1039,1085
E02001104,Oldham 007,Middle Super Output Areas and Intermediate Zones,MSOAIZ,OL,6939,3364,3575,1457,1571
E02001105,Oldham 008,Middle Super Output Areas and Intermediate Zones,MSOAIZ,OL,5997,2923,3074,1177,1186
E02001106,Oldham 009,Middle Super Output Areas and Intermediate Zones,MSOAIZ,OL,6043,2911,3132,1265,1187
E02001107,Oldham 010,Middle Super Output Areas and Intermediate Zones,MSOAIZ,OL,6150,3019,3131,1175,1199
E02001108,Oldham 011,Middle Super Output Areas and Intermediate Zones,MSOAIZ,OL,5082,2454,2628,997,1116
E02001109,Oldham 012,Middle Super Output Areas and Intermediate Zones,MSOAIZ,OL,7314,3620,3694,1553,1563
E02001110,Oldham 013,Middle Super Output Areas and Intermediate Zones,MSOAIZ,OL,6244,3112,3132,1295,1285
E02001111,Oldham 014,Middle Super Output Areas and Intermediate Zones,MSOAIZ,OL,6679,3342,3337,1319,1268
E02001112,Oldham 015,Middle Super Output Areas and Intermediate Zones,MSOAIZ,OL,5938,2994,2944,1176,1216
E02001113,Oldham 016,Middle Super Output Areas and Intermediate Zones,MSOAIZ,OL,9536,4814,4722,1904,1690
E02001114,Oldham 017,Middle Super Output Areas and Intermediate Zones,MSOAIZ,OL,8150,3992,4158,1637,1635
E02001115,Oldham 018,Middle Super Output Areas and Intermediate Zones,MSOAIZ,OL,5956,2924,3032,1221,1233
E02001116,Oldham 019,Middle Super Output Areas and Intermediate Zones,MSOAIZ,OL,6462,3202,3260,1367,1300
E02001117,Oldham 020,Middle Super Output Areas and Intermediate Zones,MSOAIZ,OL,5906,2887,3019,1083,1172
E02001118,Oldham 021,Middle Super Output Areas and Intermediate Zones,MSOAIZ,OL,6259,3005,3254,1230,1320
E02001119,Oldham 022,Middle Super Output Areas and Intermediate Zones,MSOAIZ,OL,10850,5347,5503,2052,2022
E02001121,Oldham 024,Middle Super Output Areas and Intermediate Zones,MSOAIZ,OL,6519,3281,3238,1403,1255
E02001123,Oldham 026,Middle Super Output Areas and Intermediate Zones,MSOAIZ,OL,6449,3081,3368,1239,1368
E02001124,Oldham 027,Middle Super Output Areas and Intermediate Zones,MSOAIZ,OL,5739,2740,2999,1044,1183
E02001125,Oldham 028,Middle Super Output Areas and Intermediate Zones,MSOAIZ,OL,8038,3984,4054,1653,1672
E02001126,Oldham 029,Middle Super Output Areas and Intermediate Zones,MSOAIZ,OL,7465,3632,3833,1476,1562
E02001127,Oldham 030,Middle Super Output Areas and Intermediate Zones,MSOAIZ,OL,7080,3338,3742,1287,1500
E02001128,Oldham 031,Middle Super Output Areas and Intermediate Zones,MSOAIZ,OL,7460,3600,3860,1488,1593
E02001129,Oldham 032,Middle Super Output Areas and Intermediate Zones,MSOAIZ,M,5801,2799,3002,1173,1238
E02001130,Oldham 033,Middle Super Output Areas and Intermediate Zones,MSOAIZ,OL,5778,2769,3009,1140,1183
E02001131,Oldham 034,Middle Super Output Areas and Intermediate Zones,MSOAIZ,M,5304,2578,2726,969,1025
E02001132,Rochdale 001,Middle Super Output Areas and Intermediate Zones,MSOAIZ,OL,6463,3159,3304,1316,1396
E02001133,Rochdale 002,Middle Super Output Areas and Intermediate Zones,MSOAIZ,OL,6175,3043,3132,1203,1282
E02001134,Rochdale 003,Middle Super Output Areas and Intermediate Zones,MSOAIZ,OL,6271,3038,3233,1246,1321
E02001135,Rochdale 004,Middle Super Output Areas and Intermediate Zones,MSOAIZ,OL,7607,3697,3910,1426,1497
E02001136,Rochdale 005,Middle Super Output Areas and Intermediate Zones,MSOAIZ,OL,9189,4574,4615,1917,1834
E02001137,Rochdale 006,Middle Super Output Areas and Intermediate Zones,MSOAIZ,OL,6198,3055,3143,1226,1342
E02001138,Rochdale 007,Middle Super Output Areas and Intermediate Zones,MSOAIZ,OL,8945,4343,4602,1650,1823
E02001139,Rochdale 008,Middle Super Output Areas and Intermediate Zones,MSOAIZ,OL,9257,4668,4589,1808,1812
E02001140,Rochdale 009,Middle Super Output Areas and Intermediate Zones,MSOAIZ,OL,7564,3632,3932,1443,1564
E02001141,Rochdale 010,Middle Super Output Areas and Intermediate Zones,MSOAIZ,OL,12440,6453,5987,2883,2407
E02001142,Rochdale 011,Middle Super Output Areas and Intermediate Zones,MSOAIZ,OL,5925,2894,3031,999,1081
E02001143,Rochdale 012,Middle Super Output Areas and Intermediate Zones,MSOAIZ,OL,10636,5199,5437,2108,2211
E02001144,Rochdale 013,Middle Super Output Areas and Intermediate Zones,MSOAIZ,OL,6135,3014,3121,1239,1308
E02001145,Rochdale 014,Middle Super Output Areas and Intermediate Zones,MSOAIZ,OL,7109,3478,3631,1399,1517
E02001146,Rochdale 015,Middle Super Output Areas and Intermediate Zones,MSOAIZ,OL,9132,4558,4574,1848,1840
E02001147,Rochdale 016,Middle Super Output Areas and Intermediate Zones,MSOAIZ,OL,9047,4383,4664,1745,1921
E02001148,Rochdale 017,Middle Super Output Areas and Intermediate Zones,MSOAIZ,OL,10016,4756,5260,1900,2028
E02001149,Rochdale 018,Middle Super Output Areas and Intermediate Zones,MSOAIZ,OL,9683,4722,4961,1948,1970
E02001150,Rochdale 019,Middle Super Output Areas and Intermediate Zones,MSOAIZ,OL,8490,4087,4403,1615,1819
E02001151,Rochdale 020,Middle Super Output Areas and Intermediate Zones,MSOAIZ,OL,9414,4572,4842,1861,2002
E02001152,Rochdale 021,Middle Super Output Areas and Intermediate Zones,MSOAIZ,M,9098,4407,4691,1874,1985
E02001153,Rochdale 022,Middle Super Output Areas and Intermediate Zones,MSOAIZ,OL,9998,4735,5263,1824,2095
E02001154,Rochdale 023,Middle Super Output Areas and Intermediate Zones,MSOAIZ,M,10226,5065,5161,2183,2328
E02001155,Rochdale 024,Middle Super Output Areas and Intermediate Zones,MSOAIZ,M,6965,3453,3512,1544,1516
E02001156,Rochdale 025,Middle Super Output Areas and Intermediate Zones,MSOAIZ,M,9716,4657,5059,1777,1925
E02001157,Salford 001,Middle Super Output Areas and Intermediate Zones,MSOAIZ,M,7247,3475,3772,1302,1438
E02001158,Salford 002,Middle Super Output Areas and Intermediate Zones,MSOAIZ,M,5934,2885,3049,1137,1231
E02001159,Salford 003,Middle Super Output Areas and Intermediate Zones,MSOAIZ,M,5713,2784,2929,1209,1270
E02001160,Salford 004,Middle Super Output Areas and Intermediate Zones,MSOAIZ,M,6208,2941,3267,1121,1277
E02001161,Salford 005,Middle Super Output Areas and Intermediate Zones,MSOAIZ,M,5848,2807,3041,1198,1296
E02001162,Salford 006,Middle Super Output Areas and Intermediate Zones,MSOAIZ,M,5808,2908,2900,1184,1139
E02001163,Salford 007,Middle Super Output Areas and Intermediate Zones,MSOAIZ,M,9310,4550,4760,1887,1937
E02001164,Salford 008,Middle Super Output Areas and Intermediate Zones,MSOAIZ,M,7114,3941,3173,1939,1417
E02001165,Salford 009,Middle Super Output Areas and Intermediate Zones,MSOAIZ,M,6147,2955,3192,1258,1356
E02001166,Salford 010,Middle Super Output Areas and Intermediate Zones,MSOAIZ,M,6997,3475,3522,1123,1028
E02001167,Salford 011,Middle Super Output Areas and Intermediate Zones,MSOAIZ,M,6354,3019,3335,1270,1348
E02001168,Salford 012,Middle Super Output Areas and Intermediate Zones,MSOAIZ,M,9406,4545,4861,1868,2039
E02001169,Salford 013,Middle Super Output Areas and Intermediate Zones,MSOAIZ,M,10546,5209,5337,2175,2315
E02001170,Salford 014,Middle Super Output Areas and Intermediate Zones,MSOAIZ,M,9692,4724,4968,1951,2009
E02001171,Salford 015,Middle Super Output Areas and Intermediate Zones,MSOAIZ,M,5594,2706,2888,1063,1133
E02001172,Salford 016,Middle Super Output Areas and Intermediate Zones,MSOAIZ,M,11945,6075,5870,2607,2322
E02001173,Salford 017,Middle Super Output Areas and Intermediate Zones,MSOAIZ,M,8362,4216,4146,1538,1458
E02001174,Salford 018,Middle Super Output Areas and Intermediate Zones,MSOAIZ,M,5640,2794,2846,1239,1179
E02001175,Salford 019,Middle Super Output Areas and Intermediate Zones,MSOAIZ,M,6938,3346,3592,1450,1493
E02001176,Salford 020,Middle Super Output Areas and Intermediate Zones,MSOAIZ,M,10930,5491,5439,2492,2305
E02001177,Salford 021,Middle Super Output Areas and Intermediate Zones,MSOAIZ,M,11657,5636,6021,2445,2489
E02001178,Salford 022,Middle Super Output Areas and Intermediate Zones,MSOAIZ,M,10658,6004,4654,3480,2403
E02001179,Salford 023,Middle Super Output Areas and Intermediate Zones,MSOAIZ,M,5799,2988,2811,1324,1234
E02001180,Salford 024,Middle Super Output Areas and Intermediate Zones,MSOAIZ,M,5878,3122,2756,1430,1038
E02001181,Salford 025,Middle Super Output Areas and Intermediate Zones,MSOAIZ,M,5690,2819,2871,1202,1250
E02001182,Salford 026,Middle Super Output Areas and Intermediate Zones,MSOAIZ,M,6003,3016,2987,1338,1364
E02001183,Salford 027,Middle Super Output Areas and Intermediate Zones,MSOAIZ,M,6044,2958,3086,1385,1464
E02001184,Salford 028,Middle Super Output Areas and Intermediate Zones,MSOAIZ,M,10404,5601,4803,3210,2591
E02001185,Salford 029,Middle Super Output Areas and Intermediate Zones,MSOAIZ,M,10104,4899,5205,1915,2117
E02001186,Salford 030,Middle Super Output Areas and Intermediate Zones,MSOAIZ,WA,9963,4893,5070,2132,2119
E02001187,Stockport 001,Middle Super Output Areas and Intermediate Zones,MSOAIZ,SK,7188,3427,3761,1443,1643
E02001188,Stockport 002,Middle Super Output Areas and Intermediate Zones,MSOAIZ,SK,7941,3853,4088,1686,1827
E02001189,Stockport 003,Middle Super Output Areas and Intermediate Zones,MSOAIZ,SK,8382,4059,4323,1765,1871
E02001190,Stockport 004,Middle Super Output Areas and Intermediate Zones,MSOAIZ,SK,6686,3278,3408,1308,1306
E02001191,Stockport 005,Middle Super Output Areas and Intermediate Zones,MSOAIZ,SK,5841,2933,2908,1082,1111
E02001192,Stockport 006,Middle Super Output Areas and Intermediate Zones,MSOAIZ,SK,6446,3249,3197,1537,1451
E02001193,Stockport 007,Middle Super Output Areas and Intermediate Zones,MSOAIZ,SK,6099,3056,3043,1469,1408
E02001194,Stockport 008,Middle Super Output Areas and Intermediate Zones,MSOAIZ,SK,5886,2904,2982,1206,1147
E02001195,Stockport 009,Middle Super Output Areas and Intermediate Zones,MSOAIZ,SK,7449,3642,3807,1549,1563
E02001196,Stockport 010,Middle Super Output Areas and Intermediate Zones,MSOAIZ,SK,7547,3689,3858,1377,1442
E02001197,Stockport 011,Middle Super Output Areas and Intermediate Zones,MSOAIZ,SK,6225,2979,3246,1229,1365
E02001198,Stockport 012,Middle Super Output Areas and Intermediate Zones,MSOAIZ,SK,7545,3649,3896,1386,1464
E02001199,Stockport 013,Middle Super Output Areas and Intermediate Zones,MSOAIZ,SK,7806,3824,3982,1709,1823
E02001200,Stockport 014,Middle Super Output Areas and Intermediate Zones,MSOAIZ,SK,6421,3447,2974,1596,1258
E02001201,Stockport 015,Middle Super Output Areas and Intermediate Zones,MSOAIZ,SK,5784,2833,2951,1252,1310
E02001202,Stockport 016,Middle Super Output Areas and Intermediate Zones,MSOAIZ,SK,6094,3011,3083,1531,1521
E02001203,Stockport 017,Middle Super Output Areas and Intermediate Zones,MSOAIZ,SK,5796,2841,2955,1005,1049
E02001204,Stockport 018,Middle Super Output Areas and Intermediate Zones,MSOAIZ,SK,8938,4334,4604,2047,2139
E02001205,Stockport 019,Middle Super Output Areas and Intermediate Zones,MSOAIZ,SK,7783,3908,3875,1809,1776
E02001206,Stockport 020,Middle Super Output Areas and Intermediate Zones,MSOAIZ,SK,7003,3298,3705,1190,1325
E02001207,Stockport 021,Middle Super Output Areas and Intermediate Zones,MSOAIZ,SK,7013,3486,3527,1387,1433
E02001208,Stockport 022,Middle Super Output Areas and Intermediate Zones,MSOAIZ,SK,7222,3437,3785,1574,1744
E02001209,Stockport 023,Middle Super Output Areas and Intermediate Zones,MSOAIZ,SK,7734,3782,3952,1755,1817
E02001210,Stockport 024,Middle Super Output Areas and Intermediate Zones,MSOAIZ,SK,6901,3319,3582,1200,1391
E02001211,Stockport 025,Middle Super Output Areas and Intermediate Zones,MSOAIZ,SK,6010,2864,3146,1168,1228
E02001212,Stockport 026,Middle Super Output Areas and Intermediate Zones,MSOAIZ,SK,6492,3185,3307,1225,1443
E02001213,Stockport 027,Middle Super Output Areas and Intermediate Zones,MSOAIZ,SK,9129,4496,4633,1900,1961
E02001214,Stockport 028,Middle Super Output Areas and Intermediate Zones,MSOAIZ,SK,7452,3609,3843,1256,1377
E02001215,Stockport 029,Middle Super Output Areas and Intermediate Zones,MSOAIZ,SK,5804,2785,3019,1008,1066
E02001216,Stockport 030,Middle Super Output Areas and Intermediate Zones,MSOAIZ,SK,7310,3571,3739,1346,1426
E02001217,Stockport 031,Middle Super Output Areas and Intermediate Zones,MSOAIZ,SK,6581,3188,3393,1393,1377
E02001218,Stockport 032,Middle Super Output Areas and Intermediate Zones,MSOAIZ,SK,5860,2842,3018,1021,1113
E02001219,Stockport 033,Middle Super Output Areas and Intermediate Zones,MSOAIZ,SK,5455,2644,2811,942,1012
E02001220,Stockport 034,Middle Super Output Areas and Intermediate Zones,MSOAIZ,SK,5536,2688,2848,1085,1109
E02001221,Stockport 035,Middle Super Output Areas and Intermediate Zones,MSOAIZ,SK,6003,2925,3078,1071,1098
E02001222,Stockport 036,Middle Super Output Areas and Intermediate Zones,MSOAIZ,SK,6206,3044,3162,1067,1099
E02001223,Stockport 037,Middle Super Output Areas and Intermediate Zones,MSOAIZ,SK,6893,3343,3550,1195,1319
E02001224,Stockport 038,Middle Super Output Areas and Intermediate Zones,MSOAIZ,SK,5816,2831,2985,934,985
E02001225,Stockport 039,Middle Super Output Areas and Intermediate Zones,MSOAIZ,SK,7078,3440,3638,1385,1454
E02001226,Stockport 040,Middle Super Output Areas and Intermediate Zones,MSOAIZ,SK,6810,3353,3457,1329,1350
E02001227,Stockport 041,Middle Super Output Areas and Intermediate Zones,MSOAIZ,SK,5699,2755,2944,961,1017
E02001228,Stockport 042,Middle Super Output Areas and Intermediate Zones,MSOAIZ,SK,5411,2599,2812,877,968
E02001229,Tameside 001,Middle Super Output Areas and Intermediate Zones,MSOAIZ,SK,9731,4759,4972,2265,2227
E02001230,Tameside 002,Middle Super Output Areas and Intermediate Zones,MSOAIZ,OL,6147,3044,3103,1162,1194
E02001231,Tameside 003,Middle Super Output Areas and Intermediate Zones,MSOAIZ,SK,7150,3528,3622,1450,1540
E02001232,Tameside 004,Middle Super Output Areas and Intermediate Zones,MSOAIZ,OL,8211,4021,4190,1691,1766
E02001233,Tameside 005,Middle Super Output Areas and Intermediate Zones,MSOAIZ,OL,7541,3657,3884,1430,1554
E02001234,Tameside 006,Middle Super Output Areas and Intermediate Zones,MSOAIZ,OL,7615,3699,3916,1551,1661
E02001235,Tameside 007,Middle Super Output Areas and Intermediate Zones,MSOAIZ,SK,6559,3353,3206,1542,1451
E02001236,Tameside 008,Middle Super Output Areas and Intermediate Zones,MSOAIZ,SK,5734,2806,2928,1167,1157
E02001237,Tameside 009,Middle Super Output Areas and Intermediate Zones,MSOAIZ,SK,6855,3306,3549,1440,1550
E02001238,Tameside 010,Middle Super Output Areas and Intermediate Zones,MSOAIZ,OL,7773,3800,3973,1552,1653
E02001239,Tameside 011,Middle Super Output Areas and Intermediate Zones,MSOAIZ,M,9077,4335,4742,1807,1980
E02001240,Tameside 012,Middle Super Output Areas and Intermediate Zones,MSOAIZ,M,6184,3047,3137,1295,1328
E02001241,Tameside 013,Middle Super Output Areas and Intermediate Zones,MSOAIZ,SK,9483,4937,4546,2218,1897
E02001242,Tameside 014,Middle Super Output Areas and Intermediate Zones,MSOAIZ,M,5707,2770,2937,1102,1158
E02001243,Tameside 015,Middle Super Output Areas and Intermediate Zones,MSOAIZ,SK,7872,4015,3857,1660,1582
E02001244,Tameside 016,Middle Super Output Areas and Intermediate Zones,MSOAIZ,SK,5511,2732,2779,1070,1107
E02001245,Tameside 017,Middle Super Output Areas and Intermediate Zones,MSOAIZ,SK,7848,3884,3964,1783,1732
E02001246,Tameside 018,Middle Super Output Areas and Intermediate Zones,MSOAIZ,SK,7289,3576,3713,1377,1484
E02001247,Tameside 019,Middle Super Output Areas and Intermediate Zones,MSOAIZ,SK,6926,3397,3529,1464,1551
E02001248,Tameside 020,Middle Super Output Areas and Intermediate Zones,MSOAIZ,SK,10258,5072,5186,2231,2262
E02001249,Tameside 021,Middle Super Output Areas and Intermediate Zones,MSOAIZ,M,6269,3070,3199,1320,1339
E02001250,Tameside 022,Middle Super Output Areas and Intermediate Zones,MSOAIZ,SK,6514,3164,3350,1357,1422
E02001251,Tameside 023,Middle Super Output Areas and Intermediate Zones,MSOAIZ,SK,6021,2966,3055,1161,1199
E02001252,Tameside 024,Middle Super Output Areas and Intermediate Zones,MSOAIZ,SK,7491,3629,3862,1444,1437
E02001253,Tameside 025,Middle Super Output Areas and Intermediate Zones,MSOAIZ,M,5189,2481,2708,1037,1093
E02001254,Tameside 026,Middle Super Output Areas and Intermediate Zones,MSOAIZ,M,5823,2803,3020,1126,1176
E02001255,Tameside 027,Middle Super Output Areas and Intermediate Zones,MSOAIZ,SK,6071,2953,3118,1130,1222
E02001256,Tameside 028,Middle Super Output Areas and Intermediate Zones,MSOAIZ,SK,10137,4992,5145,2129,2107
E02001257,Tameside 029,Middle Super Output Areas and Intermediate Zones,MSOAIZ,M,9106,4385,4721,1629,1735
E02001258,Tameside 030,Middle Super Output Areas and Intermediate Zones,MSOAIZ,SK,7232,3469,3763,1387,1448
E02001259,Trafford 001,Middle Super Output Areas and Intermediate Zones,MSOAIZ,M,10177,5135,5042,2535,2388
E02001260,Trafford 002,Middle Super Output Areas and Intermediate Zones,MSOAIZ,M,7632,3689,3943,1417,1610
E02001261,Trafford 003,Middle Super Output Areas and Intermediate Zones,MSOAIZ,M,8277,4168,4109,1976,2008
E02001262,Trafford 004,Middle Super Output Areas and Intermediate Zones,MSOAIZ,M,8461,4127,4334,1725,1828
E02001263,Trafford 005,Middle Super Output Areas and Intermediate Zones,MSOAIZ,M,8054,3974,4080,1500,1571
E02001264,Trafford 006,Middle Super Output Areas and Intermediate Zones,MSOAIZ,M,8149,3897,4252,1691,1872
E02001265,Trafford 007,Middle Super Output Areas and Intermediate Zones,MSOAIZ,M,8108,3941,4167,1566,1722
E02001266,Trafford 008,Middle Super Output Areas and Intermediate Zones,MSOAIZ,M,6649,3261,3388,1418,1453
E02001267,Trafford 009,Middle Super Output Areas and Intermediate Zones,MSOAIZ,M,7422,3594,3828,1620,1628
E02001268,Trafford 010,Middle Super Output Areas and Intermediate Zones,MSOAIZ,M,7196,3458,3738,1369,1425
E02001269,Trafford 011,Middle Super Output Areas and Intermediate Zones,MSOAIZ,M,8266,4096,4170,1839,1837
E02001270,Trafford 012,Middle Super Output Areas and Intermediate Zones,MSOAIZ,M,7861,3912,3949,1852,1927
E02001271,Trafford 013,Middle Super Output Areas and Intermediate Zones,MSOAIZ,M,6547,3176,3371,1342,1420
E02001272,Trafford 014,Middle Super Output Areas and Intermediate Zones,MSOAIZ,M,7850,3913,3937,1677,1659
E02001273,Trafford 015,Middle Super Output Areas and Intermediate Zones,MSOAIZ,M,8882,4442,4440,2283,2083
E02001274,Trafford 016,Middle Super Output Areas and Intermediate Zones,MSOAIZ,M,7874,3834,4040,1360,1443
E02001275,Trafford 017,Middle Super Output Areas and Intermediate Zones,MSOAIZ,WA,8395,3976,4419,1530,1783
E02001276,Trafford 018,Middle Super Output Areas and Intermediate Zones,MSOAIZ,M,7931,3804,4127,1514,1727
E02001277,Trafford 019,Middle Super Output Areas and Intermediate Zones,MSOAIZ,WA,8823,4267,4556,1940,2246
E02001278,Trafford 020,Middle Super Output Areas and Intermediate Zones,MSOAIZ,WA,8117,4067,4050,1771,1793
E02001279,Trafford 021,Middle Super Output Areas and Intermediate Zones,MSOAIZ,WA,8426,4245,4181,1718,1790
E02001280,Trafford 022,Middle Super Output Areas and Intermediate Zones,MSOAIZ,WA,8268,3915,4353,1535,1761
E02001281,Trafford 023,Middle Super Output Areas and Intermediate Zones,MSOAIZ,WA,7753,3795,3958,1441,1522
E02001282,Trafford 024,Middle Super Output Areas and Intermediate Zones,MSOAIZ,WA,9008,4504,4504,2287,2239
E02001283,Trafford 025,Middle Super Output Areas and Intermediate Zones,MSOAIZ,WA,8645,4246,4399,1789,1711
E02001284,Trafford 026,Middle Super Output Areas and Intermediate Zones,MSOAIZ,WA,8082,3954,4128,1722,1841
E02001285,Trafford 027,Middle Super Output Areas and Intermediate Zones,MSOAIZ,WA,7831,3802,4029,1504,1591
E02001286,Trafford 028,Middle Super Output Areas and Intermediate Zones,MSOAIZ,WA,7894,3767,4127,1262,1428
E02001287,Wigan 001,Middle Super Output Areas and Intermediate Zones,MSOAIZ,WN,5685,2802,2883,1114,1202
E02001288,Wigan 002,Middle Super Output Areas and Intermediate Zones,MSOAIZ,WN,7547,3697,3850,1473,1503
E02001289,Wigan 003,Middle Super Output Areas and Intermediate Zones,MSOAIZ,WN,10082,5035,5047,1941,1996
E02001290,Wigan 004,Middle Super Output Areas and Intermediate Zones,MSOAIZ,WN,6086,2979,3107,1197,1255
E02001291,Wigan 005,Middle Super Output Areas and Intermediate Zones,MSOAIZ,WN,7675,3755,3920,1480,1607
E02001292,Wigan 006,Middle Super Output Areas and Intermediate Zones,MSOAIZ,WN,7864,3927,3937,1768,1535
E02001293,Wigan 007,Middle Super Output Areas and Intermediate Zones,MSOAIZ,WN,6158,3076,3082,1261,1260
E02001294,Wigan 008,Middle Super Output Areas and Intermediate Zones,MSOAIZ,WN,7832,3962,3870,1841,1719
E02001295,Wigan 009,Middle Super Output Areas and Intermediate Zones,MSOAIZ,WN,7330,3803,3527,1644,1421
E02001296,Wigan 010,Middle Super Output Areas and Intermediate Zones,MSOAIZ,WN,8933,4386,4547,1757,1839
E02001297,Wigan 011,Middle Super Output Areas and Intermediate Zones,MSOAIZ,WN,6703,3321,3382,1413,1381
E02001298,Wigan 012,Middle Super Output Areas and Intermediate Zones,MSOAIZ,WN,8131,4056,4075,1686,1695
E02001299,Wigan 013,Middle Super Output Areas and Intermediate Zones,MSOAIZ,WN,8850,4358,4492,1932,1919
E02001300,Wigan 014,Middle Super Output Areas and Intermediate Zones,MSOAIZ,WN,7922,3965,3957,1659,1563
E02001301,Wigan 015,Middle Super Output Areas and Intermediate Zones,MSOAIZ,WN,8099,4039,4060,1904,1742
E02001302,Wigan 016,Middle Super Output Areas and Intermediate Zones,MSOAIZ,WN,7846,3861,3985,1510,1562
E02001303,Wigan 017,Middle Super Output Areas and Intermediate Zones,MSOAIZ,M,8530,4324,4206,1874,1789
E02001304,Wigan 018,Middle Super Output Areas and Intermediate Zones,MSOAIZ,WN,12240,5999,6241,2377,2407
E02001305,Wigan 019,Middle Super Output Areas and Intermediate Zones,MSOAIZ,WN,8197,4021,4176,1637,1719
E02001306,Wigan 020,Middle Super Output Areas and Intermediate Zones,MSOAIZ,WN,7302,3636,3666,1410,1488
E02001307,Wigan 021,Middle Super Output Areas and Intermediate Zones,MSOAIZ,WN,11264,5594,5670,2340,2399
E02001308,Wigan 022,Middle Super Output Areas and Intermediate Zones,MSOAIZ,M,5992,2978,3014,1207,1214
E02001309,Wigan 023,Middle Super Output Areas and Intermediate Zones,MSOAIZ,WN,7669,3851,3818,1719,1668
E02001310,Wigan 024,Middle Super Output Areas and Intermediate Zones,MSOAIZ,WN,8988,4467,4521,1946,1904
E02001311,Wigan 025,Middle Super Output Areas and Intermediate Zones,MSOAIZ,M,8317,4113,4204,1773,1756
E02001312,Wigan 026,Middle Super Output Areas and Intermediate Zones,MSOAIZ,WN,7790,4043,3747,1701,1642
E02001313,Wigan 027,Middle Super Output Areas and Intermediate Zones,MSOAIZ,WN,7893,3908,3985,1601,1680
E02001314,Wigan 028,Middle Super Output Areas and Intermediate Zones,MSOAIZ,M,8026,4084,3942,1735,1818
E02001315,Wigan 029,Middle Super Output Areas and Intermediate Zones,MSOAIZ,WN,7689,3765,3924,1564,1623
E02001316,Wigan 030,Middle Super Output Areas and Intermediate Zones,MSOAIZ,WN,6546,3302,3244,1576,1407
E02001317,Wigan 031,Middle Super Output Areas and Intermediate Zones,MSOAIZ,WN,8444,4238,4206,1818,1729
E02001318,Wigan 032,Middle Super Output Areas and Intermediate Zones,MSOAIZ,WN,7869,3922,3947,1472,1551
E02001319,Wigan 033,Middle Super Output Areas and Intermediate Zones,MSOAIZ,WN,7356,3646,3710,1498,1516
E02001320,Wigan 034,Middle Super Output Areas and Intermediate Zones,MSOAIZ,WN,7663,3723,3940,1599,1614
E02001321,Wigan 035,Middle Super Output Areas and Intermediate Zones,MSOAIZ,WN,8398,4214,4184,1731,1727
E02001322,Wigan 036,Middle Super Output Areas and Intermediate Zones,MSOAIZ,WN,7448,3666,3782,1463,1434
E02001323,Wigan 037,Middle Super Output Areas and Intermediate Zones,MSOAIZ,WN,7535,3662,3873,1514,1548
E02001324,Wigan 038,Middle Super Output Areas and Intermediate Zones,MSOAIZ,WA,8473,4202,4271,1727,1809
E02001325,Wigan 039,Middle Super Output Areas and Intermediate Zones,MSOAIZ,WA,7775,3802,3973,1534,1650
E02001326,Wigan 040,Middle Super Output Areas and Intermediate Zones,MSOAIZ,WN,7702,3814,3888,1553,1574
E02001327,Knowsley 001,Middle Super Output Areas and Intermediate Zones,MSOAIZ,L,7451,3327,4124,1204,1680
E02001328,Knowsley 002,Middle Super Output Areas and Intermediate Zones,MSOAIZ,L,10145,4883,5262,2168,2289
E02001329,Knowsley 003,Middle Super Output Areas and Intermediate Zones,MSOAIZ,L,7603,3680,3923,1561,1637
E02001330,Knowsley 004,Middle Super Output Areas and Intermediate Zones,MSOAIZ,L,8706,4078,4628,1691,1972
E02001331,Knowsley 005,Middle Super Output Areas and Intermediate Zones,MSOAIZ,WA,10062,4721,5341,1762,2096
E02001332,Knowsley 006,Middle Super Output Areas and Intermediate Zones,MSOAIZ,L,6644,3194,3450,1324,1401
E02001333,Knowsley 007,Middle Super Output Areas and Intermediate Zones,MSOAIZ,L,8200,3973,4227,1611,1713
E02001334,Knowsley 008,Middle Super Output Areas and Intermediate Zones,MSOAIZ,L,5780,2653,3127,955,1252
E02001335,Knowsley 009,Middle Super Output Areas and Intermediate Zones,MSOAIZ,L,7668,3705,3963,1557,1652
E02001336,Knowsley 010,Middle Super Output Areas and Intermediate Zones,MSOAIZ,L,6833,3189,3644,1188,1476
E02001337,Knowsley 011,Middle Super Output Areas and Intermediate Zones,MSOAIZ,L,5933,2812,3121,1140,1307
E02001338,Knowsley 012,Middle Super Output Areas and Intermediate Zones,MSOAIZ,L,5935,2792,3143,1077,1287
E02001339,Knowsley 013,Middle Super Output Areas and Intermediate Zones,MSOAIZ,L,6739,3246,3493,1280,1460
E02001340,Knowsley 014,Middle Super Output Areas and Intermediate Zones,MSOAIZ,L,8997,4312,4685,1689,1866
E02001341,Knowsley 015,Middle Super Output Areas and Intermediate Zones,MSOAIZ,L,6857,3199,3658,1264,1450
E02001342,Knowsley 016,Middle Super Output Areas and Intermediate Zones,MSOAIZ,L,7172,3377,3795,1244,1395
E02001343,Knowsley 017,Middle Super Output Areas and Intermediate Zones,MSOAIZ,WA,7118,3475,3643,1422,1509
E02001344,Knowsley 018,Middle Super Output Areas and Intermediate Zones,MSOAIZ,L,5343,2543,2800,1036,1218
E02001345,Knowsley 019,Middle Super Output Areas and Intermediate Zones,MSOAIZ,L,5637,2767,2870,1124,1200
E02001346,Knowsley 020,Middle Super Output Areas and Intermediate Zones,MSOAIZ,L,7070,3403,3667,1388,1539
E02001347,Liverpool 001,Middle Super Output Areas and Intermediate Zones,MSOAIZ,L,7653,3655,3998,1579,1765
E02001348,Liverpool 002,Middle Super Output Areas and Intermediate Zones,MSOAIZ,L,7222,3526,3696,1494,1634
E02001349,Liverpool 003,Middle Super Output Areas and Intermediate Zones,MSOAIZ,L,7966,3982,3984,1814,1805
E02001350,Liverpool 004,Middle Super Output Areas and Intermediate Zones,MSOAIZ,L,7856,3661,4195,1526,1729
E02001351,Liverpool 005,Middle Super Output Areas and Intermediate Zones,MSOAIZ,L,8894,4580,4314,2040,1818
E02001352,Liverpool 006,Middle Super Output Areas and Intermediate Zones,MSOAIZ,L,7416,4206,3210,2143,1420
E02001353,Liverpool 007,Middle Super Output Areas and Intermediate Zones,MSOAIZ,L,7572,3645,3927,1678,1855
E02001354,Liverpool 008,Middle Super Output Areas and Intermediate Zones,MSOAIZ,L,7613,3642,3971,1383,1705
E02001355,Liverpool 009,Middle Super Output Areas and Intermediate Zones,MSOAIZ,L,6664,3239,3425,1373,1470
E02001356,Liverpool 010,Middle Super Output Areas and Intermediate Zones,MSOAIZ,L,5584,2549,3035,980,1256
E02001357,Liverpool 011,Middle Super Output Areas and Intermediate Zones,MSOAIZ,L,6982,3157,3825,1161,1547
E02001358,Liverpool 012,Middle Super Output Areas and Intermediate Zones,MSOAIZ,L,7069,3423,3646,1490,1568
E02001359,Liverpool 013,Middle Super Output Areas and Intermediate Zones,MSOAIZ,L,5751,2768,2983,1087,1242
E02001360,Liverpool 014,Middle Super Output Areas and Intermediate Zones,MSOAIZ,L,8358,4222,4136,1768,1685
E02001361,Liverpool 015,Middle Super Output Areas and Intermediate Zones,MSOAIZ,L,7618,3611,4007,1438,1599
E02001362,Liverpool 016,Middle Super Output Areas and Intermediate Zones,MSOAIZ,L,7401,3498,3903,1368,1520
E02001363,Liverpool 017,Middle Super Output Areas and Intermediate Zones,MSOAIZ,L,7788,3578,4210,1504,1751
E02001364,Liverpool 018,Middle Super Output Areas and Intermediate Zones,MSOAIZ,L,5311,2561,2750,1122,1096
E02001365,Liverpool 019,Middle Super Output Areas and Intermediate Zones,MSOAIZ,L,9049,4480,4569,1978,1933
E02001366,Liverpool 020,Middle Super Output Areas and Intermediate Zones,MSOAIZ,L,8985,4535,4450,2060,1923
E02001367,Liverpool 021,Middle Super Output Areas and Intermediate Zones,MSOAIZ,L,9304,4444,4860,1785,1934
E02001368,Liverpool 022,Middle Super Output Areas and Intermediate Zones,MSOAIZ,L,5847,2836,3011,1063,1221
E02001369,Liverpool 023,Middle Super Output Areas and Intermediate Zones,MSOAIZ,L,7655,3943,3712,1691,1523
E02001370,Liverpool 024,Middle Super Output Areas and Intermediate Zones,MSOAIZ,L,6186,3068,3118,1136,1219
E02001371,Liverpool 025,Middle Super Output Areas and Intermediate Zones,MSOAIZ,L,7447,3408,4039,1431,1784
E02001372,Liverpool 026,Middle Super Output Areas and Intermediate Zones,MSOAIZ,L,6221,3018,3203,1261,1271
E02001373,Liverpool 027,Middle Super Output Areas and Intermediate Zones,MSOAIZ,L,9253,4528,4725,2000,2034
E02001374,Liverpool 028,Middle Super Output Areas and Intermediate Zones,MSOAIZ,L,8199,4499,3700,2377,1621
E02001375,Liverpool 029,Middle Super Output Areas and Intermediate Zones,MSOAIZ,L,7195,3352,3843,1389,1562
E02001376,Liverpool 030,Middle Super Output Areas and Intermediate Zones,MSOAIZ,L,8469,4285,4184,1880,1705
E02001377,Liverpool 031,Middle Super Output Areas and Intermediate Zones,MSOAIZ,L,11467,5792,5675,1891,1510
E02001378,Liverpool 032,Middle Super Output Areas and Intermediate Zones,MSOAIZ,L,7972,3920,4052,1766,1699
E02001380,Liverpool 034,Middle Super Output Areas and Intermediate Zones,MSOAIZ,L,7526,3622,3904,1443,1614
E02001381,Liverpool 035,Middle Super Output Areas and Intermediate Zones,MSOAIZ,L,9286,4697,4589,2158,1921
E02001382,Liverpool 036,Middle Super Output Areas and Intermediate Zones,MSOAIZ,L,7098,3438,3660,1440,1525
E02001383,Liverpool 037,Middle Super Output Areas and Intermediate Zones,MSOAIZ,L,7501,4118,3383,2014,1371
E02001384,Liverpool 038,Middle Super Output Areas and Intermediate Zones,MSOAIZ,L,10762,5418,5344,1735,1384
E02001385,Liverpool 039,Middle Super Output Areas and Intermediate Zones,MSOAIZ,L,8157,4245,3912,1880,1573
E02001386,Liverpool 040,Middle Super Output Areas and Intermediate Zones,MSOAIZ,L,7545,3571,3974,1358,1510
E02001387,Liverpool 041,Middle Super Output Areas and Intermediate Zones,MSOAIZ,L,8025,3826,4199,1502,1660
E02001388,Liverpool 042,Middle Super Output Areas and Intermediate Zones,MSOAIZ,L,8860,4471,4389,1849,1587
E02001389,Liverpool 043,Middle Super Output Areas and Intermediate Zones,MSOAIZ,L,6232,3440,2792,2104,1471
E02001390,Liverpool 044,Middle Super Output Areas and Intermediate Zones,MSOAIZ,L,8756,4363,4393,1851,1858
E02001391,Liverpool 045,Middle Super Output Areas and Intermediate Zones,MSOAIZ,L,5970,2741,3229,1023,1273
E02001392,Liverpool 046,Middle Super Output Areas and Intermediate Zones,MSOAIZ,L,5717,2778,2939,1000,1030
E02001393,Liverpool 047,Middle Super Output Areas and Intermediate Zones,MSOAIZ,L,7753,3692,4061,1260,1337
E02001394,Liverpool 048,Middle Super Output Areas and Intermediate Zones,MSOAIZ,L,10143,5098,5045,2254,1878
E02001395,Liverpool 049,Middle Super Output Areas and Intermediate Zones,MSOAIZ,L,6056,2905,3151,1288,1338
E02001396,Liverpool 050,Middle Super Output Areas and Intermediate Zones,MSOAIZ,L,8035,4006,4029,1923,1912
E02001397,Liverpool 051,Middle Super Output Areas and Intermediate Zones,MSOAIZ,L,7631,3708,3923,1541,1467
E02001398,Liverpool 052,Middle Super Output Areas and Intermediate Zones,MSOAIZ,L,7758,3808,3950,1885,1756
E02001399,Liverpool 053,Middle Super Output Areas and Intermediate Zones,MSOAIZ,L,7276,3524,3752,1285,1451
E02001400,Liverpool 054,Middle Super Output Areas and Intermediate Zones,MSOAIZ,L,6614,3182,3432,1281,1442
E02001401,Liverpool 055,Middle Super Output Areas and Intermediate Zones,MSOAIZ,L,7872,3772,4100,1469,1553
E02001402,Liverpool 056,Middle Super Output Areas and Intermediate Zones,MSOAIZ,L,8384,4140,4244,1823,1777
E02001403,Liverpool 057,Middle Super Output Areas and Intermediate Zones,MSOAIZ,L,6035,3050,2985,1419,1392
E02001404,Liverpool 058,Middle Super Output Areas and Intermediate Zones,MSOAIZ,L,7260,3452,3808,1411,1686
E02001405,Liverpool 059,Middle Super Output Areas and Intermediate Zones,MSOAIZ,L,9609,4446,5163,1723,2088
E02001406,St. Helens 001,Middle Super Output Areas and Intermediate Zones,MSOAIZ,WN,7779,3699,4080,1301,1332
E02001407,St. Helens 002,Middle Super Output Areas and Intermediate Zones,MSOAIZ,WN,6179,3082,3097,1029,1037
E02001408,St. Helens 003,Middle Super Output Areas and Intermediate Zones,MSOAIZ,WN,5753,2889,2864,1109,1136
E02001409,St. Helens 004,Middle Super Output Areas and Intermediate Zones,MSOAIZ,WA,9815,4837,4978,1896,1923
E02001410,St. Helens 005,Middle Super Output Areas and Intermediate Zones,MSOAIZ,WN,5837,2861,2976,1168,1175
E02001411,St. Helens 006,Middle Super Output Areas and Intermediate Zones,MSOAIZ,WA,5871,2878,2993,1161,1178
E02001412,St. Helens 007,Middle Super Output Areas and Intermediate Zones,MSOAIZ,WA,8823,4333,4490,1693,1787
E02001413,St. Helens 008,Middle Super Output Areas and Intermediate Zones,MSOAIZ,WA,9682,4708,4974,1844,1925
E02001414,St. Helens 009,Middle Super Output Areas and Intermediate Zones,MSOAIZ,WA,5355,2608,2747,906,948
E02001415,St. Helens 010,Middle Super Output Areas and Intermediate Zones,MSOAIZ,WA,6592,3246,3346,1405,1453
E02001416,St. Helens 011,Middle Super Output Areas and Intermediate Zones,MSOAIZ,WA,5926,2888,3038,1175,1188
E02001417,St. Helens 012,Middle Super Output Areas and Intermediate Zones,MSOAIZ,WA,7187,3646,3541,1720,1484
E02001418,St. Helens 013,Middle Super Output Areas and Intermediate Zones,MSOAIZ,WA,5235,2560,2675,1108,1134
E02001419,St. Helens 014,Middle Super Output Areas and Intermediate Zones,MSOAIZ,WA,6818,3381,3437,1406,1334
E02001420,St. Helens 015,Middle Super Output Areas and Intermediate Zones,MSOAIZ,WA,10206,5040,5166,2151,2147
E02001421,St. Helens 016,Middle Super Output Areas and Intermediate Zones,MSOAIZ,WA,10509,5188,5321,2262,2259
E02001422,St. Helens 017,Middle Super Output Areas and Intermediate Zones,MSOAIZ,WA,6362,3133,3229,1316,1351
E02001423,St. Helens 018,Middle Super Output Areas and Intermediate Zones,MSOAIZ,WA,6324,3091,3233,1150,1227
E02001424,St. Helens 019,Middle Super Output Areas and Intermediate Zones,MSOAIZ,WA,13529,6621,6908,2738,2769
E02001425,St. Helens 020,Middle Super Output Areas and Intermediate Zones,MSOAIZ,WA,10460,5131,5329,2063,2119
E02001426,St. Helens 021,Middle Super Output Areas and Intermediate Zones,MSOAIZ,WA,5400,2664,2736,985,1000
E02001427,St. Helens 022,Middle Super Output Areas and Intermediate Zones,MSOAIZ,WA,10213,5013,5200,2050,2196
E02001428,St. Helens 023,Middle Super Output Areas and Intermediate Zones,MSOAIZ,L,5453,2641,2812,883,918
E02001429,Sefton 001,Middle Super Output Areas and Intermediate Zones,MSOAIZ,PR,6751,3152,3599,1078,1207
E02001430,Sefton 002,Middle Super Output Areas and Intermediate Zones,MSOAIZ,PR,7142,3331,3811,1174,1334
E02001431,Sefton 003,Middle Super Output Areas and Intermediate Zones,MSOAIZ,PR,7288,3296,3992,1045,1090
E02001432,Sefton 004,Middle Super Output Areas and Intermediate Zones,MSOAIZ,PR,8398,4148,4250,1874,1566
E02001433,Sefton 005,Middle Super Output Areas and Intermediate Zones,MSOAIZ,PR,7642,3699,3943,1525,1704
E02001434,Sefton 006,Middle Super Output Areas and Intermediate Zones,MSOAIZ,PR,7210,3579,3631,1512,1584
E02001435,Sefton 007,Middle Super Output Areas and Intermediate Zones,MSOAIZ,PR,8058,3971,4087,1732,1682
E02001436,Sefton 008,Middle Super Output Areas and Intermediate Zones,MSOAIZ,PR,8704,4172,4532,1638,1857
E02001437,Sefton 009,Middle Super Output Areas and Intermediate Zones,MSOAIZ,PR,9586,4463,5123,1456,1499
E02001438,Sefton 010,Middle Super Output Areas and Intermediate Zones,MSOAIZ,PR,7500,3588,3912,1372,1571
E02001439,Sefton 011,Middle Super Output Areas and Intermediate Zones,MSOAIZ,PR,6291,2971,3320,1076,1215
E02001440,Sefton 012,Middle Super Output Areas and Intermediate Zones,MSOAIZ,PR,5811,2787,3024,829,847
E02001441,Sefton 013,Middle Super Output Areas and Intermediate Zones,MSOAIZ,L,6564,3157,3407,952,1057
E02001442,Sefton 014,Middle Super Output Areas and Intermediate Zones,MSOAIZ,L,5887,2757,3130,921,1024
E02001443,Sefton 015,Middle Super Output Areas and Intermediate Zones,MSOAIZ,L,5664,2736,2928,884,947
E02001444,Sefton 016,Middle Super Output Areas and Intermediate Zones,MSOAIZ,L,5730,2730,3000,966,1074
E02001445,Sefton 017,Middle Super Output Areas and Intermediate Zones,MSOAIZ,L,7021,3367,3654,1239,1297
E02001446,Sefton 018,Middle Super Output Areas and Intermediate Zones,MSOAIZ,L,6837,3306,3531,1222,1249
E02001447,Sefton 019,Middle Super Output Areas and Intermediate Zones,MSOAIZ,L,5964,2815,3149,1004,1076
E02001448,Sefton 020,Middle Super Output Areas and Intermediate Zones,MSOAIZ,L,6930,3343,3587,1271,1316
E02001449,Sefton 021,Middle Super Output Areas and Intermediate Zones,MSOAIZ,L,9241,4458,4783,1620,1753
E02001450,Sefton 022,Middle Super Output Areas and Intermediate Zones,MSOAIZ,L,8187,3860,4327,1427,1463
E02001451,Sefton 023,Middle Super Output Areas and Intermediate Zones,MSOAIZ,L,6205,2841,3364,1077,1194
E02001452,Sefton 024,Middle Super Output Areas and Intermediate Zones,MSOAIZ,L,6623,3083,3540,1197,1384
E02001453,Sefton 025,Middle Super Output Areas and Intermediate Zones,MSOAIZ,L,8676,4145,4531,1593,1726
E02001454,Sefton 026,Middle Super Output Areas and Intermediate Zones,MSOAIZ,L,7371,3717,3654,1551,1449
E02001455,Sefton 027,Middle Super Output Areas and Intermediate Zones,MSOAIZ,L,7197,3469,3728,1402,1560
E02001456,Sefton 028,Middle Super Output Areas and Intermediate Zones,MSOAIZ,L,7521,3550,3971,1487,1639
E02001457,Sefton 029,Middle Super Output Areas and Intermediate Zones,MSOAIZ,L,6771,3200,3571,1326,1471
E02001458,Sefton 030,Middle Super Output Areas and Intermediate Zones,MSOAIZ,L,7668,3797,3871,1715,1698
E02001459,Sefton 031,Middle Super Output Areas and Intermediate Zones,MSOAIZ,L,7267,3413,3854,1350,1568
E02001460,Sefton 032,Middle Super Output Areas and Intermediate Zones,MSOAIZ,L,7528,3744,3784,1578,1528
E02001461,Sefton 033,Middle Super Output Areas and Intermediate Zones,MSOAIZ,L,6326,3074,3252,1186,1288
E02001462,Sefton 034,Middle Super Output Areas and Intermediate Zones,MSOAIZ,L,7529,3590,3939,1466,1673
E02001463,Sefton 035,Middle Super Output Areas and Intermediate Zones,MSOAIZ,L,6850,3250,3600,1260,1472
E02001464,Sefton 036,Middle Super Output Areas and Intermediate Zones,MSOAIZ,L,6867,3277,3590,1438,1527
E02001465,Sefton 037,Middle Super Output Areas and Intermediate Zones,MSOAIZ,L,6395,3273,3122,1321,1211
E02001466,Sefton 038,Middle Super Output Areas and Intermediate Zones,MSOAIZ,L,8590,4128,4462,1576,1831
E02001467,Wirral 001,Middle Super Output Areas and Intermediate Zones,MSOAIZ,L,7547,3704,3843,1559,1575
E02001468,Wirral 002,Middle Super Output Areas and Intermediate Zones,MSOAIZ,L,7841,3796,4045,1610,1721
E02001469,Wirral 003,Middle Super Output Areas and Intermediate Zones,MSOAIZ,L,7829,3784,4045,1409,1535
E02001470,Wirral 004,Middle Super Output Areas and Intermediate Zones,MSOAIZ,L,8593,4112,4481,1578,1719
E02001471,Wirral 005,Middle Super Output Areas and Intermediate Zones,MSOAIZ,L,7525,3726,3799,1506,1582
E02001472,Wirral 006,Middle Super Output Areas and Intermediate Zones,MSOAIZ,L,7064,3421,3643,1373,1531
E02001473,Wirral 007,Middle Super Output Areas and Intermediate Zones,MSOAIZ,L,7660,3733,3927,1430,1578
E02001474,Wirral 008,Middle Super Output Areas and Intermediate Zones,MSOAIZ,L,7100,3479,3621,1296,1507
E02001475,Wirral 009,Middle Super Output Areas and Intermediate Zones,MSOAIZ,L,6168,2910,3258,1091,1313
E02001476,Wirral 010,Middle Super Output Areas and Intermediate Zones,MSOAIZ,L,7626,3674,3952,1471,1717
E02001477,Wirral 011,Middle Super Output Areas and Intermediate Zones,MSOAIZ,L,7510,3446,4064,1262,1725
E02001478,Wirral 012,Middle Super Output Areas and Intermediate Zones,MSOAIZ,L,7909,3844,4065,1374,1457
E02001479,Wirral 013,Middle Super Output Areas and Intermediate Zones,MSOAIZ,L,6173,2960,3213,1185,1280
E02001480,Wirral 014,Middle Super Output Areas and Intermediate Zones,MSOAIZ,L,7738,3689,4049,1474,1560
E02001481,Wirral 015,Middle Super Output Areas and Intermediate Zones,MSOAIZ,L,8109,3916,4193,1628,1685
E02001482,Wirral 016,Middle Super Output Areas and Intermediate Zones,MSOAIZ,L,7723,3938,3785,1674,1619
E02001483,Wirral 017,Middle Super Output Areas and Intermediate Zones,MSOAIZ,L,7396,3522,3874,1384,1547
E02001484,Wirral 018,Middle Super Output Areas and Intermediate Zones,MSOAIZ,L,7663,3586,4077,1352,1495
E02001485,Wirral 019,Middle Super Output Areas and Intermediate Zones,MSOAIZ,L,6382,2918,3464,1061,1332
E02001486,Wirral 020,Middle Super Output Areas and Intermediate Zones,MSOAIZ,L,8248,4052,4196,1796,1543
E02001487,Wirral 021,Middle Super Output Areas and Intermediate Zones,MSOAIZ,L,9284,4471,4813,1862,2060
E02001488,Wirral 022,Middle Super Output Areas and Intermediate Zones,MSOAIZ,L,8480,4123,4357,1860,1914
E02001489,Wirral 023,Middle Super Output Areas and Intermediate Zones,MSOAIZ,L,8293,3971,4322,1368,1522
E02001490,Wirral 024,Middle Super Output Areas and Intermediate Zones,MSOAIZ,L,8743,4296,4447,1722,1795
E02001491,Wirral 025,Middle Super Output Areas and Intermediate Zones,MSOAIZ,L,6833,3216,3617,1203,1395
E02001492,Wirral 026,Middle Super Output Areas and Intermediate Zones,MSOAIZ,L,7846,3684,4162,1422,1496
E02001493,Wirral 027,Middle Super Output Areas and Intermediate Zones,MSOAIZ,L,7970,3806,4164,1435,1758
E02001494,Wirral 028,Middle Super Output Areas and Intermediate Zones,MSOAIZ,L,7113,3433,3680,1143,1194
E02001495,Wirral 029,Middle Super Output Areas and Intermediate Zones,MSOAIZ,L,7789,3732,4057,1508,1591
E02001496,Wirral 030,Middle Super Output Areas and Intermediate Zones,MSOAIZ,L,6026,2910,3116,1093,1108
E02001497,Wirral 031,Middle Super Output Areas and Intermediate Zones,MSOAIZ,L,7971,3866,4105,1572,1732
E02001498,Wirral 032,Middle Super Output Areas and Intermediate Zones,MSOAIZ,L,7568,3650,3918,1422,1520
E02001499,Wirral 033,Middle Super Output Areas and Intermediate Zones,MSOAIZ,L,6691,3202,3489,1114,1172
E02001500,Wirral 034,Middle Super Output Areas and Intermediate Zones,MSOAIZ,L,7485,3606,3879,1296,1423
E02001501,Wirral 035,Middle Super Output Areas and Intermediate Zones,MSOAIZ,L,7971,3811,4160,1442,1619
E02001502,Wirral 036,Middle Super Output Areas and Intermediate Zones,MSOAIZ,L,8342,3952,4390,1658,1722
E02001503,Wirral 037,Middle Super Output Areas and Intermediate Zones,MSOAIZ,L,7518,3476,4042,1243,1338
E02001504,Wirral 038,Middle Super Output Areas and Intermediate Zones,MSOAIZ,L,7329,3523,3806,1185,1240
E02001505,Wirral 039,Middle Super Output Areas and Intermediate Zones,MSOAIZ,L,6428,3093,3335,1169,1264
E02001506,Wirral 040,Middle Super Output Areas and Intermediate Zones,MSOAIZ,L,8980,4338,4642,1342,1428
E02001507,Wirral 041,Middle Super Output Areas and Intermediate Zones,MSOAIZ,L,7296,3624,3672,1330,1289
E02001508,Wirral 042,Middle Super Output Areas and Intermediate Zones,MSOAIZ,L,8023,3854,4169,1538,1645
E02001509,Barnsley 001,Middle Super Output Areas and Intermediate Zones,MSOAIZ,S,6279,3063,3216,1251,1278
E02001510,Barnsley 002,Middle Super Output Areas and Intermediate Zones,MSOAIZ,S,5878,2903,2975,1181,1199
E02001511,Barnsley 003,Middle Super Output Areas and Intermediate Zones,MSOAIZ,S,6191,3056,3135,1179,1238
E02001512,Barnsley 004,Middle Super Output Areas and Intermediate Zones,MSOAIZ,S,7642,3706,3936,1518,1574
E02001513,Barnsley 005,Middle Super Output Areas and Intermediate Zones,MSOAIZ,S,7803,3792,4011,1511,1597
E02001514,Barnsley 006,Middle Super Output Areas and Intermediate Zones,MSOAIZ,S,7267,3557,3710,1494,1515
E02001515,Barnsley 007,Middle Super Output Areas and Intermediate Zones,MSOAIZ,S,9257,4546,4711,1769,1833
E02001516,Barnsley 008,Middle Super Output Areas and Intermediate Zones,MSOAIZ,S,6098,3006,3092,1262,1315
E02001517,Barnsley 009,Middle Super Output Areas and Intermediate Zones,MSOAIZ,S,7886,3922,3964,1600,1603
E02001518,Barnsley 010,Middle Super Output Areas and Intermediate Zones,MSOAIZ,S,10013,4938,5075,2157,2156
E02001519,Barnsley 011,Middle Super Output Areas and Intermediate Zones,MSOAIZ,S,6749,3258,3491,1350,1367
E02001520,Barnsley 012,Middle Super Output Areas and Intermediate Zones,MSOAIZ,S,10662,5228,5434,2070,2035
E02001521,Barnsley 013,Middle Super Output Areas and Intermediate Zones,MSOAIZ,S,11267,5722,5545,2809,2504
E02001522,Barnsley 014,Middle Super Output Areas and Intermediate Zones,MSOAIZ,S,8687,4245,4442,1646,1672
E02001523,Barnsley 015,Middle Super Output Areas and Intermediate Zones,MSOAIZ,S,6755,3375,3380,1551,1416
E02001524,Barnsley 016,Middle Super Output Areas and Intermediate Zones,MSOAIZ,WF,5902,2886,3016,1024,1151
E02001525,Barnsley 017,Middle Super Output Areas and Intermediate Zones,MSOAIZ,S,6010,2957,3053,1250,1185
E02001526,Barnsley 018,Middle Super Output Areas and Intermediate Zones,MSOAIZ,S,5827,2903,2924,1193,1179
E02001527,Barnsley 019,Middle Super Output Areas and Intermediate Zones,MSOAIZ,S,5900,2898,3002,1171,1221
E02001528,Barnsley 020,Middle Super Output Areas and Intermediate Zones,MSOAIZ,S,10286,4994,5292,1941,2008
E02001529,Barnsley 021,Middle Super Output Areas and Intermediate Zones,MSOAIZ,S,9416,4601,4815,1808,1842
E02001530,Barnsley 022,Middle Super Output Areas and Intermediate Zones,MSOAIZ,S,6240,3093,3147,1334,1349
E02001531,Barnsley 023,Middle Super Output Areas and Intermediate Zones,MSOAIZ,S,6424,3228,3196,1352,1330
E02001532,Barnsley 024,Middle Super Output Areas and Intermediate Zones,MSOAIZ,S,9492,4692,4800,1933,2034
E02001533,Barnsley 025,Middle Super Output Areas and Intermediate Zones,MSOAIZ,S,7460,3621,3839,1518,1555
E02001534,Barnsley 026,Middle Super Output Areas and Intermediate Zones,MSOAIZ,S,9135,4426,4709,1863,1914
E02001535,Barnsley 027,Middle Super Output Areas and Intermediate Zones,MSOAIZ,S,6114,3071,3043,1197,1208
E02001536,Barnsley 028,Middle Super Output Areas and Intermediate Zones,MSOAIZ,S,8396,4029,4367,1635,1722
E02001537,Barnsley 029,Middle Super Output Areas and Intermediate Zones,MSOAIZ,S,8240,4031,4209,1757,1837
E02001538,Barnsley 030,Middle Super Output Areas and Intermediate Zones,MSOAIZ,S,7945,3887,4058,1517,1540
E02001539,Doncaster 001,Middle Super Output Areas and Intermediate Zones,MSOAIZ,DN,6018,2926,3092,1182,1243
E02001540,Doncaster 002,Middle Super Output Areas and Intermediate Zones,MSOAIZ,WF,11673,5756,5917,2227,2294
E02001541,Doncaster 003,Middle Super Output Areas and Intermediate Zones,MSOAIZ,DN,11277,5472,5805,2167,2238
E02001542,Doncaster 004,Middle Super Output Areas and Intermediate Zones,MSOAIZ,DN,7479,3662,3817,1365,1438
E02001543,Doncaster 005,Middle Super Output Areas and Intermediate Zones,MSOAIZ,DN,8485,4126,4359,1612,1638
E02001544,Doncaster 006,Middle Super Output Areas and Intermediate Zones,MSOAIZ,DN,8711,4208,4503,1744,1839
E02001545,Doncaster 007,Middle Super Output Areas and Intermediate Zones,MSOAIZ,DN,8592,4222,4370,1637,1710
E02001546,Doncaster 008,Middle Super Output Areas and Intermediate Zones,MSOAIZ,DN,8615,5258,3357,2590,1242
E02001547,Doncaster 009,Middle Super Output Areas and Intermediate Zones,MSOAIZ,DN,10737,5291,5446,2140,2228
E02001548,Doncaster 010,Middle Super Output Areas and Intermediate Zones,MSOAIZ,DN,8009,3834,4175,1527,1654
E02001549,Doncaster 011,Middle Super Output Areas and Intermediate Zones,MSOAIZ,DN,5969,2923,3046,1184,1186
E02001550,Doncaster 012,Middle Super Output Areas and Intermediate Zones,MSOAIZ,DN,7463,3594,3869,1526,1554
E02001551,Doncaster 013,Middle Super Output Areas and Intermediate Zones,MSOAIZ,DN,6027,2986,3041,1283,1239
E02001552,Doncaster 014,Middle Super Output Areas and Intermediate Zones,MSOAIZ,DN,7686,3731,3955,1669,1687
E02001553,Doncaster 015,Middle Super Output Areas and Intermediate Zones,MSOAIZ,DN,10018,4841,5177,1984,2024
E02001554,Doncaster 016,Middle Super Output Areas and Intermediate Zones,MSOAIZ,DN,6420,3139,3281,1261,1317
E02001555,Doncaster 017,Middle Super Output Areas and Intermediate Zones,MSOAIZ,DN,5578,2704,2874,1046,1087
E02001556,Doncaster 018,Middle Super Output Areas and Intermediate Zones,MSOAIZ,DN,9294,4441,4853,1842,1956
E02001557,Doncaster 019,Middle Super Output Areas and Intermediate Zones,MSOAIZ,DN,9487,4876,4611,2370,1963
E02001558,Doncaster 020,Middle Super Output Areas and Intermediate Zones,MSOAIZ,S,6125,2948,3177,1090,1208
E02001559,Doncaster 021,Middle Super Output Areas and Intermediate Zones,MSOAIZ,DN,7742,3699,4043,1454,1586
E02001560,Doncaster 022,Middle Super Output Areas and Intermediate Zones,MSOAIZ,DN,10508,5681,4827,2871,2078
E02001561,Doncaster 023,Middle Super Output Areas and Intermediate Zones,MSOAIZ,DN,6318,3313,3005,1580,1286
E02001562,Doncaster 024,Middle Super Output Areas and Intermediate Zones,MSOAIZ,DN,5905,2816,3089,1092,1100
E02001563,Doncaster 025,Middle Super Output Areas and Intermediate Zones,MSOAIZ,DN,7635,3671,3964,1349,1407
E02001564,Doncaster 026,Middle Super Output Areas and Intermediate Zones,MSOAIZ,DN,7548,3671,3877,1343,1440
E02001565,Doncaster 027,Middle Super Output Areas and Intermediate Zones,MSOAIZ,DN,6822,3385,3437,1318,1302
E02001566,Doncaster 028,Middle Super Output Areas and Intermediate Zones,MSOAIZ,DN,7937,3974,3963,1982,1848
E02001567,Doncaster 029,Middle Super Output Areas and Intermediate Zones,MSOAIZ,DN,9155,4481,4674,1746,1820
E02001568,Doncaster 030,Middle Super Output Areas and Intermediate Zones,MSOAIZ,S,5906,2921,2985,1146,1122
E02001569,Doncaster 031,Middle Super Output Areas and Intermediate Zones,MSOAIZ,S,9207,4503,4704,1939,1860
E02001570,Doncaster 032,Middle Super Output Areas and Intermediate Zones,MSOAIZ,S,7001,3392,3609,1266,1374
E02001571,Doncaster 033,Middle Super Output Areas and Intermediate Zones,MSOAIZ,S,6086,3004,3082,1166,1174
E02001572,Doncaster 034,Middle Super Output Areas and Intermediate Zones,MSOAIZ,DN,7236,3499,3737,1399,1505
E02001573,Doncaster 035,Middle Super Output Areas and Intermediate Zones,MSOAIZ,DN,7859,3815,4044,1553,1642
E02001574,Doncaster 036,Middle Super Output Areas and Intermediate Zones,MSOAIZ,DN,6268,3094,3174,1260,1311
E02001575,Doncaster 037,Middle Super Output Areas and Intermediate Zones,MSOAIZ,DN,7269,3449,3820,1312,1481
E02001576,Doncaster 038,Middle Super Output Areas and Intermediate Zones,MSOAIZ,DN,5816,2834,2982,1193,1245
E02001577,Doncaster 039,Middle Super Output Areas and Intermediate Zones,MSOAIZ,DN,6521,3090,3431,1086,1170
E02001578,Rotherham 001,Middle Super Output Areas and Intermediate Zones,MSOAIZ,S,9461,4684,4777,2032,2047
E02001579,Rotherham 002,Middle Super Output Areas and Intermediate Zones,MSOAIZ,S,9205,4438,4767,1741,1756
E02001580,Rotherham 003,Middle Super Output Areas and Intermediate Zones,MSOAIZ,S,8261,4031,4230,1573,1590
E02001581,Rotherham 004,Middle Super Output Areas and Intermediate Zones,MSOAIZ,S,5854,2884,2970,1107,1196
E02001582,Rotherham 005,Middle Super Output Areas and Intermediate Zones,MSOAIZ,S,7216,3547,3669,1384,1398
E02001583,Rotherham 006,Middle Super Output Areas and Intermediate Zones,MSOAIZ,S,5665,2742,2923,1186,1240
E02001584,Rotherham 007,Middle Super Output Areas and Intermediate Zones,MSOAIZ,S,7105,3472,3633,1380,1519
E02001585,Rotherham 008,Middle Super Output Areas and Intermediate Zones,MSOAIZ,S,6263,3044,3219,1309,1309
E02001586,Rotherham 009,Middle Super Output Areas and Intermediate Zones,MSOAIZ,S,8129,4115,4014,1722,1543
E02001587,Rotherham 010,Middle Super Output Areas and Intermediate Zones,MSOAIZ,S,5824,2812,3012,1115,1135
E02001588,Rotherham 011,Middle Super Output Areas and Intermediate Zones,MSOAIZ,S,7151,3459,3692,1319,1453
E02001589,Rotherham 012,Middle Super Output Areas and Intermediate Zones,MSOAIZ,S,8173,4019,4154,1743,1813
E02001590,Rotherham 013,Middle Super Output Areas and Intermediate Zones,MSOAIZ,S,7492,3688,3804,1403,1511
E02001591,Rotherham 014,Middle Super Output Areas and Intermediate Zones,MSOAIZ,S,8299,4149,4150,1720,1731
E02001592,Rotherham 015,Middle Super Output Areas and Intermediate Zones,MSOAIZ,S,8899,4367,4532,1765,1805
E02001593,Rotherham 016,Middle Super Output Areas and Intermediate Zones,MSOAIZ,S,7095,3595,3500,1589,1527
E02001594,Rotherham 017,Middle Super Output Areas and Intermediate Zones,MSOAIZ,S,6880,3524,3356,1623,1299
E02001595,Rotherham 018,Middle Super Output Areas and Intermediate Zones,MSOAIZ,S,8765,4302,4463,1788,1842
E02001596,Rotherham 019,Middle Super Output Areas and Intermediate Zones,MSOAIZ,S,8651,4165,4486,1599,1653
E02001597,Rotherham 020,Middle Super Output Areas and Intermediate Zones,MSOAIZ,S,9528,4685,4843,1805,1898
E02001598,Rotherham 021,Middle Super Output Areas and Intermediate Zones,MSOAIZ,S,9629,4552,5077,1704,1880
E02001599,Rotherham 022,Middle Super Output Areas and Intermediate Zones,MSOAIZ,S,6260,3030,3230,1224,1286
E02001600,Rotherham 023,Middle Super Output Areas and Intermediate Zones,MSOAIZ,S,10777,5308,5469,2032,2005
E02001601,Rotherham 024,Middle Super Output Areas and Intermediate Zones,MSOAIZ,S,5042,2500,2542,924,977
E02001602,Rotherham 025,Middle Super Output Areas and Intermediate Zones,MSOAIZ,S,8960,4371,4589,1732,1740
E02001603,Rotherham 026,Middle Super Output Areas and Intermediate Zones,MSOAIZ,S,6583,3253,3330,1258,1233
E02001604,Rotherham 027,Middle Super Output Areas and Intermediate Zones,MSOAIZ,S,8575,4210,4365,1924,1944
E02001605,Rotherham 028,Middle Super Output Areas and Intermediate Zones,MSOAIZ,S,7234,3628,3606,1514,1528
E02001606,Rotherham 029,Middle Super Output Areas and Intermediate Zones,MSOAIZ,S,8010,3909,4101,1529,1548
E02001607,Rotherham 030,Middle Super Output Areas and Intermediate Zones,MSOAIZ,S,8812,4315,4497,1591,1723
E02001608,Rotherham 031,Middle Super Output Areas and Intermediate Zones,MSOAIZ,S,6872,3372,3500,1430,1449
E02001609,Rotherham 032,Middle Super Output Areas and Intermediate Zones,MSOAIZ,S,8368,4087,4281,1464,1549
E02001610,Rotherham 033,Middle Super Output Areas and Intermediate Zones,MSOAIZ,S,8242,3990,4252,1626,1638
E02001611,Sheffield 001,Middle Super Output Areas and Intermediate Zones,MSOAIZ,S,7597,3718,3879,1448,1494
E02001612,Sheffield 002,Middle Super Output Areas and Intermediate Zones,MSOAIZ,S,5858,2876,2982,1170,1198
E02001613,Sheffield 003,Middle Super Output Areas and Intermediate Zones,MSOAIZ,S,10444,5032,5412,1971,2157
E02001614,Sheffield 004,Middle Super Output Areas and Intermediate Zones,MSOAIZ,S,11226,5511,5715,2227,2341
E02001615,Sheffield 005,Middle Super Output Areas and Intermediate Zones,MSOAIZ,S,7519,3638,3881,1358,1402
E02001616,Sheffield 006,Middle Super Output Areas and Intermediate Zones,MSOAIZ,S,7091,3458,3633,1364,1400
E02001617,Sheffield 007,Middle Super Output Areas and Intermediate Zones,MSOAIZ,S,5615,2662,2953,1027,1276
E02001618,Sheffield 008,Middle Super Output Areas and Intermediate Zones,MSOAIZ,S,9675,4810,4865,2090,2124
E02001619,Sheffield 009,Middle Super Output Areas and Intermediate Zones,MSOAIZ,S,9422,4588,4834,1753,1900
E02001620,Sheffield 010,Middle Super Output Areas and Intermediate Zones,MSOAIZ,S,6568,3116,3452,1209,1452
E02001621,Sheffield 011,Middle Super Output Areas and Intermediate Zones,MSOAIZ,S,5471,2667,2804,1068,1068
E02001622,Sheffield 012,Middle Super Output Areas and Intermediate Zones,MSOAIZ,S,8884,4295,4589,1825,1864
E02001623,Sheffield 013,Middle Super Output Areas and Intermediate Zones,MSOAIZ,S,8276,3897,4379,1407,1609
E02001624,Sheffield 014,Middle Super Output Areas and Intermediate Zones,MSOAIZ,S,9679,4739,4940,2064,2123
E02001625,Sheffield 015,Middle Super Output Areas and Intermediate Zones,MSOAIZ,S,7830,3773,4057,1391,1646
E02001626,Sheffield 016,Middle Super Output Areas and Intermediate Zones,MSOAIZ,S,5910,2783,3127,1222,1363
E02001627,Sheffield 017,Middle Super Output Areas and Intermediate Zones,MSOAIZ,S,6070,2992,3078,1457,1516
E02001628,Sheffield 018,Middle Super Output Areas and Intermediate Zones,MSOAIZ,S,6329,3197,3132,1244,1197
E02001629,Sheffield 019,Middle Super Output Areas and Intermediate Zones,MSOAIZ,S,6489,3302,3187,1354,1254
E02001630,Sheffield 020,Middle Super Output Areas and Intermediate Zones,MSOAIZ,S,8681,4394,4287,1768,1725
E02001631,Sheffield 021,Middle Super Output Areas and Intermediate Zones,MSOAIZ,S,7778,3811,3967,1681,1766
E02001632,Sheffield 022,Middle Super Output Areas and Intermediate Zones,MSOAIZ,S,12300,6358,5942,2680,2427
E02001633,Sheffield 023,Middle Super Output Areas and Intermediate Zones,MSOAIZ,S,7425,3582,3843,1326,1423
E02001634,Sheffield 024,Middle Super Output Areas and Intermediate Zones,MSOAIZ,S,9214,4605,4609,2342,2305
E02001635,Sheffield 025,Middle Super Output Areas and Intermediate Zones,MSOAIZ,S,6032,2975,3057,1193,1121
E02001636,Sheffield 026,Middle Super Output Areas and Intermediate Zones,MSOAIZ,S,9597,4905,4692,2054,1784
E02001637,Sheffield 027,Middle Super Output Areas and Intermediate Zones,MSOAIZ,S,6925,3464,3461,1393,1284
E02001638,Sheffield 028,Middle Super Output Areas and Intermediate Zones,MSOAIZ,S,6362,3224,3138,931,907
E02001639,Sheffield 029,Middle Super Output Areas and Intermediate Zones,MSOAIZ,S,6157,2956,3201,1291,1318
E02001640,Sheffield 030,Middle Super Output Areas and Intermediate Zones,MSOAIZ,S,8302,4197,4105,1182,967
E02001642,Sheffield 032,Middle Super Output Areas and Intermediate Zones,MSOAIZ,S,9663,4819,4844,2034,2007
E02001643,Sheffield 033,Middle Super Output Areas and Intermediate Zones,MSOAIZ,S,6292,3052,3240,1130,1184
E02001646,Sheffield 036,Middle Super Output Areas and Intermediate Zones,MSOAIZ,S,8525,4301,4224,1184,989
E02001647,Sheffield 037,Middle Super Output Areas and Intermediate Zones,MSOAIZ,S,6111,2957,3154,1118,1176
E02001648,Sheffield 038,Middle Super Output Areas and Intermediate Zones,MSOAIZ,S,8833,4268,4565,1245,1231
E02001649,Sheffield 039,Middle Super Output Areas and Intermediate Zones,MSOAIZ,S,9428,4631,4797,1921,1976
E02001650,Sheffield 040,Middle Super Output Areas and Intermediate Zones,MSOAIZ,S,9106,4776,4330,1925,1345
E02001651,Sheffield 041,Middle Super Output Areas and Intermediate Zones,MSOAIZ,S,8153,3928,4225,1401,1516
E02001652,Sheffield 042,Middle Super Output Areas and Intermediate Zones,MSOAIZ,S,12330,6392,5938,2361,1762
E02001653,Sheffield 043,Middle Super Output Areas and Intermediate Zones,MSOAIZ,S,7149,3523,3626,1453,1489
E02001654,Sheffield 044,Middle Super Output Areas and Intermediate Zones,MSOAIZ,S,6404,3075,3329,1244,1270
E02001655,Sheffield 045,Middle Super Output Areas and Intermediate Zones,MSOAIZ,S,7655,3684,3971,1478,1507
E02001656,Sheffield 046,Middle Super Output Areas and Intermediate Zones,MSOAIZ,S,7799,3919,3880,1696,1531
E02001657,Sheffield 047,Middle Super Output Areas and Intermediate Zones,MSOAIZ,S,8985,4301,4684,1857,2024
E02001658,Sheffield 048,Middle Super Output Areas and Intermediate Zones,MSOAIZ,S,5380,2520,2860,952,1145
E02001659,Sheffield 049,Middle Super Output Areas and Intermediate Zones,MSOAIZ,S,6124,3038,3086,1274,1237
E02001660,Sheffield 050,Middle Super Output Areas and Intermediate Zones,MSOAIZ,S,9831,5037,4794,2527,2190
E02001661,Sheffield 051,Middle Super Output Areas and Intermediate Zones,MSOAIZ,S,7849,3830,4019,1701,1650
E02001662,Sheffield 052,Middle Super Output Areas and Intermediate Zones,MSOAIZ,S,7644,3667,3977,1402,1539
E02001663,Sheffield 053,Middle Super Output Areas and Intermediate Zones,MSOAIZ,S,7694,3821,3873,2024,1995
E02001664,Sheffield 054,Middle Super Output Areas and Intermediate Zones,MSOAIZ,S,6158,3035,3123,1205,1232
E02001665,Sheffield 055,Middle Super Output Areas and Intermediate Zones,MSOAIZ,S,9476,4600,4876,1648,1728
E02001666,Sheffield 056,Middle Super Output Areas and Intermediate Zones,MSOAIZ,S,6195,2997,3198,1254,1343
E02001669,Sheffield 059,Middle Super Output Areas and Intermediate Zones,MSOAIZ,S,7707,3709,3998,1812,1871
E02001670,Sheffield 060,Middle Super Output Areas and Intermediate Zones,MSOAIZ,S,5952,2866,3086,1139,1150
E02001671,Sheffield 061,Middle Super Output Areas and Intermediate Zones,MSOAIZ,S,5965,2910,3055,1160,1240
E02001672,Sheffield 062,Middle Super Output Areas and Intermediate Zones,MSOAIZ,S,6167,2980,3187,1131,1147
E02001673,Sheffield 063,Middle Super Output Areas and Intermediate Zones,MSOAIZ,S,5597,2796,2801,1291,1303
E02001674,Sheffield 064,Middle Super Output Areas and Intermediate Zones,MSOAIZ,S,8704,4251,4453,1636,1651
E02001675,Sheffield 065,Middle Super Output Areas and Intermediate Zones,MSOAIZ,S,9049,4401,4648,1810,1854
E02001676,Sheffield 066,Middle Super Output Areas and Intermediate Zones,MSOAIZ,S,6030,2886,3144,1090,1211
E02001678,Sheffield 068,Middle Super Output Areas and Intermediate Zones,MSOAIZ,S,10018,4786,5232,1674,1797
E02001679,Sheffield 069,Middle Super Output Areas and Intermediate Zones,MSOAIZ,S,6273,3016,3257,1229,1227
E02001680,Sheffield 070,Middle Super Output Areas and Intermediate Zones,MSOAIZ,S,6127,2985,3142,1290,1203
E02001681,Sheffield 071,Middle Super Output Areas and Intermediate Zones,MSOAIZ,S,7459,3598,3861,1352,1429
E02001682,Gateshead 001,Middle Super Output Areas and Intermediate Zones,MSOAIZ,NE,7853,3800,4053,1510,1581
E02001683,Gateshead 002,Middle Super Output Areas and Intermediate Zones,MSOAIZ,NE,9134,4392,4742,1795,2001
E02001684,Gateshead 003,Middle Super Output Areas and Intermediate Zones,MSOAIZ,NE,6867,3336,3531,1519,1491
E02001685,Gateshead 004,Middle Super Output Areas and Intermediate Zones,MSOAIZ,NE,8256,3963,4293,1696,1826
E02001686,Gateshead 005,Middle Super Output Areas and Intermediate Zones,MSOAIZ,NE,7099,3371,3728,1389,1459
E02001688,Gateshead 007,Middle Super Output Areas and Intermediate Zones,MSOAIZ,NE,7726,3931,3795,2004,1792
E02001689,Gateshead 008,Middle Super Output Areas and Intermediate Zones,MSOAIZ,NE,8243,4359,3884,1798,1542
E02001690,Gateshead 009,Middle Super Output Areas and Intermediate Zones,MSOAIZ,NE,7579,3735,3844,1572,1604
E02001691,Gateshead 010,Middle Super Output Areas and Intermediate Zones,MSOAIZ,NE,8327,4202,4125,2141,1960
E02001692,Gateshead 011,Middle Super Output Areas and Intermediate Zones,MSOAIZ,NE,6414,3085,3329,1353,1483
E02001693,Gateshead 012,Middle Super Output Areas and Intermediate Zones,MSOAIZ,NE,5613,2727,2886,1120,1119
E02001694,Gateshead 013,Middle Super Output Areas and Intermediate Zones,MSOAIZ,NE,6565,3196,3369,1356,1412
E02001695,Gateshead 014,Middle Super Output Areas and Intermediate Zones,MSOAIZ,NE,6345,3128,3217,1348,1404
E02001696,Gateshead 015,Middle Super Output Areas and Intermediate Zones,MSOAIZ,NE,9399,4453,4946,1657,1967
E02001697,Gateshead 016,Middle Super Output Areas and Intermediate Zones,MSOAIZ,NE,7823,3780,4043,1678,1735
E02001698,Gateshead 017,Middle Super Output Areas and Intermediate Zones,MSOAIZ,NE,7272,3559,3713,1189,1218
E02001699,Gateshead 018,Middle Super Output Areas and Intermediate Zones,MSOAIZ,NE,6980,3394,3586,1357,1430
E02001700,Gateshead 019,Middle Super Output Areas and Intermediate Zones,MSOAIZ,NE,10606,5090,5516,2107,2317
E02001701,Gateshead 020,Middle Super Output Areas and Intermediate Zones,MSOAIZ,NE,6320,3070,3250,1275,1248
E02001702,Gateshead 021,Middle Super Output Areas and Intermediate Zones,MSOAIZ,NE,8055,3899,4156,1563,1677
E02001703,Gateshead 022,Middle Super Output Areas and Intermediate Zones,MSOAIZ,NE,5702,2742,2960,968,1085
E02001704,Gateshead 023,Middle Super Output Areas and Intermediate Zones,MSOAIZ,NE,7156,3454,3702,1402,1455
E02001705,Gateshead 024,Middle Super Output Areas and Intermediate Zones,MSOAIZ,NE,7045,3419,3626,1363,1445
E02001706,Gateshead 025,Middle Super Output Areas and Intermediate Zones,MSOAIZ,NE,6653,3183,3470,1259,1388
E02001707,Gateshead 026,Middle Super Output Areas and Intermediate Zones,MSOAIZ,NE,8367,4045,4322,1555,1685
E02001708,Newcastle upon Tyne 001,Middle Super Output Areas and Intermediate Zones,MSOAIZ,NE,9735,4729,5006,2026,2133
E02001709,Newcastle upon Tyne 002,Middle Super Output Areas and Intermediate Zones,MSOAIZ,NE,10237,4982,5255,2090,2137
E02001710,Newcastle upon Tyne 003,Middle Super Output Areas and Intermediate Zones,MSOAIZ,NE,9826,4781,5045,1902,2058
E02001711,Newcastle upon Tyne 004,Middle Super Output Areas and Intermediate Zones,MSOAIZ,NE,9703,4654,5049,1873,2031
E02001712,Newcastle upon Tyne 005,Middle Super Output Areas and Intermediate Zones,MSOAIZ,NE,9924,4938,4986,2165,2054
E02001713,Newcastle upon Tyne 006,Middle Super Output Areas and Intermediate Zones,MSOAIZ,NE,10492,5137,5355,2243,2227
E02001714,Newcastle upon Tyne 007,Middle Super Output Areas and Intermediate Zones,MSOAIZ,NE,9817,4833,4984,2060,2176
E02001715,Newcastle upon Tyne 008,Middle Super Output Areas and Intermediate Zones,MSOAIZ,NE,11323,5577,5746,2347,2451
E02001718,Newcastle upon Tyne 011,Middle Super Output Areas and Intermediate Zones,MSOAIZ,NE,5655,2737,2918,1021,1105
E02001719,Newcastle upon Tyne 012,Middle Super Output Areas and Intermediate Zones,MSOAIZ,NE,9339,4621,4718,1834,1888
E02001720,Newcastle upon Tyne 013,Middle Super Output Areas and Intermediate Zones,MSOAIZ,NE,9726,5132,4594,1196,929
E02001721,Newcastle upon Tyne 014,Middle Super Output Areas and Intermediate Zones,MSOAIZ,NE,10261,4964,5297,1983,2113
E02001722,Newcastle upon Tyne 015,Middle Super Output Areas and Intermediate Zones,MSOAIZ,NE,9667,4582,5085,1681,1906
E02001723,Newcastle upon Tyne 016,Middle Super Output Areas and Intermediate Zones,MSOAIZ,NE,6368,2981,3387,1247,1414
E02001724,Newcastle upon Tyne 017,Middle Super Output Areas and Intermediate Zones,MSOAIZ,NE,9211,4831,4380,1538,1169
E02001725,Newcastle upon Tyne 018,Middle Super Output Areas and Intermediate Zones,MSOAIZ,NE,10336,5491,4845,2413,1772
E02001726,Newcastle upon Tyne 019,Middle Super Output Areas and Intermediate Zones,MSOAIZ,NE,11839,5703,6136,2262,2330
E02001727,Newcastle upon Tyne 020,Middle Super Output Areas and Intermediate Zones,MSOAIZ,NE,8530,4210,4320,1730,1710
E02001728,Newcastle upon Tyne 021,Middle Super Output Areas and Intermediate Zones,MSOAIZ,NE,9734,4695,5039,1850,2070
E02001729,Newcastle upon Tyne 022,Middle Super Output Areas and Intermediate Zones,MSOAIZ,NE,12296,6834,5462,3028,2097
E02001730,Newcastle upon Tyne 023,Middle Super Output Areas and Intermediate Zones,MSOAIZ,NE,12926,6833,6093,2297,1595
E02001731,Newcastle upon Tyne 024,Middle Super Output Areas and Intermediate Zones,MSOAIZ,NE,12281,6665,5616,2771,1905
E02001732,Newcastle upon Tyne 025,Middle Super Output Areas and Intermediate Zones,MSOAIZ,NE,5031,2449,2582,925,1040
E02001733,Newcastle upon Tyne 026,Middle Super Output Areas and Intermediate Zones,MSOAIZ,NE,11885,5929,5956,2560,2600
E02001734,Newcastle upon Tyne 027,Middle Super Output Areas and Intermediate Zones,MSOAIZ,NE,7663,3706,3957,1504,1604
E02001735,Newcastle upon Tyne 028,Middle Super Output Areas and Intermediate Zones,MSOAIZ,NE,6614,3063,3551,1126,1417
E02001736,Newcastle upon Tyne 029,Middle Super Output Areas and Intermediate Zones,MSOAIZ,NE,12990,6923,6067,3066,2535
E02001737,Newcastle upon Tyne 030,Middle Super Output Areas and Intermediate Zones,MSOAIZ,NE,6054,3095,2959,1276,1196
E02001738,North Tyneside 001,Middle Super Output Areas and Intermediate Zones,MSOAIZ,NE,5625,2746,2879,843,881
E02001739,North Tyneside 002,Middle Super Output Areas and Intermediate Zones,MSOAIZ,NE,7508,3669,3839,1478,1587
E02001740,North Tyneside 003,Middle Super Output Areas and Intermediate Zones,MSOAIZ,NE,5789,2838,2951,1083,1195
E02001741,North Tyneside 004,Middle Super Output Areas and Intermediate Zones,MSOAIZ,NE,6967,3289,3678,1214,1270
E02001742,North Tyneside 005,Middle Super Output Areas and Intermediate Zones,MSOAIZ,NE,6037,2824,3213,1116,1281
E02001743,North Tyneside 006,Middle Super Output Areas and Intermediate Zones,MSOAIZ,NE,7569,3774,3795,1789,1714
E02001744,North Tyneside 007,Middle Super Output Areas and Intermediate Zones,MSOAIZ,NE,6531,3113,3418,1350,1415
E02001745,North Tyneside 008,Middle Super Output Areas and Intermediate Zones,MSOAIZ,NE,6357,3037,3320,1312,1448
E02001746,North Tyneside 009,Middle Super Output Areas and Intermediate Zones,MSOAIZ,NE,8334,3993,4341,1618,1821
E02001747,North Tyneside 010,Middle Super Output Areas and Intermediate Zones,MSOAIZ,NE,6180,2993,3187,1083,1115
E02001748,North Tyneside 011,Middle Super Output Areas and Intermediate Zones,MSOAIZ,NE,7532,3608,3924,1641,1823
E02001749,North Tyneside 012,Middle Super Output Areas and Intermediate Zones,MSOAIZ,NE,6161,3007,3154,1267,1303
E02001750,North Tyneside 013,Middle Super Output Areas and Intermediate Zones,MSOAIZ,NE,6636,3158,3478,1205,1314
E02001751,North Tyneside 014,Middle Super Output Areas and Intermediate Zones,MSOAIZ,NE,6039,2873,3166,1151,1247
E02001752,North Tyneside 015,Middle Super Output Areas and Intermediate Zones,MSOAIZ,NE,6281,2964,3317,1123,1333
E02001753,North Tyneside 016,Middle Super Output Areas and Intermediate Zones,MSOAIZ,NE,6304,3029,3275,1329,1381
E02001754,North Tyneside 017,Middle Super Output Areas and Intermediate Zones,MSOAIZ,NE,6025,2900,3125,1301,1301
E02001755,North Tyneside 018,Middle Super Output Areas and Intermediate Zones,MSOAIZ,NE,7985,3878,4107,1727,1740
E02001756,North Tyneside 019,Middle Super Output Areas and Intermediate Zones,MSOAIZ,NE,9258,4419,4839,2039,2219
E02001757,North Tyneside 020,Middle Super Output Areas and Intermediate Zones,MSOAIZ,NE,5918,2800,3118,1069,1212
E02001758,North Tyneside 021,Middle Super Output Areas and Intermediate Zones,MSOAIZ,NE,5599,2622,2977,1116,1266
E02001759,North Tyneside 022,Middle Super Output Areas and Intermediate Zones,MSOAIZ,NE,6294,3125,3169,1552,1384
E02001760,North Tyneside 023,Middle Super Output Areas and Intermediate Zones,MSOAIZ,NE,7775,3662,4113,1458,1745
E02001761,North Tyneside 024,Middle Super Output Areas and Intermediate Zones,MSOAIZ,NE,5397,2579,2818,1020,1053
E02001762,North Tyneside 025,Middle Super Output Areas and Intermediate Zones,MSOAIZ,NE,5588,2764,2824,1169,1261
E02001763,North Tyneside 026,Middle Super Output Areas and Intermediate Zones,MSOAIZ,NE,6307,3052,3255,1265,1362
E02001764,North Tyneside 027,Middle Super Output Areas and Intermediate Zones,MSOAIZ,NE,7559,3855,3704,1813,1646
E02001765,North Tyneside 028,Middle Super Output Areas and Intermediate Zones,MSOAIZ,NE,7281,3481,3800,1524,1633
E02001766,North Tyneside 029,Middle Super Output Areas and Intermediate Zones,MSOAIZ,NE,6927,3467,3460,1650,1585
E02001767,North Tyneside 030,Middle Super Output Areas and Intermediate Zones,MSOAIZ,NE,7038,3364,3674,1548,1613
E02001768,South Tyneside 001,Middle Super Output Areas and Intermediate Zones,MSOAIZ,NE,8446,4183,4263,1846,1807
E02001769,South Tyneside 002,Middle Super Output Areas and Intermediate Zones,MSOAIZ,NE,7396,3828,3568,1754,1473
E02001770,South Tyneside 003,Middle Super Output Areas and Intermediate Zones,MSOAIZ,NE,6552,3306,3246,1504,1367
E02001771,South Tyneside 004,Middle Super Output Areas and Intermediate Zones,MSOAIZ,NE,6405,2996,3409,1058,1219
E02001772,South Tyneside 005,Middle Super Output Areas and Intermediate Zones,MSOAIZ,NE,5412,2616,2796,1071,1085
E02001773,South Tyneside 006,Middle Super Output Areas and Intermediate Zones,MSOAIZ,NE,5457,2588,2869,955,1013
E02001774,South Tyneside 007,Middle Super Output Areas and Intermediate Zones,MSOAIZ,NE,5495,2724,2771,1177,1143
E02001775,South Tyneside 008,Middle Super Output Areas and Intermediate Zones,MSOAIZ,NE,5637,2703,2934,1012,1114
E02001776,South Tyneside 009,Middle Super Output Areas and Intermediate Zones,MSOAIZ,NE,8387,4082,4305,1775,1866
E02001777,South Tyneside 010,Middle Super Output Areas and Intermediate Zones,MSOAIZ,NE,6330,3095,3235,1445,1415
E02001778,South Tyneside 011,Middle Super Output Areas and Intermediate Zones,MSOAIZ,NE,6152,3007,3145,1319,1330
E02001779,South Tyneside 012,Middle Super Output Areas and Intermediate Zones,MSOAIZ,NE,5449,2663,2786,1022,1067
E02001780,South Tyneside 013,Middle Super Output Areas and Intermediate Zones,MSOAIZ,NE,5194,2430,2764,819,1038
E02001781,South Tyneside 014,Middle Super Output Areas and Intermediate Zones,MSOAIZ,NE,5419,2577,2842,994,1110
E02001782,South Tyneside 015,Middle Super Output Areas and Intermediate Zones,MSOAIZ,NE,8656,4106,4550,1503,1734
E02001783,South Tyneside 016,Middle Super Output Areas and Intermediate Zones,MSOAIZ,NE,6679,3098,3581,1198,1483
E02001784,South Tyneside 017,Middle Super Output Areas and Intermediate Zones,MSOAIZ,NE,6837,3249,3588,1232,1373
E02001785,South Tyneside 018,Middle Super Output Areas and Intermediate Zones,MSOAIZ,SR,7902,3753,4149,1395,1572
E02001786,South Tyneside 019,Middle Super Output Areas and Intermediate Zones,MSOAIZ,NE,7015,3385,3630,1336,1439
E02001787,South Tyneside 020,Middle Super Output Areas and Intermediate Zones,MSOAIZ,NE,5623,2686,2937,1023,1160
E02001788,South Tyneside 021,Middle Super Output Areas and Intermediate Zones,MSOAIZ,NE,5899,2901,2998,1253,1317
E02001789,South Tyneside 022,Middle Super Output Areas and Intermediate Zones,MSOAIZ,SR,5829,2767,3062,1030,1101
E02001790,South Tyneside 023,Middle Super Output Areas and Intermediate Zones,MSOAIZ,SR,5956,2817,3139,1051,1202
E02001791,Sunderland 001,Middle Super Output Areas and Intermediate Zones,MSOAIZ,SR,5788,2789,2999,1118,1208
E02001792,Sunderland 002,Middle Super Output Areas and Intermediate Zones,MSOAIZ,SR,7133,3403,3730,1325,1398
E02001793,Sunderland 003,Middle Super Output Areas and Intermediate Zones,MSOAIZ,SR,8383,3934,4449,1622,1827
E02001794,Sunderland 004,Middle Super Output Areas and Intermediate Zones,MSOAIZ,SR,8674,4073,4601,1583,1805
E02001795,Sunderland 005,Middle Super Output Areas and Intermediate Zones,MSOAIZ,SR,7585,3672,3913,1549,1542
E02001796,Sunderland 006,Middle Super Output Areas and Intermediate Zones,MSOAIZ,SR,9277,4680,4597,2007,1839
E02001797,Sunderland 007,Middle Super Output Areas and Intermediate Zones,MSOAIZ,SR,5851,2908,2943,1181,1177
E02001798,Sunderland 008,Middle Super Output Areas and Intermediate Zones,MSOAIZ,SR,8260,3971,4289,1614,1748
E02001799,Sunderland 009,Middle Super Output Areas and Intermediate Zones,MSOAIZ,NE,10004,4737,5267,1918,2098
E02001800,Sunderland 010,Middle Super Output Areas and Intermediate Zones,MSOAIZ,NE,7275,3534,3741,1449,1576
E02001801,Sunderland 011,Middle Super Output Areas and Intermediate Zones,MSOAIZ,SR,6623,3281,3342,1321,1290
E02001802,Sunderland 012,Middle Super Output Areas and Intermediate Zones,MSOAIZ,SR,6302,2916,3386,1140,1397
E02001803,Sunderland 013,Middle Super Output Areas and Intermediate Zones,MSOAIZ,SR,8644,4735,3909,2185,1385
E02001804,Sunderland 014,Middle Super Output Areas and Intermediate Zones,MSOAIZ,SR,6457,3154,3303,1278,1365
E02001805,Sunderland 015,Middle Super Output Areas and Intermediate Zones,MSOAIZ,SR,5858,2826,3032,1088,1131
E02001806,Sunderland 016,Middle Super Output Areas and Intermediate Zones,MSOAIZ,SR,8565,4401,4164,1878,1658
E02001807,Sunderland 017,Middle Super Output Areas and Intermediate Zones,MSOAIZ,SR,7297,3526,3771,1433,1570
E02001808,Sunderland 018,Middle Super Output Areas and Intermediate Zones,MSOAIZ,SR,6058,2996,3062,1263,1204
E02001809,Sunderland 019,Middle Super Output Areas and Intermediate Zones,MSOAIZ,NE,6559,3190,3369,1186,1285
E02001810,Sunderland 020,Middle Super Output Areas and Intermediate Zones,MSOAIZ,NE,8582,4264,4318,1862,1869
E02001811,Sunderland 021,Middle Super Output Areas and Intermediate Zones,MSOAIZ,SR,9184,4352,4832,1754,1933
E02001812,Sunderland 022,Middle Super Output Areas and Intermediate Zones,MSOAIZ,SR,10468,5163,5305,1900,1926
E02001813,Sunderland 023,Middle Super Output Areas and Intermediate Zones,MSOAIZ,SR,10093,4813,5280,1905,2169
E02001814,Sunderland 024,Middle Super Output Areas and Intermediate Zones,MSOAIZ,SR,6407,3110,3297,1307,1356
E02001815,Sunderland 025,Middle Super Output Areas and Intermediate Zones,MSOAIZ,NE,10328,5053,5275,1986,2140
E02001816,Sunderland 026,Middle Super Output Areas and Intermediate Zones,MSOAIZ,SR,6913,3176,3737,1262,1384
E02001817,Sunderland 027,Middle Super Output Areas and Intermediate Zones,MSOAIZ,SR,6290,3014,3276,1189,1276
E02001818,Sunderland 028,Middle Super Output Areas and Intermediate Zones,MSOAIZ,SR,8435,4035,4400,1686,1856
E02001819,Sunderland 029,Middle Super Output Areas and Intermediate Zones,MSOAIZ,SR,6941,3379,3562,1248,1307
E02001820,Sunderland 030,Middle Super Output Areas and Intermediate Zones,MSOAIZ,DH,8528,4172,4356,1689,1819
E02001821,Sunderland 031,Middle Super Output Areas and Intermediate Zones,MSOAIZ,SR,5948,2869,3079,1273,1336
E02001822,Sunderland 032,Middle Super Output Areas and Intermediate Zones,MSOAIZ,SR,7597,3729,3868,1591,1647
E02001823,Sunderland 033,Middle Super Output Areas and Intermediate Zones,MSOAIZ,DH,7129,3455,3674,1429,1552
E02001824,Sunderland 034,Middle Super Output Areas and Intermediate Zones,MSOAIZ,DH,8406,4036,4370,1585,1634
E02001825,Sunderland 035,Middle Super Output Areas and Intermediate Zones,MSOAIZ,SR,7065,3416,3649,1352,1365
E02001826,Sunderland 036,Middle Super Output Areas and Intermediate Zones,MSOAIZ,SR,6599,3191,3408,1198,1337
E02001827,Birmingham 001,Middle Super Output Areas and Intermediate Zones,MSOAIZ,B,6045,2902,3143,1070,1166
E02001828,Birmingham 002,Middle Super Output Areas and Intermediate Zones,MSOAIZ,B,6920,3275,3645,1252,1267
E02001829,Birmingham 003,Middle Super Output Areas and Intermediate Zones,MSOAIZ,B,8735,4265,4470,1650,1762
E02001830,Birmingham 004,Middle Super Output Areas and Intermediate Zones,MSOAIZ,B,9437,4545,4892,1622,1709
E02001831,Birmingham 005,Middle Super Output Areas and Intermediate Zones,MSOAIZ,B,10326,4898,5428,1952,2227
E02001832,Birmingham 006,Middle Super Output Areas and Intermediate Zones,MSOAIZ,B,8168,4002,4166,1604,1692
E02001833,Birmingham 007,Middle Super Output Areas and Intermediate Zones,MSOAIZ,B,5808,2855,2953,1096,1162
E02001834,Birmingham 008,Middle Super Output Areas and Intermediate Zones,MSOAIZ,B,6139,2893,3246,1134,1338
E02001835,Birmingham 009,Middle Super Output Areas and Intermediate Zones,MSOAIZ,B,8176,4002,4174,1782,1741
E02001836,Birmingham 010,Middle Super Output Areas and Intermediate Zones,MSOAIZ,B,9180,4478,4702,1754,1827
E02001837,Birmingham 011,Middle Super Output Areas and Intermediate Zones,MSOAIZ,B,10585,5091,5494,1919,2234
E02001838,Birmingham 012,Middle Super Output Areas and Intermediate Zones,MSOAIZ,B,7673,3726,3947,1457,1571
E02001839,Birmingham 013,Middle Super Output Areas and Intermediate Zones,MSOAIZ,B,6442,3065,3377,1278,1320
E02001840,Birmingham 014,Middle Super Output Areas and Intermediate Zones,MSOAIZ,B,8771,4123,4648,1565,1859
E02001841,Birmingham 015,Middle Super Output Areas and Intermediate Zones,MSOAIZ,B,5993,2918,3075,1016,1041
E02001842,Birmingham 016,Middle Super Output Areas and Intermediate Zones,MSOAIZ,B,7663,3708,3955,1481,1639
E02001843,Birmingham 017,Middle Super Output Areas and Intermediate Zones,MSOAIZ,B,6455,3165,3290,1292,1353
E02001844,Birmingham 018,Middle Super Output Areas and Intermediate Zones,MSOAIZ,B,9716,4750,4966,2108,1987
E02001845,Birmingham 019,Middle Super Output Areas and Intermediate Zones,MSOAIZ,B,6274,3004,3270,1287,1487
E02001846,Birmingham 020,Middle Super Output Areas and Intermediate Zones,MSOAIZ,B,7829,3819,4010,1566,1736
E02001847,Birmingham 021,Middle Super Output Areas and Intermediate Zones,MSOAIZ,B,5521,2693,2828,1052,1078
E02001848,Birmingham 022,Middle Super Output Areas and Intermediate Zones,MSOAIZ,B,6372,2959,3413,1150,1409
E02001849,Birmingham 023,Middle Super Output Areas and Intermediate Zones,MSOAIZ,B,6882,3356,3526,1513,1555
E02001850,Birmingham 024,Middle Super Output Areas and Intermediate Zones,MSOAIZ,B,8173,3969,4204,1583,1677
E02001851,Birmingham 025,Middle Super Output Areas and Intermediate Zones,MSOAIZ,B,8576,4126,4450,1747,1861
E02001852,Birmingham 026,Middle Super Output Areas and Intermediate Zones,MSOAIZ,B,6544,3212,3332,1351,1435
E02001854,Birmingham 028,Middle Super Output Areas and Intermediate Zones,MSOAIZ,B,7777,3807,3970,1573,1646
E02001855,Birmingham 029,Middle Super Output Areas and Intermediate Zones,MSOAIZ,B,9971,4582,5389,1636,2126
E02001856,Birmingham 030,Middle Super Output Areas and Intermediate Zones,MSOAIZ,B,8512,4253,4259,1961,1964
E02001857,Birmingham 031,Middle Super Output Areas and Intermediate Zones,MSOAIZ,B,12902,6439,6463,2958,2877
E02001858,Birmingham 032,Middle Super Output Areas and Intermediate Zones,MSOAIZ,B,8453,4213,4240,1907,1816
E02001859,Birmingham 033,Middle Super Output Areas and Intermediate Zones,MSOAIZ,B,10115,5100,5015,2028,1796
E02001860,Birmingham 034,Middle Super Output Areas and Intermediate Zones,MSOAIZ,B,8337,4198,4139,1868,1802
E02001861,Birmingham 035,Middle Super Output Areas and Intermediate Zones,MSOAIZ,B,10161,5251,4910,2071,1963
E02001862,Birmingham 036,Middle Super Output Areas and Intermediate Zones,MSOAIZ,B,9904,4851,5053,2031,2181
E02001863,Birmingham 037,Middle Super Output Areas and Intermediate Zones,MSOAIZ,B,7839,3949,3890,1523,1536
E02001864,Birmingham 038,Middle Super Output Areas and Intermediate Zones,MSOAIZ,B,5531,2639,2892,1000,1176
E02001865,Birmingham 039,Middle Super Output Areas and Intermediate Zones,MSOAIZ,B,10932,5612,5320,2425,2227
E02001866,Birmingham 040,Middle Super Output Areas and Intermediate Zones,MSOAIZ,B,8671,4454,4217,1863,1714
E02001867,Birmingham 041,Middle Super Output Areas and Intermediate Zones,MSOAIZ,B,6901,3353,3548,1258,1347
E02001868,Birmingham 042,Middle Super Output Areas and Intermediate Zones,MSOAIZ,B,8617,4174,4443,1561,1623
E02001869,Birmingham 043,Middle Super Output Areas and Intermediate Zones,MSOAIZ,B,6060,2926,3134,1132,1295
E02001870,Birmingham 044,Middle Super Output Areas and Intermediate Zones,MSOAIZ,B,11560,5646,5914,2211,2255
E02001871,Birmingham 045,Middle Super Output Areas and Intermediate Zones,MSOAIZ,B,7721,3621,4100,1384,1591
E02001872,Birmingham 046,Middle Super Output Areas and Intermediate Zones,MSOAIZ,B,7161,3342,3819,1255,1496
E02001873,Birmingham 047,Middle Super Output Areas and Intermediate Zones,MSOAIZ,B,10534,5249,5285,2372,2384
E02001874,Birmingham 048,Middle Super Output Areas and Intermediate Zones,MSOAIZ,B,9352,4693,4659,1794,1782
E02001875,Birmingham 049,Middle Super Output Areas and Intermediate Zones,MSOAIZ,B,8168,4108,4060,1880,1774
E02001876,Birmingham 050,Middle Super Output Areas and Intermediate Zones,MSOAIZ,B,11909,6019,5890,1705,1454
E02001877,Birmingham 051,Middle Super Output Areas and Intermediate Zones,MSOAIZ,B,10655,5379,5276,2002,2007
E02001878,Birmingham 052,Middle Super Output Areas and Intermediate Zones,MSOAIZ,B,8955,4474,4481,1769,1812
E02001879,Birmingham 053,Middle Super Output Areas and Intermediate Zones,MSOAIZ,B,10376,5446,4930,2536,1986
E02001880,Birmingham 054,Middle Super Output Areas and Intermediate Zones,MSOAIZ,B,9434,4456,4978,1593,2089
E02001881,Birmingham 055,Middle Super Output Areas and Intermediate Zones,MSOAIZ,B,9334,4616,4718,1776,1836
E02001882,Birmingham 056,Middle Super Output Areas and Intermediate Zones,MSOAIZ,B,8152,4025,4127,1613,1567
E02001883,Birmingham 057,Middle Super Output Areas and Intermediate Zones,MSOAIZ,B,8129,3863,4266,1553,1668
E02001884,Birmingham 058,Middle Super Output Areas and Intermediate Zones,MSOAIZ,B,9239,4594,4645,1676,1747
E02001886,Birmingham 060,Middle Super Output Areas and Intermediate Zones,MSOAIZ,B,8808,4595,4213,2202,1833
E02001888,Birmingham 062,Middle Super Output Areas and Intermediate Zones,MSOAIZ,B,6247,3006,3241,1132,1327
E02001889,Birmingham 063,Middle Super Output Areas and Intermediate Zones,MSOAIZ,B,8346,4155,4191,1509,1591
E02001890,Birmingham 064,Middle Super Output Areas and Intermediate Zones,MSOAIZ,B,9806,5045,4761,2491,2050
E02001892,Birmingham 066,Middle Super Output Areas and Intermediate Zones,MSOAIZ,B,10193,4946,5247,1979,2108
E02001893,Birmingham 067,Middle Super Output Areas and Intermediate Zones,MSOAIZ,B,8097,4009,4088,1569,1572
E02001895,Birmingham 069,Middle Super Output Areas and Intermediate Zones,MSOAIZ,B,7790,3725,4065,1354,1526
E02001896,Birmingham 070,Middle Super Output Areas and Intermediate Zones,MSOAIZ,B,9287,4715,4572,1869,1719
E02001897,Birmingham 071,Middle Super Output Areas and Intermediate Zones,MSOAIZ,B,7596,3957,3639,1631,1383
E02001898,Birmingham 072,Middle Super Output Areas and Intermediate Zones,MSOAIZ,B,6488,3185,3303,1289,1333
E02001899,Birmingham 073,Middle Super Output Areas and Intermediate Zones,MSOAIZ,B,7866,3796,4070,1600,1637
E02001900,Birmingham 074,Middle Super Output Areas and Intermediate Zones,MSOAIZ,B,6801,3373,3428,1295,1146
E02001901,Birmingham 075,Middle Super Output Areas and Intermediate Zones,MSOAIZ,B,7902,3765,4137,2035,2028
E02001902,Birmingham 076,Middle Super Output Areas and Intermediate Zones,MSOAIZ,B,6101,3013,3088,1262,1305
E02001903,Birmingham 077,Middle Super Output Areas and Intermediate Zones,MSOAIZ,B,7600,3878,3722,1403,1449
E02001904,Birmingham 078,Middle Super Output Areas and Intermediate Zones,MSOAIZ,B,6939,3430,3509,1482,1536
E02001905,Birmingham 079,Middle Super Output Areas and Intermediate Zones,MSOAIZ,B,9716,4783,4933,1454,1307
E02001906,Birmingham 080,Middle Super Output Areas and Intermediate Zones,MSOAIZ,B,9315,4458,4857,1762,2021
E02001907,Birmingham 081,Middle Super Output Areas and Intermediate Zones,MSOAIZ,B,9622,4817,4805,1987,1959
E02001908,Birmingham 082,Middle Super Output Areas and Intermediate Zones,MSOAIZ,B,8908,4486,4422,1749,1694
E02001909,Birmingham 083,Middle Super Output Areas and Intermediate Zones,MSOAIZ,B,7986,4095,3891,1617,1518
E02001910,Birmingham 084,Middle Super Output Areas and Intermediate Zones,MSOAIZ,B,7117,3592,3525,1391,1364
E02001911,Birmingham 085,Middle Super Output Areas and Intermediate Zones,MSOAIZ,B,7935,3768,4167,1431,1772
E02001913,Birmingham 087,Middle Super Output Areas and Intermediate Zones,MSOAIZ,B,7186,3587,3599,1513,1421
E02001914,Birmingham 088,Middle Super Output Areas and Intermediate Zones,MSOAIZ,B,6790,3470,3320,1535,1390
E02001915,Birmingham 089,Middle Super Output Areas and Intermediate Zones,MSOAIZ,B,11507,5722,5785,2680,2595
E02001916,Birmingham 090,Middle Super Output Areas and Intermediate Zones,MSOAIZ,B,8612,4196,4416,1647,1742
E02001918,Birmingham 092,Middle Super Output Areas and Intermediate Zones,MSOAIZ,B,8956,4662,4294,2397,1977
E02001919,Birmingham 093,Middle Super Output Areas and Intermediate Zones,MSOAIZ,B,6689,3419,3270,1725,1422
E02001920,Birmingham 094,Middle Super Output Areas and Intermediate Zones,MSOAIZ,B,7587,3554,4033,1342,1569
E02001921,Birmingham 095,Middle Super Output Areas and Intermediate Zones,MSOAIZ,B,7833,3701,4132,1505,1731
E02001922,Birmingham 096,Middle Super Output Areas and Intermediate Zones,MSOAIZ,B,12650,5895,6755,871,759
E02001923,Birmingham 097,Middle Super Output Areas and Intermediate Zones,MSOAIZ,B,10457,5119,5338,2036,2046
E02001924,Birmingham 098,Middle Super Output Areas and Intermediate Zones,MSOAIZ,B,6456,3185,3271,1287,1318
E02001925,Birmingham 099,Middle Super Output Areas and Intermediate Zones,MSOAIZ,B,6684,3179,3505,1252,1319
E02001926,Birmingham 100,Middle Super Output Areas and Intermediate Zones,MSOAIZ,B,7214,3671,3543,1555,1362
E02001927,Birmingham 101,Middle Super Output Areas and Intermediate Zones,MSOAIZ,B,7702,3663,4039,1408,1657
E02001928,Birmingham 102,Middle Super Output Areas and Intermediate Zones,MSOAIZ,B,6858,3262,3596,1265,1442
E02001929,Birmingham 103,Middle Super Output Areas and Intermediate Zones,MSOAIZ,B,9649,4629,5020,1821,2187
E02001930,Birmingham 104,Middle Super Output Areas and Intermediate Zones,MSOAIZ,B,7858,3881,3977,1892,1906
E02001931,Birmingham 105,Middle Super Output Areas and Intermediate Zones,MSOAIZ,B,7886,3854,4032,1501,1598
E02001932,Birmingham 106,Middle Super Output Areas and Intermediate Zones,MSOAIZ,B,6795,3180,3615,1181,1408
E02001933,Birmingham 107,Middle Super Output Areas and Intermediate Zones,MSOAIZ,B,7625,3663,3962,1602,1723
E02001934,Birmingham 108,Middle Super Output Areas and Intermediate Zones,MSOAIZ,B,6811,3365,3446,1332,1383
E02001935,Birmingham 109,Middle Super Output Areas and Intermediate Zones,MSOAIZ,B,7839,3733,4106,1351,1514
E02001936,Birmingham 110,Middle Super Output Areas and Intermediate Zones,MSOAIZ,B,6473,3148,3325,1242,1317
E02001937,Birmingham 111,Middle Super Output Areas and Intermediate Zones,MSOAIZ,B,7923,3773,4150,1545,1649
E02001938,Birmingham 112,Middle Super Output Areas and Intermediate Zones,MSOAIZ,B,7726,3715,4011,1826,1907
E02001939,Birmingham 113,Middle Super Output Areas and Intermediate Zones,MSOAIZ,B,5812,2810,3002,1139,1134
E02001941,Birmingham 115,Middle Super Output Areas and Intermediate Zones,MSOAIZ,B,6202,2962,3240,1098,1270
E02001942,Birmingham 116,Middle Super Output Areas and Intermediate Zones,MSOAIZ,B,6767,3231,3536,1381,1437
E02001943,Birmingham 117,Middle Super Output Areas and Intermediate Zones,MSOAIZ,B,6394,3071,3323,1265,1483
E02001944,Birmingham 118,Middle Super Output Areas and Intermediate Zones,MSOAIZ,B,8126,3978,4148,1744,1860
E02001945,Birmingham 119,Middle Super Output Areas and Intermediate Zones,MSOAIZ,B,7784,3707,4077,1448,1750
E02001946,Birmingham 120,Middle Super Output Areas and Intermediate Zones,MSOAIZ,B,7688,3848,3840,1498,1527
E02001947,Birmingham 121,Middle Super Output Areas and Intermediate Zones,MSOAIZ,B,6165,2986,3179,1169,1154
E02001948,Birmingham 122,Middle Super Output Areas and Intermediate Zones,MSOAIZ,B,7433,3670,3763,1524,1566
E02001949,Birmingham 123,Middle Super Output Areas and Intermediate Zones,MSOAIZ,B,5819,2727,3092,1110,1280
E02001950,Birmingham 124,Middle Super Output Areas and Intermediate Zones,MSOAIZ,B,8406,4080,4326,1672,1737
E02001951,Birmingham 125,Middle Super Output Areas and Intermediate Zones,MSOAIZ,B,8217,3975,4242,1531,1715
E02001952,Birmingham 126,Middle Super Output Areas and Intermediate Zones,MSOAIZ,B,8895,4257,4638,1703,1841
E02001953,Birmingham 127,Middle Super Output Areas and Intermediate Zones,MSOAIZ,B,7131,3453,3678,1314,1387
E02001954,Birmingham 128,Middle Super Output Areas and Intermediate Zones,MSOAIZ,B,7812,3726,4086,1396,1550
E02001955,Birmingham 129,Middle Super Output Areas and Intermediate Zones,MSOAIZ,B,6381,3069,3312,1321,1465
E02001956,Birmingham 130,Middle Super Output Areas and Intermediate Zones,MSOAIZ,B,6406,3088,3318,1349,1467
E02001957,Birmingham 131,Middle Super Output Areas and Intermediate Zones,MSOAIZ,B,7912,3891,4021,1594,1676
E02001958,Coventry 001,Middle Super Output Areas and Intermediate Zones,MSOAIZ,CV,7452,3644,3808,1591,1638
E02001959,Coventry 002,Middle Super Output Areas and Intermediate Zones,MSOAIZ,CV,6201,3081,3120,1221,1241
E02001961,Coventry 004,Middle Super Output Areas and Intermediate Zones,MSOAIZ,CV,7498,3723,3775,1535,1548
E02001962,Coventry 005,Middle Super Output Areas and Intermediate Zones,MSOAIZ,CV,6034,2871,3163,1165,1314
E02001963,Coventry 006,Middle Super Output Areas and Intermediate Zones,MSOAIZ,CV,5926,2874,3052,1135,1226
E02001964,Coventry 007,Middle Super Output Areas and Intermediate Zones,MSOAIZ,CV,8092,3782,4310,1358,1641
E02001965,Coventry 008,Middle Super Output Areas and Intermediate Zones,MSOAIZ,CV,8019,3873,4146,1574,1737
E02001966,Coventry 009,Middle Super Output Areas and Intermediate Zones,MSOAIZ,CV,6922,3504,3418,1489,1422
E02001967,Coventry 010,Middle Super Output Areas and Intermediate Zones,MSOAIZ,CV,6281,3063,3218,1086,1117
E02001968,Coventry 011,Middle Super Output Areas and Intermediate Zones,MSOAIZ,CV,7147,3475,3672,1541,1533
E02001969,Coventry 012,Middle Super Output Areas and Intermediate Zones,MSOAIZ,CV,6377,3039,3338,1270,1359
E02001970,Coventry 013,Middle Super Output Areas and Intermediate Zones,MSOAIZ,CV,5482,2702,2780,1029,978
E02001971,Coventry 014,Middle Super Output Areas and Intermediate Zones,MSOAIZ,CV,5834,2825,3009,1180,1213
E02001972,Coventry 015,Middle Super Output Areas and Intermediate Zones,MSOAIZ,CV,10054,5157,4897,2213,2049
E02001973,Coventry 016,Middle Super Output Areas and Intermediate Zones,MSOAIZ,CV,8132,4098,4034,1816,1748
E02001974,Coventry 017,Middle Super Output Areas and Intermediate Zones,MSOAIZ,CV,9472,4563,4909,1980,2026
E02001975,Coventry 018,Middle Super Output Areas and Intermediate Zones,MSOAIZ,CV,7860,3810,4050,1560,1728
E02001976,Coventry 019,Middle Super Output Areas and Intermediate Zones,MSOAIZ,CV,7132,3517,3615,1486,1419
E02001977,Coventry 020,Middle Super Output Areas and Intermediate Zones,MSOAIZ,CV,9014,4705,4309,2188,1860
E02001978,Coventry 021,Middle Super Output Areas and Intermediate Zones,MSOAIZ,CV,6503,3258,3245,1448,1399
E02001979,Coventry 022,Middle Super Output Areas and Intermediate Zones,MSOAIZ,CV,5726,2759,2967,1079,1152
E02001980,Coventry 023,Middle Super Output Areas and Intermediate Zones,MSOAIZ,CV,5996,2948,3048,1073,1064
E02001981,Coventry 024,Middle Super Output Areas and Intermediate Zones,MSOAIZ,CV,11753,6162,5591,2471,2083
E02001982,Coventry 025,Middle Super Output Areas and Intermediate Zones,MSOAIZ,CV,7062,3467,3595,1448,1519
E02001983,Coventry 026,Middle Super Output Areas and Intermediate Zones,MSOAIZ,CV,7546,3701,3845,1645,1627
E02001984,Coventry 027,Middle Super Output Areas and Intermediate Zones,MSOAIZ,CV,8967,4421,4546,1939,1860
E02001985,Coventry 028,Middle Super Output Areas and Intermediate Zones,MSOAIZ,CV,8453,4610,3843,1666,1258
E02001986,Coventry 029,Middle Super Output Areas and Intermediate Zones,MSOAIZ,CV,7597,3677,3920,1535,1517
E02001987,Coventry 030,Middle Super Output Areas and Intermediate Zones,MSOAIZ,CV,5785,3031,2754,1391,1141
E02001988,Coventry 031,Middle Super Output Areas and Intermediate Zones,MSOAIZ,CV,8786,4985,3801,1721,1168
E02001989,Coventry 032,Middle Super Output Areas and Intermediate Zones,MSOAIZ,CV,5653,2781,2872,1162,1170
E02001990,Coventry 033,Middle Super Output Areas and Intermediate Zones,MSOAIZ,CV,9256,4548,4708,1871,1901
E02001991,Coventry 034,Middle Super Output Areas and Intermediate Zones,MSOAIZ,CV,8515,4262,4253,1662,1625
E02001992,Coventry 035,Middle Super Output Areas and Intermediate Zones,MSOAIZ,CV,9573,4563,5010,1799,2007
E02001993,Coventry 036,Middle Super Output Areas and Intermediate Zones,MSOAIZ,CV,7240,3571,3669,1329,1402
E02001994,Coventry 037,Middle Super Output Areas and Intermediate Zones,MSOAIZ,CV,8159,3954,4205,1669,1636
E02001995,Coventry 038,Middle Super Output Areas and Intermediate Zones,MSOAIZ,CV,6515,3332,3183,1524,1316
E02001996,Coventry 039,Middle Super Output Areas and Intermediate Zones,MSOAIZ,CV,6819,3414,3405,1471,1348
E02001997,Coventry 040,Middle Super Output Areas and Intermediate Zones,MSOAIZ,CV,8526,4189,4337,1562,1506
E02001998,Coventry 041,Middle Super Output Areas and Intermediate Zones,MSOAIZ,CV,5973,2932,3041,1079,1177
E02001999,Coventry 042,Middle Super Output Areas and Intermediate Zones,MSOAIZ,CV,9398,4784,4614,1170,1142
E02002000,Dudley 001,Middle Super Output Areas and Intermediate Zones,MSOAIZ,WV,7782,3801,3981,1499,1602
E02002001,Dudley 002,Middle Super Output Areas and Intermediate Zones,MSOAIZ,WV,5951,2935,3016,1174,1190
E02002002,Dudley 003,Middle Super Output Areas and Intermediate Zones,MSOAIZ,WV,7084,3439,3645,1148,1160
E02002003,Dudley 004,Middle Super Output Areas and Intermediate Zones,MSOAIZ,WV,9101,4446,4655,1767,1746
E02002004,Dudley 005,Middle Super Output Areas and Intermediate Zones,MSOAIZ,DY,7518,3626,3892,1399,1566
E02002005,Dudley 006,Middle Super Output Areas and Intermediate Zones,MSOAIZ,DY,8090,3880,4210,1441,1652
E02002006,Dudley 007,Middle Super Output Areas and Intermediate Zones,MSOAIZ,DY,6400,3175,3225,1366,1346
E02002007,Dudley 008,Middle Super Output Areas and Intermediate Zones,MSOAIZ,DY,8731,4281,4450,1542,1551
E02002008,Dudley 009,Middle Super Output Areas and Intermediate Zones,MSOAIZ,DY,8329,4126,4203,1889,1994
E02002009,Dudley 010,Middle Super Output Areas and Intermediate Zones,MSOAIZ,DY,6710,3232,3478,1275,1398
E02002010,Dudley 011,Middle Super Output Areas and Intermediate Zones,MSOAIZ,DY,7186,3652,3534,1607,1456
E02002011,Dudley 012,Middle Super Output Areas and Intermediate Zones,MSOAIZ,DY,5864,2832,3032,1046,1122
E02002012,Dudley 013,Middle Super Output Areas and Intermediate Zones,MSOAIZ,DY,7790,3872,3918,1593,1507
E02002013,Dudley 014,Middle Super Output Areas and Intermediate Zones,MSOAIZ,DY,6697,3251,3446,1151,1188
E02002014,Dudley 015,Middle Super Output Areas and Intermediate Zones,MSOAIZ,DY,6929,3407,3522,1395,1426
E02002015,Dudley 016,Middle Super Output Areas and Intermediate Zones,MSOAIZ,DY,6024,3027,2997,1166,1205
E02002016,Dudley 017,Middle Super Output Areas and Intermediate Zones,MSOAIZ,DY,7826,3804,4022,1503,1626
E02002017,Dudley 018,Middle Super Output Areas and Intermediate Zones,MSOAIZ,DY,8279,4144,4135,1742,1608
E02002018,Dudley 019,Middle Super Output Areas and Intermediate Zones,MSOAIZ,DY,9036,4436,4600,1554,1621
E02002019,Dudley 020,Middle Super Output Areas and Intermediate Zones,MSOAIZ,DY,7857,3902,3955,1555,1594
E02002020,Dudley 021,Middle Super Output Areas and Intermediate Zones,MSOAIZ,DY,9451,4647,4804,1907,1893
E02002021,Dudley 022,Middle Super Output Areas and Intermediate Zones,MSOAIZ,DY,7315,3735,3580,1749,1482
E02002022,Dudley 023,Middle Super Output Areas and Intermediate Zones,MSOAIZ,DY,8324,4035,4289,1731,1801
E02002023,Dudley 024,Middle Super Output Areas and Intermediate Zones,MSOAIZ,DY,5339,2624,2715,1098,1091
E02002024,Dudley 025,Middle Super Output Areas and Intermediate Zones,MSOAIZ,DY,8536,4166,4370,1688,1720
E02002025,Dudley 026,Middle Super Output Areas and Intermediate Zones,MSOAIZ,B,7961,3925,4036,1711,1668
E02002026,Dudley 027,Middle Super Output Areas and Intermediate Zones,MSOAIZ,DY,7087,3547,3540,1426,1495
E02002027,Dudley 028,Middle Super Output Areas and Intermediate Zones,MSOAIZ,DY,5659,2806,2853,1251,1304
E02002028,Dudley 029,Middle Super Output Areas and Intermediate Zones,MSOAIZ,DY,5846,2795,3051,1083,1058
E02002029,Dudley 030,Middle Super Output Areas and Intermediate Zones,MSOAIZ,B,5876,2838,3038,1027,1124
E02002030,Dudley 031,Middle Super Output Areas and Intermediate Zones,MSOAIZ,DY,6274,3045,3229,1274,1321
E02002031,Dudley 032,Middle Super Output Areas and Intermediate Zones,MSOAIZ,DY,6005,3007,2998,1310,1276
E02002032,Dudley 033,Middle Super Output Areas and Intermediate Zones,MSOAIZ,DY,9940,4809,5131,2012,2111
E02002033,Dudley 034,Middle Super Output Areas and Intermediate Zones,MSOAIZ,B,7455,3654,3801,1417,1477
E02002034,Dudley 035,Middle Super Output Areas and Intermediate Zones,MSOAIZ,DY,8113,4066,4047,1757,1681
E02002035,Dudley 036,Middle Super Output Areas and Intermediate Zones,MSOAIZ,B,6145,2990,3155,1056,1133
E02002036,Dudley 037,Middle Super Output Areas and Intermediate Zones,MSOAIZ,DY,6575,3314,3261,1354,1258
E02002037,Dudley 038,Middle Super Output Areas and Intermediate Zones,MSOAIZ,DY,5874,2862,3012,1130,1141
E02002038,Dudley 039,Middle Super Output Areas and Intermediate Zones,MSOAIZ,B,9410,4629,4781,1885,1878
E02002039,Dudley 040,Middle Super Output Areas and Intermediate Zones,MSOAIZ,DY,6327,3238,3089,1193,1135
E02002040,Dudley 041,Middle Super Output Areas and Intermediate Zones,MSOAIZ,DY,5967,2904,3063,951,1034
E02002041,Dudley 042,Middle Super Output Areas and Intermediate Zones,MSOAIZ,DY,6202,2996,3206,986,1051
E02002042,Dudley 043,Middle Super Output Areas and Intermediate Zones,MSOAIZ,B,8060,3919,4141,1442,1508
E02002043,Sandwell 001,Middle Super Output Areas and Intermediate Zones,MSOAIZ,WS,8480,4156,4324,1683,1763
E02002044,Sandwell 002,Middle Super Output Areas and Intermediate Zones,MSOAIZ,WS,7498,3592,3906,1549,1719
E02002045,Sandwell 003,Middle Super Output Areas and Intermediate Zones,MSOAIZ,WS,7754,3755,3999,1546,1614
E02002046,Sandwell 004,Middle Super Output Areas and Intermediate Zones,MSOAIZ,WS,5626,2691,2935,1038,1179
E02002047,Sandwell 005,Middle Super Output Areas and Intermediate Zones,MSOAIZ,WS,6465,3152,3313,1207,1197
E02002048,Sandwell 006,Middle Super Output Areas and Intermediate Zones,MSOAIZ,B,6420,3162,3258,1230,1211
E02002049,Sandwell 007,Middle Super Output Areas and Intermediate Zones,MSOAIZ,WV,5932,2975,2957,1202,1265
E02002051,Sandwell 009,Middle Super Output Areas and Intermediate Zones,MSOAIZ,DY,5517,2665,2852,1018,1140
E02002052,Sandwell 010,Middle Super Output Areas and Intermediate Zones,MSOAIZ,B,10650,5166,5484,2115,2252
E02002053,Sandwell 011,Middle Super Output Areas and Intermediate Zones,MSOAIZ,B,5975,2923,3052,1181,1223
E02002054,Sandwell 012,Middle Super Output Areas and Intermediate Zones,MSOAIZ,B,5583,2694,2889,993,1142
E02002055,Sandwell 013,Middle Super Output Areas and Intermediate Zones,MSOAIZ,WS,9053,4451,4602,1911,1931
E02002056,Sandwell 014,Middle Super Output Areas and Intermediate Zones,MSOAIZ,DY,8624,4317,4307,1764,1764
E02002057,Sandwell 015,Middle Super Output Areas and Intermediate Zones,MSOAIZ,DY,8996,4394,4602,1869,1885
E02002058,Sandwell 016,Middle Super Output Areas and Intermediate Zones,MSOAIZ,DY,11677,5790,5887,2710,2710
E02002059,Sandwell 017,Middle Super Output Areas and Intermediate Zones,MSOAIZ,B,10533,5210,5323,2180,2193
E02002060,Sandwell 018,Middle Super Output Areas and Intermediate Zones,MSOAIZ,DY,6273,3193,3080,1282,1256
E02002061,Sandwell 019,Middle Super Output Areas and Intermediate Zones,MSOAIZ,B,5802,3011,2791,1262,1082
E02002062,Sandwell 020,Middle Super Output Areas and Intermediate Zones,MSOAIZ,B,7166,3695,3471,1582,1403
E02002063,Sandwell 021,Middle Super Output Areas and Intermediate Zones,MSOAIZ,DY,9172,4515,4657,2071,2089
E02002064,Sandwell 022,Middle Super Output Areas and Intermediate Zones,MSOAIZ,B,11970,5907,6063,2462,2547
E02002065,Sandwell 023,Middle Super Output Areas and Intermediate Zones,MSOAIZ,B,12146,6090,6056,2584,2498
E02002066,Sandwell 024,Middle Super Output Areas and Intermediate Zones,MSOAIZ,B,7211,3595,3616,1517,1519
E02002067,Sandwell 025,Middle Super Output Areas and Intermediate Zones,MSOAIZ,B,5508,2702,2806,1010,1076
E02002068,Sandwell 026,Middle Super Output Areas and Intermediate Zones,MSOAIZ,B,11983,5954,6029,2512,2590
E02002069,Sandwell 027,Middle Super Output Areas and Intermediate Zones,MSOAIZ,B,6567,3259,3308,1314,1277
E02002070,Sandwell 028,Middle Super Output Areas and Intermediate Zones,MSOAIZ,B,9140,4505,4635,1994,1860
E02002071,Sandwell 029,Middle Super Output Areas and Intermediate Zones,MSOAIZ,B,6507,3116,3391,1196,1303
E02002072,Sandwell 030,Middle Super Output Areas and Intermediate Zones,MSOAIZ,B,8346,4210,4136,1777,1752
E02002073,Sandwell 031,Middle Super Output Areas and Intermediate Zones,MSOAIZ,B,7550,3602,3948,1379,1562
E02002074,Sandwell 032,Middle Super Output Areas and Intermediate Zones,MSOAIZ,B,8026,3883,4143,1537,1661
E02002075,Sandwell 033,Middle Super Output Areas and Intermediate Zones,MSOAIZ,B,8539,4179,4360,1702,1759
E02002076,Sandwell 034,Middle Super Output Areas and Intermediate Zones,MSOAIZ,B,10306,5005,5301,2562,2600
E02002077,Sandwell 035,Middle Super Output Areas and Intermediate Zones,MSOAIZ,B,10182,5106,5076,2180,2044
E02002078,Sandwell 036,Middle Super Output Areas and Intermediate Zones,MSOAIZ,B,6205,2973,3232,1129,1278
E02002079,Sandwell 037,Middle Super Output Areas and Intermediate Zones,MSOAIZ,B,7985,3846,4139,1485,1600
E02002080,Sandwell 038,Middle Super Output Areas and Intermediate Zones,MSOAIZ,B,6664,3203,3461,1304,1342
E02002081,Solihull 001,Middle Super Output Areas and Intermediate Zones,MSOAIZ,B,5379,2599,2780,975,1016
E02002082,Solihull 002,Middle Super Output Areas and Intermediate Zones,MSOAIZ,B,5909,2800,3109,1024,1239
E02002083,Solihull 003,Middle Super Output Areas and Intermediate Zones,MSOAIZ,B,5838,2884,2954,1070,1061
E02002084,Solihull 004,Middle Super Output Areas and Intermediate Zones,MSOAIZ,B,6183,2891,3292,1048,1254
E02002085,Solihull 005,Middle Super Output Areas and Intermediate Zones,MSOAIZ,B,6252,3028,3224,1136,1260
E02002086,Solihull 006,Middle Super Output Areas and Intermediate Zones,MSOAIZ,B,5443,2688,2755,1008,1026
E02002087,Solihull 007,Middle Super Output Areas and Intermediate Zones,MSOAIZ,B,6034,2883,3151,1105,1250
E02002088,Solihull 008,Middle Super Output Areas and Intermediate Zones,MSOAIZ,B,9327,4565,4762,1771,1887
E02002089,Solihull 009,Middle Super Output Areas and Intermediate Zones,MSOAIZ,CV,7733,3769,3964,1522,1584
E02002090,Solihull 010,Middle Super Output Areas and Intermediate Zones,MSOAIZ,B,5807,2835,2972,1212,1270
E02002091,Solihull 011,Middle Super Output Areas and Intermediate Zones,MSOAIZ,B,7277,3546,3731,1361,1404
E02002092,Solihull 012,Middle Super Output Areas and Intermediate Zones,MSOAIZ,B,7141,3451,3690,1353,1402
E02002093,Solihull 013,Middle Super Output Areas and Intermediate Zones,MSOAIZ,B,6557,3217,3340,1303,1290
E02002094,Solihull 014,Middle Super Output Areas and Intermediate Zones,MSOAIZ,B,5962,2873,3089,1051,1129
E02002095,Solihull 015,Middle Super Output Areas and Intermediate Zones,MSOAIZ,B,8537,4108,4429,1685,1763
E02002096,Solihull 016,Middle Super Output Areas and Intermediate Zones,MSOAIZ,B,10008,4814,5194,1883,1888
E02002097,Solihull 017,Middle Super Output Areas and Intermediate Zones,MSOAIZ,CV,6555,3220,3335,1225,1247
E02002098,Solihull 018,Middle Super Output Areas and Intermediate Zones,MSOAIZ,B,9418,4561,4857,1749,1904
E02002099,Solihull 019,Middle Super Output Areas and Intermediate Zones,MSOAIZ,B,6561,3223,3338,1135,1121
E02002101,Solihull 021,Middle Super Output Areas and Intermediate Zones,MSOAIZ,B,5843,2781,3062,1067,1167
E02002102,Solihull 022,Middle Super Output Areas and Intermediate Zones,MSOAIZ,B,8592,4150,4442,1663,1711
E02002103,Solihull 023,Middle Super Output Areas and Intermediate Zones,MSOAIZ,B,6025,2857,3168,1033,1104
E02002104,Solihull 024,Middle Super Output Areas and Intermediate Zones,MSOAIZ,B,6166,2999,3167,1171,1327
E02002105,Solihull 025,Middle Super Output Areas and Intermediate Zones,MSOAIZ,CV,7815,3851,3964,1397,1477
E02002106,Solihull 026,Middle Super Output Areas and Intermediate Zones,MSOAIZ,B,9275,4445,4830,1548,1643
E02002107,Solihull 027,Middle Super Output Areas and Intermediate Zones,MSOAIZ,B,5783,2823,2960,1177,1247
E02002108,Solihull 028,Middle Super Output Areas and Intermediate Zones,MSOAIZ,B,9797,4798,4999,1753,1896
E02002109,Solihull 029,Middle Super Output Areas and Intermediate Zones,MSOAIZ,B,9357,4741,4616,2143,2147
E02002110,Walsall 001,Middle Super Output Areas and Intermediate Zones,MSOAIZ,WS,6753,3307,3446,1456,1490
E02002111,Walsall 002,Middle Super Output Areas and Intermediate Zones,MSOAIZ,WS,5923,2990,2933,1104,1113
E02002112,Walsall 003,Middle Super Output Areas and Intermediate Zones,MSOAIZ,WS,5435,2692,2743,1033,1121
E02002113,Walsall 004,Middle Super Output Areas and Intermediate Zones,MSOAIZ,WS,6468,3175,3293,1282,1301
E02002114,Walsall 005,Middle Super Output Areas and Intermediate Zones,MSOAIZ,WS,6033,2940,3093,1105,1087
E02002115,Walsall 006,Middle Super Output Areas and Intermediate Zones,MSOAIZ,WS,6564,3195,3369,1184,1180
E02002116,Walsall 007,Middle Super Output Areas and Intermediate Zones,MSOAIZ,WS,6739,3285,3454,1234,1258
E02002117,Walsall 008,Middle Super Output Areas and Intermediate Zones,MSOAIZ,WS,6051,2979,3072,1229,1268
E02002118,Walsall 009,Middle Super Output Areas and Intermediate Zones,MSOAIZ,WV,7195,3444,3751,1305,1418
E02002119,Walsall 010,Middle Super Output Areas and Intermediate Zones,MSOAIZ,WS,5990,2951,3039,1153,1185
E02002120,Walsall 011,Middle Super Output Areas and Intermediate Zones,MSOAIZ,WV,6266,3069,3197,1234,1360
E02002121,Walsall 012,Middle Super Output Areas and Intermediate Zones,MSOAIZ,WS,6211,3021,3190,1148,1183
E02002122,Walsall 013,Middle Super Output Areas and Intermediate Zones,MSOAIZ,WS,5518,2744,2774,1071,1087
E02002123,Walsall 014,Middle Super Output Areas and Intermediate Zones,MSOAIZ,WV,6431,3140,3291,1282,1228
E02002124,Walsall 015,Middle Super Output Areas and Intermediate Zones,MSOAIZ,WS,6893,3297,3596,1297,1253
E02002125,Walsall 016,Middle Super Output Areas and Intermediate Zones,MSOAIZ,WS,5918,2845,3073,1161,1222
E02002126,Walsall 017,Middle Super Output Areas and Intermediate Zones,MSOAIZ,WS,6342,3145,3197,1225,1292
E02002127,Walsall 018,Middle Super Output Areas and Intermediate Zones,MSOAIZ,WS,8331,4103,4228,1650,1638
E02002128,Walsall 019,Middle Super Output Areas and Intermediate Zones,MSOAIZ,WV,5547,2697,2850,1060,1037
E02002129,Walsall 020,Middle Super Output Areas and Intermediate Zones,MSOAIZ,WV,5902,2953,2949,1166,1090
E02002130,Walsall 021,Middle Super Output Areas and Intermediate Zones,MSOAIZ,WS,6594,3227,3367,1313,1394
E02002131,Walsall 022,Middle Super Output Areas and Intermediate Zones,MSOAIZ,WS,7847,3840,4007,1397,1431
E02002132,Walsall 023,Middle Super Output Areas and Intermediate Zones,MSOAIZ,WS,6371,2964,3407,1125,1248
E02002133,Walsall 024,Middle Super Output Areas and Intermediate Zones,MSOAIZ,WS,6645,3376,3269,1477,1245
E02002134,Walsall 025,Middle Super Output Areas and Intermediate Zones,MSOAIZ,WV,8221,3982,4239,1646,1773
E02002135,Walsall 026,Middle Super Output Areas and Intermediate Zones,MSOAIZ,WS,7081,3513,3568,1451,1435
E02002136,Walsall 027,Middle Super Output Areas and Intermediate Zones,MSOAIZ,WV,7562,3736,3826,1681,1681
E02002137,Walsall 028,Middle Super Output Areas and Intermediate Zones,MSOAIZ,WS,6285,3089,3196,1112,1113
E02002138,Walsall 029,Middle Super Output Areas and Intermediate Zones,MSOAIZ,WS,6303,3125,3178,1280,1254
E02002139,Walsall 030,Middle Super Output Areas and Intermediate Zones,MSOAIZ,WS,9498,4880,4618,2307,1715
E02002140,Walsall 031,Middle Super Output Areas and Intermediate Zones,MSOAIZ,WS,8021,3979,4042,1602,1565
E02002141,Walsall 032,Middle Super Output Areas and Intermediate Zones,MSOAIZ,B,6690,3252,3438,1279,1352
E02002142,Walsall 033,Middle Super Output Areas and Intermediate Zones,MSOAIZ,WS,6793,3370,3423,1415,1382
E02002143,Walsall 034,Middle Super Output Areas and Intermediate Zones,MSOAIZ,WS,10027,4992,5035,2035,1897
E02002144,Walsall 035,Middle Super Output Areas and Intermediate Zones,MSOAIZ,WS,6703,3292,3411,1153,1177
E02002145,Walsall 036,Middle Super Output Areas and Intermediate Zones,MSOAIZ,WS,6799,3351,3448,1385,1400
E02002146,Walsall 037,Middle Super Output Areas and Intermediate Zones,MSOAIZ,WS,6505,3151,3354,1286,1310
E02002147,Walsall 038,Middle Super Output Areas and Intermediate Zones,MSOAIZ,WV,7858,3901,3957,1549,1532
E02002148,Walsall 039,Middle Super Output Areas and Intermediate Zones,MSOAIZ,WS,11010,5327,5683,2056,2191
E02002149,Wolverhampton 001,Middle Super Output Areas and Intermediate Zones,MSOAIZ,WV,10027,4846,5181,1855,2018
E02002150,Wolverhampton 002,Middle Super Output Areas and Intermediate Zones,MSOAIZ,WV,5715,2749,2966,1126,1214
E02002151,Wolverhampton 003,Middle Super Output Areas and Intermediate Zones,MSOAIZ,WV,5826,2806,3020,1208,1360
E02002152,Wolverhampton 004,Middle Super Output Areas and Intermediate Zones,MSOAIZ,WV,6232,2967,3265,1116,1249
E02002153,Wolverhampton 005,Middle Super Output Areas and Intermediate Zones,MSOAIZ,WV,7502,3695,3807,1471,1452
E02002154,Wolverhampton 006,Middle Super Output Areas and Intermediate Zones,MSOAIZ,WV,5580,2677,2903,1106,1219
E02002155,Wolverhampton 007,Middle Super Output Areas and Intermediate Zones,MSOAIZ,WV,5829,2707,3122,971,1263
E02002156,Wolverhampton 008,Middle Super Output Areas and Intermediate Zones,MSOAIZ,WV,8365,4016,4349,1653,1718
E02002157,Wolverhampton 009,Middle Super Output Areas and Intermediate Zones,MSOAIZ,WV,7742,3791,3951,1542,1570
E02002158,Wolverhampton 010,Middle Super Output Areas and Intermediate Zones,MSOAIZ,WV,7659,3776,3883,1506,1400
E02002159,Wolverhampton 011,Middle Super Output Areas and Intermediate Zones,MSOAIZ,WV,6023,2929,3094,1217,1321
E02002160,Wolverhampton 012,Middle Super Output Areas and Intermediate Zones,MSOAIZ,WV,7048,3478,3570,1431,1480
E02002161,Wolverhampton 013,Middle Super Output Areas and Intermediate Zones,MSOAIZ,WV,6288,3201,3087,1418,1398
E02002162,Wolverhampton 014,Middle Super Output Areas and Intermediate Zones,MSOAIZ,WV,7556,3610,3946,1271,1346
E02002163,Wolverhampton 015,Middle Super Output Areas and Intermediate Zones,MSOAIZ,WV,11250,5829,5421,2797,2358
E02002164,Wolverhampton 016,Middle Super Output Areas and Intermediate Zones,MSOAIZ,WV,6843,3739,3104,1678,1125
E02002165,Wolverhampton 017,Middle Super Output Areas and Intermediate Zones,MSOAIZ,WV,7729,4224,3505,2227,1602
E02002166,Wolverhampton 018,Middle Super Output Areas and Intermediate Zones,MSOAIZ,WV,9056,4467,4589,1828,1856
E02002167,Wolverhampton 019,Middle Super Output Areas and Intermediate Zones,MSOAIZ,WV,6548,3215,3333,1205,1245
E02002168,Wolverhampton 020,Middle Super Output Areas and Intermediate Zones,MSOAIZ,WV,10321,5333,4988,2480,2022
E02002169,Wolverhampton 021,Middle Super Output Areas and Intermediate Zones,MSOAIZ,WV,8647,4193,4454,1558,1605
E02002170,Wolverhampton 022,Middle Super Output Areas and Intermediate Zones,MSOAIZ,WV,6253,3007,3246,1207,1318
E02002171,Wolverhampton 023,Middle Super Output Areas and Intermediate Zones,MSOAIZ,WV,7367,3688,3679,1417,1423
E02002174,Wolverhampton 026,Middle Super Output Areas and Intermediate Zones,MSOAIZ,WV,7578,3719,3859,1570,1565
E02002175,Wolverhampton 027,Middle Super Output Areas and Intermediate Zones,MSOAIZ,WV,7031,3477,3554,1365,1419
E02002176,Wolverhampton 028,Middle Super Output Areas and Intermediate Zones,MSOAIZ,WV,7692,3747,3945,1496,1537
E02002177,Wolverhampton 029,Middle Super Output Areas and Intermediate Zones,MSOAIZ,WV,9032,4503,4529,1968,1937
E02002178,Wolverhampton 030,Middle Super Output Areas and Intermediate Zones,MSOAIZ,WV,8114,4026,4088,1713,1677
E02002179,Wolverhampton 031,Middle Super Output Areas and Intermediate Zones,MSOAIZ,WV,6401,3118,3283,1291,1317
E02002180,Wolverhampton 032,Middle Super Output Areas and Intermediate Zones,MSOAIZ,WV,6392,3113,3279,1191,1220
E02002181,Wolverhampton 033,Middle Super Output Areas and Intermediate Zones,MSOAIZ,WV,7079,3487,3592,1389,1403
E02002182,Wolverhampton 034,Middle Super Output Areas and Intermediate Zones,MSOAIZ,WV,6645,3231,3414,1344,1386
E02002183,Bradford 001,Middle Super Output Areas and Intermediate Zones,MSOAIZ,LS,5594,2706,2888,940,1022
E02002184,Bradford 002,Middle Super Output Areas and Intermediate Zones,MSOAIZ,LS,12945,6067,6878,2170,2378
E02002185,Bradford 003,Middle Super Output Areas and Intermediate Zones,MSOAIZ,LS,5948,2867,3081,1141,1242
E02002186,Bradford 004,Middle Super Output Areas and Intermediate Zones,MSOAIZ,BD,12643,6076,6567,2488,2599
E02002187,Bradford 005,Middle Super Output Areas and Intermediate Zones,MSOAIZ,LS,5888,2863,3025,1059,1134
E02002188,Bradford 006,Middle Super Output Areas and Intermediate Zones,MSOAIZ,BD,7726,3780,3946,1544,1598
E02002189,Bradford 007,Middle Super Output Areas and Intermediate Zones,MSOAIZ,BD,6842,3374,3468,1283,1249
E02002190,Bradford 008,Middle Super Output Areas and Intermediate Zones,MSOAIZ,BD,12001,6047,5954,2510,2262
E02002191,Bradford 009,Middle Super Output Areas and Intermediate Zones,MSOAIZ,BD,9413,4595,4818,1791,1905
E02002192,Bradford 010,Middle Super Output Areas and Intermediate Zones,MSOAIZ,BD,9239,4489,4750,1718,1843
E02002193,Bradford 011,Middle Super Output Areas and Intermediate Zones,MSOAIZ,BD,6009,2974,3035,1235,1216
E02002194,Bradford 012,Middle Super Output Areas and Intermediate Zones,MSOAIZ,BD,7500,3577,3923,1414,1559
E02002195,Bradford 013,Middle Super Output Areas and Intermediate Zones,MSOAIZ,LS,6393,3116,3277,1206,1267
E02002196,Bradford 014,Middle Super Output Areas and Intermediate Zones,MSOAIZ,BD,6364,3110,3254,1332,1410
E02002197,Bradford 015,Middle Super Output Areas and Intermediate Zones,MSOAIZ,BD,8517,4260,4257,1970,1850
E02002198,Bradford 016,Middle Super Output Areas and Intermediate Zones,MSOAIZ,BD,8139,3912,4227,1641,1693
E02002199,Bradford 017,Middle Super Output Areas and Intermediate Zones,MSOAIZ,LS,6407,3141,3266,1383,1402
E02002200,Bradford 018,Middle Super Output Areas and Intermediate Zones,MSOAIZ,BD,9216,4470,4746,1882,1928
E02002201,Bradford 019,Middle Super Output Areas and Intermediate Zones,MSOAIZ,BD,12022,5909,6113,2686,2768
E02002202,Bradford 020,Middle Super Output Areas and Intermediate Zones,MSOAIZ,BD,7029,3577,3452,1838,1592
E02002203,Bradford 021,Middle Super Output Areas and Intermediate Zones,MSOAIZ,BD,7655,3733,3922,1565,1603
E02002204,Bradford 022,Middle Super Output Areas and Intermediate Zones,MSOAIZ,BD,11394,5464,5930,2146,2359
E02002205,Bradford 023,Middle Super Output Areas and Intermediate Zones,MSOAIZ,BD,10113,4969,5144,2126,2190
E02002206,Bradford 024,Middle Super Output Areas and Intermediate Zones,MSOAIZ,BD,8721,4301,4420,1747,1824
E02002207,Bradford 025,Middle Super Output Areas and Intermediate Zones,MSOAIZ,BD,7375,3719,3656,1549,1486
E02002208,Bradford 026,Middle Super Output Areas and Intermediate Zones,MSOAIZ,BD,7621,3643,3978,1467,1617
E02002209,Bradford 027,Middle Super Output Areas and Intermediate Zones,MSOAIZ,BD,5908,2835,3073,1086,1281
E02002210,Bradford 028,Middle Super Output Areas and Intermediate Zones,MSOAIZ,BD,7627,3698,3929,1492,1625
E02002211,Bradford 029,Middle Super Output Areas and Intermediate Zones,MSOAIZ,BD,7199,3581,3618,1418,1422
E02002212,Bradford 030,Middle Super Output Areas and Intermediate Zones,MSOAIZ,BD,7294,3545,3749,1392,1482
E02002213,Bradford 031,Middle Super Output Areas and Intermediate Zones,MSOAIZ,BD,6745,3246,3499,1327,1431
E02002214,Bradford 032,Middle Super Output Areas and Intermediate Zones,MSOAIZ,BD,5917,2891,3026,1245,1291
E02002215,Bradford 033,Middle Super Output Areas and Intermediate Zones,MSOAIZ,BD,10515,5259,5256,2142,2101
E02002216,Bradford 034,Middle Super Output Areas and Intermediate Zones,MSOAIZ,BD,9365,4842,4523,2106,1763
E02002217,Bradford 035,Middle Super Output Areas and Intermediate Zones,MSOAIZ,BD,8855,4375,4480,1825,1697
E02002218,Bradford 036,Middle Super Output Areas and Intermediate Zones,MSOAIZ,BD,9354,4537,4817,1834,1996
E02002219,Bradford 037,Middle Super Output Areas and Intermediate Zones,MSOAIZ,BD,7877,3962,3915,1665,1546
E02002220,Bradford 038,Middle Super Output Areas and Intermediate Zones,MSOAIZ,BD,9288,4591,4697,1730,1877
E02002221,Bradford 039,Middle Super Output Areas and Intermediate Zones,MSOAIZ,BD,13576,7249,6327,3267,2547
E02002222,Bradford 040,Middle Super Output Areas and Intermediate Zones,MSOAIZ,BD,8111,3868,4243,1561,1727
E02002223,Bradford 041,Middle Super Output Areas and Intermediate Zones,MSOAIZ,BD,7821,3996,3825,1655,1534
E02002224,Bradford 042,Middle Super Output Areas and Intermediate Zones,MSOAIZ,BD,10589,5374,5215,2196,2068
E02002225,Bradford 043,Middle Super Output Areas and Intermediate Zones,MSOAIZ,BD,8240,4040,4200,1689,1791
E02002226,Bradford 044,Middle Super Output Areas and Intermediate Zones,MSOAIZ,BD,14938,7974,6964,2993,2233
E02002227,Bradford 045,Middle Super Output Areas and Intermediate Zones,MSOAIZ,BD,6503,3304,3199,1464,1293
E02002228,Bradford 046,Middle Super Output Areas and Intermediate Zones,MSOAIZ,BD,6795,3375,3420,1340,1405
E02002229,Bradford 047,Middle Super Output Areas and Intermediate Zones,MSOAIZ,BD,8144,3602,4542,1509,1647
E02002230,Bradford 048,Middle Super Output Areas and Intermediate Zones,MSOAIZ,BD,9502,5047,4455,2365,1808
E02002231,Bradford 049,Middle Super Output Areas and Intermediate Zones,MSOAIZ,BD,12757,6239,6518,2637,2743
E02002232,Bradford 050,Middle Super Output Areas and Intermediate Zones,MSOAIZ,BD,6458,3129,3329,1309,1304
E02002233,Bradford 051,Middle Super Output Areas and Intermediate Zones,MSOAIZ,BD,9238,4663,4575,1755,1839
E02002234,Bradford 052,Middle Super Output Areas and Intermediate Zones,MSOAIZ,BD,7933,3775,4158,1406,1669
E02002235,Bradford 053,Middle Super Output Areas and Intermediate Zones,MSOAIZ,BD,7083,3517,3566,1498,1442
E02002236,Bradford 054,Middle Super Output Areas and Intermediate Zones,MSOAIZ,BD,6002,2878,3124,1179,1258
E02002237,Bradford 055,Middle Super Output Areas and Intermediate Zones,MSOAIZ,BD,8304,3970,4334,1645,1827
E02002238,Bradford 056,Middle Super Output Areas and Intermediate Zones,MSOAIZ,BD,6122,2935,3187,1183,1312
E02002239,Bradford 057,Middle Super Output Areas and Intermediate Zones,MSOAIZ,BD,9964,4851,5113,2111,2363
E02002240,Bradford 058,Middle Super Output Areas and Intermediate Zones,MSOAIZ,HX,10686,5218,5468,2295,2394
E02002241,Bradford 059,Middle Super Output Areas and Intermediate Zones,MSOAIZ,BD,11941,5732,6209,2363,2567
E02002242,Bradford 060,Middle Super Output Areas and Intermediate Zones,MSOAIZ,BD,7751,3739,4012,1530,1606
E02002243,Bradford 061,Middle Super Output Areas and Intermediate Zones,MSOAIZ,BD,9336,4556,4780,1875,1945
E02002244,Calderdale 001,Middle Super Output Areas and Intermediate Zones,MSOAIZ,HX,6011,2922,3089,1115,1201
E02002245,Calderdale 002,Middle Super Output Areas and Intermediate Zones,MSOAIZ,HX,5627,2730,2897,1190,1159
E02002246,Calderdale 003,Middle Super Output Areas and Intermediate Zones,MSOAIZ,HX,9651,4669,4982,1834,1981
E02002247,Calderdale 004,Middle Super Output Areas and Intermediate Zones,MSOAIZ,OL,9374,4520,4854,1896,2166
E02002248,Calderdale 005,Middle Super Output Areas and Intermediate Zones,MSOAIZ,HX,7523,3669,3854,1497,1556
E02002249,Calderdale 006,Middle Super Output Areas and Intermediate Zones,MSOAIZ,HX,5522,2682,2840,1118,1208
E02002250,Calderdale 007,Middle Super Output Areas and Intermediate Zones,MSOAIZ,HX,8410,4087,4323,1606,1711
E02002251,Calderdale 008,Middle Super Output Areas and Intermediate Zones,MSOAIZ,HX,7511,3836,3675,1866,1502
E02002252,Calderdale 009,Middle Super Output Areas and Intermediate Zones,MSOAIZ,HX,6025,2891,3134,1111,1196
E02002253,Calderdale 010,Middle Super Output Areas and Intermediate Zones,MSOAIZ,HX,7616,3718,3898,1596,1604
E02002254,Calderdale 011,Middle Super Output Areas and Intermediate Zones,MSOAIZ,HX,5763,2829,2934,1104,1136
E02002255,Calderdale 012,Middle Super Output Areas and Intermediate Zones,MSOAIZ,HX,7836,3972,3864,1612,1485
E02002256,Calderdale 013,Middle Super Output Areas and Intermediate Zones,MSOAIZ,OL,9317,4483,4834,1911,1971
E02002257,Calderdale 014,Middle Super Output Areas and Intermediate Zones,MSOAIZ,HX,6202,3132,3070,1257,1264
E02002258,Calderdale 015,Middle Super Output Areas and Intermediate Zones,MSOAIZ,WF,8816,4335,4481,1867,1808
E02002259,Calderdale 016,Middle Super Output Areas and Intermediate Zones,MSOAIZ,HX,6577,3215,3362,1407,1402
E02002260,Calderdale 017,Middle Super Output Areas and Intermediate Zones,MSOAIZ,HX,9114,4511,4603,2039,1883
E02002261,Calderdale 018,Middle Super Output Areas and Intermediate Zones,MSOAIZ,HX,8108,4014,4094,1730,1702
E02002262,Calderdale 019,Middle Super Output Areas and Intermediate Zones,MSOAIZ,HX,7914,3862,4052,1619,1586
E02002263,Calderdale 020,Middle Super Output Areas and Intermediate Zones,MSOAIZ,HX,6697,3209,3488,1296,1422
E02002264,Calderdale 021,Middle Super Output Areas and Intermediate Zones,MSOAIZ,HX,6995,3340,3655,1365,1431
E02002265,Calderdale 022,Middle Super Output Areas and Intermediate Zones,MSOAIZ,OL,5432,2627,2805,1074,1110
E02002266,Calderdale 023,Middle Super Output Areas and Intermediate Zones,MSOAIZ,HD,5820,2850,2970,1191,1145
E02002267,Calderdale 024,Middle Super Output Areas and Intermediate Zones,MSOAIZ,HX,8150,3999,4151,1545,1670
E02002268,Calderdale 025,Middle Super Output Areas and Intermediate Zones,MSOAIZ,HX,9888,4739,5149,2031,2054
E02002269,Calderdale 026,Middle Super Output Areas and Intermediate Zones,MSOAIZ,HX,9569,4691,4878,2023,2119
E02002270,Calderdale 027,Middle Super Output Areas and Intermediate Zones,MSOAIZ,HX,8358,4095,4263,1830,1906
E02002271,Kirklees 001,Middle Super Output Areas and Intermediate Zones,MSOAIZ,WF,7100,3402,3698,1410,1504
E02002272,Kirklees 002,Middle Super Output Areas and Intermediate Zones,MSOAIZ,WF,9445,4591,4854,1864,1975
E02002273,Kirklees 003,Middle Super Output Areas and Intermediate Zones,MSOAIZ,BD,6174,3046,3128,1262,1253
E02002274,Kirklees 004,Middle Super Output Areas and Intermediate Zones,MSOAIZ,WF,6999,3444,3555,1421,1490
E02002275,Kirklees 005,Middle Super Output Areas and Intermediate Zones,MSOAIZ,WF,8558,4220,4338,1890,1792
E02002276,Kirklees 006,Middle Super Output Areas and Intermediate Zones,MSOAIZ,WF,7281,3611,3670,1396,1479
E02002277,Kirklees 007,Middle Super Output Areas and Intermediate Zones,MSOAIZ,WF,6510,3244,3266,1357,1315
E02002278,Kirklees 008,Middle Super Output Areas and Intermediate Zones,MSOAIZ,WF,6372,3106,3266,1235,1331
E02002279,Kirklees 009,Middle Super Output Areas and Intermediate Zones,MSOAIZ,WF,6174,3035,3139,1313,1276
E02002280,Kirklees 010,Middle Super Output Areas and Intermediate Zones,MSOAIZ,WF,6248,3077,3171,1251,1166
E02002281,Kirklees 011,Middle Super Output Areas and Intermediate Zones,MSOAIZ,WF,11399,5609,5790,2370,2334
E02002282,Kirklees 012,Middle Super Output Areas and Intermediate Zones,MSOAIZ,WF,7203,3636,3567,1504,1477
E02002283,Kirklees 013,Middle Super Output Areas and Intermediate Zones,MSOAIZ,WF,7833,3952,3881,1737,1550
E02002284,Kirklees 014,Middle Super Output Areas and Intermediate Zones,MSOAIZ,WF,6054,3012,3042,1265,1208
E02002285,Kirklees 015,Middle Super Output Areas and Intermediate Zones,MSOAIZ,WF,7991,3943,4048,1563,1610
E02002286,Kirklees 016,Middle Super Output Areas and Intermediate Zones,MSOAIZ,WF,6076,2992,3084,1285,1305
E02002287,Kirklees 017,Middle Super Output Areas and Intermediate Zones,MSOAIZ,WF,6933,3574,3359,1648,1321
E02002288,Kirklees 018,Middle Super Output Areas and Intermediate Zones,MSOAIZ,WF,9273,4519,4754,1934,1944
E02002289,Kirklees 019,Middle Super Output Areas and Intermediate Zones,MSOAIZ,WF,6560,3282,3278,1325,1300
E02002290,Kirklees 020,Middle Super Output Areas and Intermediate Zones,MSOAIZ,WF,6229,2996,3233,1124,1165
E02002291,Kirklees 021,Middle Super Output Areas and Intermediate Zones,MSOAIZ,WF,6552,3161,3391,1263,1282
E02002292,Kirklees 022,Middle Super Output Areas and Intermediate Zones,MSOAIZ,HD,5708,2797,2911,1119,1216
E02002293,Kirklees 023,Middle Super Output Areas and Intermediate Zones,MSOAIZ,WF,7932,3972,3960,1669,1566
E02002294,Kirklees 024,Middle Super Output Areas and Intermediate Zones,MSOAIZ,WF,10691,5433,5258,2091,2109
E02002295,Kirklees 025,Middle Super Output Areas and Intermediate Zones,MSOAIZ,HD,6692,3140,3552,1332,1479
E02002296,Kirklees 026,Middle Super Output Areas and Intermediate Zones,MSOAIZ,WF,6782,3301,3481,1336,1288
E02002297,Kirklees 027,Middle Super Output Areas and Intermediate Zones,MSOAIZ,HD,6899,3437,3462,1382,1377
E02002298,Kirklees 028,Middle Super Output Areas and Intermediate Zones,MSOAIZ,WF,6748,3277,3471,1243,1322
E02002299,Kirklees 029,Middle Super Output Areas and Intermediate Zones,MSOAIZ,HD,6550,3349,3201,1444,1297
E02002300,Kirklees 030,Middle Super Output Areas and Intermediate Zones,MSOAIZ,WF,6683,3195,3488,1292,1352
E02002301,Kirklees 031,Middle Super Output Areas and Intermediate Zones,MSOAIZ,HD,7655,3980,3675,1821,1556
E02002302,Kirklees 032,Middle Super Output Areas and Intermediate Zones,MSOAIZ,WF,6386,3107,3279,1332,1388
E02002303,Kirklees 033,Middle Super Output Areas and Intermediate Zones,MSOAIZ,HD,6469,3066,3403,1297,1399
E02002304,Kirklees 034,Middle Super Output Areas and Intermediate Zones,MSOAIZ,HD,6542,3402,3140,1556,1237
E02002305,Kirklees 035,Middle Super Output Areas and Intermediate Zones,MSOAIZ,HD,6071,2970,3101,1243,1259
E02002306,Kirklees 036,Middle Super Output Areas and Intermediate Zones,MSOAIZ,HD,6363,3113,3250,1273,1365
E02002307,Kirklees 037,Middle Super Output Areas and Intermediate Zones,MSOAIZ,HD,6004,2939,3065,1196,1263
E02002308,Kirklees 038,Middle Super Output Areas and Intermediate Zones,MSOAIZ,HD,6459,3172,3287,1406,1427
E02002309,Kirklees 039,Middle Super Output Areas and Intermediate Zones,MSOAIZ,HD,6767,3454,3313,1495,1274
E02002310,Kirklees 040,Middle Super Output Areas and Intermediate Zones,MSOAIZ,HD,6083,2941,3142,1244,1265
E02002311,Kirklees 041,Middle Super Output Areas and Intermediate Zones,MSOAIZ,HD,6427,3154,3273,1375,1401
E02002312,Kirklees 042,Middle Super Output Areas and Intermediate Zones,MSOAIZ,WF,8137,4194,3943,1544,1320
E02002313,Kirklees 043,Middle Super Output Areas and Intermediate Zones,MSOAIZ,HD,7663,4019,3644,1753,1492
E02002314,Kirklees 044,Middle Super Output Areas and Intermediate Zones,MSOAIZ,HD,6009,2907,3102,1076,1139
E02002315,Kirklees 045,Middle Super Output Areas and Intermediate Zones,MSOAIZ,HD,6775,3370,3405,1576,1562
E02002316,Kirklees 046,Middle Super Output Areas and Intermediate Zones,MSOAIZ,WF,6435,3120,3315,1220,1279
E02002317,Kirklees 047,Middle Super Output Areas and Intermediate Zones,MSOAIZ,HD,7042,3365,3677,1371,1467
E02002318,Kirklees 048,Middle Super Output Areas and Intermediate Zones,MSOAIZ,HD,6404,3091,3313,1209,1268
E02002319,Kirklees 049,Middle Super Output Areas and Intermediate Zones,MSOAIZ,HD,6549,3273,3276,1458,1422
E02002320,Kirklees 050,Middle Super Output Areas and Intermediate Zones,MSOAIZ,HD,6398,3163,3235,1284,1227
E02002321,Kirklees 051,Middle Super Output Areas and Intermediate Zones,MSOAIZ,WF,7232,3587,3645,1200,1220
E02002322,Kirklees 052,Middle Super Output Areas and Intermediate Zones,MSOAIZ,HX,6401,3118,3283,1369,1353
E02002323,Kirklees 053,Middle Super Output Areas and Intermediate Zones,MSOAIZ,HD,8443,4144,4299,1664,1658
E02002324,Kirklees 054,Middle Super Output Areas and Intermediate Zones,MSOAIZ,WF,6520,3198,3322,1183,1270
E02002325,Kirklees 055,Middle Super Output Areas and Intermediate Zones,MSOAIZ,HD,8534,4135,4399,1584,1710
E02002326,Kirklees 056,Middle Super Output Areas and Intermediate Zones,MSOAIZ,HD,6264,3073,3191,1261,1305
E02002327,Kirklees 057,Middle Super Output Areas and Intermediate Zones,MSOAIZ,HD,9845,4871,4974,1987,1969
E02002328,Kirklees 058,Middle Super Output Areas and Intermediate Zones,MSOAIZ,HD,6976,3465,3511,1334,1376
E02002329,Kirklees 059,Middle Super Output Areas and Intermediate Zones,MSOAIZ,HD,11956,5913,6043,2399,2565
E02002330,Leeds 001,Middle Super Output Areas and Intermediate Zones,MSOAIZ,LS,6598,3199,3399,1114,1197
E02002331,Leeds 002,Middle Super Output Areas and Intermediate Zones,MSOAIZ,LS,6592,3642,2950,1649,1076
E02002332,Leeds 003,Middle Super Output Areas and Intermediate Zones,MSOAIZ,LS,5849,2789,3060,986,1118
E02002333,Leeds 004,Middle Super Output Areas and Intermediate Zones,MSOAIZ,LS,7819,3787,4032,1575,1645
E02002334,Leeds 005,Middle Super Output Areas and Intermediate Zones,MSOAIZ,LS,7116,3374,3742,1257,1372
E02002335,Leeds 006,Middle Super Output Areas and Intermediate Zones,MSOAIZ,LS,7552,3693,3859,1332,1427
E02002336,Leeds 007,Middle Super Output Areas and Intermediate Zones,MSOAIZ,LS,6765,3332,3433,1220,1306
E02002337,Leeds 008,Middle Super Output Areas and Intermediate Zones,MSOAIZ,LS,6712,3269,3443,1377,1425
E02002338,Leeds 009,Middle Super Output Areas and Intermediate Zones,MSOAIZ,LS,6800,3323,3477,1396,1423
E02002339,Leeds 010,Middle Super Output Areas and Intermediate Zones,MSOAIZ,LS,5719,2757,2962,1160,1219
E02002340,Leeds 011,Middle Super Output Areas and Intermediate Zones,MSOAIZ,LS,5536,2671,2865,1043,1127
E02002341,Leeds 012,Middle Super Output Areas and Intermediate Zones,MSOAIZ,LS,7348,3573,3775,1358,1435
E02002342,Leeds 013,Middle Super Output Areas and Intermediate Zones,MSOAIZ,LS,5752,2782,2970,1068,1124
E02002343,Leeds 014,Middle Super Output Areas and Intermediate Zones,MSOAIZ,LS,5729,2744,2985,1187,1286
E02002344,Leeds 015,Middle Super Output Areas and Intermediate Zones,MSOAIZ,LS,7678,3606,4072,1508,1683
E02002345,Leeds 016,Middle Super Output Areas and Intermediate Zones,MSOAIZ,LS,5503,2679,2824,978,1052
E02002346,Leeds 017,Middle Super Output Areas and Intermediate Zones,MSOAIZ,LS,5982,2880,3102,1212,1286
E02002347,Leeds 018,Middle Super Output Areas and Intermediate Zones,MSOAIZ,LS,5998,2845,3153,1207,1300
E02002348,Leeds 019,Middle Super Output Areas and Intermediate Zones,MSOAIZ,LS,6111,2899,3212,1163,1259
E02002349,Leeds 020,Middle Super Output Areas and Intermediate Zones,MSOAIZ,LS,5637,2718,2919,1240,1276
E02002350,Leeds 021,Middle Super Output Areas and Intermediate Zones,MSOAIZ,LS,6201,3036,3165,1102,1094
E02002351,Leeds 022,Middle Super Output Areas and Intermediate Zones,MSOAIZ,LS,5399,2626,2773,959,1041
E02002352,Leeds 023,Middle Super Output Areas and Intermediate Zones,MSOAIZ,LS,7371,3627,3744,1591,1644
E02002353,Leeds 024,Middle Super Output Areas and Intermediate Zones,MSOAIZ,LS,5817,2888,2929,1266,1385
E02002354,Leeds 025,Middle Super Output Areas and Intermediate Zones,MSOAIZ,LS,7825,3787,4038,1666,1720
E02002356,Leeds 027,Middle Super Output Areas and Intermediate Zones,MSOAIZ,LS,7521,3608,3913,1531,1644
E02002357,Leeds 028,Middle Super Output Areas and Intermediate Zones,MSOAIZ,LS,7784,3750,4034,1701,1849
E02002358,Leeds 029,Middle Super Output Areas and Intermediate Zones,MSOAIZ,LS,7353,3567,3786,1381,1465
E02002359,Leeds 030,Middle Super Output Areas and Intermediate Zones,MSOAIZ,LS,6393,3081,3312,1195,1276
E02002360,Leeds 031,Middle Super Output Areas and Intermediate Zones,MSOAIZ,LS,6748,3193,3555,1466,1693
E02002361,Leeds 032,Middle Super Output Areas and Intermediate Zones,MSOAIZ,LS,5746,2737,3009,1215,1291
E02002362,Leeds 033,Middle Super Output Areas and Intermediate Zones,MSOAIZ,LS,7695,3718,3977,1658,1720
E02002363,Leeds 034,Middle Super Output Areas and Intermediate Zones,MSOAIZ,LS,6976,3321,3655,1892,1984
E02002364,Leeds 035,Middle Super Output Areas and Intermediate Zones,MSOAIZ,LS,5768,2730,3038,1095,1236
E02002366,Leeds 037,Middle Super Output Areas and Intermediate Zones,MSOAIZ,LS,7767,3756,4011,1536,1593
E02002367,Leeds 038,Middle Super Output Areas and Intermediate Zones,MSOAIZ,LS,5915,2778,3137,1262,1426
E02002368,Leeds 039,Middle Super Output Areas and Intermediate Zones,MSOAIZ,LS,7952,3880,4072,1762,1857
E02002369,Leeds 040,Middle Super Output Areas and Intermediate Zones,MSOAIZ,LS,6939,3315,3624,1305,1479
E02002370,Leeds 041,Middle Super Output Areas and Intermediate Zones,MSOAIZ,LS,6653,3110,3543,1228,1407
E02002371,Leeds 042,Middle Super Output Areas and Intermediate Zones,MSOAIZ,LS,9614,4643,4971,2130,2238
E02002373,Leeds 044,Middle Super Output Areas and Intermediate Zones,MSOAIZ,LS,8559,4307,4252,1022,578
E02002374,Leeds 045,Middle Super Output Areas and Intermediate Zones,MSOAIZ,LS,6636,3300,3336,1503,1450
E02002375,Leeds 046,Middle Super Output Areas and Intermediate Zones,MSOAIZ,LS,6386,3097,3289,1059,1220
E02002376,Leeds 047,Middle Super Output Areas and Intermediate Zones,MSOAIZ,LS,6869,3315,3554,1190,1464
E02002377,Leeds 048,Middle Super Output Areas and Intermediate Zones,MSOAIZ,LS,7067,3626,3441,1557,1416
E02002379,Leeds 050,Middle Super Output Areas and Intermediate Zones,MSOAIZ,LS,5243,2444,2799,902,1138
E02002380,Leeds 051,Middle Super Output Areas and Intermediate Zones,MSOAIZ,LS,5270,2570,2700,1091,1145
E02002381,Leeds 052,Middle Super Output Areas and Intermediate Zones,MSOAIZ,LS,6103,2997,3106,1441,1573
E02002382,Leeds 053,Middle Super Output Areas and Intermediate Zones,MSOAIZ,LS,6001,3054,2947,1385,1304
E02002383,Leeds 054,Middle Super Output Areas and Intermediate Zones,MSOAIZ,LS,7636,3762,3874,862,584
E02002384,Leeds 055,Middle Super Output Areas and Intermediate Zones,MSOAIZ,LS,10792,5531,5261,2326,1728
E02002385,Leeds 056,Middle Super Output Areas and Intermediate Zones,MSOAIZ,LS,7996,4239,3757,1883,1369
E02002386,Leeds 057,Middle Super Output Areas and Intermediate Zones,MSOAIZ,LS,8343,3989,4354,1517,1598
E02002387,Leeds 058,Middle Super Output Areas and Intermediate Zones,MSOAIZ,LS,5455,2597,2858,1134,1223
E02002388,Leeds 059,Middle Super Output Areas and Intermediate Zones,MSOAIZ,LS,7357,3536,3821,1650,1748
E02002389,Leeds 060,Middle Super Output Areas and Intermediate Zones,MSOAIZ,LS,6600,3172,3428,1182,1379
E02002390,Leeds 061,Middle Super Output Areas and Intermediate Zones,MSOAIZ,LS,6055,2866,3189,1243,1339
E02002391,Leeds 062,Middle Super Output Areas and Intermediate Zones,MSOAIZ,LS,7772,3735,4037,1761,1868
E02002392,Leeds 063,Middle Super Output Areas and Intermediate Zones,MSOAIZ,LS,9275,4434,4841,1211,898
E02002393,Leeds 064,Middle Super Output Areas and Intermediate Zones,MSOAIZ,LS,7589,4067,3522,2163,1589
E02002394,Leeds 065,Middle Super Output Areas and Intermediate Zones,MSOAIZ,LS,6773,3392,3381,1526,1506
E02002395,Leeds 066,Middle Super Output Areas and Intermediate Zones,MSOAIZ,LS,6340,3069,3271,1257,1322
E02002396,Leeds 067,Middle Super Output Areas and Intermediate Zones,MSOAIZ,LS,8466,4259,4207,2072,1897
E02002397,Leeds 068,Middle Super Output Areas and Intermediate Zones,MSOAIZ,LS,7430,3585,3845,1531,1635
E02002398,Leeds 069,Middle Super Output Areas and Intermediate Zones,MSOAIZ,LS,7443,3654,3789,1423,1450
E02002399,Leeds 070,Middle Super Output Areas and Intermediate Zones,MSOAIZ,LS,6204,2942,3262,1197,1403
E02002400,Leeds 071,Middle Super Output Areas and Intermediate Zones,MSOAIZ,LS,8222,4405,3817,2260,1651
E02002401,Leeds 072,Middle Super Output Areas and Intermediate Zones,MSOAIZ,LS,6203,2930,3273,1080,1285
E02002402,Leeds 073,Middle Super Output Areas and Intermediate Zones,MSOAIZ,LS,5774,2851,2923,1226,1282
E02002403,Leeds 074,Middle Super Output Areas and Intermediate Zones,MSOAIZ,LS,6071,2857,3214,1146,1194
E02002404,Leeds 075,Middle Super Output Areas and Intermediate Zones,MSOAIZ,LS,8676,4545,4131,2238,1772
E02002405,Leeds 076,Middle Super Output Areas and Intermediate Zones,MSOAIZ,LS,7484,3568,3916,1458,1591
E02002406,Leeds 077,Middle Super Output Areas and Intermediate Zones,MSOAIZ,LS,7018,3393,3625,1313,1434
E02002407,Leeds 078,Middle Super Output Areas and Intermediate Zones,MSOAIZ,LS,6389,3080,3309,1331,1448
E02002408,Leeds 079,Middle Super Output Areas and Intermediate Zones,MSOAIZ,LS,7237,3380,3857,1534,1635
E02002409,Leeds 080,Middle Super Output Areas and Intermediate Zones,MSOAIZ,LS,5940,2879,3061,1195,1300
E02002410,Leeds 081,Middle Super Output Areas and Intermediate Zones,MSOAIZ,LS,6591,3297,3294,1540,1445
E02002411,Leeds 082,Middle Super Output Areas and Intermediate Zones,MSOAIZ,LS,7054,3869,3185,2098,1480
E02002412,Leeds 083,Middle Super Output Areas and Intermediate Zones,MSOAIZ,LS,6798,3324,3474,1510,1600
E02002414,Leeds 085,Middle Super Output Areas and Intermediate Zones,MSOAIZ,LS,5725,2931,2794,1288,1155
E02002415,Leeds 086,Middle Super Output Areas and Intermediate Zones,MSOAIZ,LS,6483,3463,3020,1689,1272
E02002416,Leeds 087,Middle Super Output Areas and Intermediate Zones,MSOAIZ,LS,6319,3038,3281,1076,1126
E02002417,Leeds 088,Middle Super Output Areas and Intermediate Zones,MSOAIZ,WF,6327,3129,3198,1259,1314
E02002418,Leeds 089,Middle Super Output Areas and Intermediate Zones,MSOAIZ,LS,7234,3545,3689,1480,1604
E02002419,Leeds 090,Middle Super Output Areas and Intermediate Zones,MSOAIZ,LS,7832,3787,4045,1616,1683
E02002420,Leeds 091,Middle Super Output Areas and Intermediate Zones,MSOAIZ,LS,7853,3839,4014,1701,1698
E02002421,Leeds 092,Middle Super Output Areas and Intermediate Zones,MSOAIZ,LS,5931,2792,3139,1090,1283
E02002422,Leeds 093,Middle Super Output Areas and Intermediate Zones,MSOAIZ,LS,6180,3007,3173,1340,1394
E02002423,Leeds 094,Middle Super Output Areas and Intermediate Zones,MSOAIZ,LS,5641,2753,2888,1100,1200
E02002424,Leeds 095,Middle Super Output Areas and Intermediate Zones,MSOAIZ,LS,7612,3720,3892,1678,1722
E02002425,Leeds 096,Middle Super Output Areas and Intermediate Zones,MSOAIZ,LS,8448,4131,4317,1706,1764
E02002426,Leeds 097,Middle Super Output Areas and Intermediate Zones,MSOAIZ,LS,7661,3754,3907,1561,1628
E02002427,Leeds 098,Middle Super Output Areas and Intermediate Zones,MSOAIZ,LS,6854,3244,3610,1269,1436
E02002428,Leeds 099,Middle Super Output Areas and Intermediate Zones,MSOAIZ,LS,6878,3304,3574,1512,1564
E02002429,Leeds 100,Middle Super Output Areas and Intermediate Zones,MSOAIZ,WF,8245,3954,4291,1749,1872
E02002430,Leeds 101,Middle Super Output Areas and Intermediate Zones,MSOAIZ,LS,7175,3380,3795,1318,1571
E02002431,Leeds 102,Middle Super Output Areas and Intermediate Zones,MSOAIZ,WF,7992,3895,4097,1930,1995
E02002432,Leeds 103,Middle Super Output Areas and Intermediate Zones,MSOAIZ,WF,7200,3495,3705,1466,1542
E02002433,Leeds 104,Middle Super Output Areas and Intermediate Zones,MSOAIZ,WF,6177,2993,3184,1469,1426
E02002434,Leeds 105,Middle Super Output Areas and Intermediate Zones,MSOAIZ,WF,8621,4213,4408,2076,2159
E02002435,Leeds 106,Middle Super Output Areas and Intermediate Zones,MSOAIZ,WF,7394,3630,3764,1651,1620
E02002436,Leeds 107,Middle Super Output Areas and Intermediate Zones,MSOAIZ,WF,6605,3238,3367,1354,1449
E02002437,Leeds 108,Middle Super Output Areas and Intermediate Zones,MSOAIZ,WF,6190,3024,3166,1281,1419
E02002438,Wakefield 001,Middle Super Output Areas and Intermediate Zones,MSOAIZ,WF,7871,3833,4038,1457,1560
E02002439,Wakefield 002,Middle Super Output Areas and Intermediate Zones,MSOAIZ,WF,7639,3748,3891,1687,1599
E02002440,Wakefield 003,Middle Super Output Areas and Intermediate Zones,MSOAIZ,WF,7751,3761,3990,1471,1581
E02002441,Wakefield 004,Middle Super Output Areas and Intermediate Zones,MSOAIZ,WF,8626,4251,4375,1852,1799
E02002442,Wakefield 005,Middle Super Output Areas and Intermediate Zones,MSOAIZ,WF,6713,3334,3379,1533,1522
E02002443,Wakefield 006,Middle Super Output Areas and Intermediate Zones,MSOAIZ,WF,5943,2954,2989,1357,1353
E02002444,Wakefield 007,Middle Super Output Areas and Intermediate Zones,MSOAIZ,WF,5881,2857,3024,1228,1291
E02002445,Wakefield 008,Middle Super Output Areas and Intermediate Zones,MSOAIZ,WF,7004,3410,3594,1381,1395
E02002446,Wakefield 009,Middle Super Output Areas and Intermediate Zones,MSOAIZ,WF,6038,2960,3078,1187,1243
E02002447,Wakefield 010,Middle Super Output Areas and Intermediate Zones,MSOAIZ,WF,6146,3065,3081,1244,1222
E02002448,Wakefield 011,Middle Super Output Areas and Intermediate Zones,MSOAIZ,WF,7564,3665,3899,1436,1506
E02002449,Wakefield 012,Middle Super Output Areas and Intermediate Zones,MSOAIZ,WF,8138,3984,4154,1743,1834
E02002450,Wakefield 013,Middle Super Output Areas and Intermediate Zones,MSOAIZ,WF,6757,3345,3412,1487,1519
E02002451,Wakefield 014,Middle Super Output Areas and Intermediate Zones,MSOAIZ,WF,7186,3470,3716,1339,1407
E02002452,Wakefield 015,Middle Super Output Areas and Intermediate Zones,MSOAIZ,WF,7963,3952,4011,1757,1633
E02002453,Wakefield 016,Middle Super Output Areas and Intermediate Zones,MSOAIZ,WF,9248,4511,4737,1884,1973
E02002454,Wakefield 017,Middle Super Output Areas and Intermediate Zones,MSOAIZ,WF,7553,3983,3570,2061,1539
E02002455,Wakefield 018,Middle Super Output Areas and Intermediate Zones,MSOAIZ,WF,6149,2913,3236,1100,1279
E02002456,Wakefield 019,Middle Super Output Areas and Intermediate Zones,MSOAIZ,WF,7166,3957,3209,2034,1397
E02002457,Wakefield 020,Middle Super Output Areas and Intermediate Zones,MSOAIZ,WF,7603,3700,3903,1540,1600
E02002458,Wakefield 021,Middle Super Output Areas and Intermediate Zones,MSOAIZ,WF,8809,4272,4537,1759,1861
E02002459,Wakefield 022,Middle Super Output Areas and Intermediate Zones,MSOAIZ,WF,9349,4586,4763,2022,2052
E02002460,Wakefield 023,Middle Super Output Areas and Intermediate Zones,MSOAIZ,WF,7055,3423,3632,1247,1333
E02002461,Wakefield 024,Middle Super Output Areas and Intermediate Zones,MSOAIZ,WF,10059,4877,5182,2104,2209
E02002462,Wakefield 025,Middle Super Output Areas and Intermediate Zones,MSOAIZ,WF,7307,3571,3736,1496,1503
E02002463,Wakefield 026,Middle Super Output Areas and Intermediate Zones,MSOAIZ,WF,9104,4293,4811,1702,1929
E02002464,Wakefield 027,Middle Super Output Areas and Intermediate Zones,MSOAIZ,WF,7848,3800,4048,1522,1542
E02002465,Wakefield 028,Middle Super Output Areas and Intermediate Zones,MSOAIZ,WF,5988,2971,3017,1212,1148
E02002466,Wakefield 029,Middle Super Output Areas and Intermediate Zones,MSOAIZ,WF,8986,4361,4625,1758,1803
E02002467,Wakefield 030,Middle Super Output Areas and Intermediate Zones,MSOAIZ,WF,8234,4182,4052,2015,1795
E02002468,Wakefield 031,Middle Super Output Areas and Intermediate Zones,MSOAIZ,WF,6046,2901,3145,1214,1310
E02002469,Wakefield 032,Middle Super Output Areas and Intermediate Zones,MSOAIZ,WF,5945,2931,3014,1139,1185
E02002470,Wakefield 033,Middle Super Output Areas and Intermediate Zones,MSOAIZ,WF,6144,2981,3163,992,1067
E02002471,Wakefield 034,Middle Super Output Areas and Intermediate Zones,MSOAIZ,WF,10404,5114,5290,1975,2052
E02002472,Wakefield 035,Middle Super Output Areas and Intermediate Zones,MSOAIZ,WF,5963,2776,3187,1092,1362
E02002473,Wakefield 036,Middle Super Output Areas and Intermediate Zones,MSOAIZ,WF,6336,3086,3250,1250,1310
E02002474,Wakefield 037,Middle Super Output Areas and Intermediate Zones,MSOAIZ,WF,6115,2988,3127,1195,1260
E02002475,Wakefield 038,Middle Super Output Areas and Intermediate Zones,MSOAIZ,WF,5975,2894,3081,1135,1190
E02002476,Wakefield 039,Middle Super Output Areas and Intermediate Zones,MSOAIZ,WF,5845,2864,2981,1051,1163
E02002477,Wakefield 040,Middle Super Output Areas and Intermediate Zones,MSOAIZ,WF,6321,3093,3228,1243,1304
E02002478,Wakefield 041,Middle Super Output Areas and Intermediate Zones,MSOAIZ,WF,5832,2889,2943,1222,1251
E02002479,Wakefield 042,Middle Super Output Areas and Intermediate Zones,MSOAIZ,WF,8334,4090,4244,1625,1662
E02002480,Wakefield 043,Middle Super Output Areas and Intermediate Zones,MSOAIZ,WF,5872,2910,2962,1190,1120
E02002481,Wakefield 044,Middle Super Output Areas and Intermediate Zones,MSOAIZ,WF,6325,3127,3198,1283,1336
E02002482,Wakefield 045,Middle Super Output Areas and Intermediate Zones,MSOAIZ,WF,6702,3280,3422,1304,1350
E02002483,Hartlepool 001,Middle Super Output Areas and Intermediate Zones,MSOAIZ,TS,9084,4361,4723,1863,2024
E02002484,Hartlepool 002,Middle Super Output Areas and Intermediate Zones,MSOAIZ,TS,10316,5070,5246,1944,2017
E02002485,Hartlepool 003,Middle Super Output Areas and Intermediate Zones,MSOAIZ,TS,7835,3773,4062,1491,1535
E02002487,Hartlepool 005,Middle Super Output Areas and Intermediate Zones,MSOAIZ,TS,5357,2754,2603,1296,1095
E02002488,Hartlepool 006,Middle Super Output Areas and Intermediate Zones,MSOAIZ,TS,6110,2960,3150,1138,1241
E02002489,Hartlepool 007,Middle Super Output Areas and Intermediate Zones,MSOAIZ,TS,7927,3993,3934,1622,1545
E02002490,Hartlepool 008,Middle Super Output Areas and Intermediate Zones,MSOAIZ,TS,6079,2927,3152,1245,1333
E02002491,Hartlepool 009,Middle Super Output Areas and Intermediate Zones,MSOAIZ,TS,6559,3131,3428,1124,1252
E02002492,Hartlepool 010,Middle Super Output Areas and Intermediate Zones,MSOAIZ,TS,6684,3176,3508,1225,1395
E02002493,Hartlepool 011,Middle Super Output Areas and Intermediate Zones,MSOAIZ,TS,6458,3142,3316,1165,1246
E02002494,Hartlepool 012,Middle Super Output Areas and Intermediate Zones,MSOAIZ,TS,7750,3687,4063,1361,1607
E02002496,Middlesbrough 001,Middle Super Output Areas and Intermediate Zones,MSOAIZ,TS,11646,6400,5246,2491,1859
E02002497,Middlesbrough 002,Middle Super Output Areas and Intermediate Zones,MSOAIZ,TS,6268,2978,3290,1154,1306
E02002498,Middlesbrough 003,Middle Super Output Areas and Intermediate Zones,MSOAIZ,TS,8584,4593,3991,1971,1596
E02002499,Middlesbrough 004,Middle Super Output Areas and Intermediate Zones,MSOAIZ,TS,7516,3374,4142,1184,1568
E02002500,Middlesbrough 005,Middle Super Output Areas and Intermediate Zones,MSOAIZ,TS,5919,2922,2997,1257,1207
E02002501,Middlesbrough 006,Middle Super Output Areas and Intermediate Zones,MSOAIZ,TS,5346,2606,2740,1039,1174
E02002502,Middlesbrough 007,Middle Super Output Areas and Intermediate Zones,MSOAIZ,TS,9615,4700,4915,1784,1905
E02002503,Middlesbrough 008,Middle Super Output Areas and Intermediate Zones,MSOAIZ,TS,6515,3096,3419,1227,1453
E02002504,Middlesbrough 009,Middle Super Output Areas and Intermediate Zones,MSOAIZ,TS,9711,4837,4874,2062,2041
E02002505,Middlesbrough 010,Middle Super Output Areas and Intermediate Zones,MSOAIZ,TS,6254,2836,3418,1058,1373
E02002506,Middlesbrough 011,Middle Super Output Areas and Intermediate Zones,MSOAIZ,TS,5932,2833,3099,1115,1240
E02002507,Middlesbrough 012,Middle Super Output Areas and Intermediate Zones,MSOAIZ,TS,6027,2927,3100,1153,1218
E02002508,Middlesbrough 013,Middle Super Output Areas and Intermediate Zones,MSOAIZ,TS,5074,2429,2645,908,915
E02002509,Middlesbrough 014,Middle Super Output Areas and Intermediate Zones,MSOAIZ,TS,5583,2708,2875,1009,1142
E02002510,Middlesbrough 015,Middle Super Output Areas and Intermediate Zones,MSOAIZ,TS,5712,2743,2969,987,1040
E02002512,Middlesbrough 017,Middle Super Output Areas and Intermediate Zones,MSOAIZ,TS,5305,2585,2720,1009,1087
E02002513,Middlesbrough 018,Middle Super Output Areas and Intermediate Zones,MSOAIZ,TS,8844,4215,4629,1585,1807
E02002514,Middlesbrough 019,Middle Super Output Areas and Intermediate Zones,MSOAIZ,TS,8967,4290,4677,1856,1992
E02002515,Redcar and Cleveland 001,Middle Super Output Areas and Intermediate Zones,MSOAIZ,TS,6810,3459,3351,1539,1386
E02002516,Redcar and Cleveland 002,Middle Super Output Areas and Intermediate Zones,MSOAIZ,TS,5734,2791,2943,1081,1176
E02002517,Redcar and Cleveland 003,Middle Super Output Areas and Intermediate Zones,MSOAIZ,TS,5380,2588,2792,945,1073
E02002518,Redcar and Cleveland 004,Middle Super Output Areas and Intermediate Zones,MSOAIZ,TS,10723,5165,5558,2093,2255
E02002519,Redcar and Cleveland 005,Middle Super Output Areas and Intermediate Zones,MSOAIZ,TS,7045,3313,3732,1144,1349
E02002520,Redcar and Cleveland 006,Middle Super Output Areas and Intermediate Zones,MSOAIZ,TS,13176,6416,6760,2389,2458
E02002521,Redcar and Cleveland 007,Middle Super Output Areas and Intermediate Zones,MSOAIZ,TS,5958,2872,3086,1086,1118
E02002523,Redcar and Cleveland 009,Middle Super Output Areas and Intermediate Zones,MSOAIZ,TS,6514,3063,3451,1147,1370
E02002524,Redcar and Cleveland 010,Middle Super Output Areas and Intermediate Zones,MSOAIZ,TS,5394,2669,2725,1039,1046
E02002525,Redcar and Cleveland 011,Middle Super Output Areas and Intermediate Zones,MSOAIZ,TS,8357,4007,4350,1565,1683
E02002526,Redcar and Cleveland 012,Middle Super Output Areas and Intermediate Zones,MSOAIZ,TS,7454,3622,3832,1450,1573
E02002527,Redcar and Cleveland 013,Middle Super Output Areas and Intermediate Zones,MSOAIZ,TS,5177,2569,2608,970,1015
E02002529,Redcar and Cleveland 015,Middle Super Output Areas and Intermediate Zones,MSOAIZ,TS,5736,2833,2903,1119,1146
E02002530,Redcar and Cleveland 016,Middle Super Output Areas and Intermediate Zones,MSOAIZ,TS,6519,3289,3230,1190,1200
E02002532,Redcar and Cleveland 018,Middle Super Output Areas and Intermediate Zones,MSOAIZ,TS,6261,3014,3247,1200,1267
E02002533,Redcar and Cleveland 019,Middle Super Output Areas and Intermediate Zones,MSOAIZ,TS,5758,2788,2970,989,1079
E02002534,Redcar and Cleveland 020,Middle Super Output Areas and Intermediate Zones,MSOAIZ,TS,5758,2816,2942,943,1021
E02002535,Stockton-on-Tees 001,Middle Super Output Areas and Intermediate Zones,MSOAIZ,TS,10032,4902,5130,2146,2264
E02002536,Stockton-on-Tees 002,Middle Super Output Areas and Intermediate Zones,MSOAIZ,TS,9595,4561,5034,1754,1924
E02002537,Stockton-on-Tees 003,Middle Super Output Areas and Intermediate Zones,MSOAIZ,TS,9013,4326,4687,1701,1870
E02002538,Stockton-on-Tees 004,Middle Super Output Areas and Intermediate Zones,MSOAIZ,TS,5989,2941,3048,1102,1213
E02002539,Stockton-on-Tees 005,Middle Super Output Areas and Intermediate Zones,MSOAIZ,TS,8793,4310,4483,1625,1807
E02002540,Stockton-on-Tees 006,Middle Super Output Areas and Intermediate Zones,MSOAIZ,TS,6286,3027,3259,1122,1207
E02002541,Stockton-on-Tees 007,Middle Super Output Areas and Intermediate Zones,MSOAIZ,TS,6301,3148,3153,1287,1315
E02002542,Stockton-on-Tees 008,Middle Super Output Areas and Intermediate Zones,MSOAIZ,TS,8341,4003,4338,1517,1777
E02002543,Stockton-on-Tees 009,Middle Super Output Areas and Intermediate Zones,MSOAIZ,TS,8255,3917,4338,1577,1806
E02002544,Stockton-on-Tees 010,Middle Super Output Areas and Intermediate Zones,MSOAIZ,TS,8594,4662,3932,2188,1618
E02002545,Stockton-on-Tees 011,Middle Super Output Areas and Intermediate Zones,MSOAIZ,TS,5395,2641,2754,1043,1098
E02002546,Stockton-on-Tees 012,Middle Super Output Areas and Intermediate Zones,MSOAIZ,TS,7739,3791,3948,1483,1654
E02002547,Stockton-on-Tees 013,Middle Super Output Areas and Intermediate Zones,MSOAIZ,TS,6343,3045,3298,1089,1185
E02002548,Stockton-on-Tees 014,Middle Super Output Areas and Intermediate Zones,MSOAIZ,TS,11233,5752,5481,2513,2251
E02002549,Stockton-on-Tees 015,Middle Super Output Areas and Intermediate Zones,MSOAIZ,TS,7844,3712,4132,1314,1496
E02002550,Stockton-on-Tees 016,Middle Super Output Areas and Intermediate Zones,MSOAIZ,TS,6398,3126,3272,1249,1304
E02002551,Stockton-on-Tees 017,Middle Super Output Areas and Intermediate Zones,MSOAIZ,TS,6531,3215,3316,1225,1226
E02002552,Stockton-on-Tees 018,Middle Super Output Areas and Intermediate Zones,MSOAIZ,TS,6814,3332,3482,1353,1482
E02002553,Stockton-on-Tees 019,Middle Super Output Areas and Intermediate Zones,MSOAIZ,TS,5891,2871,3020,1096,1153
E02002554,Stockton-on-Tees 020,Middle Super Output Areas and Intermediate Zones,MSOAIZ,TS,5505,2592,2913,940,1039
E02002555,Stockton-on-Tees 021,Middle Super Output Areas and Intermediate Zones,MSOAIZ,TS,9928,4813,5115,1910,2043
E02002556,Stockton-on-Tees 022,Middle Super Output Areas and Intermediate Zones,MSOAIZ,TS,7160,3603,3557,1509,1651
E02002557,Stockton-on-Tees 023,Middle Super Output Areas and Intermediate Zones,MSOAIZ,TS,13885,6858,7027,3439,3688
E02002558,Stockton-on-Tees 024,Middle Super Output Areas and Intermediate Zones,MSOAIZ,TS,9745,4934,4811,2024,1903
E02002559,Darlington 001,Middle Super Output Areas and Intermediate Zones,MSOAIZ,TS,8842,4364,4478,1859,1988
E02002560,Darlington 002,Middle Super Output Areas and Intermediate Zones,MSOAIZ,DL,5997,2987,3010,1249,1317
E02002561,Darlington 003,Middle Super Output Areas and Intermediate Zones,MSOAIZ,DL,5741,2781,2960,1068,1226
E02002562,Darlington 004,Middle Super Output Areas and Intermediate Zones,MSOAIZ,DL,6066,3001,3065,1286,1272
E02002563,Darlington 005,Middle Super Output Areas and Intermediate Zones,MSOAIZ,DL,5463,2606,2857,940,1024
E02002564,Darlington 006,Middle Super Output Areas and Intermediate Zones,MSOAIZ,DL,9502,4571,4931,1817,2042
E02002565,Darlington 007,Middle Super Output Areas and Intermediate Zones,MSOAIZ,DL,5450,2601,2849,1210,1298
E02002566,Darlington 008,Middle Super Output Areas and Intermediate Zones,MSOAIZ,DL,6918,3613,3305,1777,1443
E02002567,Darlington 009,Middle Super Output Areas and Intermediate Zones,MSOAIZ,DL,7254,3479,3775,1294,1407
E02002568,Darlington 010,Middle Super Output Areas and Intermediate Zones,MSOAIZ,DL,5905,2857,3048,1130,1134
E02002569,Darlington 011,Middle Super Output Areas and Intermediate Zones,MSOAIZ,DL,9095,4324,4771,1404,1547
E02002570,Darlington 012,Middle Super Output Areas and Intermediate Zones,MSOAIZ,DL,8213,4005,4208,1662,1701
E02002571,Darlington 013,Middle Super Output Areas and Intermediate Zones,MSOAIZ,DL,6516,3181,3335,1326,1382
E02002572,Darlington 014,Middle Super Output Areas and Intermediate Zones,MSOAIZ,DL,6312,3074,3238,1334,1311
E02002573,Darlington 015,Middle Super Output Areas and Intermediate Zones,MSOAIZ,DL,8290,4039,4251,1628,1700
E02002574,Halton 001,Middle Super Output Areas and Intermediate Zones,MSOAIZ,WA,7137,3520,3617,1455,1456
E02002575,Halton 002,Middle Super Output Areas and Intermediate Zones,MSOAIZ,WA,9666,4875,4791,2184,2253
E02002576,Halton 003,Middle Super Output Areas and Intermediate Zones,MSOAIZ,WA,7369,3621,3748,1497,1486
E02002577,Halton 004,Middle Super Output Areas and Intermediate Zones,MSOAIZ,WA,7495,3579,3916,1397,1503
E02002578,Halton 005,Middle Super Output Areas and Intermediate Zones,MSOAIZ,WA,7725,3695,4030,1518,1602
E02002579,Halton 006,Middle Super Output Areas and Intermediate Zones,MSOAIZ,WA,7805,3672,4133,1443,1622
E02002580,Halton 007,Middle Super Output Areas and Intermediate Zones,MSOAIZ,WA,7512,3689,3823,1632,1573
E02002581,Halton 008,Middle Super Output Areas and Intermediate Zones,MSOAIZ,WA,7353,3577,3776,1407,1448
E02002582,Halton 009,Middle Super Output Areas and Intermediate Zones,MSOAIZ,WA,8192,4089,4103,1832,1951
E02002583,Halton 010,Middle Super Output Areas and Intermediate Zones,MSOAIZ,WA,6851,3418,3433,1359,1328
E02002584,Halton 011,Middle Super Output Areas and Intermediate Zones,MSOAIZ,WA,7460,3584,3876,1418,1534
E02002585,Halton 012,Middle Super Output Areas and Intermediate Zones,MSOAIZ,WA,10492,5247,5245,2361,2251
E02002586,Halton 013,Middle Super Output Areas and Intermediate Zones,MSOAIZ,WA,9816,4747,5069,1718,1932
E02002587,Halton 014,Middle Super Output Areas and Intermediate Zones,MSOAIZ,WA,6925,3327,3598,1252,1467
E02002588,Halton 015,Middle Super Output Areas and Intermediate Zones,MSOAIZ,WA,7500,3568,3932,1374,1540
E02002589,Halton 016,Middle Super Output Areas and Intermediate Zones,MSOAIZ,WA,6448,3160,3288,1177,1223
E02002590,Warrington 001,Middle Super Output Areas and Intermediate Zones,MSOAIZ,WA,7215,4042,3173,1879,1251
E02002591,Warrington 002,Middle Super Output Areas and Intermediate Zones,MSOAIZ,WA,6435,3080,3355,1168,1264
E02002592,Warrington 003,Middle Super Output Areas and Intermediate Zones,MSOAIZ,WA,6348,3095,3253,1255,1325
E02002593,Warrington 004,Middle Super Output Areas and Intermediate Zones,MSOAIZ,WA,5236,2617,2619,1068,1086
E02002594,Warrington 005,Middle Super Output Areas and Intermediate Zones,MSOAIZ,WA,5465,2727,2738,1227,1235
E02002595,Warrington 006,Middle Super Output Areas and Intermediate Zones,MSOAIZ,WA,7920,3804,4116,1582,1685
E02002596,Warrington 007,Middle Super Output Areas and Intermediate Zones,MSOAIZ,WA,8503,4140,4363,1573,1670
E02002597,Warrington 008,Middle Super Output Areas and Intermediate Zones,MSOAIZ,WA,9001,4389,4612,1711,1862
E02002598,Warrington 009,Middle Super Output Areas and Intermediate Zones,MSOAIZ,WA,7690,3853,3837,1925,1961
E02002599,Warrington 010,Middle Super Output Areas and Intermediate Zones,MSOAIZ,WA,10910,5408,5502,2473,2546
E02002600,Warrington 011,Middle Super Output Areas and Intermediate Zones,MSOAIZ,WA,9183,4536,4647,2033,1930
E02002601,Warrington 012,Middle Super Output Areas and Intermediate Zones,MSOAIZ,WA,7931,3880,4051,1548,1563
E02002602,Warrington 013,Middle Super Output Areas and Intermediate Zones,MSOAIZ,WA,7345,3671,3674,1661,1599
E02002603,Warrington 014,Middle Super Output Areas and Intermediate Zones,MSOAIZ,WA,7156,3553,3603,1362,1436
E02002604,Warrington 015,Middle Super Output Areas and Intermediate Zones,MSOAIZ,WA,7693,3784,3909,1525,1569
E02002605,Warrington 016,Middle Super Output Areas and Intermediate Zones,MSOAIZ,WA,9234,4532,4702,1939,2017
E02002606,Warrington 017,Middle Super Output Areas and Intermediate Zones,MSOAIZ,WA,10174,5218,4956,2750,2371
E02002607,Warrington 018,Middle Super Output Areas and Intermediate Zones,MSOAIZ,WA,9964,5100,4864,2396,2089
E02002608,Warrington 019,Middle Super Output Areas and Intermediate Zones,MSOAIZ,WA,8543,4058,4485,1565,1564
E02002609,Warrington 020,Middle Super Output Areas and Intermediate Zones,MSOAIZ,WA,8134,4089,4045,1868,1752
E02002610,Warrington 021,Middle Super Output Areas and Intermediate Zones,MSOAIZ,WA,12350,6031,6319,2427,2593
E02002611,Warrington 022,Middle Super Output Areas and Intermediate Zones,MSOAIZ,WA,7952,3844,4108,1528,1659
E02002612,Warrington 023,Middle Super Output Areas and Intermediate Zones,MSOAIZ,WA,9352,4568,4784,1895,1930
E02002613,Warrington 024,Middle Super Output Areas and Intermediate Zones,MSOAIZ,WA,6398,3293,3105,1212,1267
E02002614,Warrington 025,Middle Super Output Areas and Intermediate Zones,MSOAIZ,WA,6096,2988,3108,1034,1162
E02002615,Blackburn with Darwen 001,Middle Super Output Areas and Intermediate Zones,MSOAIZ,BB,9298,4559,4739,1818,1823
E02002616,Blackburn with Darwen 002,Middle Super Output Areas and Intermediate Zones,MSOAIZ,BB,8617,4262,4355,1684,1688
E02002617,Blackburn with Darwen 003,Middle Super Output Areas and Intermediate Zones,MSOAIZ,BB,8913,4459,4454,1753,1787
E02002618,Blackburn with Darwen 004,Middle Super Output Areas and Intermediate Zones,MSOAIZ,BB,7543,3761,3782,1593,1519
E02002619,Blackburn with Darwen 005,Middle Super Output Areas and Intermediate Zones,MSOAIZ,PR,8784,4516,4268,1991,1708
E02002620,Blackburn with Darwen 006,Middle Super Output Areas and Intermediate Zones,MSOAIZ,BB,8465,4451,4014,1990,1607
E02002621,Blackburn with Darwen 007,Middle Super Output Areas and Intermediate Zones,MSOAIZ,BB,8381,4262,4119,1783,1648
E02002622,Blackburn with Darwen 008,Middle Super Output Areas and Intermediate Zones,MSOAIZ,BB,10137,5101,5036,1993,1988
E02002623,Blackburn with Darwen 009,Middle Super Output Areas and Intermediate Zones,MSOAIZ,BB,10066,5023,5043,2229,2133
E02002624,Blackburn with Darwen 010,Middle Super Output Areas and Intermediate Zones,MSOAIZ,BB,8121,4006,4115,1494,1532
E02002625,Blackburn with Darwen 011,Middle Super Output Areas and Intermediate Zones,MSOAIZ,BB,9930,4839,5091,2004,2187
E02002626,Blackburn with Darwen 012,Middle Super Output Areas and Intermediate Zones,MSOAIZ,BB,7216,3489,3727,1305,1444
E02002627,Blackburn with Darwen 013,Middle Super Output Areas and Intermediate Zones,MSOAIZ,BB,7703,3900,3803,1826,1850
E02002628,Blackburn with Darwen 014,Middle Super Output Areas and Intermediate Zones,MSOAIZ,BB,7056,3407,3649,1422,1427
E02002629,Blackburn with Darwen 015,Middle Super Output Areas and Intermediate Zones,MSOAIZ,BB,5783,2828,2955,1130,1191
E02002630,Blackburn with Darwen 016,Middle Super Output Areas and Intermediate Zones,MSOAIZ,BB,6106,3040,3066,1343,1292
E02002631,Blackburn with Darwen 017,Middle Super Output Areas and Intermediate Zones,MSOAIZ,BB,9101,4554,4547,1964,1949
E02002632,Blackburn with Darwen 018,Middle Super Output Areas and Intermediate Zones,MSOAIZ,PR,6269,3090,3179,1239,1314
E02002633,Blackpool 001,Middle Super Output Areas and Intermediate Zones,MSOAIZ,FY,7808,3660,4148,1327,1347
E02002634,Blackpool 002,Middle Super Output Areas and Intermediate Zones,MSOAIZ,FY,8256,3955,4301,1495,1540
E02002635,Blackpool 003,Middle Super Output Areas and Intermediate Zones,MSOAIZ,FY,7996,3881,4115,1435,1370
E02002636,Blackpool 004,Middle Super Output Areas and Intermediate Zones,MSOAIZ,FY,8374,3979,4395,1589,1761
E02002637,Blackpool 005,Middle Super Output Areas and Intermediate Zones,MSOAIZ,FY,6189,3018,3171,1191,1228
E02002638,Blackpool 006,Middle Super Output Areas and Intermediate Zones,MSOAIZ,FY,6406,3578,2828,1714,1143
E02002639,Blackpool 007,Middle Super Output Areas and Intermediate Zones,MSOAIZ,FY,5770,2803,2967,1116,1198
E02002640,Blackpool 008,Middle Super Output Areas and Intermediate Zones,MSOAIZ,FY,7317,3712,3605,1662,1460
E02002641,Blackpool 009,Middle Super Output Areas and Intermediate Zones,MSOAIZ,FY,8268,3903,4365,1655,1850
E02002642,Blackpool 010,Middle Super Output Areas and Intermediate Zones,MSOAIZ,FY,7081,3836,3245,1748,1272
E02002643,Blackpool 011,Middle Super Output Areas and Intermediate Zones,MSOAIZ,FY,7502,3720,3782,1531,1544
E02002644,Blackpool 012,Middle Super Output Areas and Intermediate Zones,MSOAIZ,FY,8035,3886,4149,1619,1722
E02002645,Blackpool 013,Middle Super Output Areas and Intermediate Zones,MSOAIZ,FY,5777,3147,2630,1459,1144
E02002646,Blackpool 014,Middle Super Output Areas and Intermediate Zones,MSOAIZ,FY,7102,3398,3704,1275,1396
E02002647,Blackpool 015,Middle Super Output Areas and Intermediate Zones,MSOAIZ,FY,8203,3994,4209,1570,1643
E02002648,Blackpool 016,Middle Super Output Areas and Intermediate Zones,MSOAIZ,FY,7329,3525,3804,1372,1507
E02002649,Blackpool 017,Middle Super Output Areas and Intermediate Zones,MSOAIZ,FY,8587,4204,4383,1695,1641
E02002650,Blackpool 018,Middle Super Output Areas and Intermediate Zones,MSOAIZ,FY,7983,3744,4239,1370,1553
E02002651,Blackpool 019,Middle Super Output Areas and Intermediate Zones,MSOAIZ,FY,8082,3832,4250,1426,1545
E02002652,Kingston upon Hull 001,Middle Super Output Areas and Intermediate Zones,MSOAIZ,HU,10846,5277,5569,2533,2657
E02002653,Kingston upon Hull 002,Middle Super Output Areas and Intermediate Zones,MSOAIZ,HU,8323,4073,4250,1421,1607
E02002654,Kingston upon Hull 003,Middle Super Output Areas and Intermediate Zones,MSOAIZ,HU,7640,3698,3942,1336,1529
E02002655,Kingston upon Hull 004,Middle Super Output Areas and Intermediate Zones,MSOAIZ,HU,8926,4253,4673,1665,1865
E02002656,Kingston upon Hull 005,Middle Super Output Areas and Intermediate Zones,MSOAIZ,HU,5361,2638,2723,1040,1021
E02002657,Kingston upon Hull 006,Middle Super Output Areas and Intermediate Zones,MSOAIZ,HU,7537,3764,3773,1477,1518
E02002658,Kingston upon Hull 007,Middle Super Output Areas and Intermediate Zones,MSOAIZ,HU,6881,3402,3479,1377,1432
E02002659,Kingston upon Hull 008,Middle Super Output Areas and Intermediate Zones,MSOAIZ,HU,11018,5342,5676,1986,2263
E02002660,Kingston upon Hull 009,Middle Super Output Areas and Intermediate Zones,MSOAIZ,HU,6942,3402,3540,1251,1331
E02002661,Kingston upon Hull 010,Middle Super Output Areas and Intermediate Zones,MSOAIZ,HU,7963,3703,4260,1412,1607
E02002662,Kingston upon Hull 011,Middle Super Output Areas and Intermediate Zones,MSOAIZ,HU,7215,3438,3777,1245,1343
E02002663,Kingston upon Hull 012,Middle Super Output Areas and Intermediate Zones,MSOAIZ,HU,6850,3552,3298,1111,1043
E02002664,Kingston upon Hull 013,Middle Super Output Areas and Intermediate Zones,MSOAIZ,HU,7614,3816,3798,1553,1647
E02002665,Kingston upon Hull 014,Middle Super Output Areas and Intermediate Zones,MSOAIZ,HU,8312,4058,4254,1659,1737
E02002666,Kingston upon Hull 015,Middle Super Output Areas and Intermediate Zones,MSOAIZ,HU,8961,4859,4102,1797,1341
E02002667,Kingston upon Hull 016,Middle Super Output Areas and Intermediate Zones,MSOAIZ,HU,7110,3570,3540,1731,1575
E02002668,Kingston upon Hull 017,Middle Super Output Areas and Intermediate Zones,MSOAIZ,HU,8864,4174,4690,1471,1711
E02002669,Kingston upon Hull 018,Middle Super Output Areas and Intermediate Zones,MSOAIZ,HU,8486,4436,4050,2005,1741
E02002670,Kingston upon Hull 019,Middle Super Output Areas and Intermediate Zones,MSOAIZ,HU,7871,3764,4107,1516,1616
E02002671,Kingston upon Hull 020,Middle Super Output Areas and Intermediate Zones,MSOAIZ,HU,8365,4510,3855,2217,1694
E02002672,Kingston upon Hull 021,Middle Super Output Areas and Intermediate Zones,MSOAIZ,HU,7373,3519,3854,1247,1449
E02002673,Kingston upon Hull 022,Middle Super Output Areas and Intermediate Zones,MSOAIZ,HU,7916,3958,3958,1829,1702
E02002674,Kingston upon Hull 023,Middle Super Output Areas and Intermediate Zones,MSOAIZ,HU,6905,3395,3510,1553,1570
E02002675,Kingston upon Hull 024,Middle Super Output Areas and Intermediate Zones,MSOAIZ,HU,8464,4572,3892,2214,1649
E02002676,Kingston upon Hull 025,Middle Super Output Areas and Intermediate Zones,MSOAIZ,HU,7581,3844,3737,1845,1749
E02002677,Kingston upon Hull 026,Middle Super Output Areas and Intermediate Zones,MSOAIZ,HU,8420,4426,3994,2209,1820
E02002678,Kingston upon Hull 027,Middle Super Output Areas and Intermediate Zones,MSOAIZ,HU,7692,3910,3782,1827,1741
E02002679,Kingston upon Hull 028,Middle Super Output Areas and Intermediate Zones,MSOAIZ,HU,7415,3633,3782,1441,1461
E02002680,Kingston upon Hull 029,Middle Super Output Areas and Intermediate Zones,MSOAIZ,HU,8871,5236,3635,2985,1608
E02002681,Kingston upon Hull 030,Middle Super Output Areas and Intermediate Zones,MSOAIZ,HU,8511,4360,4151,2152,1807
E02002682,Kingston upon Hull 031,Middle Super Output Areas and Intermediate Zones,MSOAIZ,HU,7953,3899,4054,1623,1734
E02002684,East Riding of Yorkshire 001,Middle Super Output Areas and Intermediate Zones,MSOAIZ,YO,9688,4649,5039,1382,1508
E02002685,East Riding of Yorkshire 002,Middle Super Output Areas and Intermediate Zones,MSOAIZ,YO,8071,3844,4227,1142,1238
E02002686,East Riding of Yorkshire 003,Middle Super Output Areas and Intermediate Zones,MSOAIZ,YO,7904,3737,4167,1250,1364
E02002687,East Riding of Yorkshire 004,Middle Super Output Areas and Intermediate Zones,MSOAIZ,YO,6032,2952,3080,1105,1072
E02002688,East Riding of Yorkshire 005,Middle Super Output Areas and Intermediate Zones,MSOAIZ,YO,5662,2830,2832,1139,986
E02002689,East Riding of Yorkshire 006,Middle Super Output Areas and Intermediate Zones,MSOAIZ,YO,5891,2857,3034,994,1032
E02002691,East Riding of Yorkshire 008,Middle Super Output Areas and Intermediate Zones,MSOAIZ,YO,8074,3920,4154,1425,1547
E02002692,East Riding of Yorkshire 009,Middle Super Output Areas and Intermediate Zones,MSOAIZ,YO,8805,4586,4219,1982,1617
E02002693,East Riding of Yorkshire 010,Middle Super Output Areas and Intermediate Zones,MSOAIZ,YO,6842,3397,3445,1247,1296
E02002694,East Riding of Yorkshire 011,Middle Super Output Areas and Intermediate Zones,MSOAIZ,YO,10943,5309,5634,2058,2150
E02002695,East Riding of Yorkshire 012,Middle Super Output Areas and Intermediate Zones,MSOAIZ,HU,8099,3896,4203,1278,1294
E02002696,East Riding of Yorkshire 013,Middle Super Output Areas and Intermediate Zones,MSOAIZ,YO,6008,3027,2981,1109,1211
E02002697,East Riding of Yorkshire 014,Middle Super Output Areas and Intermediate Zones,MSOAIZ,HU,7593,3742,3851,1330,1441
E02002698,East Riding of Yorkshire 015,Middle Super Output Areas and Intermediate Zones,MSOAIZ,YO,7586,3701,3885,1440,1508
E02002699,East Riding of Yorkshire 016,Middle Super Output Areas and Intermediate Zones,MSOAIZ,HU,9442,4498,4944,1764,1863
E02002700,East Riding of Yorkshire 017,Middle Super Output Areas and Intermediate Zones,MSOAIZ,HU,6308,3051,3257,1193,1239
E02002701,East Riding of Yorkshire 018,Middle Super Output Areas and Intermediate Zones,MSOAIZ,YO,8541,4230,4311,1633,1709
E02002702,East Riding of Yorkshire 019,Middle Super Output Areas and Intermediate Zones,MSOAIZ,HU,9796,4679,5117,2051,2093
E02002703,East Riding of Yorkshire 020,Middle Super Output Areas and Intermediate Zones,MSOAIZ,HU,9198,4444,4754,1710,1877
E02002704,East Riding of Yorkshire 021,Middle Super Output Areas and Intermediate Zones,MSOAIZ,HU,7241,3582,3659,1228,1300
E02002705,East Riding of Yorkshire 022,Middle Super Output Areas and Intermediate Zones,MSOAIZ,HU,6330,3051,3279,1014,1065
E02002706,East Riding of Yorkshire 023,Middle Super Output Areas and Intermediate Zones,MSOAIZ,HU,6907,3348,3559,1293,1342
E02002707,East Riding of Yorkshire 024,Middle Super Output Areas and Intermediate Zones,MSOAIZ,YO,7617,4063,3554,1863,1381
E02002708,East Riding of Yorkshire 025,Middle Super Output Areas and Intermediate Zones,MSOAIZ,HU,7120,3417,3703,986,967
E02002709,East Riding of Yorkshire 026,Middle Super Output Areas and Intermediate Zones,MSOAIZ,YO,7534,3711,3823,1456,1489
E02002710,East Riding of Yorkshire 027,Middle Super Output Areas and Intermediate Zones,MSOAIZ,HU,7550,3614,3936,1420,1490
E02002711,East Riding of Yorkshire 028,Middle Super Output Areas and Intermediate Zones,MSOAIZ,HU,7584,3727,3857,1256,1285
E02002712,East Riding of Yorkshire 029,Middle Super Output Areas and Intermediate Zones,MSOAIZ,HU,7511,3607,3904,1410,1441
E02002714,East Riding of Yorkshire 031,Middle Super Output Areas and Intermediate Zones,MSOAIZ,HU,7707,3879,3828,1373,1421
E02002715,East Riding of Yorkshire 032,Middle Super Output Areas and Intermediate Zones,MSOAIZ,HU,12472,6101,6371,2779,2792
E02002716,East Riding of Yorkshire 033,Middle Super Output Areas and Intermediate Zones,MSOAIZ,HU,8570,4227,4343,1629,1685
E02002717,East Riding of Yorkshire 034,Middle Super Output Areas and Intermediate Zones,MSOAIZ,HU,7606,3646,3960,1504,1577
E02002718,East Riding of Yorkshire 035,Middle Super Output Areas and Intermediate Zones,MSOAIZ,HU,7844,3851,3993,1321,1443
E02002719,East Riding of Yorkshire 036,Middle Super Output Areas and Intermediate Zones,MSOAIZ,HU,5925,2834,3091,1154,1177
E02002720,East Riding of Yorkshire 037,Middle Super Output Areas and Intermediate Zones,MSOAIZ,YO,6994,3452,3542,1443,1437
E02002721,East Riding of Yorkshire 038,Middle Super Output Areas and Intermediate Zones,MSOAIZ,HU,6379,3142,3237,1186,1263
E02002722,East Riding of Yorkshire 039,Middle Super Output Areas and Intermediate Zones,MSOAIZ,HU,8744,4355,4389,1468,1499
E02002723,East Riding of Yorkshire 040,Middle Super Output Areas and Intermediate Zones,MSOAIZ,DN,8439,4106,4333,1756,1714
E02002724,East Riding of Yorkshire 041,Middle Super Output Areas and Intermediate Zones,MSOAIZ,DN,8789,4360,4429,1791,1789
E02002725,East Riding of Yorkshire 042,Middle Super Output Areas and Intermediate Zones,MSOAIZ,DN,6599,3240,3359,1314,1327
E02002726,North East Lincolnshire 001,Middle Super Output Areas and Intermediate Zones,MSOAIZ,DN,10273,5030,5243,1930,1996
E02002727,North East Lincolnshire 002,Middle Super Output Areas and Intermediate Zones,MSOAIZ,DN,5894,3104,2790,1264,1066
E02002728,North East Lincolnshire 003,Middle Super Output Areas and Intermediate Zones,MSOAIZ,DN,7754,3842,3912,1735,1626
E02002729,North East Lincolnshire 004,Middle Super Output Areas and Intermediate Zones,MSOAIZ,DN,5946,2950,2996,1135,1187
E02002730,North East Lincolnshire 005,Middle Super Output Areas and Intermediate Zones,MSOAIZ,DN,7599,3807,3792,1643,1579
E02002731,North East Lincolnshire 006,Middle Super Output Areas and Intermediate Zones,MSOAIZ,DN,5941,2915,3026,1225,1263
E02002732,North East Lincolnshire 007,Middle Super Output Areas and Intermediate Zones,MSOAIZ,DN,7588,3752,3836,1423,1590
E02002733,North East Lincolnshire 008,Middle Super Output Areas and Intermediate Zones,MSOAIZ,DN,6052,2965,3087,1306,1247
E02002734,North East Lincolnshire 009,Middle Super Output Areas and Intermediate Zones,MSOAIZ,DN,5146,2421,2725,983,1066
E02002735,North East Lincolnshire 010,Middle Super Output Areas and Intermediate Zones,MSOAIZ,DN,5354,2636,2718,1166,1165
E02002736,North East Lincolnshire 011,Middle Super Output Areas and Intermediate Zones,MSOAIZ,DN,5872,3051,2821,1356,1229
E02002737,North East Lincolnshire 012,Middle Super Output Areas and Intermediate Zones,MSOAIZ,DN,7426,3644,3782,1468,1514
E02002738,North East Lincolnshire 013,Middle Super Output Areas and Intermediate Zones,MSOAIZ,DN,7161,3493,3668,1429,1502
E02002739,North East Lincolnshire 014,Middle Super Output Areas and Intermediate Zones,MSOAIZ,DN,5974,2832,3142,1175,1192
E02002740,North East Lincolnshire 015,Middle Super Output Areas and Intermediate Zones,MSOAIZ,DN,5604,2695,2909,1041,1098
E02002741,North East Lincolnshire 016,Middle Super Output Areas and Intermediate Zones,MSOAIZ,DN,9200,4573,4627,1868,1834
E02002742,North East Lincolnshire 017,Middle Super Output Areas and Intermediate Zones,MSOAIZ,DN,5693,2818,2875,1081,1038
E02002743,North East Lincolnshire 018,Middle Super Output Areas and Intermediate Zones,MSOAIZ,DN,5460,2572,2888,831,858
E02002744,North East Lincolnshire 019,Middle Super Output Areas and Intermediate Zones,MSOAIZ,DN,7124,3394,3730,1132,1391
E02002745,North East Lincolnshire 020,Middle Super Output Areas and Intermediate Zones,MSOAIZ,DN,7621,3676,3945,1292,1346
E02002746,North East Lincolnshire 021,Middle Super Output Areas and Intermediate Zones,MSOAIZ,DN,8832,4271,4561,1629,1707
E02002747,North East Lincolnshire 022,Middle Super Output Areas and Intermediate Zones,MSOAIZ,DN,7999,3914,4085,1436,1503
E02002748,North East Lincolnshire 023,Middle Super Output Areas and Intermediate Zones,MSOAIZ,LN,8103,3892,4211,1388,1512
E02002749,North Lincolnshire 001,Middle Super Output Areas and Intermediate Zones,MSOAIZ,DN,11066,5380,5686,2129,2204
E02002750,North Lincolnshire 002,Middle Super Output Areas and Intermediate Zones,MSOAIZ,DN,6282,3136,3146,1252,1256
E02002751,North Lincolnshire 003,Middle Super Output Areas and Intermediate Zones,MSOAIZ,DN,6451,3213,3238,1200,1256
E02002752,North Lincolnshire 004,Middle Super Output Areas and Intermediate Zones,MSOAIZ,DN,6801,3326,3475,1343,1431
E02002753,North Lincolnshire 005,Middle Super Output Areas and Intermediate Zones,MSOAIZ,DN,8691,4302,4389,1695,1672
E02002754,North Lincolnshire 006,Middle Super Output Areas and Intermediate Zones,MSOAIZ,DN,8288,4187,4101,1677,1695
E02002755,North Lincolnshire 007,Middle Super Output Areas and Intermediate Zones,MSOAIZ,DN,7038,3616,3422,1713,1397
E02002756,North Lincolnshire 008,Middle Super Output Areas and Intermediate Zones,MSOAIZ,DN,8522,4349,4173,1907,1687
E02002757,North Lincolnshire 009,Middle Super Output Areas and Intermediate Zones,MSOAIZ,DN,6188,3105,3083,1339,1259
E02002758,North Lincolnshire 010,Middle Super Output Areas and Intermediate Zones,MSOAIZ,DN,6349,3126,3223,1390,1363
E02002759,North Lincolnshire 011,Middle Super Output Areas and Intermediate Zones,MSOAIZ,DN,9610,4720,4890,1784,1828
E02002760,North Lincolnshire 012,Middle Super Output Areas and Intermediate Zones,MSOAIZ,DN,5876,2901,2975,1159,1113
E02002761,North Lincolnshire 013,Middle Super Output Areas and Intermediate Zones,MSOAIZ,DN,6793,3310,3483,1354,1367
E02002762,North Lincolnshire 014,Middle Super Output Areas and Intermediate Zones,MSOAIZ,DN,6707,3242,3465,1334,1263
E02002763,North Lincolnshire 015,Middle Super Output Areas and Intermediate Zones,MSOAIZ,DN,7379,3658,3721,1475,1490
E02002764,North Lincolnshire 016,Middle Super Output Areas and Intermediate Zones,MSOAIZ,DN,5820,2815,3005,1026,1180
E02002765,North Lincolnshire 017,Middle Super Output Areas and Intermediate Zones,MSOAIZ,DN,6373,3080,3293,1237,1214
E02002766,North Lincolnshire 018,Middle Super Output Areas and Intermediate Zones,MSOAIZ,DN,9160,4468,4692,1757,1823
E02002767,North Lincolnshire 019,Middle Super Output Areas and Intermediate Zones,MSOAIZ,DN,6788,3324,3464,1300,1317
E02002768,North Lincolnshire 020,Middle Super Output Areas and Intermediate Zones,MSOAIZ,DN,7247,3543,3704,1341,1457
E02002769,North Lincolnshire 021,Middle Super Output Areas and Intermediate Zones,MSOAIZ,DN,5841,2856,2985,1015,1083
E02002770,North Lincolnshire 022,Middle Super Output Areas and Intermediate Zones,MSOAIZ,LN,7014,3480,3534,1363,1371
E02002771,North Lincolnshire 023,Middle Super Output Areas and Intermediate Zones,MSOAIZ,DN,7162,3486,3676,1278,1353
E02002772,York 001,Middle Super Output Areas and Intermediate Zones,MSOAIZ,YO,6923,3350,3573,1392,1526
E02002773,York 002,Middle Super Output Areas and Intermediate Zones,MSOAIZ,YO,5756,2681,3075,963,1037
E02002774,York 003,Middle Super Output Areas and Intermediate Zones,MSOAIZ,YO,6282,2943,3339,1113,1223
E02002775,York 004,Middle Super Output Areas and Intermediate Zones,MSOAIZ,YO,5653,2597,3056,904,1045
E02002776,York 005,Middle Super Output Areas and Intermediate Zones,MSOAIZ,YO,6455,3092,3363,1244,1291
E02002777,York 006,Middle Super Output Areas and Intermediate Zones,MSOAIZ,YO,8274,4075,4199,1887,2015
E02002778,York 007,Middle Super Output Areas and Intermediate Zones,MSOAIZ,YO,8280,4032,4248,1732,1711
E02002779,York 008,Middle Super Output Areas and Intermediate Zones,MSOAIZ,YO,9588,4711,4877,1773,1773
E02002780,York 009,Middle Super Output Areas and Intermediate Zones,MSOAIZ,YO,8387,4032,4355,1851,1780
E02002781,York 010,Middle Super Output Areas and Intermediate Zones,MSOAIZ,YO,9885,4764,5121,2089,1964
E02002782,York 011,Middle Super Output Areas and Intermediate Zones,MSOAIZ,YO,6345,2990,3355,1045,1230
E02002783,York 012,Middle Super Output Areas and Intermediate Zones,MSOAIZ,YO,10164,5029,5135,2092,2096
E02002784,York 013,Middle Super Output Areas and Intermediate Zones,MSOAIZ,YO,10622,5435,5187,2822,2163
E02002785,York 014,Middle Super Output Areas and Intermediate Zones,MSOAIZ,YO,6872,3358,3514,1125,1205
E02002786,York 015,Middle Super Output Areas and Intermediate Zones,MSOAIZ,YO,10668,5368,5300,1848,1807
E02002787,York 016,Middle Super Output Areas and Intermediate Zones,MSOAIZ,YO,9075,4326,4749,1970,2003
E02002788,York 017,Middle Super Output Areas and Intermediate Zones,MSOAIZ,YO,8921,4460,4461,2298,2208
E02002789,York 018,Middle Super Output Areas and Intermediate Zones,MSOAIZ,YO,8862,4246,4616,1768,1925
E02002790,York 019,Middle Super Output Areas and Intermediate Zones,MSOAIZ,YO,11399,5751,5648,2477,2185
E02002791,York 020,Middle Super Output Areas and Intermediate Zones,MSOAIZ,YO,6540,3139,3401,1100,1198
E02002792,York 021,Middle Super Output Areas and Intermediate Zones,MSOAIZ,YO,7039,3393,3646,1613,1655
E02002793,York 022,Middle Super Output Areas and Intermediate Zones,MSOAIZ,YO,9165,4437,4728,1732,1860
E02002794,York 023,Middle Super Output Areas and Intermediate Zones,MSOAIZ,YO,8817,4125,4692,997,1037
E02002795,York 024,Middle Super Output Areas and Intermediate Zones,MSOAIZ,YO,8079,3920,4159,1387,1532
E02002796,Derby 001,Middle Super Output Areas and Intermediate Zones,MSOAIZ,DE,6135,2973,3162,1109,1118
E02002797,Derby 002,Middle Super Output Areas and Intermediate Zones,MSOAIZ,DE,7487,3625,3862,1284,1254
E02002798,Derby 003,Middle Super Output Areas and Intermediate Zones,MSOAIZ,DE,10138,4998,5140,2392,2446
E02002799,Derby 004,Middle Super Output Areas and Intermediate Zones,MSOAIZ,DE,5992,2899,3093,1120,1308
E02002800,Derby 005,Middle Super Output Areas and Intermediate Zones,MSOAIZ,DE,7131,3474,3657,1495,1408
E02002801,Derby 006,Middle Super Output Areas and Intermediate Zones,MSOAIZ,DE,7611,3691,3920,1463,1559
E02002802,Derby 007,Middle Super Output Areas and Intermediate Zones,MSOAIZ,DE,8012,3874,4138,1553,1743
E02002803,Derby 008,Middle Super Output Areas and Intermediate Zones,MSOAIZ,DE,7766,4171,3595,1822,1387
E02002804,Derby 009,Middle Super Output Areas and Intermediate Zones,MSOAIZ,DE,7633,3623,4010,1349,1540
E02002805,Derby 010,Middle Super Output Areas and Intermediate Zones,MSOAIZ,DE,5701,2813,2888,1010,1023
E02002806,Derby 011,Middle Super Output Areas and Intermediate Zones,MSOAIZ,DE,6547,3501,3046,1440,1191
E02002807,Derby 012,Middle Super Output Areas and Intermediate Zones,MSOAIZ,DE,9021,4426,4595,1735,1825
E02002808,Derby 013,Middle Super Output Areas and Intermediate Zones,MSOAIZ,DE,11819,6234,5585,3021,2343
E02002809,Derby 014,Middle Super Output Areas and Intermediate Zones,MSOAIZ,DE,6676,3251,3425,1279,1366
E02002810,Derby 015,Middle Super Output Areas and Intermediate Zones,MSOAIZ,DE,8220,3967,4253,1514,1638
E02002811,Derby 016,Middle Super Output Areas and Intermediate Zones,MSOAIZ,DE,9971,5247,4724,2430,1958
E02002812,Derby 017,Middle Super Output Areas and Intermediate Zones,MSOAIZ,DE,6965,3422,3543,1410,1394
E02002813,Derby 018,Middle Super Output Areas and Intermediate Zones,MSOAIZ,DE,10322,5389,4933,2489,2017
E02002814,Derby 019,Middle Super Output Areas and Intermediate Zones,MSOAIZ,DE,7360,3508,3852,1322,1435
E02002815,Derby 020,Middle Super Output Areas and Intermediate Zones,MSOAIZ,DE,7664,3865,3799,1602,1578
E02002816,Derby 021,Middle Super Output Areas and Intermediate Zones,MSOAIZ,DE,9406,4614,4792,1963,2128
E02002817,Derby 022,Middle Super Output Areas and Intermediate Zones,MSOAIZ,DE,6317,3025,3292,1128,1205
E02002818,Derby 023,Middle Super Output Areas and Intermediate Zones,MSOAIZ,DE,7665,3721,3944,1475,1639
E02002819,Derby 024,Middle Super Output Areas and Intermediate Zones,MSOAIZ,DE,7408,3742,3666,1762,1588
E02002820,Derby 025,Middle Super Output Areas and Intermediate Zones,MSOAIZ,DE,9708,4809,4899,2041,2128
E02002821,Derby 026,Middle Super Output Areas and Intermediate Zones,MSOAIZ,DE,11010,5319,5691,2127,2425
E02002822,Derby 027,Middle Super Output Areas and Intermediate Zones,MSOAIZ,DE,6738,3209,3529,1265,1411
E02002823,Derby 028,Middle Super Output Areas and Intermediate Zones,MSOAIZ,DE,7475,3586,3889,1345,1453
E02002824,Derby 029,Middle Super Output Areas and Intermediate Zones,MSOAIZ,DE,9656,4698,4958,1821,2078
E02002825,Derby 030,Middle Super Output Areas and Intermediate Zones,MSOAIZ,DE,8544,4174,4370,1749,1790
E02002826,Derby 031,Middle Super Output Areas and Intermediate Zones,MSOAIZ,DE,6654,3198,3456,1350,1500
E02002827,Leicester 001,Middle Super Output Areas and Intermediate Zones,MSOAIZ,LE,6431,3181,3250,1441,1538
E02002828,Leicester 002,Middle Super Output Areas and Intermediate Zones,MSOAIZ,LE,7582,3739,3843,1585,1657
E02002829,Leicester 003,Middle Super Output Areas and Intermediate Zones,MSOAIZ,LE,10609,5145,5464,2105,2236
E02002830,Leicester 004,Middle Super Output Areas and Intermediate Zones,MSOAIZ,LE,10049,5039,5010,2231,2267
E02002831,Leicester 005,Middle Super Output Areas and Intermediate Zones,MSOAIZ,LE,6832,3354,3478,1351,1468
E02002832,Leicester 006,Middle Super Output Areas and Intermediate Zones,MSOAIZ,LE,8072,3930,4142,1671,1769
E02002833,Leicester 007,Middle Super Output Areas and Intermediate Zones,MSOAIZ,LE,8160,4023,4137,1700,1813
E02002834,Leicester 008,Middle Super Output Areas and Intermediate Zones,MSOAIZ,LE,9731,4889,4842,2230,2127
E02002835,Leicester 009,Middle Super Output Areas and Intermediate Zones,MSOAIZ,LE,12628,6207,6421,2944,3080
E02002836,Leicester 010,Middle Super Output Areas and Intermediate Zones,MSOAIZ,LE,9331,4512,4819,1904,2046
E02002837,Leicester 011,Middle Super Output Areas and Intermediate Zones,MSOAIZ,LE,7445,3725,3720,1548,1631
E02002838,Leicester 012,Middle Super Output Areas and Intermediate Zones,MSOAIZ,LE,7723,3618,4105,1342,1536
E02002839,Leicester 013,Middle Super Output Areas and Intermediate Zones,MSOAIZ,LE,7638,3685,3953,1418,1567
E02002842,Leicester 016,Middle Super Output Areas and Intermediate Zones,MSOAIZ,LE,7658,3896,3762,2038,1859
E02002843,Leicester 017,Middle Super Output Areas and Intermediate Zones,MSOAIZ,LE,13049,6569,6480,2773,2670
E02002844,Leicester 018,Middle Super Output Areas and Intermediate Zones,MSOAIZ,LE,11954,5986,5968,2539,2352
E02002845,Leicester 019,Middle Super Output Areas and Intermediate Zones,MSOAIZ,LE,10350,5109,5241,2144,2243
E02002846,Leicester 020,Middle Super Output Areas and Intermediate Zones,MSOAIZ,LE,7385,3629,3756,1608,1601
E02002847,Leicester 021,Middle Super Output Areas and Intermediate Zones,MSOAIZ,LE,10274,5229,5045,2130,2041
E02002848,Leicester 022,Middle Super Output Areas and Intermediate Zones,MSOAIZ,LE,11199,5844,5355,2323,2068
E02002849,Leicester 023,Middle Super Output Areas and Intermediate Zones,MSOAIZ,LE,12432,6354,6078,3181,2306
E02002851,Leicester 025,Middle Super Output Areas and Intermediate Zones,MSOAIZ,LE,7984,3876,4108,1443,1486
E02002852,Leicester 026,Middle Super Output Areas and Intermediate Zones,MSOAIZ,LE,7098,3398,3700,1224,1516
E02002853,Leicester 027,Middle Super Output Areas and Intermediate Zones,MSOAIZ,LE,12799,6495,6304,2526,2429
E02002854,Leicester 028,Middle Super Output Areas and Intermediate Zones,MSOAIZ,LE,8224,3934,4290,1667,1779
E02002855,Leicester 029,Middle Super Output Areas and Intermediate Zones,MSOAIZ,LE,6583,3384,3199,1794,1482
E02002856,Leicester 030,Middle Super Output Areas and Intermediate Zones,MSOAIZ,LE,11621,5764,5857,2538,2297
E02002857,Leicester 031,Middle Super Output Areas and Intermediate Zones,MSOAIZ,LE,6230,3084,3146,1568,1527
E02002858,Leicester 032,Middle Super Output Areas and Intermediate Zones,MSOAIZ,LE,7464,3575,3889,1481,1576
E02002860,Leicester 034,Middle Super Output Areas and Intermediate Zones,MSOAIZ,LE,7944,3937,4007,1628,1631
E02002861,Leicester 035,Middle Super Output Areas and Intermediate Zones,MSOAIZ,LE,7752,3646,4106,1312,1674
E02002862,Leicester 036,Middle Super Output Areas and Intermediate Zones,MSOAIZ,LE,8317,3901,4416,1518,1730
E02002863,Rutland 001,Middle Super Output Areas and Intermediate Zones,MSOAIZ,PE,7812,4458,3354,2159,1310
E02002864,Rutland 002,Middle Super Output Areas and Intermediate Zones,MSOAIZ,LE,5851,2843,3008,1042,1080
E02002865,Rutland 003,Middle Super Output Areas and Intermediate Zones,MSOAIZ,LE,7902,3788,4114,1360,1406
E02002866,Rutland 004,Middle Super Output Areas and Intermediate Zones,MSOAIZ,PE,7384,3657,3727,1262,1382
E02002867,Rutland 005,Middle Super Output Areas and Intermediate Zones,MSOAIZ,LE,8420,4169,4251,1319,1432
E02002868,Nottingham 001,Middle Super Output Areas and Intermediate Zones,MSOAIZ,NG,5773,2778,2995,1044,1126
E02002869,Nottingham 002,Middle Super Output Areas and Intermediate Zones,MSOAIZ,NG,7425,3443,3982,1353,1555
E02002871,Nottingham 004,Middle Super Output Areas and Intermediate Zones,MSOAIZ,NG,7841,3841,4000,1595,1703
E02002872,Nottingham 005,Middle Super Output Areas and Intermediate Zones,MSOAIZ,NG,8732,4226,4506,1709,1865
E02002873,Nottingham 006,Middle Super Output Areas and Intermediate Zones,MSOAIZ,NG,9042,4364,4678,1996,2022
E02002874,Nottingham 007,Middle Super Output Areas and Intermediate Zones,MSOAIZ,NG,7958,4010,3948,1832,1736
E02002875,Nottingham 008,Middle Super Output Areas and Intermediate Zones,MSOAIZ,NG,8250,3968,4282,1728,1939
E02002876,Nottingham 009,Middle Super Output Areas and Intermediate Zones,MSOAIZ,NG,7957,3903,4054,1714,1761
E02002877,Nottingham 010,Middle Super Output Areas and Intermediate Zones,MSOAIZ,NG,7527,3795,3732,1943,1793
E02002878,Nottingham 011,Middle Super Output Areas and Intermediate Zones,MSOAIZ,NG,8983,4165,4818,1501,2007
E02002879,Nottingham 012,Middle Super Output Areas and Intermediate Zones,MSOAIZ,NG,9107,4542,4565,2300,2225
E02002880,Nottingham 013,Middle Super Output Areas and Intermediate Zones,MSOAIZ,NG,8639,4110,4529,1530,1951
E02002881,Nottingham 014,Middle Super Output Areas and Intermediate Zones,MSOAIZ,NG,6175,2923,3252,1146,1361
E02002882,Nottingham 015,Middle Super Output Areas and Intermediate Zones,MSOAIZ,NG,8201,4224,3977,2210,1745
E02002883,Nottingham 016,Middle Super Output Areas and Intermediate Zones,MSOAIZ,NG,7574,3806,3768,1903,1813
E02002884,Nottingham 017,Middle Super Output Areas and Intermediate Zones,MSOAIZ,NG,6131,3306,2825,1682,1255
E02002885,Nottingham 018,Middle Super Output Areas and Intermediate Zones,MSOAIZ,NG,8149,4285,3864,2042,1594
E02002886,Nottingham 019,Middle Super Output Areas and Intermediate Zones,MSOAIZ,NG,8785,4397,4388,1807,1729
E02002887,Nottingham 020,Middle Super Output Areas and Intermediate Zones,MSOAIZ,NG,6463,3058,3405,1123,1184
E02002888,Nottingham 021,Middle Super Output Areas and Intermediate Zones,MSOAIZ,NG,6554,3257,3297,1496,1447
E02002889,Nottingham 022,Middle Super Output Areas and Intermediate Zones,MSOAIZ,NG,8585,4526,4059,1531,866
E02002890,Nottingham 023,Middle Super Output Areas and Intermediate Zones,MSOAIZ,NG,11170,5880,5290,2145,1508
E02002891,Nottingham 024,Middle Super Output Areas and Intermediate Zones,MSOAIZ,NG,8332,4116,4216,1696,1761
E02002892,Nottingham 025,Middle Super Output Areas and Intermediate Zones,MSOAIZ,NG,6071,2903,3168,1094,1215
E02002893,Nottingham 026,Middle Super Output Areas and Intermediate Zones,MSOAIZ,NG,13419,7122,6297,2491,1742
E02002894,Nottingham 027,Middle Super Output Areas and Intermediate Zones,MSOAIZ,NG,6845,3420,3425,1411,1415
E02002895,Nottingham 028,Middle Super Output Areas and Intermediate Zones,MSOAIZ,NG,7995,4429,3566,1710,1048
E02002896,Nottingham 029,Middle Super Output Areas and Intermediate Zones,MSOAIZ,NG,10014,5347,4667,2779,2203
E02002897,Nottingham 030,Middle Super Output Areas and Intermediate Zones,MSOAIZ,NG,7896,3847,4049,1464,1449
E02002898,Nottingham 031,Middle Super Output Areas and Intermediate Zones,MSOAIZ,NG,10920,6022,4898,1713,1022
E02002899,Nottingham 032,Middle Super Output Areas and Intermediate Zones,MSOAIZ,NG,9952,4995,4957,1108,1083
E02002901,Nottingham 034,Middle Super Output Areas and Intermediate Zones,MSOAIZ,NG,5735,2834,2901,1180,1162
E02002902,Nottingham 035,Middle Super Output Areas and Intermediate Zones,MSOAIZ,NG,8620,4194,4426,1509,1541
E02002903,Nottingham 036,Middle Super Output Areas and Intermediate Zones,MSOAIZ,NG,6343,3060,3283,1150,1244
E02002904,Nottingham 037,Middle Super Output Areas and Intermediate Zones,MSOAIZ,NG,6137,2986,3151,1199,1200
E02002905,Herefordshire 001,Middle Super Output Areas and Intermediate Zones,MSOAIZ,WR,6043,2986,3057,980,1059
E02002906,Herefordshire 002,Middle Super Output Areas and Intermediate Zones,MSOAIZ,HR,5775,2792,2983,1044,1074
E02002907,Herefordshire 003,Middle Super Output Areas and Intermediate Zones,MSOAIZ,HR,5916,2903,3013,1136,1089
E02002908,Herefordshire 004,Middle Super Output Areas and Intermediate Zones,MSOAIZ,WR,8557,4235,4322,1411,1430
E02002909,Herefordshire 005,Middle Super Output Areas and Intermediate Zones,MSOAIZ,WR,10349,5115,5234,1800,1856
E02002910,Herefordshire 006,Middle Super Output Areas and Intermediate Zones,MSOAIZ,LD,7875,3851,4024,1350,1331
E02002911,Herefordshire 007,Middle Super Output Areas and Intermediate Zones,MSOAIZ,HR,9323,4593,4730,1717,1698
E02002912,Herefordshire 008,Middle Super Output Areas and Intermediate Zones,MSOAIZ,HR,7144,3598,3546,1402,1425
E02002913,Herefordshire 009,Middle Super Output Areas and Intermediate Zones,MSOAIZ,WR,5600,2716,2884,882,927
E02002914,Herefordshire 010,Middle Super Output Areas and Intermediate Zones,MSOAIZ,HR,8929,4432,4497,1939,1897
E02002915,Herefordshire 011,Middle Super Output Areas and Intermediate Zones,MSOAIZ,HR,6715,3224,3491,1242,1192
E02002916,Herefordshire 012,Middle Super Output Areas and Intermediate Zones,MSOAIZ,HR,9663,4905,4758,2318,2030
E02002917,Herefordshire 013,Middle Super Output Areas and Intermediate Zones,MSOAIZ,HR,6900,3438,3462,1532,1437
E02002918,Herefordshire 014,Middle Super Output Areas and Intermediate Zones,MSOAIZ,HR,5963,2852,3111,998,1087
E02002919,Herefordshire 015,Middle Super Output Areas and Intermediate Zones,MSOAIZ,HR,9312,4621,4691,2044,1966
E02002920,Herefordshire 016,Middle Super Output Areas and Intermediate Zones,MSOAIZ,HR,6524,3259,3265,1393,1338
E02002921,Herefordshire 017,Middle Super Output Areas and Intermediate Zones,MSOAIZ,HR,7757,3743,4014,1536,1610
E02002922,Herefordshire 018,Middle Super Output Areas and Intermediate Zones,MSOAIZ,HR,6247,3098,3149,1119,1133
E02002923,Herefordshire 019,Middle Super Output Areas and Intermediate Zones,MSOAIZ,WR,9636,4644,4992,1808,1792
E02002924,Herefordshire 020,Middle Super Output Areas and Intermediate Zones,MSOAIZ,NP,6073,3011,3062,1012,1051
E02002925,Herefordshire 021,Middle Super Output Areas and Intermediate Zones,MSOAIZ,HR,10952,5459,5493,2074,2131
E02002926,Herefordshire 022,Middle Super Output Areas and Intermediate Zones,MSOAIZ,HR,10582,5068,5514,1918,1937
E02002927,Herefordshire 023,Middle Super Output Areas and Intermediate Zones,MSOAIZ,NP,11642,5759,5883,1977,2105
E02002928,Telford and Wrekin 001,Middle Super Output Areas and Intermediate Zones,MSOAIZ,TF,6003,2990,3013,1056,1091
E02002929,Telford and Wrekin 002,Middle Super Output Areas and Intermediate Zones,MSOAIZ,TF,6230,3125,3105,971,998
E02002930,Telford and Wrekin 003,Middle Super Output Areas and Intermediate Zones,MSOAIZ,TF,5533,2748,2785,1018,944
E02002931,Telford and Wrekin 004,Middle Super Output Areas and Intermediate Zones,MSOAIZ,TF,6370,3128,3242,1272,1362
E02002932,Telford and Wrekin 005,Middle Super Output Areas and Intermediate Zones,MSOAIZ,TF,8620,4264,4356,1907,1821
E02002933,Telford and Wrekin 006,Middle Super Output Areas and Intermediate Zones,MSOAIZ,TF,8207,4044,4163,1673,1673
E02002934,Telford and Wrekin 007,Middle Super Output Areas and Intermediate Zones,MSOAIZ,TF,6007,2927,3080,1258,1313
E02002935,Telford and Wrekin 008,Middle Super Output Areas and Intermediate Zones,MSOAIZ,TF,6679,3283,3396,1332,1296
E02002936,Telford and Wrekin 009,Middle Super Output Areas and Intermediate Zones,MSOAIZ,TF,8616,4234,4382,1932,1869
E02002937,Telford and Wrekin 010,Middle Super Output Areas and Intermediate Zones,MSOAIZ,TF,10133,5131,5002,2105,2090
E02002938,Telford and Wrekin 011,Middle Super Output Areas and Intermediate Zones,MSOAIZ,TF,6726,3378,3348,1410,1313
E02002939,Telford and Wrekin 012,Middle Super Output Areas and Intermediate Zones,MSOAIZ,TF,6419,3121,3298,1256,1240
E02002940,Telford and Wrekin 013,Middle Super Output Areas and Intermediate Zones,MSOAIZ,TF,6084,2988,3096,1358,1262
E02002941,Telford and Wrekin 014,Middle Super Output Areas and Intermediate Zones,MSOAIZ,TF,9545,4745,4800,2076,1987
E02002942,Telford and Wrekin 015,Middle Super Output Areas and Intermediate Zones,MSOAIZ,TF,6325,3181,3144,1332,1385
E02002943,Telford and Wrekin 016,Middle Super Output Areas and Intermediate Zones,MSOAIZ,TF,9519,4739,4780,2269,2262
E02002944,Telford and Wrekin 017,Middle Super Output Areas and Intermediate Zones,MSOAIZ,TF,7790,3877,3913,1575,1552
E02002945,Telford and Wrekin 018,Middle Super Output Areas and Intermediate Zones,MSOAIZ,WV,9381,4699,4682,2095,1993
E02002946,Telford and Wrekin 019,Middle Super Output Areas and Intermediate Zones,MSOAIZ,TF,7900,3912,3988,1750,1711
E02002947,Telford and Wrekin 020,Middle Super Output Areas and Intermediate Zones,MSOAIZ,TF,6923,3452,3471,1416,1418
E02002948,Telford and Wrekin 021,Middle Super Output Areas and Intermediate Zones,MSOAIZ,TF,6898,3282,3616,1246,1420
E02002949,Telford and Wrekin 022,Middle Super Output Areas and Intermediate Zones,MSOAIZ,TF,5329,2639,2690,1092,988
E02002950,Telford and Wrekin 023,Middle Super Output Areas and Intermediate Zones,MSOAIZ,TF,5404,2662,2742,1027,958
E02002951,Stoke-on-Trent 001,Middle Super Output Areas and Intermediate Zones,MSOAIZ,ST,7714,3785,3929,1549,1589
E02002952,Stoke-on-Trent 002,Middle Super Output Areas and Intermediate Zones,MSOAIZ,ST,6829,3302,3527,1368,1450
E02002953,Stoke-on-Trent 003,Middle Super Output Areas and Intermediate Zones,MSOAIZ,ST,7350,3501,3849,1298,1416
E02002954,Stoke-on-Trent 004,Middle Super Output Areas and Intermediate Zones,MSOAIZ,ST,8258,4025,4233,1607,1586
E02002955,Stoke-on-Trent 005,Middle Super Output Areas and Intermediate Zones,MSOAIZ,ST,7046,3449,3597,1502,1461
E02002956,Stoke-on-Trent 006,Middle Super Output Areas and Intermediate Zones,MSOAIZ,ST,9277,4579,4698,1850,1904
E02002957,Stoke-on-Trent 007,Middle Super Output Areas and Intermediate Zones,MSOAIZ,ST,9750,4787,4963,1971,1961
E02002958,Stoke-on-Trent 008,Middle Super Output Areas and Intermediate Zones,MSOAIZ,ST,7977,3875,4102,1594,1606
E02002959,Stoke-on-Trent 009,Middle Super Output Areas and Intermediate Zones,MSOAIZ,ST,8436,4330,4106,1913,1665
E02002960,Stoke-on-Trent 010,Middle Super Output Areas and Intermediate Zones,MSOAIZ,ST,5900,2976,2924,1215,1211
E02002961,Stoke-on-Trent 011,Middle Super Output Areas and Intermediate Zones,MSOAIZ,ST,6480,3312,3168,1544,1297
E02002962,Stoke-on-Trent 012,Middle Super Output Areas and Intermediate Zones,MSOAIZ,ST,6958,3350,3608,1271,1387
E02002963,Stoke-on-Trent 013,Middle Super Output Areas and Intermediate Zones,MSOAIZ,ST,7294,3715,3579,1757,1563
E02002964,Stoke-on-Trent 014,Middle Super Output Areas and Intermediate Zones,MSOAIZ,ST,8520,4126,4394,1564,1618
E02002965,Stoke-on-Trent 015,Middle Super Output Areas and Intermediate Zones,MSOAIZ,ST,7126,3926,3200,1744,1262
E02002966,Stoke-on-Trent 016,Middle Super Output Areas and Intermediate Zones,MSOAIZ,ST,9079,5147,3932,2023,1188
E02002967,Stoke-on-Trent 017,Middle Super Output Areas and Intermediate Zones,MSOAIZ,ST,9747,4697,5050,1879,1998
E02002968,Stoke-on-Trent 018,Middle Super Output Areas and Intermediate Zones,MSOAIZ,ST,9030,4471,4559,2024,1945
E02002969,Stoke-on-Trent 019,Middle Super Output Areas and Intermediate Zones,MSOAIZ,ST,8653,4456,4197,2090,1755
E02002970,Stoke-on-Trent 020,Middle Super Output Areas and Intermediate Zones,MSOAIZ,ST,8123,3978,4145,1774,1732
E02002971,Stoke-on-Trent 021,Middle Super Output Areas and Intermediate Zones,MSOAIZ,ST,5252,2635,2617,1137,1102
E02002972,Stoke-on-Trent 022,Middle Super Output Areas and Intermediate Zones,MSOAIZ,ST,6265,3078,3187,1270,1238
E02002973,Stoke-on-Trent 023,Middle Super Output Areas and Intermediate Zones,MSOAIZ,ST,8045,4064,3981,1726,1673
E02002974,Stoke-on-Trent 024,Middle Super Output Areas and Intermediate Zones,MSOAIZ,ST,5622,2763,2859,953,1027
E02002975,Stoke-on-Trent 025,Middle Super Output Areas and Intermediate Zones,MSOAIZ,ST,7658,3826,3832,1708,1665
E02002976,Stoke-on-Trent 026,Middle Super Output Areas and Intermediate Zones,MSOAIZ,ST,6008,2908,3100,1090,1211
E02002977,Stoke-on-Trent 027,Middle Super Output Areas and Intermediate Zones,MSOAIZ,ST,5884,2832,3052,998,1005
E02002978,Stoke-on-Trent 028,Middle Super Output Areas and Intermediate Zones,MSOAIZ,ST,6381,3182,3199,1279,1177
E02002979,Stoke-on-Trent 029,Middle Super Output Areas and Intermediate Zones,MSOAIZ,ST,5622,2810,2812,1120,1100
E02002980,Stoke-on-Trent 030,Middle Super Output Areas and Intermediate Zones,MSOAIZ,ST,6082,2957,3125,1064,1121
E02002981,Stoke-on-Trent 031,Middle Super Output Areas and Intermediate Zones,MSOAIZ,ST,8260,4032,4228,1678,1772
E02002982,Stoke-on-Trent 032,Middle Super Output Areas and Intermediate Zones,MSOAIZ,ST,7048,3504,3544,1503,1391
E02002983,Stoke-on-Trent 033,Middle Super Output Areas and Intermediate Zones,MSOAIZ,ST,5580,2785,2795,1134,1169
E02002984,Stoke-on-Trent 034,Middle Super Output Areas and Intermediate Zones,MSOAIZ,ST,5754,2832,2922,1163,1190
E02002985,Bath and North East Somerset 001,Middle Super Output Areas and Intermediate Zones,MSOAIZ,BS,5213,2506,2707,983,1023
E02002986,Bath and North East Somerset 002,Middle Super Output Areas and Intermediate Zones,MSOAIZ,BS,5024,2322,2702,876,932
E02002987,Bath and North East Somerset 003,Middle Super Output Areas and Intermediate Zones,MSOAIZ,BS,5404,2645,2759,878,927
E02002988,Bath and North East Somerset 004,Middle Super Output Areas and Intermediate Zones,MSOAIZ,BA,5469,2628,2841,1084,1166
E02002989,Bath and North East Somerset 005,Middle Super Output Areas and Intermediate Zones,MSOAIZ,BA,5324,2541,2783,988,1022
E02002990,Bath and North East Somerset 006,Middle Super Output Areas and Intermediate Zones,MSOAIZ,BA,5920,3023,2897,1466,1346
E02002991,Bath and North East Somerset 007,Middle Super Output Areas and Intermediate Zones,MSOAIZ,BA,10259,5111,5148,2482,2033
E02002992,Bath and North East Somerset 008,Middle Super Output Areas and Intermediate Zones,MSOAIZ,BA,5938,2796,3142,1159,1216
E02002993,Bath and North East Somerset 009,Middle Super Output Areas and Intermediate Zones,MSOAIZ,BA,5516,2772,2744,1305,1118
E02002994,Bath and North East Somerset 010,Middle Super Output Areas and Intermediate Zones,MSOAIZ,BA,10199,4956,5243,1729,1902
E02002995,Bath and North East Somerset 011,Middle Super Output Areas and Intermediate Zones,MSOAIZ,BA,5315,2574,2741,1088,1121
E02002996,Bath and North East Somerset 012,Middle Super Output Areas and Intermediate Zones,MSOAIZ,BA,10633,5278,5355,1516,1460
E02002997,Bath and North East Somerset 013,Middle Super Output Areas and Intermediate Zones,MSOAIZ,BA,6469,3131,3338,990,917
E02002998,Bath and North East Somerset 014,Middle Super Output Areas and Intermediate Zones,MSOAIZ,BA,5882,2924,2958,979,942
E02002999,Bath and North East Somerset 015,Middle Super Output Areas and Intermediate Zones,MSOAIZ,BA,5529,2699,2830,1052,1071
E02003000,Bath and North East Somerset 016,Middle Super Output Areas and Intermediate Zones,MSOAIZ,BS,9202,4524,4678,1538,1600
E02003001,Bath and North East Somerset 017,Middle Super Output Areas and Intermediate Zones,MSOAIZ,BA,5505,2703,2802,992,1043
E02003002,Bath and North East Somerset 018,Middle Super Output Areas and Intermediate Zones,MSOAIZ,BA,5419,2582,2837,899,1035
E02003003,Bath and North East Somerset 019,Middle Super Output Areas and Intermediate Zones,MSOAIZ,BA,5681,2773,2908,1139,1243
E02003004,Bath and North East Somerset 020,Middle Super Output Areas and Intermediate Zones,MSOAIZ,BS,6302,3084,3218,1171,1195
E02003005,Bath and North East Somerset 021,Middle Super Output Areas and Intermediate Zones,MSOAIZ,BS,6154,3006,3148,1055,1132
E02003006,Bath and North East Somerset 022,Middle Super Output Areas and Intermediate Zones,MSOAIZ,BA,8881,4351,4530,1717,1803
E02003007,Bath and North East Somerset 023,Middle Super Output Areas and Intermediate Zones,MSOAIZ,BS,8307,4073,4234,1574,1591
E02003008,Bath and North East Somerset 024,Middle Super Output Areas and Intermediate Zones,MSOAIZ,BA,5620,2760,2860,1127,1186
E02003009,Bath and North East Somerset 025,Middle Super Output Areas and Intermediate Zones,MSOAIZ,BS,5875,2886,2989,1219,1206
E02003010,Bath and North East Somerset 026,Middle Super Output Areas and Intermediate Zones,MSOAIZ,BA,5854,2895,2959,1187,1225
E02003011,Bath and North East Somerset 027,Middle Super Output Areas and Intermediate Zones,MSOAIZ,BA,5122,2529,2593,921,911
E02003012,Bristol 001,Middle Super Output Areas and Intermediate Zones,MSOAIZ,BS,10699,5035,5664,2064,2248
E02003013,Bristol 002,Middle Super Output Areas and Intermediate Zones,MSOAIZ,BS,11956,5777,6179,2341,2432
E02003014,Bristol 003,Middle Super Output Areas and Intermediate Zones,MSOAIZ,BS,7755,3724,4031,1450,1529
E02003015,Bristol 004,Middle Super Output Areas and Intermediate Zones,MSOAIZ,BS,5801,2823,2978,1178,1189
E02003016,Bristol 005,Middle Super Output Areas and Intermediate Zones,MSOAIZ,BS,7529,3796,3733,1705,1631
E02003017,Bristol 006,Middle Super Output Areas and Intermediate Zones,MSOAIZ,BS,6042,2854,3188,1205,1207
E02003018,Bristol 007,Middle Super Output Areas and Intermediate Zones,MSOAIZ,BS,5728,2769,2959,1024,1166
E02003019,Bristol 008,Middle Super Output Areas and Intermediate Zones,MSOAIZ,BS,9339,4550,4789,1894,2004
E02003020,Bristol 009,Middle Super Output Areas and Intermediate Zones,MSOAIZ,BS,6233,2870,3363,1007,1109
E02003021,Bristol 010,Middle Super Output Areas and Intermediate Zones,MSOAIZ,BS,6771,3518,3253,1600,1503
E02003022,Bristol 011,Middle Super Output Areas and Intermediate Zones,MSOAIZ,BS,5867,2807,3060,1051,1142
E02003023,Bristol 012,Middle Super Output Areas and Intermediate Zones,MSOAIZ,BS,5971,2909,3062,1101,1143
E02003024,Bristol 013,Middle Super Output Areas and Intermediate Zones,MSOAIZ,BS,8759,4223,4536,1648,1587
E02003025,Bristol 014,Middle Super Output Areas and Intermediate Zones,MSOAIZ,BS,6766,3408,3358,1326,1345
E02003026,Bristol 015,Middle Super Output Areas and Intermediate Zones,MSOAIZ,BS,9269,4521,4748,1348,1393
E02003027,Bristol 016,Middle Super Output Areas and Intermediate Zones,MSOAIZ,BS,11911,6032,5879,3112,2804
E02003028,Bristol 017,Middle Super Output Areas and Intermediate Zones,MSOAIZ,BS,8524,4308,4216,1995,1831
E02003029,Bristol 018,Middle Super Output Areas and Intermediate Zones,MSOAIZ,BS,6222,2981,3241,1194,1340
E02003030,Bristol 019,Middle Super Output Areas and Intermediate Zones,MSOAIZ,BS,7176,3624,3552,1736,1588
E02003031,Bristol 020,Middle Super Output Areas and Intermediate Zones,MSOAIZ,BS,10253,5297,4956,2518,2276
E02003032,Bristol 021,Middle Super Output Areas and Intermediate Zones,MSOAIZ,BS,7282,3592,3690,1569,1569
E02003033,Bristol 022,Middle Super Output Areas and Intermediate Zones,MSOAIZ,BS,8999,4663,4336,1985,1707
E02003034,Bristol 023,Middle Super Output Areas and Intermediate Zones,MSOAIZ,BS,12263,6343,5920,3465,3059
E02003036,Bristol 025,Middle Super Output Areas and Intermediate Zones,MSOAIZ,BS,8557,4536,4021,2204,1677
E02003037,Bristol 026,Middle Super Output Areas and Intermediate Zones,MSOAIZ,BS,8734,4523,4211,2372,1921
E02003038,Bristol 027,Middle Super Output Areas and Intermediate Zones,MSOAIZ,BS,6359,3132,3227,1463,1423
E02003039,Bristol 028,Middle Super Output Areas and Intermediate Zones,MSOAIZ,BS,8045,3903,4142,1722,1783
E02003040,Bristol 029,Middle Super Output Areas and Intermediate Zones,MSOAIZ,BS,9125,4635,4490,2620,2332
E02003041,Bristol 030,Middle Super Output Areas and Intermediate Zones,MSOAIZ,BS,6194,3248,2946,1615,1335
E02003043,Bristol 032,Middle Super Output Areas and Intermediate Zones,MSOAIZ,BS,10938,5835,5103,2477,1812
E02003044,Bristol 033,Middle Super Output Areas and Intermediate Zones,MSOAIZ,BS,5798,2871,2927,1305,1294
E02003045,Bristol 034,Middle Super Output Areas and Intermediate Zones,MSOAIZ,BS,6890,3635,3255,1633,1335
E02003046,Bristol 035,Middle Super Output Areas and Intermediate Zones,MSOAIZ,BS,9214,4524,4690,2362,2344
E02003047,Bristol 036,Middle Super Output Areas and Intermediate Zones,MSOAIZ,BS,10037,5080,4957,2750,2527
E02003048,Bristol 037,Middle Super Output Areas and Intermediate Zones,MSOAIZ,BS,6516,3335,3181,1991,1844
E02003049,Bristol 038,Middle Super Output Areas and Intermediate Zones,MSOAIZ,BS,7272,3639,3633,1584,1499
E02003050,Bristol 039,Middle Super Output Areas and Intermediate Zones,MSOAIZ,BS,8452,4344,4108,2421,2072
E02003051,Bristol 040,Middle Super Output Areas and Intermediate Zones,MSOAIZ,BS,6664,3279,3385,1721,1711
E02003052,Bristol 041,Middle Super Output Areas and Intermediate Zones,MSOAIZ,BS,6502,3122,3380,1519,1599
E02003053,Bristol 042,Middle Super Output Areas and Intermediate Zones,MSOAIZ,BS,8066,4018,4048,1839,1733
E02003054,Bristol 043,Middle Super Output Areas and Intermediate Zones,MSOAIZ,BS,6453,3248,3205,1500,1454
E02003055,Bristol 044,Middle Super Output Areas and Intermediate Zones,MSOAIZ,BS,8300,3923,4377,1523,1807
E02003056,Bristol 045,Middle Super Output Areas and Intermediate Zones,MSOAIZ,BS,7216,3429,3787,1294,1530
E02003057,Bristol 046,Middle Super Output Areas and Intermediate Zones,MSOAIZ,BS,5822,2850,2972,1110,1161
E02003058,Bristol 047,Middle Super Output Areas and Intermediate Zones,MSOAIZ,BS,8987,4319,4668,1724,1794
E02003059,Bristol 048,Middle Super Output Areas and Intermediate Zones,MSOAIZ,BS,5638,2696,2942,1028,1092
E02003060,Bristol 049,Middle Super Output Areas and Intermediate Zones,MSOAIZ,BS,10802,5194,5608,1989,2099
E02003061,Bristol 050,Middle Super Output Areas and Intermediate Zones,MSOAIZ,BS,5754,2647,3107,1002,1184
E02003062,Bristol 051,Middle Super Output Areas and Intermediate Zones,MSOAIZ,BS,5836,2808,3028,1077,1141
E02003063,Bristol 052,Middle Super Output Areas and Intermediate Zones,MSOAIZ,BS,7040,3520,3520,1297,1337
E02003064,Bristol 053,Middle Super Output Areas and Intermediate Zones,MSOAIZ,BS,6535,3068,3467,1144,1277
E02003065,North Somerset 001,Middle Super Output Areas and Intermediate Zones,MSOAIZ,BS,8503,4233,4270,1823,1736
E02003066,North Somerset 002,Middle Super Output Areas and Intermediate Zones,MSOAIZ,BS,6014,2938,3076,998,1076
E02003067,North Somerset 003,Middle Super Output Areas and Intermediate Zones,MSOAIZ,BS,7526,3621,3905,1569,1644
E02003068,North Somerset 004,Middle Super Output Areas and Intermediate Zones,MSOAIZ,BS,6180,3085,3095,1117,1137
E02003069,North Somerset 005,Middle Super Output Areas and Intermediate Zones,MSOAIZ,BS,5409,2598,2811,954,919
E02003070,North Somerset 006,Middle Super Output Areas and Intermediate Zones,MSOAIZ,BS,12108,6008,6100,2367,2521
E02003071,North Somerset 007,Middle Super Output Areas and Intermediate Zones,MSOAIZ,BS,7901,3755,4146,1454,1505
E02003072,North Somerset 008,Middle Super Output Areas and Intermediate Zones,MSOAIZ,BS,9045,4346,4699,1505,1613
E02003073,North Somerset 009,Middle Super Output Areas and Intermediate Zones,MSOAIZ,BS,6585,3213,3372,1143,1233
E02003074,North Somerset 010,Middle Super Output Areas and Intermediate Zones,MSOAIZ,BS,7971,3866,4105,1675,1742
E02003075,North Somerset 011,Middle Super Output Areas and Intermediate Zones,MSOAIZ,BS,5788,2816,2972,966,1057
E02003076,North Somerset 012,Middle Super Output Areas and Intermediate Zones,MSOAIZ,BS,9273,4568,4705,1751,1874
E02003077,North Somerset 013,Middle Super Output Areas and Intermediate Zones,MSOAIZ,BS,5975,2901,3074,1055,1129
E02003078,North Somerset 014,Middle Super Output Areas and Intermediate Zones,MSOAIZ,BS,6877,3263,3614,1189,1319
E02003079,North Somerset 015,Middle Super Output Areas and Intermediate Zones,MSOAIZ,BS,9599,4683,4916,1954,2107
E02003080,North Somerset 016,Middle Super Output Areas and Intermediate Zones,MSOAIZ,BS,8589,4046,4543,1320,1530
E02003081,North Somerset 017,Middle Super Output Areas and Intermediate Zones,MSOAIZ,BS,9166,4483,4683,1618,1605
E02003082,North Somerset 018,Middle Super Output Areas and Intermediate Zones,MSOAIZ,BS,8583,4204,4379,1874,1553
E02003084,North Somerset 020,Middle Super Output Areas and Intermediate Zones,MSOAIZ,BS,9506,4746,4760,2123,1797
E02003085,North Somerset 021,Middle Super Output Areas and Intermediate Zones,MSOAIZ,BS,7534,3630,3904,1414,1562
E02003086,North Somerset 022,Middle Super Output Areas and Intermediate Zones,MSOAIZ,BS,6053,2893,3160,1144,1063
E02003087,North Somerset 023,Middle Super Output Areas and Intermediate Zones,MSOAIZ,BS,9169,4434,4735,1492,1636
E02003088,North Somerset 024,Middle Super Output Areas and Intermediate Zones,MSOAIZ,BS,8361,4034,4327,1287,1386
E02003089,North Somerset 025,Middle Super Output Areas and Intermediate Zones,MSOAIZ,BS,5777,2746,3031,876,999
E02003090,South Gloucestershire 001,Middle Super Output Areas and Intermediate Zones,MSOAIZ,GL,6918,3272,3646,1181,1337
E02003091,South Gloucestershire 002,Middle Super Output Areas and Intermediate Zones,MSOAIZ,GL,6573,3288,3285,1220,1221
E02003092,South Gloucestershire 003,Middle Super Output Areas and Intermediate Zones,MSOAIZ,GL,7915,4180,3735,1879,1544
E02003093,South Gloucestershire 004,Middle Super Output Areas and Intermediate Zones,MSOAIZ,GL,6581,3241,3340,1102,1125
E02003094,South Gloucestershire 005,Middle Super Output Areas and Intermediate Zones,MSOAIZ,BS,8352,4159,4193,1654,1689
E02003095,South Gloucestershire 006,Middle Super Output Areas and Intermediate Zones,MSOAIZ,BS,7123,3508,3615,1423,1441
E02003096,South Gloucestershire 007,Middle Super Output Areas and Intermediate Zones,MSOAIZ,BS,6453,3172,3281,1390,1413
E02003097,South Gloucestershire 008,Middle Super Output Areas and Intermediate Zones,MSOAIZ,BS,6220,3015,3205,1110,1104
E02003098,South Gloucestershire 009,Middle Super Output Areas and Intermediate Zones,MSOAIZ,BS,10038,5061,4977,2753,2648
E02003099,South Gloucestershire 010,Middle Super Output Areas and Intermediate Zones,MSOAIZ,BS,6825,3368,3457,1300,1332
E02003100,South Gloucestershire 011,Middle Super Output Areas and Intermediate Zones,MSOAIZ,BS,10511,5239,5272,2204,2161
E02003101,South Gloucestershire 012,Middle Super Output Areas and Intermediate Zones,MSOAIZ,BS,10561,5319,5242,2840,2789
E02003102,South Gloucestershire 013,Middle Super Output Areas and Intermediate Zones,MSOAIZ,BS,6520,3258,3262,1175,1253
E02003103,South Gloucestershire 014,Middle Super Output Areas and Intermediate Zones,MSOAIZ,BS,7216,3584,3632,1675,1582
E02003104,South Gloucestershire 015,Middle Super Output Areas and Intermediate Zones,MSOAIZ,BS,7654,3781,3873,1620,1686
E02003105,South Gloucestershire 016,Middle Super Output Areas and Intermediate Zones,MSOAIZ,BS,6298,3034,3264,1061,1130
E02003106,South Gloucestershire 017,Middle Super Output Areas and Intermediate Zones,MSOAIZ,BS,10507,5450,5057,2128,1921
E02003107,South Gloucestershire 018,Middle Super Output Areas and Intermediate Zones,MSOAIZ,BS,10607,5445,5162,2315,1992
E02003108,South Gloucestershire 019,Middle Super Output Areas and Intermediate Zones,MSOAIZ,BS,9307,4685,4622,1845,1823
E02003109,South Gloucestershire 020,Middle Super Output Areas and Intermediate Zones,MSOAIZ,BS,5985,2929,3056,1102,1114
E02003110,South Gloucestershire 021,Middle Super Output Areas and Intermediate Zones,MSOAIZ,BS,10369,5171,5198,2538,2572
E02003111,South Gloucestershire 022,Middle Super Output Areas and Intermediate Zones,MSOAIZ,BS,6294,3060,3234,1251,1227
E02003112,South Gloucestershire 023,Middle Super Output Areas and Intermediate Zones,MSOAIZ,BS,6381,3150,3231,1156,1261
E02003113,South Gloucestershire 024,Middle Super Output Areas and Intermediate Zones,MSOAIZ,SN,10167,5035,5132,1893,2004
E02003114,South Gloucestershire 025,Middle Super Output Areas and Intermediate Zones,MSOAIZ,BS,6988,3423,3565,1369,1335
E02003115,South Gloucestershire 026,Middle Super Output Areas and Intermediate Zones,MSOAIZ,BS,9159,4499,4660,1958,1940
E02003116,South Gloucestershire 027,Middle Super Output Areas and Intermediate Zones,MSOAIZ,BS,7557,3615,3942,1400,1466
E02003117,South Gloucestershire 028,Middle Super Output Areas and Intermediate Zones,MSOAIZ,BS,8582,4229,4353,1807,1787
E02003118,South Gloucestershire 029,Middle Super Output Areas and Intermediate Zones,MSOAIZ,BS,10199,5046,5153,2293,2386
E02003119,South Gloucestershire 030,Middle Super Output Areas and Intermediate Zones,MSOAIZ,BS,10344,5090,5254,2051,2180
E02003120,South Gloucestershire 031,Middle Super Output Areas and Intermediate Zones,MSOAIZ,BS,8393,4097,4296,1534,1583
E02003121,South Gloucestershire 032,Middle Super Output Areas and Intermediate Zones,MSOAIZ,BS,10170,5021,5149,1929,1958
E02003122,Plymouth 001,Middle Super Output Areas and Intermediate Zones,MSOAIZ,PL,6729,3213,3516,1106,1204
E02003123,Plymouth 002,Middle Super Output Areas and Intermediate Zones,MSOAIZ,PL,8033,3847,4186,1474,1591
E02003124,Plymouth 003,Middle Super Output Areas and Intermediate Zones,MSOAIZ,PL,7807,3794,4013,1545,1646
E02003125,Plymouth 004,Middle Super Output Areas and Intermediate Zones,MSOAIZ,PL,5995,2937,3058,1190,1252
E02003126,Plymouth 005,Middle Super Output Areas and Intermediate Zones,MSOAIZ,PL,7262,3481,3781,1254,1385
E02003127,Plymouth 006,Middle Super Output Areas and Intermediate Zones,MSOAIZ,PL,7570,3632,3938,1406,1544
E02003128,Plymouth 007,Middle Super Output Areas and Intermediate Zones,MSOAIZ,PL,8654,4132,4522,1676,1809
E02003129,Plymouth 008,Middle Super Output Areas and Intermediate Zones,MSOAIZ,PL,6521,3095,3426,1136,1288
E02003130,Plymouth 009,Middle Super Output Areas and Intermediate Zones,MSOAIZ,PL,10224,5023,5201,2013,2141
E02003131,Plymouth 010,Middle Super Output Areas and Intermediate Zones,MSOAIZ,PL,7499,3572,3927,1350,1530
E02003132,Plymouth 011,Middle Super Output Areas and Intermediate Zones,MSOAIZ,PL,7935,3848,4087,1577,1664
E02003133,Plymouth 012,Middle Super Output Areas and Intermediate Zones,MSOAIZ,PL,7347,3553,3794,1316,1498
E02003134,Plymouth 013,Middle Super Output Areas and Intermediate Zones,MSOAIZ,PL,6930,3395,3535,1303,1458
E02003135,Plymouth 014,Middle Super Output Areas and Intermediate Zones,MSOAIZ,PL,7479,3675,3804,1548,1654
E02003136,Plymouth 015,Middle Super Output Areas and Intermediate Zones,MSOAIZ,PL,7905,3718,4187,1316,1419
E02003137,Plymouth 016,Middle Super Output Areas and Intermediate Zones,MSOAIZ,PL,7794,3788,4006,1457,1505
E02003138,Plymouth 017,Middle Super Output Areas and Intermediate Zones,MSOAIZ,PL,7476,3631,3845,1711,1817
E02003139,Plymouth 018,Middle Super Output Areas and Intermediate Zones,MSOAIZ,PL,6506,3224,3282,1479,1543
E02003140,Plymouth 019,Middle Super Output Areas and Intermediate Zones,MSOAIZ,PL,7697,3704,3993,1438,1518
E02003141,Plymouth 020,Middle Super Output Areas and Intermediate Zones,MSOAIZ,PL,8014,4106,3908,2067,1838
E02003142,Plymouth 021,Middle Super Output Areas and Intermediate Zones,MSOAIZ,PL,9084,4403,4681,1870,1960
E02003143,Plymouth 022,Middle Super Output Areas and Intermediate Zones,MSOAIZ,PL,7791,3745,4046,1477,1649
E02003144,Plymouth 023,Middle Super Output Areas and Intermediate Zones,MSOAIZ,PL,9041,4949,4092,1677,1186
E02003145,Plymouth 024,Middle Super Output Areas and Intermediate Zones,MSOAIZ,PL,6976,3523,3453,1503,1397
E02003146,Plymouth 025,Middle Super Output Areas and Intermediate Zones,MSOAIZ,PL,9018,4644,4374,1941,1674
E02003147,Plymouth 026,Middle Super Output Areas and Intermediate Zones,MSOAIZ,PL,7645,3917,3728,1691,1548
E02003148,Plymouth 027,Middle Super Output Areas and Intermediate Zones,MSOAIZ,PL,9886,5244,4642,1817,1380
E02003149,Plymouth 028,Middle Super Output Areas and Intermediate Zones,MSOAIZ,PL,9340,4850,4490,2114,1770
E02003150,Plymouth 029,Middle Super Output Areas and Intermediate Zones,MSOAIZ,PL,11468,6144,5324,2931,2269
E02003151,Plymouth 030,Middle Super Output Areas and Intermediate Zones,MSOAIZ,PL,7449,3511,3938,1129,1269
E02003152,Plymouth 031,Middle Super Output Areas and Intermediate Zones,MSOAIZ,PL,9426,4586,4840,1744,1767
E02003153,Plymouth 032,Middle Super Output Areas and Intermediate Zones,MSOAIZ,PL,7883,3800,4083,1502,1568
E02003154,Torbay 001,Middle Super Output Areas and Intermediate Zones,MSOAIZ,TQ,7178,3413,3765,1171,1359
E02003155,Torbay 002,Middle Super Output Areas and Intermediate Zones,MSOAIZ,TQ,5822,2782,3040,1028,1086
E02003156,Torbay 003,Middle Super Output Areas and Intermediate Zones,MSOAIZ,TQ,9525,4581,4944,1785,2051
E02003157,Torbay 004,Middle Super Output Areas and Intermediate Zones,MSOAIZ,TQ,6223,3109,3114,1265,1282
E02003158,Torbay 005,Middle Super Output Areas and Intermediate Zones,MSOAIZ,TQ,5440,2542,2898,918,939
E02003159,Torbay 006,Middle Super Output Areas and Intermediate Zones,MSOAIZ,TQ,5747,2785,2962,1127,1243
E02003161,Torbay 008,Middle Super Output Areas and Intermediate Zones,MSOAIZ,TQ,6897,3600,3297,1703,1366
E02003163,Torbay 010,Middle Super Output Areas and Intermediate Zones,MSOAIZ,TQ,7777,3826,3951,1352,1255
E02003164,Torbay 011,Middle Super Output Areas and Intermediate Zones,MSOAIZ,TQ,8826,4188,4638,1413,1512
E02003165,Torbay 012,Middle Super Output Areas and Intermediate Zones,MSOAIZ,TQ,7133,3425,3708,1278,1378
E02003166,Torbay 013,Middle Super Output Areas and Intermediate Zones,MSOAIZ,TQ,10477,5096,5381,1817,2140
E02003167,Torbay 014,Middle Super Output Areas and Intermediate Zones,MSOAIZ,TQ,9018,4286,4732,1662,1590
E02003168,Torbay 015,Middle Super Output Areas and Intermediate Zones,MSOAIZ,TQ,6910,3242,3668,1149,1242
E02003169,Torbay 016,Middle Super Output Areas and Intermediate Zones,MSOAIZ,TQ,6657,3181,3476,867,959
E02003170,Torbay 017,Middle Super Output Areas and Intermediate Zones,MSOAIZ,TQ,9331,4444,4887,1377,1494
E02003171,Torbay 018,Middle Super Output Areas and Intermediate Zones,MSOAIZ,TQ,7362,3524,3838,1160,1308
E02003172,Bournemouth 001,Middle Super Output Areas and Intermediate Zones,MSOAIZ,BH,6227,3076,3151,1090,1136
E02003173,Bournemouth 002,Middle Super Output Areas and Intermediate Zones,MSOAIZ,BH,6608,3169,3439,1149,1176
E02003174,Bournemouth 003,Middle Super Output Areas and Intermediate Zones,MSOAIZ,BH,8096,3892,4204,1455,1600
E02003175,Bournemouth 004,Middle Super Output Areas and Intermediate Zones,MSOAIZ,BH,8982,4278,4704,1820,2050
E02003176,Bournemouth 005,Middle Super Output Areas and Intermediate Zones,MSOAIZ,BH,7019,3363,3656,1334,1511
E02003177,Bournemouth 006,Middle Super Output Areas and Intermediate Zones,MSOAIZ,BH,7977,3912,4065,1619,1685
E02003178,Bournemouth 007,Middle Super Output Areas and Intermediate Zones,MSOAIZ,BH,8342,4094,4248,1552,1607
E02003179,Bournemouth 008,Middle Super Output Areas and Intermediate Zones,MSOAIZ,BH,6469,3098,3371,1155,1241
E02003180,Bournemouth 009,Middle Super Output Areas and Intermediate Zones,MSOAIZ,BH,9481,4637,4844,1673,1620
E02003181,Bournemouth 010,Middle Super Output Areas and Intermediate Zones,MSOAIZ,BH,8496,4171,4325,1732,1756
E02003182,Bournemouth 011,Middle Super Output Areas and Intermediate Zones,MSOAIZ,BH,6561,3180,3381,1324,1318
E02003183,Bournemouth 012,Middle Super Output Areas and Intermediate Zones,MSOAIZ,BH,7069,3427,3642,1234,1152
E02003184,Bournemouth 013,Middle Super Output Areas and Intermediate Zones,MSOAIZ,BH,7911,4119,3792,1874,1586
E02003185,Bournemouth 014,Middle Super Output Areas and Intermediate Zones,MSOAIZ,BH,7524,3664,3860,1564,1681
E02003186,Bournemouth 015,Middle Super Output Areas and Intermediate Zones,MSOAIZ,BH,8799,4558,4241,2233,1991
E02003187,Bournemouth 016,Middle Super Output Areas and Intermediate Zones,MSOAIZ,BH,9110,4586,4524,2152,1980
E02003188,Bournemouth 017,Middle Super Output Areas and Intermediate Zones,MSOAIZ,BH,9950,5232,4718,2614,1854
E02003189,Bournemouth 018,Middle Super Output Areas and Intermediate Zones,MSOAIZ,BH,8372,4041,4331,1751,1643
E02003190,Bournemouth 019,Middle Super Output Areas and Intermediate Zones,MSOAIZ,BH,9843,5348,4495,3154,2242
E02003191,Bournemouth 020,Middle Super Output Areas and Intermediate Zones,MSOAIZ,BH,7995,3763,4232,1339,1397
E02003192,Bournemouth 021,Middle Super Output Areas and Intermediate Zones,MSOAIZ,BH,10184,5477,4707,2684,1903
E02003194,Poole 001,Middle Super Output Areas and Intermediate Zones,MSOAIZ,BH,6241,3023,3218,936,979
E02003195,Poole 002,Middle Super Output Areas and Intermediate Zones,MSOAIZ,BH,5612,2760,2852,1097,1202
E02003196,Poole 003,Middle Super Output Areas and Intermediate Zones,MSOAIZ,BH,10303,4919,5384,1618,1765
E02003197,Poole 004,Middle Super Output Areas and Intermediate Zones,MSOAIZ,BH,6815,3324,3491,1367,1474
E02003198,Poole 005,Middle Super Output Areas and Intermediate Zones,MSOAIZ,BH,7264,3527,3737,1467,1598
E02003199,Poole 006,Middle Super Output Areas and Intermediate Zones,MSOAIZ,BH,9180,4433,4747,1834,1898
E02003200,Poole 007,Middle Super Output Areas and Intermediate Zones,MSOAIZ,BH,9962,4883,5079,1845,1931
E02003201,Poole 008,Middle Super Output Areas and Intermediate Zones,MSOAIZ,BH,10573,5252,5321,2202,2246
E02003202,Poole 009,Middle Super Output Areas and Intermediate Zones,MSOAIZ,BH,6206,3089,3117,1319,1186
E02003203,Poole 010,Middle Super Output Areas and Intermediate Zones,MSOAIZ,BH,7415,3672,3743,1709,1675
E02003204,Poole 011,Middle Super Output Areas and Intermediate Zones,MSOAIZ,BH,8690,4135,4555,1673,1743
E02003205,Poole 012,Middle Super Output Areas and Intermediate Zones,MSOAIZ,BH,8238,4042,4196,1591,1594
E02003206,Poole 013,Middle Super Output Areas and Intermediate Zones,MSOAIZ,BH,9596,4777,4819,2184,2037
E02003207,Poole 014,Middle Super Output Areas and Intermediate Zones,MSOAIZ,BH,7099,3533,3566,1491,1455
E02003208,Poole 015,Middle Super Output Areas and Intermediate Zones,MSOAIZ,BH,10683,5123,5560,2317,2179
E02003209,Poole 016,Middle Super Output Areas and Intermediate Zones,MSOAIZ,BH,6042,2987,3055,1207,1213
E02003210,Poole 017,Middle Super Output Areas and Intermediate Zones,MSOAIZ,BH,9106,4450,4656,1774,1694
E02003211,Poole 018,Middle Super Output Areas and Intermediate Zones,MSOAIZ,BH,8620,4192,4428,1420,1211
E02003212,Swindon 001,Middle Super Output Areas and Intermediate Zones,MSOAIZ,SN,8259,4005,4254,1505,1589
E02003214,Swindon 003,Middle Super Output Areas and Intermediate Zones,MSOAIZ,SN,6328,3033,3295,1164,1266
E02003215,Swindon 004,Middle Super Output Areas and Intermediate Zones,MSOAIZ,SN,6993,3432,3561,1433,1412
E02003216,Swindon 005,Middle Super Output Areas and Intermediate Zones,MSOAIZ,SN,9095,4456,4639,1759,1842
E02003217,Swindon 006,Middle Super Output Areas and Intermediate Zones,MSOAIZ,SN,6515,3229,3286,1353,1289
E02003218,Swindon 007,Middle Super Output Areas and Intermediate Zones,MSOAIZ,SN,6575,3187,3388,1243,1371
E02003219,Swindon 008,Middle Super Output Areas and Intermediate Zones,MSOAIZ,SN,6686,3324,3362,1255,1327
E02003220,Swindon 009,Middle Super Output Areas and Intermediate Zones,MSOAIZ,SN,10274,5037,5237,2122,2060
E02003221,Swindon 010,Middle Super Output Areas and Intermediate Zones,MSOAIZ,SN,6450,3289,3161,1600,1396
E02003222,Swindon 011,Middle Super Output Areas and Intermediate Zones,MSOAIZ,SN,6306,3127,3179,1561,1661
E02003223,Swindon 012,Middle Super Output Areas and Intermediate Zones,MSOAIZ,SN,9672,4994,4678,2585,2231
E02003224,Swindon 013,Middle Super Output Areas and Intermediate Zones,MSOAIZ,SN,8742,4328,4414,1755,1763
E02003225,Swindon 014,Middle Super Output Areas and Intermediate Zones,MSOAIZ,SN,5956,3007,2949,1501,1426
E02003226,Swindon 015,Middle Super Output Areas and Intermediate Zones,MSOAIZ,SN,8352,4622,3730,2520,1805
E02003227,Swindon 016,Middle Super Output Areas and Intermediate Zones,MSOAIZ,SN,6339,3127,3212,1311,1325
E02003228,Swindon 017,Middle Super Output Areas and Intermediate Zones,MSOAIZ,SN,6590,3297,3293,1496,1383
E02003229,Swindon 018,Middle Super Output Areas and Intermediate Zones,MSOAIZ,SN,5661,2792,2869,1384,1468
E02003230,Swindon 019,Middle Super Output Areas and Intermediate Zones,MSOAIZ,SN,7273,3966,3307,2411,1718
E02003231,Swindon 020,Middle Super Output Areas and Intermediate Zones,MSOAIZ,SN,8514,4119,4395,1615,1805
E02003232,Swindon 021,Middle Super Output Areas and Intermediate Zones,MSOAIZ,SN,8145,4239,3906,2155,1854
E02003233,Swindon 022,Middle Super Output Areas and Intermediate Zones,MSOAIZ,SN,8859,4439,4420,1884,1891
E02003234,Swindon 023,Middle Super Output Areas and Intermediate Zones,MSOAIZ,SN,8684,4279,4405,1743,1767
E02003235,Swindon 024,Middle Super Output Areas and Intermediate Zones,MSOAIZ,SN,7302,3579,3723,1491,1393
E02003236,Swindon 025,Middle Super Output Areas and Intermediate Zones,MSOAIZ,SN,10512,5096,5416,1916,2027
E02003237,Peterborough 001,Middle Super Output Areas and Intermediate Zones,MSOAIZ,PE,6216,3055,3161,1133,1249
E02003238,Peterborough 002,Middle Super Output Areas and Intermediate Zones,MSOAIZ,PE,5927,2890,3037,1324,1448
E02003239,Peterborough 003,Middle Super Output Areas and Intermediate Zones,MSOAIZ,PE,7898,3941,3957,1603,1665
E02003240,Peterborough 004,Middle Super Output Areas and Intermediate Zones,MSOAIZ,PE,6629,3461,3168,1533,1410
E02003241,Peterborough 005,Middle Super Output Areas and Intermediate Zones,MSOAIZ,PE,6138,2957,3181,1179,1318
E02003242,Peterborough 006,Middle Super Output Areas and Intermediate Zones,MSOAIZ,PE,7925,3832,4093,1501,1507
E02003243,Peterborough 007,Middle Super Output Areas and Intermediate Zones,MSOAIZ,PE,9741,4746,4995,1986,2137
E02003244,Peterborough 008,Middle Super Output Areas and Intermediate Zones,MSOAIZ,PE,8826,4278,4548,1768,1775
E02003245,Peterborough 009,Middle Super Output Areas and Intermediate Zones,MSOAIZ,PE,7658,3739,3919,1590,1667
E02003246,Peterborough 010,Middle Super Output Areas and Intermediate Zones,MSOAIZ,PE,9097,4695,4402,2195,1964
E02003247,Peterborough 011,Middle Super Output Areas and Intermediate Zones,MSOAIZ,PE,7862,3842,4020,1598,1655
E02003248,Peterborough 012,Middle Super Output Areas and Intermediate Zones,MSOAIZ,PE,10337,5132,5205,2157,2079
E02003249,Peterborough 013,Middle Super Output Areas and Intermediate Zones,MSOAIZ,PE,10563,5264,5299,2342,2265
E02003250,Peterborough 014,Middle Super Output Areas and Intermediate Zones,MSOAIZ,PE,10022,5245,4777,2627,2078
E02003251,Peterborough 015,Middle Super Output Areas and Intermediate Zones,MSOAIZ,PE,7118,3474,3644,1163,1234
E02003252,Peterborough 016,Middle Super Output Areas and Intermediate Zones,MSOAIZ,PE,10250,5124,5126,2595,2427
E02003253,Peterborough 017,Middle Super Output Areas and Intermediate Zones,MSOAIZ,PE,8392,4124,4268,2023,1987
E02003254,Peterborough 018,Middle Super Output Areas and Intermediate Zones,MSOAIZ,PE,8646,4207,4439,1702,1827
E02003255,Peterborough 019,Middle Super Output Areas and Intermediate Zones,MSOAIZ,PE,8807,4343,4464,1798,1825
E02003257,Peterborough 021,Middle Super Output Areas and Intermediate Zones,MSOAIZ,PE,8626,4166,4460,1768,1900
E02003258,Luton 001,Middle Super Output Areas and Intermediate Zones,MSOAIZ,LU,8486,4208,4278,1777,1876
E02003259,Luton 002,Middle Super Output Areas and Intermediate Zones,MSOAIZ,LU,6431,3221,3210,1306,1343
E02003260,Luton 003,Middle Super Output Areas and Intermediate Zones,MSOAIZ,LU,8392,3994,4398,1610,1928
E02003261,Luton 004,Middle Super Output Areas and Intermediate Zones,MSOAIZ,LU,6039,2884,3155,1124,1171
E02003262,Luton 005,Middle Super Output Areas and Intermediate Zones,MSOAIZ,LU,9812,4686,5126,1927,2136
E02003263,Luton 006,Middle Super Output Areas and Intermediate Zones,MSOAIZ,LU,11760,5793,5967,2391,2464
E02003264,Luton 007,Middle Super Output Areas and Intermediate Zones,MSOAIZ,LU,9326,4524,4802,1823,2009
E02003265,Luton 008,Middle Super Output Areas and Intermediate Zones,MSOAIZ,LU,8233,4049,4184,1691,1725
E02003266,Luton 009,Middle Super Output Areas and Intermediate Zones,MSOAIZ,LU,9268,4445,4823,1833,2117
E02003267,Luton 010,Middle Super Output Areas and Intermediate Zones,MSOAIZ,LU,13253,6688,6565,2843,2628
E02003268,Luton 011,Middle Super Output Areas and Intermediate Zones,MSOAIZ,LU,10907,5440,5467,2324,2331
E02003269,Luton 012,Middle Super Output Areas and Intermediate Zones,MSOAIZ,LU,9985,4949,5036,2205,2220
E02003270,Luton 013,Middle Super Output Areas and Intermediate Zones,MSOAIZ,LU,8000,3942,4058,1629,1682
E02003271,Luton 014,Middle Super Output Areas and Intermediate Zones,MSOAIZ,LU,9775,4838,4937,2309,2401
E02003272,Luton 015,Middle Super Output Areas and Intermediate Zones,MSOAIZ,LU,10490,5362,5128,2280,2029
E02003273,Luton 016,Middle Super Output Areas and Intermediate Zones,MSOAIZ,LU,10286,5064,5222,2169,2251
E02003274,Luton 017,Middle Super Output Areas and Intermediate Zones,MSOAIZ,LU,10849,5646,5203,2619,2085
E02003275,Luton 018,Middle Super Output Areas and Intermediate Zones,MSOAIZ,LU,11733,6410,5323,3339,2465
E02003276,Luton 019,Middle Super Output Areas and Intermediate Zones,MSOAIZ,LU,8445,4511,3934,2018,1695
E02003277,Luton 020,Middle Super Output Areas and Intermediate Zones,MSOAIZ,LU,10190,4980,5210,2038,2152
E02003278,Luton 021,Middle Super Output Areas and Intermediate Zones,MSOAIZ,LU,11541,6320,5221,3059,2479
E02003279,Southend-on-Sea 001,Middle Super Output Areas and Intermediate Zones,MSOAIZ,SS,9364,4565,4799,1716,1668
E02003280,Southend-on-Sea 002,Middle Super Output Areas and Intermediate Zones,MSOAIZ,SS,9726,4739,4987,1819,1927
E02003281,Southend-on-Sea 003,Middle Super Output Areas and Intermediate Zones,MSOAIZ,SS,9219,4424,4795,1557,1627
E02003282,Southend-on-Sea 004,Middle Super Output Areas and Intermediate Zones,MSOAIZ,SS,9971,4920,5051,1913,1904
E02003283,Southend-on-Sea 005,Middle Super Output Areas and Intermediate Zones,MSOAIZ,SS,10475,5063,5412,1979,2114
E02003284,Southend-on-Sea 006,Middle Super Output Areas and Intermediate Zones,MSOAIZ,SS,11213,5513,5700,2421,2473
E02003285,Southend-on-Sea 007,Middle Super Output Areas and Intermediate Zones,MSOAIZ,SS,10847,5400,5447,2575,2617
E02003286,Southend-on-Sea 008,Middle Super Output Areas and Intermediate Zones,MSOAIZ,SS,9154,4472,4682,1780,1835
E02003287,Southend-on-Sea 009,Middle Super Output Areas and Intermediate Zones,MSOAIZ,SS,9710,4653,5057,1672,1848
E02003288,Southend-on-Sea 010,Middle Super Output Areas and Intermediate Zones,MSOAIZ,SS,11004,5525,5479,2525,2379
E02003289,Southend-on-Sea 011,Middle Super Output Areas and Intermediate Zones,MSOAIZ,SS,10083,4892,5191,2441,2427
E02003290,Southend-on-Sea 012,Middle Super Output Areas and Intermediate Zones,MSOAIZ,SS,10045,4982,5063,2440,2075
E02003291,Southend-on-Sea 013,Middle Super Output Areas and Intermediate Zones,MSOAIZ,SS,11159,5390,5769,2263,2442
E02003292,Southend-on-Sea 014,Middle Super Output Areas and Intermediate Zones,MSOAIZ,SS,11130,5515,5615,2572,2493
E02003293,Southend-on-Sea 015,Middle Super Output Areas and Intermediate Zones,MSOAIZ,SS,11063,5612,5451,2935,2339
E02003294,Southend-on-Sea 016,Middle Super Output Areas and Intermediate Zones,MSOAIZ,SS,9215,4443,4772,1624,1666
E02003295,Southend-on-Sea 017,Middle Super Output Areas and Intermediate Zones,MSOAIZ,SS,10280,4929,5351,1776,2011
E02003296,Thurrock 001,Middle Super Output Areas and Intermediate Zones,MSOAIZ,SS,7040,3491,3549,1287,1340
E02003297,Thurrock 002,Middle Super Output Areas and Intermediate Zones,MSOAIZ,SS,7213,3418,3795,1231,1390
E02003298,Thurrock 003,Middle Super Output Areas and Intermediate Zones,MSOAIZ,SS,7060,3397,3663,1276,1346
E02003299,Thurrock 004,Middle Super Output Areas and Intermediate Zones,MSOAIZ,SS,6115,2986,3129,1212,1276
E02003300,Thurrock 005,Middle Super Output Areas and Intermediate Zones,MSOAIZ,SS,7658,3797,3861,1620,1633
E02003301,Thurrock 006,Middle Super Output Areas and Intermediate Zones,MSOAIZ,RM,9486,4662,4824,1956,2034
E02003302,Thurrock 007,Middle Super Output Areas and Intermediate Zones,MSOAIZ,RM,9974,4972,5002,2232,2218
E02003303,Thurrock 008,Middle Super Output Areas and Intermediate Zones,MSOAIZ,RM,7736,3812,3924,1593,1634
E02003304,Thurrock 009,Middle Super Output Areas and Intermediate Zones,MSOAIZ,RM,9314,4594,4720,1709,1779
E02003305,Thurrock 010,Middle Super Output Areas and Intermediate Zones,MSOAIZ,RM,5770,2858,2912,1064,1086
E02003307,Thurrock 012,Middle Super Output Areas and Intermediate Zones,MSOAIZ,RM,9865,4742,5123,1823,1886
E02003308,Thurrock 013,Middle Super Output Areas and Intermediate Zones,MSOAIZ,SS,6364,3107,3257,1350,1429
E02003309,Thurrock 014,Middle Super Output Areas and Intermediate Zones,MSOAIZ,RM,7425,3677,3748,1576,1533
E02003310,Thurrock 015,Middle Super Output Areas and Intermediate Zones,MSOAIZ,RM,11654,5915,5739,3106,2942
E02003311,Thurrock 016,Middle Super Output Areas and Intermediate Zones,MSOAIZ,RM,8435,4217,4218,2097,1972
E02003312,Thurrock 017,Middle Super Output Areas and Intermediate Zones,MSOAIZ,RM,8086,4163,3923,2261,2023
E02003313,Thurrock 018,Middle Super Output Areas and Intermediate Zones,MSOAIZ,RM,13055,6320,6735,2651,2839
E02003314,Medway 001,Middle Super Output Areas and Intermediate Zones,MSOAIZ,ME,6310,3095,3215,1146,1157
E02003315,Medway 002,Middle Super Output Areas and Intermediate Zones,MSOAIZ,ME,5556,2809,2747,1110,1145
E02003316,Medway 003,Middle Super Output Areas and Intermediate Zones,MSOAIZ,ME,9692,4712,4980,1922,2078
E02003317,Medway 004,Middle Super Output Areas and Intermediate Zones,MSOAIZ,ME,5903,2906,2997,1200,1204
E02003318,Medway 005,Middle Super Output Areas and Intermediate Zones,MSOAIZ,ME,5998,2921,3077,1090,1212
E02003319,Medway 006,Middle Super Output Areas and Intermediate Zones,MSOAIZ,ME,7768,3857,3911,1782,1753
E02003320,Medway 007,Middle Super Output Areas and Intermediate Zones,MSOAIZ,ME,8258,4539,3719,2014,1680
E02003321,Medway 008,Middle Super Output Areas and Intermediate Zones,MSOAIZ,ME,6087,2932,3155,1174,1222
E02003322,Medway 009,Middle Super Output Areas and Intermediate Zones,MSOAIZ,ME,6975,3517,3458,1360,1224
E02003323,Medway 010,Middle Super Output Areas and Intermediate Zones,MSOAIZ,ME,7265,3627,3638,1557,1627
E02003324,Medway 011,Middle Super Output Areas and Intermediate Zones,MSOAIZ,ME,8989,4366,4623,1933,2043
E02003325,Medway 012,Middle Super Output Areas and Intermediate Zones,MSOAIZ,ME,7000,3634,3366,1702,1491
E02003326,Medway 013,Middle Super Output Areas and Intermediate Zones,MSOAIZ,ME,7787,3853,3934,1672,1673
E02003327,Medway 014,Middle Super Output Areas and Intermediate Zones,MSOAIZ,ME,7314,3721,3593,1823,1564
E02003328,Medway 015,Middle Super Output Areas and Intermediate Zones,MSOAIZ,ME,8279,4184,4095,2085,1641
E02003329,Medway 016,Middle Super Output Areas and Intermediate Zones,MSOAIZ,ME,6656,3361,3295,1537,1448
E02003330,Medway 017,Middle Super Output Areas and Intermediate Zones,MSOAIZ,ME,6755,3297,3458,1441,1520
E02003331,Medway 018,Middle Super Output Areas and Intermediate Zones,MSOAIZ,ME,8789,4218,4571,1600,1772
E02003332,Medway 019,Middle Super Output Areas and Intermediate Zones,MSOAIZ,ME,6002,2958,3044,1180,1230
E02003333,Medway 020,Middle Super Output Areas and Intermediate Zones,MSOAIZ,ME,6704,3519,3185,1715,1299
E02003334,Medway 021,Middle Super Output Areas and Intermediate Zones,MSOAIZ,ME,5961,2951,3010,1310,1294
E02003335,Medway 022,Middle Super Output Areas and Intermediate Zones,MSOAIZ,ME,7135,3539,3596,1562,1603
E02003336,Medway 023,Middle Super Output Areas and Intermediate Zones,MSOAIZ,ME,5856,2879,2977,1007,1074
E02003337,Medway 024,Middle Super Output Areas and Intermediate Zones,MSOAIZ,ME,7061,3749,3312,1236,1299
E02003338,Medway 025,Middle Super Output Areas and Intermediate Zones,MSOAIZ,ME,7030,3324,3706,1403,1476
E02003339,Medway 026,Middle Super Output Areas and Intermediate Zones,MSOAIZ,ME,6277,3071,3206,1177,1252
E02003340,Medway 027,Middle Super Output Areas and Intermediate Zones,MSOAIZ,ME,7792,3717,4075,1476,1579
E02003341,Medway 028,Middle Super Output Areas and Intermediate Zones,MSOAIZ,ME,5448,2673,2775,1062,1133
E02003342,Medway 029,Middle Super Output Areas and Intermediate Zones,MSOAIZ,ME,6270,3067,3203,1167,1196
E02003343,Medway 030,Middle Super Output Areas and Intermediate Zones,MSOAIZ,ME,5954,2884,3070,1002,1088
E02003344,Medway 031,Middle Super Output Areas and Intermediate Zones,MSOAIZ,ME,7022,3399,3623,1395,1522
E02003345,Medway 032,Middle Super Output Areas and Intermediate Zones,MSOAIZ,ME,5903,2938,2965,1288,1340
E02003346,Medway 033,Middle Super Output Areas and Intermediate Zones,MSOAIZ,ME,6228,3027,3201,1130,1185
E02003347,Medway 034,Middle Super Output Areas and Intermediate Zones,MSOAIZ,ME,6228,3068,3160,1451,1552
E02003348,Medway 035,Middle Super Output Areas and Intermediate Zones,MSOAIZ,ME,8003,3910,4093,1424,1505
E02003349,Medway 036,Middle Super Output Areas and Intermediate Zones,MSOAIZ,ME,7478,3622,3856,1370,1498
E02003350,Medway 037,Middle Super Output Areas and Intermediate Zones,MSOAIZ,ME,6291,3083,3208,1159,1279
E02003351,Medway 038,Middle Super Output Areas and Intermediate Zones,MSOAIZ,ME,7901,3898,4003,1596,1690
E02003352,Bracknell Forest 001,Middle Super Output Areas and Intermediate Zones,MSOAIZ,SL,5816,2809,3007,1151,1211
E02003353,Bracknell Forest 002,Middle Super Output Areas and Intermediate Zones,MSOAIZ,RG,8689,4294,4395,2041,2125
E02003354,Bracknell Forest 003,Middle Super Output Areas and Intermediate Zones,MSOAIZ,RG,9867,4864,5003,2365,2518
E02003355,Bracknell Forest 004,Middle Super Output Areas and Intermediate Zones,MSOAIZ,RG,6369,3124,3245,1398,1466
E02003356,Bracknell Forest 005,Middle Super Output Areas and Intermediate Zones,MSOAIZ,SL,7022,3339,3683,1380,1546
E02003357,Bracknell Forest 006,Middle Super Output Areas and Intermediate Zones,MSOAIZ,RG,8924,4446,4478,2126,2055
E02003358,Bracknell Forest 007,Middle Super Output Areas and Intermediate Zones,MSOAIZ,RG,9082,4445,4637,2118,2048
E02003359,Bracknell Forest 008,Middle Super Output Areas and Intermediate Zones,MSOAIZ,RG,6409,3138,3271,1725,1768
E02003360,Bracknell Forest 009,Middle Super Output Areas and Intermediate Zones,MSOAIZ,RG,9493,4632,4861,2023,2180
E02003361,Bracknell Forest 010,Middle Super Output Areas and Intermediate Zones,MSOAIZ,RG,7410,3700,3710,1744,1784
E02003362,Bracknell Forest 011,Middle Super Output Areas and Intermediate Zones,MSOAIZ,RG,6581,3252,3329,1464,1512
E02003363,Bracknell Forest 012,Middle Super Output Areas and Intermediate Zones,MSOAIZ,RG,6692,3378,3314,1213,1153
E02003364,Bracknell Forest 013,Middle Super Output Areas and Intermediate Zones,MSOAIZ,RG,6653,3349,3304,1579,1555
E02003365,Bracknell Forest 014,Middle Super Output Areas and Intermediate Zones,MSOAIZ,RG,6670,3298,3372,1364,1397
E02003366,Bracknell Forest 015,Middle Super Output Areas and Intermediate Zones,MSOAIZ,GU,7528,4039,3489,1794,1641
E02003367,West Berkshire 001,Middle Super Output Areas and Intermediate Zones,MSOAIZ,RG,6262,3170,3092,1227,1316
E02003368,West Berkshire 002,Middle Super Output Areas and Intermediate Zones,MSOAIZ,SN,5575,2774,2801,1187,1180
E02003369,West Berkshire 003,Middle Super Output Areas and Intermediate Zones,MSOAIZ,RG,6081,3007,3074,1157,1220
E02003370,West Berkshire 004,Middle Super Output Areas and Intermediate Zones,MSOAIZ,RG,6548,3217,3331,1317,1369
E02003371,West Berkshire 005,Middle Super Output Areas and Intermediate Zones,MSOAIZ,RG,5945,2964,2981,1176,1218
E02003372,West Berkshire 006,Middle Super Output Areas and Intermediate Zones,MSOAIZ,RG,7657,3754,3903,1464,1575
E02003373,West Berkshire 007,Middle Super Output Areas and Intermediate Zones,MSOAIZ,RG,8623,4120,4503,1670,1723
E02003374,West Berkshire 008,Middle Super Output Areas and Intermediate Zones,MSOAIZ,RG,5728,2825,2903,1272,1374
E02003375,West Berkshire 009,Middle Super Output Areas and Intermediate Zones,MSOAIZ,RG,5788,2836,2952,1241,1300
E02003376,West Berkshire 010,Middle Super Output Areas and Intermediate Zones,MSOAIZ,RG,5767,2796,2971,1162,1221
E02003377,West Berkshire 011,Middle Super Output Areas and Intermediate Zones,MSOAIZ,RG,10236,5300,4936,1964,2017
E02003378,West Berkshire 012,Middle Super Output Areas and Intermediate Zones,MSOAIZ,RG,7725,3751,3974,1575,1548
E02003379,West Berkshire 013,Middle Super Output Areas and Intermediate Zones,MSOAIZ,RG,6827,3435,3392,1656,1562
E02003380,West Berkshire 014,Middle Super Output Areas and Intermediate Zones,MSOAIZ,RG,7851,3970,3881,1825,1778
E02003381,West Berkshire 015,Middle Super Output Areas and Intermediate Zones,MSOAIZ,RG,5955,2953,3002,1238,1288
E02003382,West Berkshire 016,Middle Super Output Areas and Intermediate Zones,MSOAIZ,RG,7585,3722,3863,1634,1648
E02003383,West Berkshire 017,Middle Super Output Areas and Intermediate Zones,MSOAIZ,RG,6918,3485,3433,1622,1617
E02003384,West Berkshire 018,Middle Super Output Areas and Intermediate Zones,MSOAIZ,RG,6385,3169,3216,1284,1311
E02003385,West Berkshire 019,Middle Super Output Areas and Intermediate Zones,MSOAIZ,RG,7536,3756,3780,1987,1782
E02003386,West Berkshire 020,Middle Super Output Areas and Intermediate Zones,MSOAIZ,RG,7965,3906,4059,1798,1720
E02003387,West Berkshire 021,Middle Super Output Areas and Intermediate Zones,MSOAIZ,RG,9133,4540,4593,1736,1776
E02003388,West Berkshire 022,Middle Super Output Areas and Intermediate Zones,MSOAIZ,RG,5732,2871,2861,1133,1099
E02003389,Reading 001,Middle Super Output Areas and Intermediate Zones,MSOAIZ,RG,7781,3789,3992,1562,1589
E02003390,Reading 002,Middle Super Output Areas and Intermediate Zones,MSOAIZ,RG,7601,3744,3857,1495,1520
E02003391,Reading 003,Middle Super Output Areas and Intermediate Zones,MSOAIZ,RG,8233,3900,4333,1693,1722
E02003392,Reading 004,Middle Super Output Areas and Intermediate Zones,MSOAIZ,RG,8119,4038,4081,2111,2157
E02003393,Reading 005,Middle Super Output Areas and Intermediate Zones,MSOAIZ,RG,7830,3783,4047,1653,1706
E02003394,Reading 006,Middle Super Output Areas and Intermediate Zones,MSOAIZ,RG,7536,3674,3862,1549,1685
E02003395,Reading 007,Middle Super Output Areas and Intermediate Zones,MSOAIZ,RG,9453,4894,4559,2795,2504
E02003396,Reading 008,Middle Super Output Areas and Intermediate Zones,MSOAIZ,RG,9210,4712,4498,2507,2289
E02003397,Reading 009,Middle Super Output Areas and Intermediate Zones,MSOAIZ,RG,7444,3566,3878,1399,1511
E02003398,Reading 010,Middle Super Output Areas and Intermediate Zones,MSOAIZ,RG,10517,5531,4986,2830,2320
E02003399,Reading 011,Middle Super Output Areas and Intermediate Zones,MSOAIZ,RG,11836,6436,5400,4152,3202
E02003400,Reading 012,Middle Super Output Areas and Intermediate Zones,MSOAIZ,RG,8463,4330,4133,1751,1469
E02003401,Reading 013,Middle Super Output Areas and Intermediate Zones,MSOAIZ,RG,8306,4127,4179,2161,2004
E02003402,Reading 014,Middle Super Output Areas and Intermediate Zones,MSOAIZ,RG,9543,4922,4621,2618,2251
E02003403,Reading 015,Middle Super Output Areas and Intermediate Zones,MSOAIZ,RG,8548,4078,4470,1698,1812
E02003404,Reading 016,Middle Super Output Areas and Intermediate Zones,MSOAIZ,RG,7888,3884,4004,1241,1261
E02003405,Reading 017,Middle Super Output Areas and Intermediate Zones,MSOAIZ,RG,9931,4926,5005,2199,2265
E02003406,Reading 018,Middle Super Output Areas and Intermediate Zones,MSOAIZ,RG,7459,3633,3826,1486,1631
E02003407,Slough 001,Middle Super Output Areas and Intermediate Zones,MSOAIZ,SL,9376,4560,4816,1883,2151
E02003408,Slough 002,Middle Super Output Areas and Intermediate Zones,MSOAIZ,SL,10334,5224,5110,2481,2332
E02003409,Slough 003,Middle Super Output Areas and Intermediate Zones,MSOAIZ,SL,10357,5053,5304,2374,2526
E02003410,Slough 004,Middle Super Output Areas and Intermediate Zones,MSOAIZ,SL,11450,5702,5748,2571,2511
E02003411,Slough 005,Middle Super Output Areas and Intermediate Zones,MSOAIZ,SL,11017,5406,5611,2340,2447
E02003412,Slough 006,Middle Super Output Areas and Intermediate Zones,MSOAIZ,SL,9447,4692,4755,2200,2191
E02003413,Slough 007,Middle Super Output Areas and Intermediate Zones,MSOAIZ,SL,12364,6261,6103,2999,2828
E02003414,Slough 008,Middle Super Output Areas and Intermediate Zones,MSOAIZ,SL,12116,6052,6064,3096,3135
E02003415,Slough 009,Middle Super Output Areas and Intermediate Zones,MSOAIZ,SL,12117,6366,5751,3259,2753
E02003416,Slough 010,Middle Super Output Areas and Intermediate Zones,MSOAIZ,SL,8079,4042,4037,1914,1914
E02003417,Slough 011,Middle Super Output Areas and Intermediate Zones,MSOAIZ,SL,9386,4722,4664,2444,2238
E02003418,Slough 012,Middle Super Output Areas and Intermediate Zones,MSOAIZ,SL,9504,4639,4865,2033,2208
E02003419,Slough 013,Middle Super Output Areas and Intermediate Zones,MSOAIZ,SL,8501,4232,4269,1908,1973
E02003420,Slough 014,Middle Super Output Areas and Intermediate Zones,MSOAIZ,SL,6157,3169,2988,1651,1517
E02003421,Windsor and Maidenhead 001,Middle Super Output Areas and Intermediate Zones,MSOAIZ,SL,5590,2689,2901,1062,1158
E02003422,Windsor and Maidenhead 002,Middle Super Output Areas and Intermediate Zones,MSOAIZ,SL,11490,5660,5830,2227,2309
E02003423,Windsor and Maidenhead 003,Middle Super Output Areas and Intermediate Zones,MSOAIZ,SL,6067,2988,3079,1249,1291
E02003424,Windsor and Maidenhead 004,Middle Super Output Areas and Intermediate Zones,MSOAIZ,SL,8116,4019,4097,1722,1693
E02003425,Windsor and Maidenhead 005,Middle Super Output Areas and Intermediate Zones,MSOAIZ,SL,10853,5385,5468,2638,2551
E02003426,Windsor and Maidenhead 006,Middle Super Output Areas and Intermediate Zones,MSOAIZ,SL,9586,4590,4996,1950,2117
E02003427,Windsor and Maidenhead 007,Middle Super Output Areas and Intermediate Zones,MSOAIZ,SL,7540,3747,3793,1690,1738
E02003428,Windsor and Maidenhead 008,Middle Super Output Areas and Intermediate Zones,MSOAIZ,SL,9022,4425,4597,1824,1888
E02003429,Windsor and Maidenhead 009,Middle Super Output Areas and Intermediate Zones,MSOAIZ,SL,7483,3717,3766,1502,1555
E02003430,Windsor and Maidenhead 010,Middle Super Output Areas and Intermediate Zones,MSOAIZ,SL,6713,3895,2818,1540,1344
E02003431,Windsor and Maidenhead 011,Middle Super Output Areas and Intermediate Zones,MSOAIZ,TW,6596,3242,3354,1451,1525
E02003432,Windsor and Maidenhead 012,Middle Super Output Areas and Intermediate Zones,MSOAIZ,SL,6758,3424,3334,1795,1652
E02003433,Windsor and Maidenhead 013,Middle Super Output Areas and Intermediate Zones,MSOAIZ,SL,6614,3216,3398,1260,1357
E02003434,Windsor and Maidenhead 014,Middle Super Output Areas and Intermediate Zones,MSOAIZ,SL,8773,4244,4529,1856,1925
E02003435,Windsor and Maidenhead 015,Middle Super Output Areas and Intermediate Zones,MSOAIZ,SL,6911,3357,3554,1555,1605
E02003436,Windsor and Maidenhead 016,Middle Super Output Areas and Intermediate Zones,MSOAIZ,TW,8357,4129,4228,1597,1638
E02003437,Windsor and Maidenhead 017,Middle Super Output Areas and Intermediate Zones,MSOAIZ,SL,7516,3644,3872,1497,1573
E02003438,Windsor and Maidenhead 018,Middle Super Output Areas and Intermediate Zones,MSOAIZ,SL,10575,4957,5618,1930,2100
E02003439,Wokingham 001,Middle Super Output Areas and Intermediate Zones,MSOAIZ,RG,5421,2668,2753,1012,1032
E02003440,Wokingham 002,Middle Super Output Areas and Intermediate Zones,MSOAIZ,RG,8833,4334,4499,1906,1973
E02003441,Wokingham 003,Middle Super Output Areas and Intermediate Zones,MSOAIZ,RG,7634,3755,3879,1462,1501
E02003442,Wokingham 004,Middle Super Output Areas and Intermediate Zones,MSOAIZ,RG,7107,3499,3608,1593,1680
E02003443,Wokingham 005,Middle Super Output Areas and Intermediate Zones,MSOAIZ,RG,5974,2963,3011,1152,1134
E02003444,Wokingham 006,Middle Super Output Areas and Intermediate Zones,MSOAIZ,RG,8890,4441,4449,1794,1806
E02003445,Wokingham 007,Middle Super Output Areas and Intermediate Zones,MSOAIZ,RG,8331,4161,4170,1671,1651
E02003446,Wokingham 008,Middle Super Output Areas and Intermediate Zones,MSOAIZ,RG,8488,4260,4228,1671,1718
E02003447,Wokingham 009,Middle Super Output Areas and Intermediate Zones,MSOAIZ,RG,9438,4615,4823,2112,2194
E02003448,Wokingham 010,Middle Super Output Areas and Intermediate Zones,MSOAIZ,RG,6672,3374,3298,1406,1395
E02003449,Wokingham 011,Middle Super Output Areas and Intermediate Zones,MSOAIZ,RG,7464,3770,3694,2019,1978
E02003450,Wokingham 012,Middle Super Output Areas and Intermediate Zones,MSOAIZ,RG,10638,5229,5409,2513,2556
E02003451,Wokingham 013,Middle Super Output Areas and Intermediate Zones,MSOAIZ,RG,7939,3758,4181,1692,1695
E02003452,Wokingham 014,Middle Super Output Areas and Intermediate Zones,MSOAIZ,RG,6100,3029,3071,1284,1357
E02003453,Wokingham 015,Middle Super Output Areas and Intermediate Zones,MSOAIZ,RG,6512,3174,3338,1329,1405
E02003454,Wokingham 016,Middle Super Output Areas and Intermediate Zones,MSOAIZ,RG,7612,3668,3944,1552,1579
E02003455,Wokingham 017,Middle Super Output Areas and Intermediate Zones,MSOAIZ,RG,6715,3361,3354,1472,1496
E02003456,Wokingham 018,Middle Super Output Areas and Intermediate Zones,MSOAIZ,RG,6824,3478,3346,1426,1482
E02003457,Wokingham 019,Middle Super Output Areas and Intermediate Zones,MSOAIZ,RG,9764,4839,4925,1913,2062
E02003458,Wokingham 020,Middle Super Output Areas and Intermediate Zones,MSOAIZ,RG,8024,4088,3936,1482,1610
E02003459,Milton Keynes 001,Middle Super Output Areas and Intermediate Zones,MSOAIZ,NN,8735,4233,4502,1720,1837
E02003460,Milton Keynes 002,Middle Super Output Areas and Intermediate Zones,MSOAIZ,NN,9234,4534,4700,1837,1904
E02003461,Milton Keynes 003,Middle Super Output Areas and Intermediate Zones,MSOAIZ,MK,7392,3535,3857,1401,1529
E02003462,Milton Keynes 004,Middle Super Output Areas and Intermediate Zones,MSOAIZ,MK,7726,3812,3914,1751,1764
E02003463,Milton Keynes 005,Middle Super Output Areas and Intermediate Zones,MSOAIZ,MK,6755,3266,3489,1340,1432
E02003464,Milton Keynes 006,Middle Super Output Areas and Intermediate Zones,MSOAIZ,MK,6744,3278,3466,1329,1467
E02003465,Milton Keynes 007,Middle Super Output Areas and Intermediate Zones,MSOAIZ,MK,6215,3040,3175,1320,1340
E02003466,Milton Keynes 008,Middle Super Output Areas and Intermediate Zones,MSOAIZ,MK,7258,3647,3611,1793,1641
E02003467,Milton Keynes 009,Middle Super Output Areas and Intermediate Zones,MSOAIZ,MK,6371,3079,3292,1350,1330
E02003468,Milton Keynes 010,Middle Super Output Areas and Intermediate Zones,MSOAIZ,MK,7382,3576,3806,1544,1566
E02003469,Milton Keynes 011,Middle Super Output Areas and Intermediate Zones,MSOAIZ,MK,5801,2888,2913,1261,1246
E02003470,Milton Keynes 012,Middle Super Output Areas and Intermediate Zones,MSOAIZ,MK,5620,2691,2929,1060,1193
E02003471,Milton Keynes 013,Middle Super Output Areas and Intermediate Zones,MSOAIZ,MK,6565,3342,3223,1469,1444
E02003472,Milton Keynes 014,Middle Super Output Areas and Intermediate Zones,MSOAIZ,MK,8596,4691,3905,2796,2034
E02003473,Milton Keynes 015,Middle Super Output Areas and Intermediate Zones,MSOAIZ,MK,5683,2843,2840,1318,1302
E02003474,Milton Keynes 016,Middle Super Output Areas and Intermediate Zones,MSOAIZ,MK,8643,4357,4286,2119,2077
E02003475,Milton Keynes 017,Middle Super Output Areas and Intermediate Zones,MSOAIZ,MK,14877,7364,7513,4024,4056
E02003476,Milton Keynes 018,Middle Super Output Areas and Intermediate Zones,MSOAIZ,MK,8646,4397,4249,2031,1946
E02003477,Milton Keynes 019,Middle Super Output Areas and Intermediate Zones,MSOAIZ,MK,11382,5880,5502,2972,2684
E02003478,Milton Keynes 020,Middle Super Output Areas and Intermediate Zones,MSOAIZ,MK,6900,3357,3543,1635,1684
E02003479,Milton Keynes 021,Middle Super Output Areas and Intermediate Zones,MSOAIZ,MK,7436,3777,3659,1917,1829
E02003480,Milton Keynes 022,Middle Super Output Areas and Intermediate Zones,MSOAIZ,MK,8186,4062,4124,2044,2160
E02003481,Milton Keynes 023,Middle Super Output Areas and Intermediate Zones,MSOAIZ,MK,7133,3560,3573,1586,1480
E02003482,Milton Keynes 024,Middle Super Output Areas and Intermediate Zones,MSOAIZ,MK,6229,3055,3174,1298,1369
E02003483,Milton Keynes 025,Middle Super Output Areas and Intermediate Zones,MSOAIZ,MK,10902,5376,5526,2706,2861
E02003484,Milton Keynes 026,Middle Super Output Areas and Intermediate Zones,MSOAIZ,MK,7243,3502,3741,1639,1732
E02003485,Milton Keynes 027,Middle Super Output Areas and Intermediate Zones,MSOAIZ,MK,8062,3904,4158,1538,1646
E02003486,Milton Keynes 028,Middle Super Output Areas and Intermediate Zones,MSOAIZ,MK,8899,4393,4506,2240,2370
E02003487,Milton Keynes 029,Middle Super Output Areas and Intermediate Zones,MSOAIZ,MK,7231,3481,3750,1296,1458
E02003488,Milton Keynes 030,Middle Super Output Areas and Intermediate Zones,MSOAIZ,MK,7059,3440,3619,1328,1316
E02003489,Milton Keynes 031,Middle Super Output Areas and Intermediate Zones,MSOAIZ,MK,6920,3410,3510,1425,1478
E02003490,Milton Keynes 032,Middle Super Output Areas and Intermediate Zones,MSOAIZ,MK,6996,3346,3650,1308,1515
E02003491,Brighton and Hove 001,Middle Super Output Areas and Intermediate Zones,MSOAIZ,BN,7726,3703,4023,1506,1633
E02003492,Brighton and Hove 002,Middle Super Output Areas and Intermediate Zones,MSOAIZ,BN,9491,4534,4957,1165,1179
E02003493,Brighton and Hove 003,Middle Super Output Areas and Intermediate Zones,MSOAIZ,BN,7824,3777,4047,1446,1520
E02003494,Brighton and Hove 004,Middle Super Output Areas and Intermediate Zones,MSOAIZ,BN,6514,3145,3369,1194,1361
E02003495,Brighton and Hove 005,Middle Super Output Areas and Intermediate Zones,MSOAIZ,BN,7200,3470,3730,1412,1646
E02003496,Brighton and Hove 006,Middle Super Output Areas and Intermediate Zones,MSOAIZ,BN,7430,3501,3929,1282,1503
E02003497,Brighton and Hove 007,Middle Super Output Areas and Intermediate Zones,MSOAIZ,BN,7291,3595,3696,1352,1456
E02003498,Brighton and Hove 008,Middle Super Output Areas and Intermediate Zones,MSOAIZ,BN,8382,4224,4158,1512,1559
E02003499,Brighton and Hove 009,Middle Super Output Areas and Intermediate Zones,MSOAIZ,BN,8022,3921,4101,1291,1507
E02003500,Brighton and Hove 010,Middle Super Output Areas and Intermediate Zones,MSOAIZ,BN,8360,4005,4355,1740,1953
E02003501,Brighton and Hove 011,Middle Super Output Areas and Intermediate Zones,MSOAIZ,BN,8322,4149,4173,2004,1913
E02003502,Brighton and Hove 012,Middle Super Output Areas and Intermediate Zones,MSOAIZ,BN,7574,3685,3889,1597,1720
E02003503,Brighton and Hove 013,Middle Super Output Areas and Intermediate Zones,MSOAIZ,BN,8974,4331,4643,1612,1884
E02003504,Brighton and Hove 014,Middle Super Output Areas and Intermediate Zones,MSOAIZ,BN,8390,4240,4150,2301,2092
E02003505,Brighton and Hove 015,Middle Super Output Areas and Intermediate Zones,MSOAIZ,BN,8984,4451,4533,2132,1893
E02003506,Brighton and Hove 016,Middle Super Output Areas and Intermediate Zones,MSOAIZ,BN,6760,3246,3514,1624,1863
E02003507,Brighton and Hove 017,Middle Super Output Areas and Intermediate Zones,MSOAIZ,BN,9793,4710,5083,1755,1915
E02003508,Brighton and Hove 018,Middle Super Output Areas and Intermediate Zones,MSOAIZ,BN,8741,4298,4443,1870,1830
E02003509,Brighton and Hove 019,Middle Super Output Areas and Intermediate Zones,MSOAIZ,BN,8704,4439,4265,2711,2388
E02003510,Brighton and Hove 020,Middle Super Output Areas and Intermediate Zones,MSOAIZ,BN,8509,4189,4320,2347,2211
E02003511,Brighton and Hove 021,Middle Super Output Areas and Intermediate Zones,MSOAIZ,BN,7986,3779,4207,1753,1992
E02003512,Brighton and Hove 022,Middle Super Output Areas and Intermediate Zones,MSOAIZ,BN,9079,4622,4457,2246,1999
E02003513,Brighton and Hove 023,Middle Super Output Areas and Intermediate Zones,MSOAIZ,BN,6619,3163,3456,1435,1475
E02003514,Brighton and Hove 024,Middle Super Output Areas and Intermediate Zones,MSOAIZ,BN,8437,4471,3966,2953,2451
E02003515,Brighton and Hove 025,Middle Super Output Areas and Intermediate Zones,MSOAIZ,BN,9086,4378,4708,1665,1979
E02003516,Brighton and Hove 026,Middle Super Output Areas and Intermediate Zones,MSOAIZ,BN,8366,4477,3889,3004,2392
E02003517,Brighton and Hove 027,Middle Super Output Areas and Intermediate Zones,MSOAIZ,BN,10818,5827,4991,3120,2288
E02003518,Brighton and Hove 028,Middle Super Output Areas and Intermediate Zones,MSOAIZ,BN,7572,3724,3848,2113,1912
E02003519,Brighton and Hove 029,Middle Super Output Areas and Intermediate Zones,MSOAIZ,BN,8669,4765,3904,3083,2402
E02003520,Brighton and Hove 030,Middle Super Output Areas and Intermediate Zones,MSOAIZ,BN,8645,4669,3976,2498,1908
E02003521,Brighton and Hove 031,Middle Super Output Areas and Intermediate Zones,MSOAIZ,BN,8083,4264,3819,2208,1774
E02003522,Brighton and Hove 032,Middle Super Output Areas and Intermediate Zones,MSOAIZ,BN,7047,3615,3432,1804,1488
E02003523,Brighton and Hove 033,Middle Super Output Areas and Intermediate Zones,MSOAIZ,BN,9971,4741,5230,1778,1840
E02003524,Portsmouth 001,Middle Super Output Areas and Intermediate Zones,MSOAIZ,PO,7989,3910,4079,1491,1684
E02003525,Portsmouth 002,Middle Super Output Areas and Intermediate Zones,MSOAIZ,PO,6239,3002,3237,1140,1368
E02003526,Portsmouth 003,Middle Super Output Areas and Intermediate Zones,MSOAIZ,PO,6509,3166,3343,1094,1121
E02003527,Portsmouth 004,Middle Super Output Areas and Intermediate Zones,MSOAIZ,PO,5869,2887,2982,1228,1256
E02003529,Portsmouth 006,Middle Super Output Areas and Intermediate Zones,MSOAIZ,PO,7743,3783,3960,1511,1619
E02003530,Portsmouth 007,Middle Super Output Areas and Intermediate Zones,MSOAIZ,PO,7525,3584,3941,1563,1673
E02003531,Portsmouth 008,Middle Super Output Areas and Intermediate Zones,MSOAIZ,PO,7949,3914,4035,1666,1711
E02003532,Portsmouth 009,Middle Super Output Areas and Intermediate Zones,MSOAIZ,PO,7538,3781,3757,1767,1672
E02003533,Portsmouth 010,Middle Super Output Areas and Intermediate Zones,MSOAIZ,PO,5570,2703,2867,1216,1265
E02003534,Portsmouth 011,Middle Super Output Areas and Intermediate Zones,MSOAIZ,PO,8817,4401,4416,2029,1977
E02003535,Portsmouth 012,Middle Super Output Areas and Intermediate Zones,MSOAIZ,PO,9491,4674,4817,2175,2306
E02003536,Portsmouth 013,Middle Super Output Areas and Intermediate Zones,MSOAIZ,PO,7513,3650,3863,1397,1534
E02003537,Portsmouth 014,Middle Super Output Areas and Intermediate Zones,MSOAIZ,PO,10468,5239,5229,2297,2244
E02003538,Portsmouth 015,Middle Super Output Areas and Intermediate Zones,MSOAIZ,PO,10207,5196,5011,2439,2202
E02003539,Portsmouth 016,Middle Super Output Areas and Intermediate Zones,MSOAIZ,PO,12367,6480,5887,2500,2101
E02003540,Portsmouth 017,Middle Super Output Areas and Intermediate Zones,MSOAIZ,PO,9119,4489,4630,1773,1774
E02003541,Portsmouth 018,Middle Super Output Areas and Intermediate Zones,MSOAIZ,PO,11628,5980,5648,1969,1779
E02003542,Portsmouth 019,Middle Super Output Areas and Intermediate Zones,MSOAIZ,PO,9456,4828,4628,1841,1679
E02003543,Portsmouth 020,Middle Super Output Areas and Intermediate Zones,MSOAIZ,PO,8951,4787,4164,1724,1430
E02003544,Portsmouth 021,Middle Super Output Areas and Intermediate Zones,MSOAIZ,PO,6450,3201,3249,1512,1589
E02003545,Portsmouth 022,Middle Super Output Areas and Intermediate Zones,MSOAIZ,PO,7148,3878,3270,1810,1285
E02003546,Portsmouth 023,Middle Super Output Areas and Intermediate Zones,MSOAIZ,PO,8525,4199,4326,1896,1805
E02003547,Portsmouth 024,Middle Super Output Areas and Intermediate Zones,MSOAIZ,PO,8644,4620,4024,2103,1567
E02003548,Portsmouth 025,Middle Super Output Areas and Intermediate Zones,MSOAIZ,PO,6796,3624,3172,1602,1309
E02003549,Southampton 001,Middle Super Output Areas and Intermediate Zones,MSOAIZ,SO,8453,4327,4126,1388,1311
E02003550,Southampton 002,Middle Super Output Areas and Intermediate Zones,MSOAIZ,SO,7878,3855,4023,1577,1682
E02003551,Southampton 003,Middle Super Output Areas and Intermediate Zones,MSOAIZ,SO,6655,3371,3284,1123,1024
E02003552,Southampton 004,Middle Super Output Areas and Intermediate Zones,MSOAIZ,SO,6168,2988,3180,1172,1289
E02003553,Southampton 005,Middle Super Output Areas and Intermediate Zones,MSOAIZ,SO,7009,3726,3283,1327,1135
E02003554,Southampton 006,Middle Super Output Areas and Intermediate Zones,MSOAIZ,SO,6079,3012,3067,1311,1194
E02003555,Southampton 007,Middle Super Output Areas and Intermediate Zones,MSOAIZ,SO,7325,3594,3731,1441,1540
E02003556,Southampton 008,Middle Super Output Areas and Intermediate Zones,MSOAIZ,SO,5941,2956,2985,1201,1257
E02003557,Southampton 009,Middle Super Output Areas and Intermediate Zones,MSOAIZ,SO,6897,3560,3337,1272,1038
E02003558,Southampton 010,Middle Super Output Areas and Intermediate Zones,MSOAIZ,SO,6612,3216,3396,1483,1564
E02003559,Southampton 011,Middle Super Output Areas and Intermediate Zones,MSOAIZ,SO,7813,3797,4016,1596,1660
E02003560,Southampton 012,Middle Super Output Areas and Intermediate Zones,MSOAIZ,SO,7165,3486,3679,1452,1513
E02003561,Southampton 013,Middle Super Output Areas and Intermediate Zones,MSOAIZ,SO,7934,4112,3822,1627,1347
E02003562,Southampton 014,Middle Super Output Areas and Intermediate Zones,MSOAIZ,SO,8085,4133,3952,2031,1825
E02003563,Southampton 015,Middle Super Output Areas and Intermediate Zones,MSOAIZ,SO,7717,3754,3963,1797,1738
E02003564,Southampton 016,Middle Super Output Areas and Intermediate Zones,MSOAIZ,SO,8000,3830,4170,1578,1684
E02003565,Southampton 017,Middle Super Output Areas and Intermediate Zones,MSOAIZ,SO,6622,3508,3114,1348,1007
E02003566,Southampton 018,Middle Super Output Areas and Intermediate Zones,MSOAIZ,SO,6035,2898,3137,1108,1197
E02003567,Southampton 019,Middle Super Output Areas and Intermediate Zones,MSOAIZ,SO,7665,3722,3943,1629,1683
E02003568,Southampton 020,Middle Super Output Areas and Intermediate Zones,MSOAIZ,SO,8509,4586,3923,2472,1896
E02003569,Southampton 021,Middle Super Output Areas and Intermediate Zones,MSOAIZ,SO,7428,3867,3561,2183,1825
E02003570,Southampton 022,Middle Super Output Areas and Intermediate Zones,MSOAIZ,SO,10222,5649,4573,2803,1887
E02003571,Southampton 023,Middle Super Output Areas and Intermediate Zones,MSOAIZ,SO,7164,3725,3439,1372,871
E02003572,Southampton 024,Middle Super Output Areas and Intermediate Zones,MSOAIZ,SO,6127,3042,3085,1304,1328
E02003573,Southampton 025,Middle Super Output Areas and Intermediate Zones,MSOAIZ,SO,7452,3604,3848,1386,1485
E02003574,Southampton 026,Middle Super Output Areas and Intermediate Zones,MSOAIZ,SO,7757,3823,3934,1557,1585
E02003575,Southampton 027,Middle Super Output Areas and Intermediate Zones,MSOAIZ,SO,6348,3032,3316,1277,1345
E02003576,Southampton 028,Middle Super Output Areas and Intermediate Zones,MSOAIZ,SO,8076,4013,4063,1812,1805
E02003577,Southampton 029,Middle Super Output Areas and Intermediate Zones,MSOAIZ,SO,11598,6420,5178,3080,2069
E02003578,Southampton 030,Middle Super Output Areas and Intermediate Zones,MSOAIZ,SO,6296,3136,3160,1352,1367
E02003579,Southampton 031,Middle Super Output Areas and Intermediate Zones,MSOAIZ,SO,7822,3798,4024,1764,1793
E02003580,Southampton 032,Middle Super Output Areas and Intermediate Zones,MSOAIZ,SO,6030,2913,3117,1182,1237
E02003581,Isle of Wight 001,Middle Super Output Areas and Intermediate Zones,MSOAIZ,PO,7830,3801,4029,1636,1712
E02003582,Isle of Wight 002,Middle Super Output Areas and Intermediate Zones,MSOAIZ,PO,8210,3987,4223,1379,1527
E02003583,Isle of Wight 003,Middle Super Output Areas and Intermediate Zones,MSOAIZ,PO,6459,3094,3365,1053,1164
E02003584,Isle of Wight 004,Middle Super Output Areas and Intermediate Zones,MSOAIZ,PO,6233,3079,3154,1392,1293
E02003585,Isle of Wight 005,Middle Super Output Areas and Intermediate Zones,MSOAIZ,PO,6662,3164,3498,1017,1115
E02003586,Isle of Wight 006,Middle Super Output Areas and Intermediate Zones,MSOAIZ,PO,7664,3666,3998,1291,1475
E02003587,Isle of Wight 007,Middle Super Output Areas and Intermediate Zones,MSOAIZ,PO,8408,4036,4372,1568,1736
E02003588,Isle of Wight 008,Middle Super Output Areas and Intermediate Zones,MSOAIZ,PO,7463,3886,3577,1585,1315
E02003589,Isle of Wight 009,Middle Super Output Areas and Intermediate Zones,MSOAIZ,PO,8494,4706,3788,2340,1571
E02003590,Isle of Wight 010,Middle Super Output Areas and Intermediate Zones,MSOAIZ,PO,7450,3465,3985,968,1064
E02003591,Isle of Wight 011,Middle Super Output Areas and Intermediate Zones,MSOAIZ,PO,9226,4428,4798,1676,1802
E02003592,Isle of Wight 012,Middle Super Output Areas and Intermediate Zones,MSOAIZ,PO,9482,4488,4994,1272,1383
E02003593,Isle of Wight 013,Middle Super Output Areas and Intermediate Zones,MSOAIZ,PO,5308,2581,2727,819,899
E02003594,Isle of Wight 014,Middle Super Output Areas and Intermediate Zones,MSOAIZ,PO,9219,4444,4775,1553,1726
E02003595,Isle of Wight 015,Middle Super Output Areas and Intermediate Zones,MSOAIZ,PO,8085,3887,4198,1218,1351
E02003596,Isle of Wight 016,Middle Super Output Areas and Intermediate Zones,MSOAIZ,PO,8726,4228,4498,1474,1504
E02003597,Isle of Wight 017,Middle Super Output Areas and Intermediate Zones,MSOAIZ,PO,5617,2748,2869,884,944
E02003598,Isle of Wight 018,Middle Super Output Areas and Intermediate Zones,MSOAIZ,PO,7729,3736,3993,1196,1288
E02003599,Central Bedfordshire 001,Middle Super Output Areas and Intermediate Zones,MSOAIZ,SG,5601,2832,2769,1249,1271
E02003600,Central Bedfordshire 002,Middle Super Output Areas and Intermediate Zones,MSOAIZ,SG,6056,2991,3065,1254,1240
E02003601,Central Bedfordshire 003,Middle Super Output Areas and Intermediate Zones,MSOAIZ,SG,7199,3555,3644,1488,1503
E02003602,Central Bedfordshire 004,Middle Super Output Areas and Intermediate Zones,MSOAIZ,SG,5946,2972,2974,1075,1110
E02003603,Central Bedfordshire 005,Middle Super Output Areas and Intermediate Zones,MSOAIZ,SG,9611,4760,4851,2186,2121
E02003604,Central Bedfordshire 006,Middle Super Output Areas and Intermediate Zones,MSOAIZ,SG,6940,3376,3564,1394,1474
E02003605,Central Bedfordshire 007,Middle Super Output Areas and Intermediate Zones,MSOAIZ,MK,8312,4369,3943,1885,1660
E02003606,Central Bedfordshire 008,Middle Super Output Areas and Intermediate Zones,MSOAIZ,SG,7583,3737,3846,1436,1515
E02003607,Central Bedfordshire 009,Middle Super Output Areas and Intermediate Zones,MSOAIZ,MK,8487,4174,4313,1812,1866
E02003608,Central Bedfordshire 010,Middle Super Output Areas and Intermediate Zones,MSOAIZ,SG,10928,5407,5521,2334,2446
E02003609,Central Bedfordshire 011,Middle Super Output Areas and Intermediate Zones,MSOAIZ,SG,10017,4996,5021,2171,2243
E02003610,Central Bedfordshire 012,Middle Super Output Areas and Intermediate Zones,MSOAIZ,MK,7175,3533,3642,1432,1484
E02003611,Central Bedfordshire 013,Middle Super Output Areas and Intermediate Zones,MSOAIZ,SG,8480,4224,4256,1845,1835
E02003612,Central Bedfordshire 014,Middle Super Output Areas and Intermediate Zones,MSOAIZ,SG,9632,4735,4897,2169,2244
E02003613,Central Bedfordshire 015,Middle Super Output Areas and Intermediate Zones,MSOAIZ,MK,5861,2942,2919,1245,1236
E02003614,Central Bedfordshire 016,Middle Super Output Areas and Intermediate Zones,MSOAIZ,MK,7373,3700,3673,1642,1711
E02003615,Central Bedfordshire 017,Middle Super Output Areas and Intermediate Zones,MSOAIZ,MK,8788,4397,4391,1646,1776
E02003616,Bedford 001,Middle Super Output Areas and Intermediate Zones,MSOAIZ,PE,5675,2773,2902,985,1099
E02003617,Bedford 002,Middle Super Output Areas and Intermediate Zones,MSOAIZ,NN,8947,4429,4518,1636,1716
E02003618,Bedford 003,Middle Super Output Areas and Intermediate Zones,MSOAIZ,MK,8768,4213,4555,1625,1900
E02003619,Bedford 004,Middle Super Output Areas and Intermediate Zones,MSOAIZ,PE,10034,4907,5127,1916,2083
E02003620,Bedford 005,Middle Super Output Areas and Intermediate Zones,MSOAIZ,MK,8153,3981,4172,1504,1560
E02003621,Bedford 006,Middle Super Output Areas and Intermediate Zones,MSOAIZ,MK,8072,3932,4140,1358,1419
E02003622,Bedford 007,Middle Super Output Areas and Intermediate Zones,MSOAIZ,MK,9090,4327,4763,1667,1952
E02003623,Bedford 008,Middle Super Output Areas and Intermediate Zones,MSOAIZ,MK,8144,3992,4152,1513,1655
E02003624,Bedford 009,Middle Super Output Areas and Intermediate Zones,MSOAIZ,MK,6008,3076,2932,1170,1009
E02003625,Bedford 010,Middle Super Output Areas and Intermediate Zones,MSOAIZ,MK,8248,4251,3997,1957,1648
E02003626,Bedford 011,Middle Super Output Areas and Intermediate Zones,MSOAIZ,MK,5395,2621,2774,1130,1198
E02003627,Bedford 012,Middle Super Output Areas and Intermediate Zones,MSOAIZ,MK,9069,4609,4460,2306,1992
E02003628,Bedford 013,Middle Super Output Areas and Intermediate Zones,MSOAIZ,MK,8552,4292,4260,1879,1828
E02003629,Bedford 014,Middle Super Output Areas and Intermediate Zones,MSOAIZ,MK,9468,4597,4871,2042,2133
E02003630,Bedford 015,Middle Super Output Areas and Intermediate Zones,MSOAIZ,MK,9681,4727,4954,2257,2260
E02003631,Bedford 016,Middle Super Output Areas and Intermediate Zones,MSOAIZ,MK,5475,2659,2816,1097,1236
E02003632,Bedford 017,Middle Super Output Areas and Intermediate Zones,MSOAIZ,MK,6061,2943,3118,1297,1413
E02003633,Bedford 018,Middle Super Output Areas and Intermediate Zones,MSOAIZ,MK,7794,3786,4008,1541,1673
E02003634,Bedford 019,Middle Super Output Areas and Intermediate Zones,MSOAIZ,MK,9499,4561,4938,1975,2146
E02003635,Bedford 020,Middle Super Output Areas and Intermediate Zones,MSOAIZ,MK,5346,2636,2710,997,1099
E02003636,Central Bedfordshire 018,Middle Super Output Areas and Intermediate Zones,MSOAIZ,MK,7312,3610,3702,1514,1621
E02003637,Central Bedfordshire 019,Middle Super Output Areas and Intermediate Zones,MSOAIZ,MK,9389,4697,4692,1792,1940
E02003638,Central Bedfordshire 020,Middle Super Output Areas and Intermediate Zones,MSOAIZ,LU,7501,3713,3788,1419,1451
E02003639,Central Bedfordshire 021,Middle Super Output Areas and Intermediate Zones,MSOAIZ,LU,8645,4158,4487,1893,1899
E02003640,Central Bedfordshire 022,Middle Super Output Areas and Intermediate Zones,MSOAIZ,LU,6010,3018,2992,1259,1216
E02003641,Central Bedfordshire 023,Middle Super Output Areas and Intermediate Zones,MSOAIZ,LU,5474,2718,2756,1182,1195
E02003642,Central Bedfordshire 025,Middle Super Output Areas and Intermediate Zones,MSOAIZ,LU,8796,4358,4438,1830,1965
E02003643,Central Bedfordshire 024,Middle Super Output Areas and Intermediate Zones,MSOAIZ,LU,9839,4910,4929,2397,2386
E02003644,Central Bedfordshire 026,Middle Super Output Areas and Intermediate Zones,MSOAIZ,LU,8487,4098,4389,1790,1921
E02003645,Central Bedfordshire 027,Middle Super Output Areas and Intermediate Zones,MSOAIZ,LU,6746,3337,3409,1322,1365
E02003646,Central Bedfordshire 028,Middle Super Output Areas and Intermediate Zones,MSOAIZ,LU,8865,4370,4495,1763,1858
E02003647,Central Bedfordshire 029,Middle Super Output Areas and Intermediate Zones,MSOAIZ,LU,8574,4215,4359,1864,1865
E02003648,Central Bedfordshire 030,Middle Super Output Areas and Intermediate Zones,MSOAIZ,LU,5193,2526,2667,996,1084
E02003649,Central Bedfordshire 031,Middle Super Output Areas and Intermediate Zones,MSOAIZ,LU,6875,3392,3483,1367,1384
E02003650,Central Bedfordshire 032,Middle Super Output Areas and Intermediate Zones,MSOAIZ,LU,6760,3328,3432,1210,1271
E02003651,Central Bedfordshire 033,Middle Super Output Areas and Intermediate Zones,MSOAIZ,LU,5926,2896,3030,1104,1186
E02003652,Aylesbury Vale 001,Middle Super Output Areas and Intermediate Zones,MSOAIZ,NN,8623,4348,4275,1641,1692
E02003653,Aylesbury Vale 002,Middle Super Output Areas and Intermediate Zones,MSOAIZ,MK,6469,3215,3254,1282,1273
E02003654,Aylesbury Vale 003,Middle Super Output Areas and Intermediate Zones,MSOAIZ,MK,5531,2781,2750,1039,1104
E02003655,Aylesbury Vale 004,Middle Super Output Areas and Intermediate Zones,MSOAIZ,OX,9456,4694,4762,1909,2059
E02003656,Aylesbury Vale 005,Middle Super Output Areas and Intermediate Zones,MSOAIZ,MK,5725,2762,2963,1088,1149
E02003657,Aylesbury Vale 006,Middle Super Output Areas and Intermediate Zones,MSOAIZ,MK,6053,2978,3075,1127,1194
E02003658,Aylesbury Vale 007,Middle Super Output Areas and Intermediate Zones,MSOAIZ,LU,7041,3449,3592,1353,1479
E02003659,Aylesbury Vale 008,Middle Super Output Areas and Intermediate Zones,MSOAIZ,MK,8334,4068,4266,1664,1854
E02003660,Aylesbury Vale 009,Middle Super Output Areas and Intermediate Zones,MSOAIZ,LU,9544,4736,4808,1906,2062
E02003661,Aylesbury Vale 010,Middle Super Output Areas and Intermediate Zones,MSOAIZ,OX,5750,3096,2654,1490,1057
E02003662,Aylesbury Vale 011,Middle Super Output Areas and Intermediate Zones,MSOAIZ,HP,6266,3100,3166,1519,1536
E02003663,Aylesbury Vale 012,Middle Super Output Areas and Intermediate Zones,MSOAIZ,HP,5478,2674,2804,1173,1317
E02003664,Aylesbury Vale 013,Middle Super Output Areas and Intermediate Zones,MSOAIZ,HP,6187,3075,3112,1375,1337
E02003665,Aylesbury Vale 014,Middle Super Output Areas and Intermediate Zones,MSOAIZ,HP,5896,3075,2821,1318,1260
E02003666,Aylesbury Vale 015,Middle Super Output Areas and Intermediate Zones,MSOAIZ,HP,6723,3390,3333,1710,1520
E02003667,Aylesbury Vale 016,Middle Super Output Areas and Intermediate Zones,MSOAIZ,HP,9398,4675,4723,2639,2494
E02003668,Aylesbury Vale 017,Middle Super Output Areas and Intermediate Zones,MSOAIZ,HP,8804,4369,4435,1704,1648
E02003669,Aylesbury Vale 018,Middle Super Output Areas and Intermediate Zones,MSOAIZ,HP,6912,3402,3510,1483,1468
E02003670,Aylesbury Vale 019,Middle Super Output Areas and Intermediate Zones,MSOAIZ,HP,8726,4352,4374,2078,1966
E02003671,Aylesbury Vale 020,Middle Super Output Areas and Intermediate Zones,MSOAIZ,HP,5882,2858,3024,1397,1505
E02003672,Aylesbury Vale 021,Middle Super Output Areas and Intermediate Zones,MSOAIZ,HP,9641,4676,4965,1845,1959
E02003673,Aylesbury Vale 022,Middle Super Output Areas and Intermediate Zones,MSOAIZ,OX,8105,3910,4195,1487,1596
E02003674,Aylesbury Vale 023,Middle Super Output Areas and Intermediate Zones,MSOAIZ,OX,5259,2559,2700,955,1039
E02003675,Aylesbury Vale 024,Middle Super Output Areas and Intermediate Zones,MSOAIZ,HP,8334,3999,4335,1620,1723
E02003676,Chiltern 001,Middle Super Output Areas and Intermediate Zones,MSOAIZ,WD,8015,3994,4021,1396,1508
E02003677,Chiltern 002,Middle Super Output Areas and Intermediate Zones,MSOAIZ,HP,9593,4775,4818,2005,1907
E02003678,Chiltern 003,Middle Super Output Areas and Intermediate Zones,MSOAIZ,HP,5518,2718,2800,1138,1173
E02003679,Chiltern 004,Middle Super Output Areas and Intermediate Zones,MSOAIZ,HP,6372,3107,3265,1432,1404
E02003680,Chiltern 005,Middle Super Output Areas and Intermediate Zones,MSOAIZ,HP,10072,4857,5215,1730,1875
E02003681,Chiltern 006,Middle Super Output Areas and Intermediate Zones,MSOAIZ,HP,10172,4925,5247,1875,1939
E02003682,Chiltern 007,Middle Super Output Areas and Intermediate Zones,MSOAIZ,HP,7329,3600,3729,1518,1553
E02003683,Chiltern 008,Middle Super Output Areas and Intermediate Zones,MSOAIZ,HP,6292,3019,3273,1158,1251
E02003685,Chiltern 010,Middle Super Output Areas and Intermediate Zones,MSOAIZ,SL,7957,3835,4122,1414,1559
E02003686,Chiltern 011,Middle Super Output Areas and Intermediate Zones,MSOAIZ,WD,7068,3414,3654,1273,1365
E02003687,Chiltern 012,Middle Super Output Areas and Intermediate Zones,MSOAIZ,SL,5698,2689,3009,1000,1128
E02003688,South Bucks 001,Middle Super Output Areas and Intermediate Zones,MSOAIZ,HP,12081,5853,6228,2395,2432
E02003689,South Bucks 002,Middle Super Output Areas and Intermediate Zones,MSOAIZ,UB,8693,4181,4512,1577,1695
E02003690,South Bucks 003,Middle Super Output Areas and Intermediate Zones,MSOAIZ,WD,6463,3146,3317,1266,1268
E02003691,South Bucks 004,Middle Super Output Areas and Intermediate Zones,MSOAIZ,SL,6857,3293,3564,1266,1367
E02003692,South Bucks 005,Middle Super Output Areas and Intermediate Zones,MSOAIZ,SL,8476,4162,4314,1661,1692
E02003693,South Bucks 006,Middle Super Output Areas and Intermediate Zones,MSOAIZ,SL,6205,2983,3222,1132,1228
E02003694,South Bucks 007,Middle Super Output Areas and Intermediate Zones,MSOAIZ,SL,7846,3761,4085,1607,1757
E02003695,South Bucks 008,Middle Super Output Areas and Intermediate Zones,MSOAIZ,SL,10246,5060,5186,2089,2119
E02003696,Wycombe 001,Middle Super Output Areas and Intermediate Zones,MSOAIZ,HP,8101,3847,4254,1398,1463
E02003697,Wycombe 002,Middle Super Output Areas and Intermediate Zones,MSOAIZ,OX,6052,2982,3070,1131,1194
E02003698,Wycombe 003,Middle Super Output Areas and Intermediate Zones,MSOAIZ,HP,8362,4135,4227,1497,1565
E02003699,Wycombe 004,Middle Super Output Areas and Intermediate Zones,MSOAIZ,OX,5554,2763,2791,1107,1142
E02003701,Wycombe 006,Middle Super Output Areas and Intermediate Zones,MSOAIZ,HP,11169,5569,5600,2316,2378
E02003702,Wycombe 007,Middle Super Output Areas and Intermediate Zones,MSOAIZ,SL,8286,4165,4121,1768,1723
E02003703,Wycombe 008,Middle Super Output Areas and Intermediate Zones,MSOAIZ,HP,7835,3944,3891,1708,1621
E02003704,Wycombe 009,Middle Super Output Areas and Intermediate Zones,MSOAIZ,HP,5919,2921,2998,1164,1250
E02003705,Wycombe 010,Middle Super Output Areas and Intermediate Zones,MSOAIZ,HP,6920,3547,3373,1597,1526
E02003706,Wycombe 011,Middle Super Output Areas and Intermediate Zones,MSOAIZ,HP,6562,3208,3354,1424,1452
E02003707,Wycombe 012,Middle Super Output Areas and Intermediate Zones,MSOAIZ,HP,6214,3169,3045,1531,1384
E02003708,Wycombe 013,Middle Super Output Areas and Intermediate Zones,MSOAIZ,HP,9406,4847,4559,2170,1938
E02003709,Wycombe 014,Middle Super Output Areas and Intermediate Zones,MSOAIZ,HP,5807,2807,3000,1240,1320
E02003710,Wycombe 015,Middle Super Output Areas and Intermediate Zones,MSOAIZ,HP,10365,4987,5378,2168,1975
E02003711,Wycombe 016,Middle Super Output Areas and Intermediate Zones,MSOAIZ,HP,8486,4247,4239,2160,2028
E02003712,Wycombe 017,Middle Super Output Areas and Intermediate Zones,MSOAIZ,RG,7825,3819,4006,1574,1558
E02003713,Wycombe 018,Middle Super Output Areas and Intermediate Zones,MSOAIZ,HP,5965,2876,3089,1061,1118
E02003714,Wycombe 019,Middle Super Output Areas and Intermediate Zones,MSOAIZ,SL,6627,3194,3433,1425,1512
E02003715,Wycombe 020,Middle Super Output Areas and Intermediate Zones,MSOAIZ,SL,6710,3382,3328,1246,1317
E02003716,Wycombe 021,Middle Super Output Areas and Intermediate Zones,MSOAIZ,SL,5531,2675,2856,1041,1085
E02003717,Wycombe 022,Middle Super Output Areas and Intermediate Zones,MSOAIZ,SL,8799,4238,4561,1640,1739
E02003718,Wycombe 023,Middle Super Output Areas and Intermediate Zones,MSOAIZ,SL,5526,2644,2882,1160,1241
E02003719,Cambridge 001,Middle Super Output Areas and Intermediate Zones,MSOAIZ,CB,9142,4644,4498,2282,2106
E02003720,Cambridge 002,Middle Super Output Areas and Intermediate Zones,MSOAIZ,CB,9070,4607,4463,2240,1881
E02003721,Cambridge 003,Middle Super Output Areas and Intermediate Zones,MSOAIZ,CB,9405,4731,4674,2332,2205
E02003722,Cambridge 004,Middle Super Output Areas and Intermediate Zones,MSOAIZ,CB,8629,4424,4205,2246,1882
E02003723,Cambridge 005,Middle Super Output Areas and Intermediate Zones,MSOAIZ,CB,9785,5165,4620,1521,1290
E02003724,Cambridge 006,Middle Super Output Areas and Intermediate Zones,MSOAIZ,CB,9907,5104,4803,2577,2331
E02003725,Cambridge 007,Middle Super Output Areas and Intermediate Zones,MSOAIZ,CB,15017,7933,7084,2640,2134
E02003726,Cambridge 008,Middle Super Output Areas and Intermediate Zones,MSOAIZ,CB,8333,4277,4056,2173,1850
E02003727,Cambridge 009,Middle Super Output Areas and Intermediate Zones,MSOAIZ,CB,9252,4704,4548,2585,2335
E02003728,Cambridge 010,Middle Super Output Areas and Intermediate Zones,MSOAIZ,CB,9386,4770,4616,2175,2010
E02003729,Cambridge 011,Middle Super Output Areas and Intermediate Zones,MSOAIZ,CB,8780,4293,4487,1916,1997
E02003730,Cambridge 012,Middle Super Output Areas and Intermediate Zones,MSOAIZ,CB,8034,3979,4055,1840,1737
E02003731,Cambridge 013,Middle Super Output Areas and Intermediate Zones,MSOAIZ,CB,9127,4353,4774,1750,1805
E02003732,East Cambridgeshire 001,Middle Super Output Areas and Intermediate Zones,MSOAIZ,PE,8738,4329,4409,1836,1810
E02003733,East Cambridgeshire 002,Middle Super Output Areas and Intermediate Zones,MSOAIZ,CB,8376,4140,4236,1696,1771
E02003734,East Cambridgeshire 003,Middle Super Output Areas and Intermediate Zones,MSOAIZ,CB,11773,5754,6019,2540,2573
E02003735,East Cambridgeshire 004,Middle Super Output Areas and Intermediate Zones,MSOAIZ,CB,8483,4188,4295,1914,1856
E02003736,East Cambridgeshire 005,Middle Super Output Areas and Intermediate Zones,MSOAIZ,PE,9900,4975,4925,1972,2023
E02003737,East Cambridgeshire 006,Middle Super Output Areas and Intermediate Zones,MSOAIZ,CB,11699,5875,5824,2659,2570
E02003738,East Cambridgeshire 007,Middle Super Output Areas and Intermediate Zones,MSOAIZ,IP,6146,3036,3110,1250,1331
E02003739,East Cambridgeshire 008,Middle Super Output Areas and Intermediate Zones,MSOAIZ,CB,6309,3084,3225,1250,1301
E02003740,East Cambridgeshire 009,Middle Super Output Areas and Intermediate Zones,MSOAIZ,CB,6039,2907,3132,1075,1173
E02003742,Fenland 001,Middle Super Output Areas and Intermediate Zones,MSOAIZ,PE,6305,3114,3191,1067,1122
E02003743,Fenland 002,Middle Super Output Areas and Intermediate Zones,MSOAIZ,PE,10173,5007,5166,1986,2018
E02003744,Fenland 003,Middle Super Output Areas and Intermediate Zones,MSOAIZ,PE,12668,6178,6490,2542,2482
E02003745,Fenland 004,Middle Super Output Areas and Intermediate Zones,MSOAIZ,PE,9690,4766,4924,1749,1854
E02003746,Fenland 005,Middle Super Output Areas and Intermediate Zones,MSOAIZ,PE,7835,4079,3756,1816,1443
E02003747,Fenland 006,Middle Super Output Areas and Intermediate Zones,MSOAIZ,PE,11197,5396,5801,2025,2205
E02003748,Fenland 007,Middle Super Output Areas and Intermediate Zones,MSOAIZ,PE,7430,3581,3849,1314,1348
E02003749,Fenland 008,Middle Super Output Areas and Intermediate Zones,MSOAIZ,PE,5998,2983,3015,1208,1258
E02003750,Fenland 009,Middle Super Output Areas and Intermediate Zones,MSOAIZ,PE,7033,3366,3667,1197,1252
E02003751,Fenland 010,Middle Super Output Areas and Intermediate Zones,MSOAIZ,PE,6480,3178,3302,1262,1278
E02003752,Fenland 011,Middle Super Output Areas and Intermediate Zones,MSOAIZ,PE,10453,5163,5290,2105,2136
E02003753,Huntingdonshire 001,Middle Super Output Areas and Intermediate Zones,MSOAIZ,PE,11041,5400,5641,2317,2414
E02003754,Huntingdonshire 002,Middle Super Output Areas and Intermediate Zones,MSOAIZ,PE,5758,2844,2914,1108,1196
E02003755,Huntingdonshire 003,Middle Super Output Areas and Intermediate Zones,MSOAIZ,PE,8479,4231,4248,1698,1679
E02003756,Huntingdonshire 004,Middle Super Output Areas and Intermediate Zones,MSOAIZ,PE,6536,3246,3290,1270,1361
E02003757,Huntingdonshire 005,Middle Super Output Areas and Intermediate Zones,MSOAIZ,PE,6354,3140,3214,1245,1326
E02003758,Huntingdonshire 006,Middle Super Output Areas and Intermediate Zones,MSOAIZ,PE,9375,4662,4713,1981,1985
E02003759,Huntingdonshire 007,Middle Super Output Areas and Intermediate Zones,MSOAIZ,PE,6126,3095,3031,1200,1236
E02003760,Huntingdonshire 008,Middle Super Output Areas and Intermediate Zones,MSOAIZ,PE,8377,4137,4240,1794,1885
E02003761,Huntingdonshire 009,Middle Super Output Areas and Intermediate Zones,MSOAIZ,PE,5957,2902,3055,1157,1173
E02003762,Huntingdonshire 010,Middle Super Output Areas and Intermediate Zones,MSOAIZ,PE,8571,4273,4298,1719,1714
E02003763,Huntingdonshire 011,Middle Super Output Areas and Intermediate Zones,MSOAIZ,PE,9869,4859,5010,2137,2205
E02003764,Huntingdonshire 012,Middle Super Output Areas and Intermediate Zones,MSOAIZ,PE,9398,4682,4716,2350,2291
E02003765,Huntingdonshire 013,Middle Super Output Areas and Intermediate Zones,MSOAIZ,PE,6515,3245,3270,1357,1253
E02003766,Huntingdonshire 014,Middle Super Output Areas and Intermediate Zones,MSOAIZ,PE,6711,3275,3436,1443,1463
E02003767,Huntingdonshire 015,Middle Super Output Areas and Intermediate Zones,MSOAIZ,PE,6528,3238,3290,1223,1290
E02003768,Huntingdonshire 016,Middle Super Output Areas and Intermediate Zones,MSOAIZ,PE,9278,4526,4752,1675,1805
E02003769,Huntingdonshire 017,Middle Super Output Areas and Intermediate Zones,MSOAIZ,PE,7433,4241,3192,1670,1233
E02003770,Huntingdonshire 018,Middle Super Output Areas and Intermediate Zones,MSOAIZ,SG,7934,3909,4025,1605,1640
E02003771,Huntingdonshire 019,Middle Super Output Areas and Intermediate Zones,MSOAIZ,PE,6272,3098,3174,1277,1254
E02003772,Huntingdonshire 020,Middle Super Output Areas and Intermediate Zones,MSOAIZ,PE,6815,3407,3408,1383,1340
E02003773,Huntingdonshire 021,Middle Super Output Areas and Intermediate Zones,MSOAIZ,PE,10477,5263,5214,2400,2340
E02003774,Huntingdonshire 022,Middle Super Output Areas and Intermediate Zones,MSOAIZ,PE,5704,2859,2845,1231,1170
E02003775,South Cambridgeshire 001,Middle Super Output Areas and Intermediate Zones,MSOAIZ,PE,6877,3402,3475,1399,1500
E02003776,South Cambridgeshire 002,Middle Super Output Areas and Intermediate Zones,MSOAIZ,CB,6543,3181,3362,1303,1397
E02003777,South Cambridgeshire 003,Middle Super Output Areas and Intermediate Zones,MSOAIZ,CB,6647,3347,3300,1454,1486
E02003778,South Cambridgeshire 004,Middle Super Output Areas and Intermediate Zones,MSOAIZ,CB,6014,3229,2785,1426,1202
E02003779,South Cambridgeshire 005,Middle Super Output Areas and Intermediate Zones,MSOAIZ,CB,5048,2519,2529,1087,1092
E02003780,South Cambridgeshire 006,Middle Super Output Areas and Intermediate Zones,MSOAIZ,CB,10600,5217,5383,2285,2260
E02003781,South Cambridgeshire 007,Middle Super Output Areas and Intermediate Zones,MSOAIZ,CB,6361,3195,3166,1530,1430
E02003783,South Cambridgeshire 009,Middle Super Output Areas and Intermediate Zones,MSOAIZ,CB,7065,3479,3586,1285,1301
E02003784,South Cambridgeshire 010,Middle Super Output Areas and Intermediate Zones,MSOAIZ,SG,8643,4237,4406,1677,1802
E02003785,South Cambridgeshire 011,Middle Super Output Areas and Intermediate Zones,MSOAIZ,CB,8695,4320,4375,1857,1844
E02003786,South Cambridgeshire 012,Middle Super Output Areas and Intermediate Zones,MSOAIZ,CB,6104,2982,3122,1143,1162
E02003787,South Cambridgeshire 013,Middle Super Output Areas and Intermediate Zones,MSOAIZ,SG,7229,3552,3677,1329,1419
E02003788,South Cambridgeshire 014,Middle Super Output Areas and Intermediate Zones,MSOAIZ,SG,6359,3176,3183,1179,1210
E02003789,South Cambridgeshire 015,Middle Super Output Areas and Intermediate Zones,MSOAIZ,CB,7145,3531,3614,1418,1448
E02003790,South Cambridgeshire 016,Middle Super Output Areas and Intermediate Zones,MSOAIZ,CB,9528,4656,4872,1751,1876
E02003791,South Cambridgeshire 017,Middle Super Output Areas and Intermediate Zones,MSOAIZ,SG,7816,3861,3955,1535,1621
E02003792,South Cambridgeshire 018,Middle Super Output Areas and Intermediate Zones,MSOAIZ,SG,9367,4577,4790,1790,1838
E02003793,South Cambridgeshire 019,Middle Super Output Areas and Intermediate Zones,MSOAIZ,SG,7492,3770,3722,1631,1582
E02003794,Cheshire West and Chester 022,Middle Super Output Areas and Intermediate Zones,MSOAIZ,WA,8609,4271,4338,1694,1787
E02003795,Cheshire West and Chester 025,Middle Super Output Areas and Intermediate Zones,MSOAIZ,L,5595,2730,2865,993,1048
E02003796,Cheshire West and Chester 027,Middle Super Output Areas and Intermediate Zones,MSOAIZ,CH,7178,3402,3776,1297,1382
E02003797,Cheshire West and Chester 028,Middle Super Output Areas and Intermediate Zones,MSOAIZ,CH,9547,4607,4940,1989,1956
E02003798,Cheshire West and Chester 029,Middle Super Output Areas and Intermediate Zones,MSOAIZ,CH,6060,2877,3183,1137,1324
E02003799,Cheshire West and Chester 031,Middle Super Output Areas and Intermediate Zones,MSOAIZ,CH,7039,3421,3618,1375,1431
E02003800,Cheshire West and Chester 030,Middle Super Output Areas and Intermediate Zones,MSOAIZ,CW,6273,3025,3248,1083,1176
E02003801,Cheshire West and Chester 032,Middle Super Output Areas and Intermediate Zones,MSOAIZ,CH,7019,3426,3593,1382,1486
E02003802,Cheshire West and Chester 033,Middle Super Output Areas and Intermediate Zones,MSOAIZ,CH,8051,4179,3872,2240,1758
E02003803,Cheshire West and Chester 034,Middle Super Output Areas and Intermediate Zones,MSOAIZ,CH,8909,4138,4771,1686,1333
E02003804,Cheshire West and Chester 036,Middle Super Output Areas and Intermediate Zones,MSOAIZ,CH,6773,3312,3461,1607,1634
E02003805,Cheshire West and Chester 039,Middle Super Output Areas and Intermediate Zones,MSOAIZ,CH,6195,2978,3217,1015,1130
E02003806,Cheshire West and Chester 041,Middle Super Output Areas and Intermediate Zones,MSOAIZ,CH,5942,2884,3058,1160,1229
E02003807,Cheshire West and Chester 043,Middle Super Output Areas and Intermediate Zones,MSOAIZ,CH,8181,3912,4269,1515,1618
E02003808,Cheshire West and Chester 044,Middle Super Output Areas and Intermediate Zones,MSOAIZ,CH,6419,3157,3262,1460,1487
E02003809,Cheshire West and Chester 046,Middle Super Output Areas and Intermediate Zones,MSOAIZ,CW,7496,3652,3844,1344,1460
E02003810,Cheshire West and Chester 047,Middle Super Output Areas and Intermediate Zones,MSOAIZ,SY,7973,3871,4102,1352,1521
E02003811,Cheshire East 022,Middle Super Output Areas and Intermediate Zones,MSOAIZ,WA,5893,2941,2952,989,1063
E02003812,Cheshire East 023,Middle Super Output Areas and Intermediate Zones,MSOAIZ,CW,5605,2699,2906,1008,1055
E02003813,Cheshire East 024,Middle Super Output Areas and Intermediate Zones,MSOAIZ,CW,6248,3086,3162,1252,1285
E02003814,Cheshire East 025,Middle Super Output Areas and Intermediate Zones,MSOAIZ,CW,7347,3628,3719,1622,1746
E02003815,Cheshire East 026,Middle Super Output Areas and Intermediate Zones,MSOAIZ,CW,6818,3391,3427,1334,1342
E02003816,Cheshire East 027,Middle Super Output Areas and Intermediate Zones,MSOAIZ,CW,6823,3371,3452,1405,1351
E02003817,Cheshire East 028,Middle Super Output Areas and Intermediate Zones,MSOAIZ,CW,7029,3426,3603,1287,1320
E02003818,Cheshire East 029,Middle Super Output Areas and Intermediate Zones,MSOAIZ,CW,5812,2854,2958,1113,1125
E02003819,Cheshire East 030,Middle Super Output Areas and Intermediate Zones,MSOAIZ,CW,5748,2753,2995,999,1025
E02003820,Cheshire East 031,Middle Super Output Areas and Intermediate Zones,MSOAIZ,CW,6792,3379,3413,1561,1583
E02003821,Cheshire East 032,Middle Super Output Areas and Intermediate Zones,MSOAIZ,CW,5436,2649,2787,1011,1025
E02003822,Cheshire East 033,Middle Super Output Areas and Intermediate Zones,MSOAIZ,ST,10634,5286,5348,1921,2082
E02003823,Cheshire East 040,Middle Super Output Areas and Intermediate Zones,MSOAIZ,ST,6525,3136,3389,1125,1168
E02003824,Cheshire East 042,Middle Super Output Areas and Intermediate Zones,MSOAIZ,ST,5250,2582,2668,938,1031
E02003825,Cheshire East 034,Middle Super Output Areas and Intermediate Zones,MSOAIZ,CW,6800,3479,3321,1684,1684
E02003826,Cheshire East 035,Middle Super Output Areas and Intermediate Zones,MSOAIZ,CW,7513,3627,3886,1382,1520
E02003827,Cheshire East 036,Middle Super Output Areas and Intermediate Zones,MSOAIZ,CW,8707,4307,4400,1827,1768
E02003828,Cheshire East 037,Middle Super Output Areas and Intermediate Zones,MSOAIZ,CW,6713,3259,3454,1285,1367
E02003829,Cheshire East 038,Middle Super Output Areas and Intermediate Zones,MSOAIZ,CW,6436,3156,3280,1017,1015
E02003830,Cheshire East 039,Middle Super Output Areas and Intermediate Zones,MSOAIZ,CW,7294,3606,3688,1651,1631
E02003831,Cheshire East 041,Middle Super Output Areas and Intermediate Zones,MSOAIZ,ST,9062,4419,4643,1780,1855
E02003832,Cheshire East 043,Middle Super Output Areas and Intermediate Zones,MSOAIZ,CW,6008,3121,2887,1394,1259
E02003833,Cheshire East 044,Middle Super Output Areas and Intermediate Zones,MSOAIZ,CW,6374,3107,3267,1285,1327
E02003834,Cheshire East 045,Middle Super Output Areas and Intermediate Zones,MSOAIZ,CW,6737,3399,3338,1466,1462
E02003835,Cheshire East 046,Middle Super Output Areas and Intermediate Zones,MSOAIZ,CW,7853,3893,3960,1362,1438
E02003836,Cheshire East 047,Middle Super Output Areas and Intermediate Zones,MSOAIZ,CW,6898,3298,3600,1296,1263
E02003837,Cheshire East 049,Middle Super Output Areas and Intermediate Zones,MSOAIZ,CW,12035,6018,6017,2496,2593
E02003838,Cheshire East 048,Middle Super Output Areas and Intermediate Zones,MSOAIZ,CW,6104,2962,3142,1126,1175
E02003839,Cheshire East 050,Middle Super Output Areas and Intermediate Zones,MSOAIZ,CW,7066,3395,3671,1358,1369
E02003840,Cheshire East 051,Middle Super Output Areas and Intermediate Zones,MSOAIZ,TF,10043,4965,5078,1768,1859
E02003841,Cheshire West and Chester 001,Middle Super Output Areas and Intermediate Zones,MSOAIZ,L,7636,3641,3995,1296,1397
E02003842,Cheshire West and Chester 004,Middle Super Output Areas and Intermediate Zones,MSOAIZ,L,5332,2592,2740,850,945
E02003843,Cheshire West and Chester 005,Middle Super Output Areas and Intermediate Zones,MSOAIZ,L,5852,2852,3000,1107,1141
E02003844,Cheshire West and Chester 006,Middle Super Output Areas and Intermediate Zones,MSOAIZ,L,6772,3269,3503,1177,1243
E02003845,Cheshire West and Chester 007,Middle Super Output Areas and Intermediate Zones,MSOAIZ,L,8128,3929,4199,1785,1842
E02003846,Cheshire West and Chester 008,Middle Super Output Areas and Intermediate Zones,MSOAIZ,L,6781,3192,3589,1266,1482
E02003847,Cheshire West and Chester 009,Middle Super Output Areas and Intermediate Zones,MSOAIZ,L,9625,4782,4843,2006,2105
E02003848,Cheshire West and Chester 010,Middle Super Output Areas and Intermediate Zones,MSOAIZ,L,5113,2465,2648,943,1088
E02003849,Cheshire West and Chester 011,Middle Super Output Areas and Intermediate Zones,MSOAIZ,L,6855,3371,3484,1385,1424
E02003850,Cheshire West and Chester 013,Middle Super Output Areas and Intermediate Zones,MSOAIZ,L,5351,2593,2758,1002,1093
E02003851,Cheshire West and Chester 014,Middle Super Output Areas and Intermediate Zones,MSOAIZ,L,5891,2886,3005,1148,1243
E02003852,Cheshire West and Chester 016,Middle Super Output Areas and Intermediate Zones,MSOAIZ,L,6870,3420,3450,1355,1440
E02003853,Cheshire East 001,Middle Super Output Areas and Intermediate Zones,MSOAIZ,SK,5688,2805,2883,1020,1076
E02003854,Cheshire East 002,Middle Super Output Areas and Intermediate Zones,MSOAIZ,SK,6402,3082,3320,1088,1208
E02003855,Cheshire East 003,Middle Super Output Areas and Intermediate Zones,MSOAIZ,SK,6614,3215,3399,1073,1107
E02003856,Cheshire East 004,Middle Super Output Areas and Intermediate Zones,MSOAIZ,SK,10241,5039,5202,2179,2216
E02003857,Cheshire East 005,Middle Super Output Areas and Intermediate Zones,MSOAIZ,SK,6396,3181,3215,1401,1437
E02003858,Cheshire East 006,Middle Super Output Areas and Intermediate Zones,MSOAIZ,SK,6605,3204,3401,1311,1352
E02003859,Cheshire East 007,Middle Super Output Areas and Intermediate Zones,MSOAIZ,WA,11807,5640,6167,2038,2396
E02003860,Cheshire East 008,Middle Super Output Areas and Intermediate Zones,MSOAIZ,SK,6990,3413,3577,1322,1373
E02003861,Cheshire East 009,Middle Super Output Areas and Intermediate Zones,MSOAIZ,WA,6418,3088,3330,1224,1337
E02003862,Cheshire East 011,Middle Super Output Areas and Intermediate Zones,MSOAIZ,SK,5128,2420,2708,737,866
E02003863,Cheshire East 010,Middle Super Output Areas and Intermediate Zones,MSOAIZ,WA,6773,3269,3504,1257,1306
E02003864,Cheshire East 012,Middle Super Output Areas and Intermediate Zones,MSOAIZ,WA,8026,3853,4173,1470,1542
E02003865,Cheshire East 013,Middle Super Output Areas and Intermediate Zones,MSOAIZ,SK,7593,3741,3852,1564,1649
E02003866,Cheshire East 014,Middle Super Output Areas and Intermediate Zones,MSOAIZ,SK,5961,2961,3000,1158,1248
E02003867,Cheshire East 015,Middle Super Output Areas and Intermediate Zones,MSOAIZ,SK,7544,3649,3895,1534,1681
E02003868,Cheshire East 016,Middle Super Output Areas and Intermediate Zones,MSOAIZ,SK,8257,4049,4208,1786,1766
E02003869,Cheshire East 017,Middle Super Output Areas and Intermediate Zones,MSOAIZ,SK,7020,3458,3562,1431,1389
E02003870,Cheshire East 018,Middle Super Output Areas and Intermediate Zones,MSOAIZ,SK,10288,5098,5190,2630,2467
E02003871,Cheshire East 019,Middle Super Output Areas and Intermediate Zones,MSOAIZ,SK,6996,3381,3615,1328,1403
E02003872,Cheshire East 020,Middle Super Output Areas and Intermediate Zones,MSOAIZ,SK,9657,4738,4919,1689,1766
E02003873,Cheshire East 021,Middle Super Output Areas and Intermediate Zones,MSOAIZ,SK,6120,2933,3187,1289,1380
E02003874,Cheshire West and Chester 002,Middle Super Output Areas and Intermediate Zones,MSOAIZ,WA,9077,4335,4742,1623,1721
E02003875,Cheshire West and Chester 003,Middle Super Output Areas and Intermediate Zones,MSOAIZ,WA,6414,3264,3150,1197,1214
E02003876,Cheshire West and Chester 012,Middle Super Output Areas and Intermediate Zones,MSOAIZ,CW,5614,2702,2912,1078,1158
E02003877,Cheshire West and Chester 015,Middle Super Output Areas and Intermediate Zones,MSOAIZ,WA,9214,4492,4722,1715,1811
E02003878,Cheshire West and Chester 017,Middle Super Output Areas and Intermediate Zones,MSOAIZ,WA,8009,4003,4006,1537,1565
E02003879,Cheshire West and Chester 018,Middle Super Output Areas and Intermediate Zones,MSOAIZ,CW,6270,3089,3181,1448,1406
E02003880,Cheshire West and Chester 019,Middle Super Output Areas and Intermediate Zones,MSOAIZ,CW,6391,3101,3290,1132,1218
E02003881,Cheshire West and Chester 020,Middle Super Output Areas and Intermediate Zones,MSOAIZ,CW,6069,3022,3047,1410,1406
E02003882,Cheshire West and Chester 021,Middle Super Output Areas and Intermediate Zones,MSOAIZ,CW,9513,4711,4802,1954,2021
E02003883,Cheshire West and Chester 023,Middle Super Output Areas and Intermediate Zones,MSOAIZ,CW,9893,4824,5069,2083,2240
E02003884,Cheshire West and Chester 024,Middle Super Output Areas and Intermediate Zones,MSOAIZ,WA,7897,3878,4019,1339,1444
E02003885,Cheshire West and Chester 026,Middle Super Output Areas and Intermediate Zones,MSOAIZ,CW,5646,2801,2845,1062,1123
E02003886,Cheshire West and Chester 035,Middle Super Output Areas and Intermediate Zones,MSOAIZ,CW,6647,3211,3436,1351,1439
E02003887,Cheshire West and Chester 037,Middle Super Output Areas and Intermediate Zones,MSOAIZ,CW,6137,3009,3128,1314,1383
E02003888,Cheshire West and Chester 038,Middle Super Output Areas and Intermediate Zones,MSOAIZ,CW,6124,2987,3137,1316,1289
E02003889,Cheshire West and Chester 040,Middle Super Output Areas and Intermediate Zones,MSOAIZ,CW,5643,2669,2974,994,1136
E02003890,Cheshire West and Chester 042,Middle Super Output Areas and Intermediate Zones,MSOAIZ,CW,5930,2874,3056,1168,1281
E02003891,Cheshire West and Chester 045,Middle Super Output Areas and Intermediate Zones,MSOAIZ,CW,5655,2780,2875,944,1031
E02003892,Cornwall 010,Middle Super Output Areas and Intermediate Zones,MSOAIZ,PL,6253,3023,3230,1002,1138
E02003893,Cornwall 012,Middle Super Output Areas and Intermediate Zones,MSOAIZ,PL,6481,3213,3268,1158,1200
E02003894,Cornwall 013,Middle Super Output Areas and Intermediate Zones,MSOAIZ,PL,8017,3954,4063,1508,1554
E02003895,Cornwall 016,Middle Super Output Areas and Intermediate Zones,MSOAIZ,PL,7965,3788,4177,1483,1575
E02003896,Cornwall 017,Middle Super Output Areas and Intermediate Zones,MSOAIZ,PL,5593,2716,2877,1001,1015
E02003897,Cornwall 022,Middle Super Output Areas and Intermediate Zones,MSOAIZ,PL,5412,2665,2747,1038,1120
E02003898,Cornwall 023,Middle Super Output Areas and Intermediate Zones,MSOAIZ,PL,6606,3253,3353,1079,1182
E02003899,Cornwall 025,Middle Super Output Areas and Intermediate Zones,MSOAIZ,PL,5280,2504,2776,897,992
E02003900,Cornwall 026,Middle Super Output Areas and Intermediate Zones,MSOAIZ,PL,7163,3501,3662,1397,1477
E02003901,Cornwall 028,Middle Super Output Areas and Intermediate Zones,MSOAIZ,PL,7453,3614,3839,1148,1219
E02003902,Cornwall 029,Middle Super Output Areas and Intermediate Zones,MSOAIZ,PL,5411,2582,2829,983,1083
E02003903,Cornwall 034,Middle Super Output Areas and Intermediate Zones,MSOAIZ,PL,6423,3128,3295,1140,1228
E02003904,Cornwall 037,Middle Super Output Areas and Intermediate Zones,MSOAIZ,PL,5325,2608,2717,858,896
E02003905,Cornwall 032,Middle Super Output Areas and Intermediate Zones,MSOAIZ,TR,6173,3029,3144,1237,1311
E02003906,Cornwall 033,Middle Super Output Areas and Intermediate Zones,MSOAIZ,TR,5406,2647,2759,986,1025
E02003907,Cornwall 040,Middle Super Output Areas and Intermediate Zones,MSOAIZ,TR,7565,3555,4010,1338,1532
E02003908,Cornwall 042,Middle Super Output Areas and Intermediate Zones,MSOAIZ,TR,7860,3716,4144,1460,1662
E02003909,Cornwall 043,Middle Super Output Areas and Intermediate Zones,MSOAIZ,TR,9113,4349,4764,1713,1859
E02003910,Cornwall 044,Middle Super Output Areas and Intermediate Zones,MSOAIZ,TR,6068,2871,3197,1201,1276
E02003911,Cornwall 047,Middle Super Output Areas and Intermediate Zones,MSOAIZ,TR,8381,4043,4338,1331,1489
E02003912,Cornwall 048,Middle Super Output Areas and Intermediate Zones,MSOAIZ,TR,7710,3668,4042,1276,1383
E02003913,Cornwall 056,Middle Super Output Areas and Intermediate Zones,MSOAIZ,TR,5804,2794,3010,836,944
E02003914,Cornwall 060,Middle Super Output Areas and Intermediate Zones,MSOAIZ,TR,7093,3482,3611,1382,1413
E02003915,Cornwall 062,Middle Super Output Areas and Intermediate Zones,MSOAIZ,TR,7725,3634,4091,1296,1417
E02003916,Cornwall 063,Middle Super Output Areas and Intermediate Zones,MSOAIZ,TR,6616,3158,3458,1058,1010
E02003917,Cornwall 064,Middle Super Output Areas and Intermediate Zones,MSOAIZ,TR,7456,3614,3842,1339,1479
E02003918,Cornwall 045,Middle Super Output Areas and Intermediate Zones,MSOAIZ,TR,6740,3277,3463,1253,1296
E02003919,Cornwall 046,Middle Super Output Areas and Intermediate Zones,MSOAIZ,TR,6804,3318,3486,1318,1353
E02003920,Cornwall 049,Middle Super Output Areas and Intermediate Zones,MSOAIZ,TR,7214,3531,3683,1448,1414
E02003921,Cornwall 050,Middle Super Output Areas and Intermediate Zones,MSOAIZ,TR,5821,2756,3065,1047,1174
E02003922,Cornwall 051,Middle Super Output Areas and Intermediate Zones,MSOAIZ,TR,7721,3826,3895,1536,1583
E02003923,Cornwall 052,Middle Super Output Areas and Intermediate Zones,MSOAIZ,TR,7204,3531,3673,1379,1404
E02003924,Cornwall 053,Middle Super Output Areas and Intermediate Zones,MSOAIZ,TR,6866,3242,3624,1171,1223
E02003925,Cornwall 055,Middle Super Output Areas and Intermediate Zones,MSOAIZ,TR,7067,3451,3616,1254,1427
E02003926,Cornwall 059,Middle Super Output Areas and Intermediate Zones,MSOAIZ,TR,7764,3849,3915,1431,1579
E02003927,Cornwall 066,Middle Super Output Areas and Intermediate Zones,MSOAIZ,TR,9645,4689,4956,1354,1430
E02003928,Cornwall 071,Middle Super Output Areas and Intermediate Zones,MSOAIZ,TR,11682,5635,6047,2314,2465
E02003929,Cornwall 072,Middle Super Output Areas and Intermediate Zones,MSOAIZ,TR,6585,3191,3394,1066,1131
E02003930,Cornwall 073,Middle Super Output Areas and Intermediate Zones,MSOAIZ,TR,8917,4702,4215,1582,1421
E02003931,Cornwall 001,Middle Super Output Areas and Intermediate Zones,MSOAIZ,EX,9934,4797,5137,1626,1784
E02003932,Cornwall 002,Middle Super Output Areas and Intermediate Zones,MSOAIZ,PL,6945,3438,3507,1204,1209
E02003933,Cornwall 003,Middle Super Output Areas and Intermediate Zones,MSOAIZ,PL,6881,3324,3557,1149,1222
E02003934,Cornwall 004,Middle Super Output Areas and Intermediate Zones,MSOAIZ,PL,6669,3260,3409,1163,1208
E02003935,Cornwall 005,Middle Super Output Areas and Intermediate Zones,MSOAIZ,PL,9216,4452,4764,1873,1868
E02003936,Cornwall 006,Middle Super Output Areas and Intermediate Zones,MSOAIZ,PL,8257,4055,4202,1393,1413
E02003937,Cornwall 007,Middle Super Output Areas and Intermediate Zones,MSOAIZ,PL,5553,2692,2861,875,928
E02003938,Cornwall 008,Middle Super Output Areas and Intermediate Zones,MSOAIZ,TR,6561,3167,3394,1166,1221
E02003939,Cornwall 009,Middle Super Output Areas and Intermediate Zones,MSOAIZ,PL,6721,3079,3642,1095,1240
E02003940,Cornwall 011,Middle Super Output Areas and Intermediate Zones,MSOAIZ,PL,6089,2976,3113,1019,1102
E02003941,Cornwall 014,Middle Super Output Areas and Intermediate Zones,MSOAIZ,PL,7347,3606,3741,1454,1444
E02003942,Cornwall 015,Middle Super Output Areas and Intermediate Zones,MSOAIZ,PL,7389,3536,3853,1399,1480
E02003943,Cornwall 054,Middle Super Output Areas and Intermediate Zones,MSOAIZ,TR,7543,3555,3988,1264,1407
E02003944,Cornwall 057,Middle Super Output Areas and Intermediate Zones,MSOAIZ,TR,9403,4498,4905,1667,1782
E02003945,Cornwall 058,Middle Super Output Areas and Intermediate Zones,MSOAIZ,TR,5973,2865,3108,928,1053
E02003946,Cornwall 061,Middle Super Output Areas and Intermediate Zones,MSOAIZ,TR,8803,4234,4569,1477,1607
E02003947,Cornwall 065,Middle Super Output Areas and Intermediate Zones,MSOAIZ,TR,6447,3114,3333,1100,1173
E02003948,Cornwall 067,Middle Super Output Areas and Intermediate Zones,MSOAIZ,TR,8265,3862,4403,1371,1568
E02003949,Cornwall 068,Middle Super Output Areas and Intermediate Zones,MSOAIZ,TR,6668,3176,3492,1343,1320
E02003950,Cornwall 069,Middle Super Output Areas and Intermediate Zones,MSOAIZ,TR,5375,2640,2735,970,1033
E02003951,Cornwall 070,Middle Super Output Areas and Intermediate Zones,MSOAIZ,TR,6112,2943,3169,917,1041
E02003952,Cornwall 018,Middle Super Output Areas and Intermediate Zones,MSOAIZ,TR,6671,3273,3398,1323,1288
E02003953,Cornwall 019,Middle Super Output Areas and Intermediate Zones,MSOAIZ,TR,10551,5161,5390,2006,2139
E02003954,Cornwall 020,Middle Super Output Areas and Intermediate Zones,MSOAIZ,TR,6891,3361,3530,1485,1440
E02003955,Cornwall 021,Middle Super Output Areas and Intermediate Zones,MSOAIZ,TR,9277,4557,4720,1839,1923
E02003956,Cornwall 024,Middle Super Output Areas and Intermediate Zones,MSOAIZ,TR,7050,3474,3576,1376,1394
E02003957,Cornwall 027,Middle Super Output Areas and Intermediate Zones,MSOAIZ,PL,10100,4998,5102,1827,1965
E02003958,Cornwall 030,Middle Super Output Areas and Intermediate Zones,MSOAIZ,TR,7827,3820,4007,1479,1576
E02003959,Cornwall 031,Middle Super Output Areas and Intermediate Zones,MSOAIZ,PL,6873,3327,3546,1226,1349
E02003960,Cornwall 035,Middle Super Output Areas and Intermediate Zones,MSOAIZ,PL,5858,2758,3100,866,998
E02003961,Cornwall 036,Middle Super Output Areas and Intermediate Zones,MSOAIZ,PL,9299,4496,4803,1611,1823
E02003962,Cornwall 038,Middle Super Output Areas and Intermediate Zones,MSOAIZ,PL,6344,3075,3269,1161,1189
E02003963,Cornwall 039,Middle Super Output Areas and Intermediate Zones,MSOAIZ,PL,9287,4419,4868,1703,1688
E02003964,Cornwall 041,Middle Super Output Areas and Intermediate Zones,MSOAIZ,TR,7712,3710,4002,1161,1242
E02003965,Allerdale 001,Middle Super Output Areas and Intermediate Zones,MSOAIZ,CA,10902,5232,5670,1930,1990
E02003966,Allerdale 002,Middle Super Output Areas and Intermediate Zones,MSOAIZ,CA,7063,3557,3506,1270,1301
E02003967,Allerdale 003,Middle Super Output Areas and Intermediate Zones,MSOAIZ,CA,8285,4128,4157,1513,1602
E02003968,Allerdale 004,Middle Super Output Areas and Intermediate Zones,MSOAIZ,CA,8619,4278,4341,1642,1680
E02003969,Allerdale 005,Middle Super Output Areas and Intermediate Zones,MSOAIZ,CA,6690,3253,3437,1239,1311
E02003970,Allerdale 006,Middle Super Output Areas and Intermediate Zones,MSOAIZ,CA,7750,3804,3946,1493,1535
E02003971,Allerdale 007,Middle Super Output Areas and Intermediate Zones,MSOAIZ,CA,8021,3945,4076,1434,1515
E02003972,Allerdale 008,Middle Super Output Areas and Intermediate Zones,MSOAIZ,CA,9232,4623,4609,1908,1858
E02003973,Allerdale 009,Middle Super Output Areas and Intermediate Zones,MSOAIZ,CA,8751,4327,4424,1770,1810
E02003974,Allerdale 010,Middle Super Output Areas and Intermediate Zones,MSOAIZ,CA,7796,3728,4068,1413,1562
E02003975,Allerdale 011,Middle Super Output Areas and Intermediate Zones,MSOAIZ,CA,6455,3150,3305,1212,1251
E02003976,Allerdale 012,Middle Super Output Areas and Intermediate Zones,MSOAIZ,CA,6858,3346,3512,1242,1278
E02003977,Barrow-in-Furness 001,Middle Super Output Areas and Intermediate Zones,MSOAIZ,LA,6407,3185,3222,1244,1284
E02003978,Barrow-in-Furness 002,Middle Super Output Areas and Intermediate Zones,MSOAIZ,LA,5935,2927,3008,1162,1181
E02003979,Barrow-in-Furness 003,Middle Super Output Areas and Intermediate Zones,MSOAIZ,LA,7709,3762,3947,1280,1292
E02003980,Barrow-in-Furness 004,Middle Super Output Areas and Intermediate Zones,MSOAIZ,LA,6705,3382,3323,1327,1364
E02003981,Barrow-in-Furness 005,Middle Super Output Areas and Intermediate Zones,MSOAIZ,LA,6829,3360,3469,1464,1498
E02003982,Barrow-in-Furness 006,Middle Super Output Areas and Intermediate Zones,MSOAIZ,LA,7594,3732,3862,1478,1527
E02003983,Barrow-in-Furness 007,Middle Super Output Areas and Intermediate Zones,MSOAIZ,LA,7733,3809,3924,1509,1586
E02003984,Barrow-in-Furness 008,Middle Super Output Areas and Intermediate Zones,MSOAIZ,LA,6908,3451,3457,1497,1313
E02003985,Barrow-in-Furness 009,Middle Super Output Areas and Intermediate Zones,MSOAIZ,LA,6679,3256,3423,1230,1252
E02003986,Barrow-in-Furness 010,Middle Super Output Areas and Intermediate Zones,MSOAIZ,LA,6588,3321,3267,1401,1261
E02003987,Carlisle 001,Middle Super Output Areas and Intermediate Zones,MSOAIZ,TD,6056,3061,2995,1218,1141
E02003988,Carlisle 002,Middle Super Output Areas and Intermediate Zones,MSOAIZ,CA,6629,3239,3390,1224,1226
E02003989,Carlisle 003,Middle Super Output Areas and Intermediate Zones,MSOAIZ,CA,7609,3692,3917,1447,1476
E02003990,Carlisle 004,Middle Super Output Areas and Intermediate Zones,MSOAIZ,CA,9757,4718,5039,1915,1953
E02003991,Carlisle 005,Middle Super Output Areas and Intermediate Zones,MSOAIZ,CA,7721,3756,3965,1437,1516
E02003992,Carlisle 006,Middle Super Output Areas and Intermediate Zones,MSOAIZ,CA,8594,4284,4310,1879,1675
E02003993,Carlisle 007,Middle Super Output Areas and Intermediate Zones,MSOAIZ,CA,8582,4180,4402,1543,1680
E02003994,Carlisle 008,Middle Super Output Areas and Intermediate Zones,MSOAIZ,CA,7515,3639,3876,1589,1578
E02003995,Carlisle 009,Middle Super Output Areas and Intermediate Zones,MSOAIZ,CA,9494,4591,4903,1949,1978
E02003996,Carlisle 010,Middle Super Output Areas and Intermediate Zones,MSOAIZ,CA,9698,4846,4852,2457,2240
E02003997,Carlisle 011,Middle Super Output Areas and Intermediate Zones,MSOAIZ,CA,9581,4572,5009,1835,2037
E02003998,Carlisle 012,Middle Super Output Areas and Intermediate Zones,MSOAIZ,CA,6908,3315,3593,1273,1427
E02003999,Carlisle 013,Middle Super Output Areas and Intermediate Zones,MSOAIZ,CA,9380,4585,4795,1732,1784
E02004000,Copeland 001,Middle Super Output Areas and Intermediate Zones,MSOAIZ,CA,5506,2688,2818,1087,1120
E02004001,Copeland 002,Middle Super Output Areas and Intermediate Zones,MSOAIZ,CA,5612,2899,2713,1277,1069
E02004002,Copeland 003,Middle Super Output Areas and Intermediate Zones,MSOAIZ,CA,10332,5130,5202,2129,2172
E02004003,Copeland 004,Middle Super Output Areas and Intermediate Zones,MSOAIZ,CA,12019,6027,5992,2406,2509
E02004004,Copeland 005,Middle Super Output Areas and Intermediate Zones,MSOAIZ,CA,9398,4616,4782,1824,1900
E02004005,Copeland 006,Middle Super Output Areas and Intermediate Zones,MSOAIZ,CA,8194,4067,4127,1603,1655
E02004006,Copeland 007,Middle Super Output Areas and Intermediate Zones,MSOAIZ,CA,9044,4619,4425,1698,1680
E02004007,Copeland 008,Middle Super Output Areas and Intermediate Zones,MSOAIZ,LA,10498,5430,5068,2224,1849
E02004008,Eden 001,Middle Super Output Areas and Intermediate Zones,MSOAIZ,CA,6394,3201,3193,1160,1190
E02004009,Eden 002,Middle Super Output Areas and Intermediate Zones,MSOAIZ,CA,6078,3060,3018,1095,1173
E02004010,Eden 003,Middle Super Output Areas and Intermediate Zones,MSOAIZ,CA,7119,3484,3635,1501,1508
E02004011,Eden 004,Middle Super Output Areas and Intermediate Zones,MSOAIZ,CA,9815,4761,5054,1800,1814
E02004012,Eden 005,Middle Super Output Areas and Intermediate Zones,MSOAIZ,CA,5666,2820,2846,998,1026
E02004013,Eden 006,Middle Super Output Areas and Intermediate Zones,MSOAIZ,DL,9903,4942,4961,1800,1821
E02004014,Eden 007,Middle Super Output Areas and Intermediate Zones,MSOAIZ,LA,7589,3765,3824,1338,1378
E02004015,South Lakeland 001,Middle Super Output Areas and Intermediate Zones,MSOAIZ,LA,6494,3149,3345,1202,1195
E02004016,South Lakeland 002,Middle Super Output Areas and Intermediate Zones,MSOAIZ,LA,8401,4138,4263,1545,1666
E02004017,South Lakeland 003,Middle Super Output Areas and Intermediate Zones,MSOAIZ,LA,8391,4089,4302,1688,1755
E02004018,South Lakeland 004,Middle Super Output Areas and Intermediate Zones,MSOAIZ,LA,8147,4011,4136,1702,1744
E02004019,South Lakeland 005,Middle Super Output Areas and Intermediate Zones,MSOAIZ,LA,7993,3910,4083,1402,1531
E02004020,South Lakeland 006,Middle Super Output Areas and Intermediate Zones,MSOAIZ,LA,8283,3990,4293,1578,1685
E02004021,South Lakeland 007,Middle Super Output Areas and Intermediate Zones,MSOAIZ,LA,5276,2644,2632,917,975
E02004022,South Lakeland 008,Middle Super Output Areas and Intermediate Zones,MSOAIZ,LA,5575,2785,2790,990,1035
E02004023,South Lakeland 009,Middle Super Output Areas and Intermediate Zones,MSOAIZ,LA,6245,3064,3181,924,985
E02004024,South Lakeland 010,Middle Super Output Areas and Intermediate Zones,MSOAIZ,LA,7185,3485,3700,1153,1292
E02004025,South Lakeland 011,Middle Super Output Areas and Intermediate Zones,MSOAIZ,LA,8073,3870,4203,1238,1360
E02004026,South Lakeland 012,Middle Super Output Areas and Intermediate Zones,MSOAIZ,LA,8022,3896,4126,1615,1637
E02004027,South Lakeland 013,Middle Super Output Areas and Intermediate Zones,MSOAIZ,LA,7814,3700,4114,1118,1185
E02004028,South Lakeland 014,Middle Super Output Areas and Intermediate Zones,MSOAIZ,LA,7759,3791,3968,1304,1396
E02004029,Amber Valley 001,Middle Super Output Areas and Intermediate Zones,MSOAIZ,DE,6459,3206,3253,1330,1298
E02004030,Amber Valley 002,Middle Super Output Areas and Intermediate Zones,MSOAIZ,DE,5630,2759,2871,939,1050
E02004031,Amber Valley 003,Middle Super Output Areas and Intermediate Zones,MSOAIZ,NG,7474,3603,3871,1482,1510
E02004032,Amber Valley 004,Middle Super Output Areas and Intermediate Zones,MSOAIZ,DE,8261,4089,4172,1667,1653
E02004033,Amber Valley 005,Middle Super Output Areas and Intermediate Zones,MSOAIZ,NG,8824,4382,4442,1926,1853
E02004034,Amber Valley 006,Middle Super Output Areas and Intermediate Zones,MSOAIZ,DE,7326,3576,3750,1370,1393
E02004035,Amber Valley 007,Middle Super Output Areas and Intermediate Zones,MSOAIZ,DE,6475,3250,3225,1191,1204
E02004036,Amber Valley 008,Middle Super Output Areas and Intermediate Zones,MSOAIZ,DE,9919,4907,5012,1896,1980
E02004037,Amber Valley 009,Middle Super Output Areas and Intermediate Zones,MSOAIZ,DE,7670,3811,3859,1563,1622
E02004038,Amber Valley 010,Middle Super Output Areas and Intermediate Zones,MSOAIZ,DE,7797,3752,4045,1674,1667
E02004039,Amber Valley 011,Middle Super Output Areas and Intermediate Zones,MSOAIZ,DE,8044,3969,4075,1703,1750
E02004040,Amber Valley 012,Middle Super Output Areas and Intermediate Zones,MSOAIZ,NG,9016,4455,4561,1896,1907
E02004041,Amber Valley 013,Middle Super Output Areas and Intermediate Zones,MSOAIZ,NG,7029,3506,3523,1502,1526
E02004043,Amber Valley 015,Middle Super Output Areas and Intermediate Zones,MSOAIZ,DE,7025,3419,3606,1330,1373
E02004044,Amber Valley 016,Middle Super Output Areas and Intermediate Zones,MSOAIZ,S,7717,3787,3930,1330,1376
E02004045,Bolsover 001,Middle Super Output Areas and Intermediate Zones,MSOAIZ,S,9092,4523,4569,1860,1889
E02004046,Bolsover 002,Middle Super Output Areas and Intermediate Zones,MSOAIZ,S,6221,3046,3175,1192,1208
E02004047,Bolsover 003,Middle Super Output Areas and Intermediate Zones,MSOAIZ,S,5651,2758,2893,1157,1170
E02004048,Bolsover 004,Middle Super Output Areas and Intermediate Zones,MSOAIZ,S,6687,3316,3371,1362,1372
E02004049,Bolsover 005,Middle Super Output Areas and Intermediate Zones,MSOAIZ,S,7781,3750,4031,1432,1521
E02004050,Bolsover 006,Middle Super Output Areas and Intermediate Zones,MSOAIZ,NG,7045,3412,3633,1400,1398
E02004051,Bolsover 007,Middle Super Output Areas and Intermediate Zones,MSOAIZ,S,9016,4435,4581,1764,1846
E02004052,Bolsover 008,Middle Super Output Areas and Intermediate Zones,MSOAIZ,S,7868,3865,4003,1583,1611
E02004053,Bolsover 009,Middle Super Output Areas and Intermediate Zones,MSOAIZ,DE,7877,3921,3956,1643,1639
E02004054,Bolsover 010,Middle Super Output Areas and Intermediate Zones,MSOAIZ,NG,8628,4362,4266,1914,1816
E02004055,Chesterfield 001,Middle Super Output Areas and Intermediate Zones,MSOAIZ,S,7127,3501,3626,1463,1457
E02004056,Chesterfield 002,Middle Super Output Areas and Intermediate Zones,MSOAIZ,S,7802,3838,3964,1489,1555
E02004057,Chesterfield 003,Middle Super Output Areas and Intermediate Zones,MSOAIZ,S,7675,3813,3862,1769,1728
E02004058,Chesterfield 004,Middle Super Output Areas and Intermediate Zones,MSOAIZ,S,7814,3760,4054,1462,1540
E02004059,Chesterfield 005,Middle Super Output Areas and Intermediate Zones,MSOAIZ,S,7261,3483,3778,1398,1470
E02004060,Chesterfield 006,Middle Super Output Areas and Intermediate Zones,MSOAIZ,S,7632,3710,3922,1365,1480
E02004061,Chesterfield 007,Middle Super Output Areas and Intermediate Zones,MSOAIZ,S,7186,3614,3572,1512,1361
E02004062,Chesterfield 008,Middle Super Output Areas and Intermediate Zones,MSOAIZ,S,7992,3916,4076,1548,1576
E02004063,Chesterfield 009,Middle Super Output Areas and Intermediate Zones,MSOAIZ,S,7973,3854,4119,1493,1538
E02004064,Chesterfield 010,Middle Super Output Areas and Intermediate Zones,MSOAIZ,S,8748,4457,4291,2245,1983
E02004065,Chesterfield 011,Middle Super Output Areas and Intermediate Zones,MSOAIZ,S,8437,4080,4357,1415,1538
E02004066,Chesterfield 012,Middle Super Output Areas and Intermediate Zones,MSOAIZ,S,11731,5732,5999,2504,2537
E02004067,Chesterfield 013,Middle Super Output Areas and Intermediate Zones,MSOAIZ,S,6410,3142,3268,1245,1266
E02004068,Derbyshire Dales 001,Middle Super Output Areas and Intermediate Zones,MSOAIZ,SK,7566,3708,3858,1353,1421
E02004069,Derbyshire Dales 002,Middle Super Output Areas and Intermediate Zones,MSOAIZ,SK,6762,3278,3484,1083,1147
E02004070,Derbyshire Dales 003,Middle Super Output Areas and Intermediate Zones,MSOAIZ,SK,6385,3003,3382,989,1066
E02004071,Derbyshire Dales 004,Middle Super Output Areas and Intermediate Zones,MSOAIZ,DE,5118,2467,2651,898,936
E02004072,Derbyshire Dales 005,Middle Super Output Areas and Intermediate Zones,MSOAIZ,DE,8558,4244,4314,1609,1587
E02004073,Derbyshire Dales 006,Middle Super Output Areas and Intermediate Zones,MSOAIZ,DE,9050,4441,4609,1672,1658
E02004074,Derbyshire Dales 007,Middle Super Output Areas and Intermediate Zones,MSOAIZ,DE,5813,2910,2903,1083,1060
E02004075,Derbyshire Dales 008,Middle Super Output Areas and Intermediate Zones,MSOAIZ,SK,7447,3724,3723,1324,1405
E02004076,Derbyshire Dales 009,Middle Super Output Areas and Intermediate Zones,MSOAIZ,DE,6582,3184,3398,1274,1326
E02004077,Derbyshire Dales 010,Middle Super Output Areas and Intermediate Zones,MSOAIZ,ST,7835,4112,3723,1778,1391
E02004078,Erewash 001,Middle Super Output Areas and Intermediate Zones,MSOAIZ,DE,7148,3440,3708,1324,1386
E02004080,Erewash 003,Middle Super Output Areas and Intermediate Zones,MSOAIZ,DE,9395,4698,4697,2043,1914
E02004081,Erewash 004,Middle Super Output Areas and Intermediate Zones,MSOAIZ,DE,5716,2787,2929,1040,1067
E02004082,Erewash 005,Middle Super Output Areas and Intermediate Zones,MSOAIZ,DE,6304,3059,3245,1129,1198
E02004083,Erewash 006,Middle Super Output Areas and Intermediate Zones,MSOAIZ,NG,7760,3864,3896,1663,1678
E02004084,Erewash 007,Middle Super Output Areas and Intermediate Zones,MSOAIZ,DE,6216,2981,3235,1095,1173
E02004085,Erewash 008,Middle Super Output Areas and Intermediate Zones,MSOAIZ,NG,8688,4199,4489,1640,1768
E02004086,Erewash 009,Middle Super Output Areas and Intermediate Zones,MSOAIZ,DE,7335,3516,3819,1409,1463
E02004087,Erewash 010,Middle Super Output Areas and Intermediate Zones,MSOAIZ,NG,7818,3814,4004,1644,1709
E02004088,Erewash 011,Middle Super Output Areas and Intermediate Zones,MSOAIZ,NG,7614,3750,3864,1523,1557
E02004089,Erewash 012,Middle Super Output Areas and Intermediate Zones,MSOAIZ,NG,6705,3362,3343,1572,1544
E02004090,Erewash 013,Middle Super Output Areas and Intermediate Zones,MSOAIZ,NG,6140,3018,3122,1211,1240
E02004091,Erewash 014,Middle Super Output Areas and Intermediate Zones,MSOAIZ,NG,8889,4420,4469,1964,1912
E02004092,Erewash 015,Middle Super Output Areas and Intermediate Zones,MSOAIZ,NG,9556,4672,4884,1881,1984
E02004093,High Peak 001,Middle Super Output Areas and Intermediate Zones,MSOAIZ,SK,6408,3139,3269,1375,1485
E02004094,High Peak 002,Middle Super Output Areas and Intermediate Zones,MSOAIZ,SK,7325,3533,3792,1371,1539
E02004095,High Peak 003,Middle Super Output Areas and Intermediate Zones,MSOAIZ,SK,9866,4854,5012,2215,2231
E02004096,High Peak 004,Middle Super Output Areas and Intermediate Zones,MSOAIZ,SK,9491,4681,4810,1790,1920
E02004097,High Peak 005,Middle Super Output Areas and Intermediate Zones,MSOAIZ,SK,7678,3854,3824,1696,1584
E02004098,High Peak 006,Middle Super Output Areas and Intermediate Zones,MSOAIZ,SK,7317,3589,3728,1398,1501
E02004100,High Peak 008,Middle Super Output Areas and Intermediate Zones,MSOAIZ,SK,7610,3766,3844,1441,1498
E02004102,High Peak 010,Middle Super Output Areas and Intermediate Zones,MSOAIZ,SK,8540,4170,4370,1664,1509
E02004103,High Peak 011,Middle Super Output Areas and Intermediate Zones,MSOAIZ,SK,7072,3477,3595,1413,1466
E02004104,High Peak 012,Middle Super Output Areas and Intermediate Zones,MSOAIZ,SK,7074,3505,3569,1378,1446
E02004105,North East Derbyshire 001,Middle Super Output Areas and Intermediate Zones,MSOAIZ,S,9445,4652,4793,1870,2037
E02004106,North East Derbyshire 002,Middle Super Output Areas and Intermediate Zones,MSOAIZ,S,6986,3442,3544,1220,1227
E02004108,North East Derbyshire 004,Middle Super Output Areas and Intermediate Zones,MSOAIZ,S,7538,3636,3902,1434,1465
E02004109,North East Derbyshire 005,Middle Super Output Areas and Intermediate Zones,MSOAIZ,S,6742,3298,3444,1099,1132
E02004110,North East Derbyshire 006,Middle Super Output Areas and Intermediate Zones,MSOAIZ,S,7464,3661,3803,1348,1423
E02004111,North East Derbyshire 007,Middle Super Output Areas and Intermediate Zones,MSOAIZ,S,5477,2655,2822,1009,1050
E02004112,North East Derbyshire 008,Middle Super Output Areas and Intermediate Zones,MSOAIZ,S,6525,3205,3320,1105,1111
E02004113,North East Derbyshire 009,Middle Super Output Areas and Intermediate Zones,MSOAIZ,S,9191,4539,4652,1797,1814
E02004114,North East Derbyshire 010,Middle Super Output Areas and Intermediate Zones,MSOAIZ,S,7283,3558,3725,1246,1273
E02004115,North East Derbyshire 011,Middle Super Output Areas and Intermediate Zones,MSOAIZ,S,9020,4460,4560,1877,1896
E02004116,North East Derbyshire 012,Middle Super Output Areas and Intermediate Zones,MSOAIZ,S,7887,3902,3985,1602,1571
E02004117,North East Derbyshire 013,Middle Super Output Areas and Intermediate Zones,MSOAIZ,S,7312,3563,3749,1364,1413
E02004118,South Derbyshire 001,Middle Super Output Areas and Intermediate Zones,MSOAIZ,DE,6815,3335,3480,1419,1544
E02004119,South Derbyshire 002,Middle Super Output Areas and Intermediate Zones,MSOAIZ,DE,10860,5411,5449,2426,2550
E02004120,South Derbyshire 003,Middle Super Output Areas and Intermediate Zones,MSOAIZ,DE,7252,3603,3649,1481,1576
E02004121,South Derbyshire 004,Middle Super Output Areas and Intermediate Zones,MSOAIZ,DE,6666,3315,3351,1384,1392
E02004122,South Derbyshire 005,Middle Super Output Areas and Intermediate Zones,MSOAIZ,DE,6544,3287,3257,1122,1163
E02004123,South Derbyshire 006,Middle Super Output Areas and Intermediate Zones,MSOAIZ,LE,6383,3127,3256,1219,1308
E02004124,South Derbyshire 007,Middle Super Output Areas and Intermediate Zones,MSOAIZ,DE,7614,3730,3884,1410,1497
E02004125,South Derbyshire 008,Middle Super Output Areas and Intermediate Zones,MSOAIZ,DE,8988,4450,4538,1836,1859
E02004126,South Derbyshire 009,Middle Super Output Areas and Intermediate Zones,MSOAIZ,DE,6900,3498,3402,1465,1380
E02004128,South Derbyshire 011,Middle Super Output Areas and Intermediate Zones,MSOAIZ,DE,10255,5054,5201,2025,2026
E02004129,East Devon 001,Middle Super Output Areas and Intermediate Zones,MSOAIZ,TA,5492,2737,2755,863,906
E02004130,East Devon 002,Middle Super Output Areas and Intermediate Zones,MSOAIZ,EX,5919,2773,3146,1001,1030
E02004131,East Devon 003,Middle Super Output Areas and Intermediate Zones,MSOAIZ,EX,5564,2628,2936,964,1097
E02004132,East Devon 004,Middle Super Output Areas and Intermediate Zones,MSOAIZ,EX,8231,4025,4206,1438,1595
E02004133,East Devon 005,Middle Super Output Areas and Intermediate Zones,MSOAIZ,EX,8180,3925,4255,1320,1380
E02004134,East Devon 006,Middle Super Output Areas and Intermediate Zones,MSOAIZ,EX,6883,3360,3523,1256,1373
E02004135,East Devon 007,Middle Super Output Areas and Intermediate Zones,MSOAIZ,EX,8044,3847,4197,1123,1207
E02004136,East Devon 008,Middle Super Output Areas and Intermediate Zones,MSOAIZ,EX,7959,3802,4157,1279,1392
E02004137,East Devon 009,Middle Super Output Areas and Intermediate Zones,MSOAIZ,EX,5339,2559,2780,748,808
E02004138,East Devon 010,Middle Super Output Areas and Intermediate Zones,MSOAIZ,EX,7096,3260,3836,873,958
E02004139,East Devon 011,Middle Super Output Areas and Intermediate Zones,MSOAIZ,EX,6372,2947,3425,877,1011
E02004140,East Devon 012,Middle Super Output Areas and Intermediate Zones,MSOAIZ,EX,5178,2322,2856,584,641
E02004141,East Devon 013,Middle Super Output Areas and Intermediate Zones,MSOAIZ,EX,5820,2807,3013,952,1061
E02004142,East Devon 014,Middle Super Output Areas and Intermediate Zones,MSOAIZ,EX,5981,3371,2610,997,897
E02004143,East Devon 015,Middle Super Output Areas and Intermediate Zones,MSOAIZ,EX,6320,3008,3312,1109,1238
E02004144,East Devon 016,Middle Super Output Areas and Intermediate Zones,MSOAIZ,EX,6719,3191,3528,1094,1203
E02004145,East Devon 017,Middle Super Output Areas and Intermediate Zones,MSOAIZ,EX,5967,2717,3250,733,812
E02004146,East Devon 018,Middle Super Output Areas and Intermediate Zones,MSOAIZ,EX,7223,3369,3854,1290,1454
E02004147,East Devon 019,Middle Super Output Areas and Intermediate Zones,MSOAIZ,EX,7025,3399,3626,1521,1511
E02004148,East Devon 020,Middle Super Output Areas and Intermediate Zones,MSOAIZ,EX,7145,3274,3871,975,1058
E02004149,Exeter 001,Middle Super Output Areas and Intermediate Zones,MSOAIZ,EX,9019,4385,4634,1176,1153
E02004150,Exeter 002,Middle Super Output Areas and Intermediate Zones,MSOAIZ,EX,6825,3352,3473,1342,1341
E02004151,Exeter 003,Middle Super Output Areas and Intermediate Zones,MSOAIZ,EX,7957,3762,4195,1437,1556
E02004152,Exeter 004,Middle Super Output Areas and Intermediate Zones,MSOAIZ,EX,8421,4117,4304,1369,1021
E02004153,Exeter 005,Middle Super Output Areas and Intermediate Zones,MSOAIZ,EX,7546,3704,3842,1698,1774
E02004154,Exeter 006,Middle Super Output Areas and Intermediate Zones,MSOAIZ,EX,8173,4090,4083,1717,1651
E02004155,Exeter 007,Middle Super Output Areas and Intermediate Zones,MSOAIZ,EX,7557,3607,3950,1379,1508
E02004156,Exeter 008,Middle Super Output Areas and Intermediate Zones,MSOAIZ,EX,9584,4902,4682,2229,1748
E02004157,Exeter 009,Middle Super Output Areas and Intermediate Zones,MSOAIZ,EX,6587,3071,3516,1432,1495
E02004158,Exeter 010,Middle Super Output Areas and Intermediate Zones,MSOAIZ,EX,7824,3840,3984,1833,1890
E02004159,Exeter 011,Middle Super Output Areas and Intermediate Zones,MSOAIZ,EX,9307,4606,4701,2023,2053
E02004160,Exeter 012,Middle Super Output Areas and Intermediate Zones,MSOAIZ,EX,7175,3438,3737,1301,1344
E02004161,Exeter 013,Middle Super Output Areas and Intermediate Zones,MSOAIZ,EX,7976,3817,4159,1590,1743
E02004162,Exeter 014,Middle Super Output Areas and Intermediate Zones,MSOAIZ,EX,7231,3521,3710,1642,1569
E02004163,Exeter 015,Middle Super Output Areas and Intermediate Zones,MSOAIZ,EX,6591,2999,3592,1106,1185
E02004164,Mid Devon 001,Middle Super Output Areas and Intermediate Zones,MSOAIZ,TA,6586,3245,3341,1135,1206
E02004165,Mid Devon 002,Middle Super Output Areas and Intermediate Zones,MSOAIZ,EX,8047,3895,4152,1428,1509
E02004166,Mid Devon 003,Middle Super Output Areas and Intermediate Zones,MSOAIZ,TA,6487,3194,3293,1164,1262
E02004167,Mid Devon 004,Middle Super Output Areas and Intermediate Zones,MSOAIZ,EX,7200,3495,3705,1318,1411
E02004168,Mid Devon 005,Middle Super Output Areas and Intermediate Zones,MSOAIZ,EX,6088,3003,3085,1191,1136
E02004169,Mid Devon 006,Middle Super Output Areas and Intermediate Zones,MSOAIZ,EX,7103,3499,3604,1307,1431
E02004170,Mid Devon 007,Middle Super Output Areas and Intermediate Zones,MSOAIZ,EX,7643,3716,3927,1532,1569
E02004171,Mid Devon 008,Middle Super Output Areas and Intermediate Zones,MSOAIZ,EX,7562,3663,3899,1304,1462
E02004172,Mid Devon 009,Middle Super Output Areas and Intermediate Zones,MSOAIZ,EX,6155,3024,3131,1057,1168
E02004173,Mid Devon 010,Middle Super Output Areas and Intermediate Zones,MSOAIZ,EX,7279,3625,3654,1315,1371
E02004174,Mid Devon 011,Middle Super Output Areas and Intermediate Zones,MSOAIZ,EX,7600,3711,3889,1424,1426
E02004175,North Devon 001,Middle Super Output Areas and Intermediate Zones,MSOAIZ,EX,5517,2697,2820,1032,1012
E02004176,North Devon 002,Middle Super Output Areas and Intermediate Zones,MSOAIZ,EX,5588,2710,2878,862,957
E02004177,North Devon 003,Middle Super Output Areas and Intermediate Zones,MSOAIZ,EX,5992,2900,3092,1063,1112
E02004178,North Devon 004,Middle Super Output Areas and Intermediate Zones,MSOAIZ,EX,5471,2687,2784,943,995
E02004179,North Devon 005,Middle Super Output Areas and Intermediate Zones,MSOAIZ,EX,9078,4601,4477,1794,1604
E02004180,North Devon 006,Middle Super Output Areas and Intermediate Zones,MSOAIZ,EX,5900,2885,3015,994,1069
E02004181,North Devon 007,Middle Super Output Areas and Intermediate Zones,MSOAIZ,EX,5849,2804,3045,1100,1181
E02004182,North Devon 008,Middle Super Output Areas and Intermediate Zones,MSOAIZ,EX,6200,3009,3191,1182,1213
E02004183,North Devon 009,Middle Super Output Areas and Intermediate Zones,MSOAIZ,EX,5782,2790,2992,1014,989
E02004184,North Devon 010,Middle Super Output Areas and Intermediate Zones,MSOAIZ,EX,8614,4104,4510,1668,1895
E02004185,North Devon 011,Middle Super Output Areas and Intermediate Zones,MSOAIZ,EX,5811,2760,3051,893,976
E02004186,North Devon 012,Middle Super Output Areas and Intermediate Zones,MSOAIZ,EX,8224,3971,4253,1490,1612
E02004187,North Devon 013,Middle Super Output Areas and Intermediate Zones,MSOAIZ,TA,9336,4553,4783,1606,1745
E02004188,North Devon 014,Middle Super Output Areas and Intermediate Zones,MSOAIZ,TA,6305,3087,3218,1003,1068
E02004189,South Hams 001,Middle Super Output Areas and Intermediate Zones,MSOAIZ,PL,5925,3021,2904,1238,1292
E02004190,South Hams 002,Middle Super Output Areas and Intermediate Zones,MSOAIZ,TQ,7883,3764,4119,1342,1509
E02004191,South Hams 003,Middle Super Output Areas and Intermediate Zones,MSOAIZ,TQ,8076,3760,4316,1395,1649
E02004192,South Hams 004,Middle Super Output Areas and Intermediate Zones,MSOAIZ,TQ,7163,3482,3681,1061,1233
E02004193,South Hams 005,Middle Super Output Areas and Intermediate Zones,MSOAIZ,PL,11851,5716,6135,2228,2507
E02004194,South Hams 006,Middle Super Output Areas and Intermediate Zones,MSOAIZ,TQ,6235,2988,3247,1027,1173
E02004195,South Hams 007,Middle Super Output Areas and Intermediate Zones,MSOAIZ,TQ,5605,2849,2756,948,933
E02004196,South Hams 008,Middle Super Output Areas and Intermediate Zones,MSOAIZ,TQ,7120,3421,3699,1135,1289
E02004197,South Hams 009,Middle Super Output Areas and Intermediate Zones,MSOAIZ,PL,6269,3019,3250,942,1041
E02004198,South Hams 010,Middle Super Output Areas and Intermediate Zones,MSOAIZ,TQ,6423,3024,3399,1070,1156
E02004199,South Hams 011,Middle Super Output Areas and Intermediate Zones,MSOAIZ,TQ,5351,2566,2785,667,747
E02004200,South Hams 012,Middle Super Output Areas and Intermediate Zones,MSOAIZ,TQ,5239,2506,2733,743,775
E02004201,Teignbridge 001,Middle Super Output Areas and Intermediate Zones,MSOAIZ,TQ,5193,2518,2675,816,887
E02004202,Teignbridge 002,Middle Super Output Areas and Intermediate Zones,MSOAIZ,EX,7759,3754,4005,1475,1598
E02004203,Teignbridge 003,Middle Super Output Areas and Intermediate Zones,MSOAIZ,TQ,5636,2737,2899,912,992
E02004204,Teignbridge 004,Middle Super Output Areas and Intermediate Zones,MSOAIZ,TQ,9304,4561,4743,1693,1825
E02004205,Teignbridge 005,Middle Super Output Areas and Intermediate Zones,MSOAIZ,EX,6450,3090,3360,1055,1178
E02004206,Teignbridge 006,Middle Super Output Areas and Intermediate Zones,MSOAIZ,TQ,6711,3141,3570,1020,1049
E02004207,Teignbridge 007,Middle Super Output Areas and Intermediate Zones,MSOAIZ,TQ,5957,2878,3079,1030,1121
E02004208,Teignbridge 008,Middle Super Output Areas and Intermediate Zones,MSOAIZ,TQ,7969,3861,4108,1245,1359
E02004209,Teignbridge 009,Middle Super Output Areas and Intermediate Zones,MSOAIZ,TQ,8306,3998,4308,1533,1692
E02004210,Teignbridge 010,Middle Super Output Areas and Intermediate Zones,MSOAIZ,TQ,6780,3157,3623,1128,1239
E02004211,Teignbridge 011,Middle Super Output Areas and Intermediate Zones,MSOAIZ,TQ,6499,3099,3400,945,1064
E02004212,Teignbridge 012,Middle Super Output Areas and Intermediate Zones,MSOAIZ,TQ,5939,2865,3074,1130,1197
E02004213,Teignbridge 013,Middle Super Output Areas and Intermediate Zones,MSOAIZ,TQ,5668,3092,2576,1419,993
E02004214,Teignbridge 014,Middle Super Output Areas and Intermediate Zones,MSOAIZ,TQ,5919,2877,3042,1258,1279
E02004215,Teignbridge 015,Middle Super Output Areas and Intermediate Zones,MSOAIZ,TQ,5650,2711,2939,988,1071
E02004216,Teignbridge 016,Middle Super Output Areas and Intermediate Zones,MSOAIZ,TQ,5562,2740,2822,974,999
E02004217,Teignbridge 017,Middle Super Output Areas and Intermediate Zones,MSOAIZ,TQ,7718,3710,4008,1323,1492
E02004218,Teignbridge 018,Middle Super Output Areas and Intermediate Zones,MSOAIZ,TQ,5679,2762,2917,921,1040
E02004219,Teignbridge 019,Middle Super Output Areas and Intermediate Zones,MSOAIZ,TQ,5521,2628,2893,850,983
E02004220,Torridge 001,Middle Super Output Areas and Intermediate Zones,MSOAIZ,EX,6184,2968,3216,993,1083
E02004221,Torridge 002,Middle Super Output Areas and Intermediate Zones,MSOAIZ,EX,5878,2775,3103,908,890
E02004222,Torridge 003,Middle Super Output Areas and Intermediate Zones,MSOAIZ,EX,5717,2841,2876,1115,1104
E02004223,Torridge 004,Middle Super Output Areas and Intermediate Zones,MSOAIZ,EX,11348,5522,5826,2061,2265
E02004224,Torridge 005,Middle Super Output Areas and Intermediate Zones,MSOAIZ,EX,6254,3080,3174,990,1069
E02004225,Torridge 006,Middle Super Output Areas and Intermediate Zones,MSOAIZ,EX,5714,2716,2998,1038,1078
E02004226,Torridge 007,Middle Super Output Areas and Intermediate Zones,MSOAIZ,EX,6916,3451,3465,1113,1168
E02004227,Torridge 008,Middle Super Output Areas and Intermediate Zones,MSOAIZ,EX,8929,4414,4515,1547,1592
E02004228,Torridge 009,Middle Super Output Areas and Intermediate Zones,MSOAIZ,PL,6899,3400,3499,1112,1200
E02004229,West Devon 001,Middle Super Output Areas and Intermediate Zones,MSOAIZ,EX,7963,3973,3990,1459,1456
E02004230,West Devon 002,Middle Super Output Areas and Intermediate Zones,MSOAIZ,EX,7500,3662,3838,1394,1441
E02004231,West Devon 003,Middle Super Output Areas and Intermediate Zones,MSOAIZ,TQ,6793,3486,3307,1419,1248
E02004232,West Devon 004,Middle Super Output Areas and Intermediate Zones,MSOAIZ,PL,6529,3208,3321,1104,1212
E02004233,West Devon 005,Middle Super Output Areas and Intermediate Zones,MSOAIZ,PL,12280,5825,6455,2075,2210
E02004234,West Devon 006,Middle Super Output Areas and Intermediate Zones,MSOAIZ,PL,6119,2919,3200,941,1096
E02004235,West Devon 007,Middle Super Output Areas and Intermediate Zones,MSOAIZ,PL,6369,3050,3319,1036,1134
E02004236,Christchurch 001,Middle Super Output Areas and Intermediate Zones,MSOAIZ,BH,5773,2806,2967,967,1007
E02004237,Christchurch 002,Middle Super Output Areas and Intermediate Zones,MSOAIZ,BH,7783,3791,3992,1308,1413
E02004238,Christchurch 003,Middle Super Output Areas and Intermediate Zones,MSOAIZ,BH,7094,3291,3803,852,885
E02004239,Christchurch 004,Middle Super Output Areas and Intermediate Zones,MSOAIZ,BH,5587,2653,2934,786,806
E02004240,Christchurch 005,Middle Super Output Areas and Intermediate Zones,MSOAIZ,BH,6077,3008,3069,1176,1237
E02004241,Christchurch 006,Middle Super Output Areas and Intermediate Zones,MSOAIZ,BH,9010,4324,4686,1663,1715
E02004242,Christchurch 007,Middle Super Output Areas and Intermediate Zones,MSOAIZ,BH,6428,3001,3427,838,922
E02004243,East Dorset 001,Middle Super Output Areas and Intermediate Zones,MSOAIZ,SP,6465,3196,3269,1139,1286
E02004244,East Dorset 002,Middle Super Output Areas and Intermediate Zones,MSOAIZ,BH,7221,3452,3769,1270,1375
E02004245,East Dorset 003,Middle Super Output Areas and Intermediate Zones,MSOAIZ,BH,7631,3721,3910,1321,1431
E02004246,East Dorset 004,Middle Super Output Areas and Intermediate Zones,MSOAIZ,BH,6859,3327,3532,851,951
E02004247,East Dorset 005,Middle Super Output Areas and Intermediate Zones,MSOAIZ,SP,5931,2938,2993,1022,1113
E02004248,East Dorset 006,Middle Super Output Areas and Intermediate Zones,MSOAIZ,BH,7561,3563,3998,1012,1074
E02004249,East Dorset 007,Middle Super Output Areas and Intermediate Zones,MSOAIZ,BH,5393,2656,2737,845,931
E02004250,East Dorset 008,Middle Super Output Areas and Intermediate Zones,MSOAIZ,BH,7643,3611,4032,1090,1113
E02004251,East Dorset 009,Middle Super Output Areas and Intermediate Zones,MSOAIZ,BH,6334,2999,3335,1037,1101
E02004252,East Dorset 010,Middle Super Output Areas and Intermediate Zones,MSOAIZ,BH,7014,3252,3762,1238,1222
E02004253,East Dorset 011,Middle Super Output Areas and Intermediate Zones,MSOAIZ,BH,8981,4319,4662,1281,1333
E02004254,East Dorset 012,Middle Super Output Areas and Intermediate Zones,MSOAIZ,BH,10133,4956,5177,1765,1931
E02004255,North Dorset 001,Middle Super Output Areas and Intermediate Zones,MSOAIZ,SP,7502,3638,3864,1432,1358
E02004256,North Dorset 002,Middle Super Output Areas and Intermediate Zones,MSOAIZ,SP,9204,4543,4661,1599,1746
E02004257,North Dorset 003,Middle Super Output Areas and Intermediate Zones,MSOAIZ,SP,7314,3488,3826,1354,1399
E02004258,North Dorset 004,Middle Super Output Areas and Intermediate Zones,MSOAIZ,DT,10329,5068,5261,1721,1777
E02004259,North Dorset 005,Middle Super Output Areas and Intermediate Zones,MSOAIZ,SP,7095,3591,3504,1248,1098
E02004260,North Dorset 006,Middle Super Output Areas and Intermediate Zones,MSOAIZ,SP,9442,5010,4432,1833,1704
E02004261,North Dorset 007,Middle Super Output Areas and Intermediate Zones,MSOAIZ,DT,9983,4982,5001,2026,1967
E02004262,North Dorset 008,Middle Super Output Areas and Intermediate Zones,MSOAIZ,DT,7714,3896,3818,1276,1388
E02004263,Purbeck 001,Middle Super Output Areas and Intermediate Zones,MSOAIZ,DT,5692,2784,2908,1011,1083
E02004264,Purbeck 002,Middle Super Output Areas and Intermediate Zones,MSOAIZ,BH,7983,3852,4131,1456,1586
E02004265,Purbeck 003,Middle Super Output Areas and Intermediate Zones,MSOAIZ,BH,8270,3960,4310,1403,1438
E02004266,Purbeck 004,Middle Super Output Areas and Intermediate Zones,MSOAIZ,DT,8392,4313,4079,1705,1621
E02004267,Purbeck 005,Middle Super Output Areas and Intermediate Zones,MSOAIZ,BH,5035,2498,2537,762,781
E02004268,Purbeck 006,Middle Super Output Areas and Intermediate Zones,MSOAIZ,BH,9601,4621,4980,1466,1553
E02004269,West Dorset 001,Middle Super Output Areas and Intermediate Zones,MSOAIZ,DT,9523,4499,5024,1322,1376
E02004270,West Dorset 002,Middle Super Output Areas and Intermediate Zones,MSOAIZ,DT,7489,3609,3880,1130,1223
E02004271,West Dorset 003,Middle Super Output Areas and Intermediate Zones,MSOAIZ,TA,9772,4766,5006,1540,1618
E02004272,West Dorset 004,Middle Super Output Areas and Intermediate Zones,MSOAIZ,DT,11403,5560,5843,1951,2143
E02004273,West Dorset 005,Middle Super Output Areas and Intermediate Zones,MSOAIZ,TA,7085,3299,3786,933,1073
E02004274,West Dorset 006,Middle Super Output Areas and Intermediate Zones,MSOAIZ,DT,6460,3089,3371,1020,1133
E02004275,West Dorset 007,Middle Super Output Areas and Intermediate Zones,MSOAIZ,DT,7419,3559,3860,1100,1204
E02004276,West Dorset 008,Middle Super Output Areas and Intermediate Zones,MSOAIZ,DT,5675,2637,3038,873,869
E02004277,West Dorset 009,Middle Super Output Areas and Intermediate Zones,MSOAIZ,DT,10290,5000,5290,1981,1943
E02004278,West Dorset 010,Middle Super Output Areas and Intermediate Zones,MSOAIZ,DT,8770,4215,4555,1513,1698
E02004279,West Dorset 011,Middle Super Output Areas and Intermediate Zones,MSOAIZ,DT,7769,3760,4009,1309,1411
E02004280,West Dorset 012,Middle Super Output Areas and Intermediate Zones,MSOAIZ,DT,7609,3738,3871,1330,1391
E02004281,Weymouth and Portland 001,Middle Super Output Areas and Intermediate Zones,MSOAIZ,DT,7316,3542,3774,1426,1570
E02004282,Weymouth and Portland 002,Middle Super Output Areas and Intermediate Zones,MSOAIZ,DT,8641,4127,4514,1297,1342
E02004283,Weymouth and Portland 003,Middle Super Output Areas and Intermediate Zones,MSOAIZ,DT,8669,4261,4408,1461,1569
E02004284,Weymouth and Portland 004,Middle Super Output Areas and Intermediate Zones,MSOAIZ,DT,9470,4808,4662,2102,1655
E02004285,Weymouth and Portland 005,Middle Super Output Areas and Intermediate Zones,MSOAIZ,DT,7465,3632,3833,1486,1428
E02004286,Weymouth and Portland 006,Middle Super Output Areas and Intermediate Zones,MSOAIZ,DT,5191,2570,2621,964,1032
E02004287,Weymouth and Portland 007,Middle Super Output Areas and Intermediate Zones,MSOAIZ,DT,5571,2695,2876,993,1075
E02004288,Weymouth and Portland 008,Middle Super Output Areas and Intermediate Zones,MSOAIZ,DT,5643,3285,2358,1362,963
E02004289,Weymouth and Portland 009,Middle Super Output Areas and Intermediate Zones,MSOAIZ,DT,7201,3512,3689,1333,1366
E02004290,County Durham 002,Middle Super Output Areas and Intermediate Zones,MSOAIZ,DH,5981,2951,3030,1244,1286
E02004291,County Durham 005,Middle Super Output Areas and Intermediate Zones,MSOAIZ,DH,6787,3286,3501,1431,1435
E02004292,County Durham 007,Middle Super Output Areas and Intermediate Zones,MSOAIZ,NE,7916,3824,4092,1434,1509
E02004293,County Durham 011,Middle Super Output Areas and Intermediate Zones,MSOAIZ,DH,9379,4476,4903,1826,1933
E02004294,County Durham 013,Middle Super Output Areas and Intermediate Zones,MSOAIZ,DH,8484,4145,4339,1729,1812
E02004295,County Durham 015,Middle Super Output Areas and Intermediate Zones,MSOAIZ,DH,7537,3564,3973,1372,1518
E02004296,County Durham 019,Middle Super Output Areas and Intermediate Zones,MSOAIZ,DH,8033,3996,4037,1712,1672
E02004297,County Durham 001,Middle Super Output Areas and Intermediate Zones,MSOAIZ,NE,7900,3918,3982,1683,1718
E02004298,County Durham 003,Middle Super Output Areas and Intermediate Zones,MSOAIZ,NE,9703,4757,4946,1858,1996
E02004299,County Durham 004,Middle Super Output Areas and Intermediate Zones,MSOAIZ,NE,8474,4169,4305,1659,1740
E02004300,County Durham 006,Middle Super Output Areas and Intermediate Zones,MSOAIZ,NE,7686,3720,3966,1434,1485
E02004301,County Durham 008,Middle Super Output Areas and Intermediate Zones,MSOAIZ,DH,8894,4343,4551,1790,1847
E02004302,County Durham 009,Middle Super Output Areas and Intermediate Zones,MSOAIZ,DH,7747,3796,3951,1575,1587
E02004303,County Durham 010,Middle Super Output Areas and Intermediate Zones,MSOAIZ,DH,11457,5714,5743,2570,2410
E02004304,County Durham 012,Middle Super Output Areas and Intermediate Zones,MSOAIZ,DH,8892,4272,4620,1782,1854
E02004305,County Durham 014,Middle Super Output Areas and Intermediate Zones,MSOAIZ,DH,8640,4195,4445,1707,1807
E02004306,County Durham 020,Middle Super Output Areas and Intermediate Zones,MSOAIZ,DL,5789,2839,2950,1069,1093
E02004307,County Durham 024,Middle Super Output Areas and Intermediate Zones,MSOAIZ,DL,6570,3154,3416,1350,1402
E02004308,County Durham 022,Middle Super Output Areas and Intermediate Zones,MSOAIZ,DH,7819,4136,3683,1933,1498
E02004309,County Durham 023,Middle Super Output Areas and Intermediate Zones,MSOAIZ,DH,5902,2777,3125,1190,1241
E02004310,County Durham 026,Middle Super Output Areas and Intermediate Zones,MSOAIZ,DH,7962,3874,4088,1606,1671
E02004311,County Durham 027,Middle Super Output Areas and Intermediate Zones,MSOAIZ,DH,9108,4416,4692,1809,1977
E02004312,County Durham 028,Middle Super Output Areas and Intermediate Zones,MSOAIZ,DH,7549,3639,3910,1338,1364
E02004313,County Durham 029,Middle Super Output Areas and Intermediate Zones,MSOAIZ,DH,6684,3320,3364,1327,1301
E02004314,County Durham 030,Middle Super Output Areas and Intermediate Zones,MSOAIZ,DH,12248,6354,5894,1200,690
E02004315,County Durham 033,Middle Super Output Areas and Intermediate Zones,MSOAIZ,DH,10184,5118,5066,1948,1894
E02004316,County Durham 031,Middle Super Output Areas and Intermediate Zones,MSOAIZ,DL,5683,2794,2889,1213,1239
E02004317,County Durham 038,Middle Super Output Areas and Intermediate Zones,MSOAIZ,DL,7663,3710,3953,1502,1544
E02004318,County Durham 041,Middle Super Output Areas and Intermediate Zones,MSOAIZ,DH,6099,2950,3149,1230,1240
E02004319,County Durham 044,Middle Super Output Areas and Intermediate Zones,MSOAIZ,TS,7474,3704,3770,1541,1622
E02004320,County Durham 016,Middle Super Output Areas and Intermediate Zones,MSOAIZ,SR,8956,4412,4544,1917,1928
E02004321,County Durham 017,Middle Super Output Areas and Intermediate Zones,MSOAIZ,SR,8345,4150,4195,1786,1772
E02004322,County Durham 018,Middle Super Output Areas and Intermediate Zones,MSOAIZ,SR,8490,3967,4523,1512,1681
E02004323,County Durham 021,Middle Super Output Areas and Intermediate Zones,MSOAIZ,SR,7906,3981,3925,1650,1631
E02004324,County Durham 025,Middle Super Output Areas and Intermediate Zones,MSOAIZ,SR,5732,2888,2844,1142,1172
E02004325,County Durham 032,Middle Super Output Areas and Intermediate Zones,MSOAIZ,SR,8722,4199,4523,1688,1762
E02004326,County Durham 034,Middle Super Output Areas and Intermediate Zones,MSOAIZ,SR,6190,3082,3108,1230,1237
E02004327,County Durham 036,Middle Super Output Areas and Intermediate Zones,MSOAIZ,SR,6374,3096,3278,1182,1230
E02004328,County Durham 035,Middle Super Output Areas and Intermediate Zones,MSOAIZ,SR,7337,3482,3855,1428,1579
E02004329,County Durham 037,Middle Super Output Areas and Intermediate Zones,MSOAIZ,SR,6772,3332,3440,1287,1391
E02004330,County Durham 039,Middle Super Output Areas and Intermediate Zones,MSOAIZ,TS,5944,2887,3057,1113,1128
E02004331,County Durham 040,Middle Super Output Areas and Intermediate Zones,MSOAIZ,TS,7085,3515,3570,1436,1388
E02004332,County Durham 043,Middle Super Output Areas and Intermediate Zones,MSOAIZ,TS,7278,3540,3738,1537,1582
E02004333,County Durham 047,Middle Super Output Areas and Intermediate Zones,MSOAIZ,DL,7181,3570,3611,1355,1404
E02004334,County Durham 048,Middle Super Output Areas and Intermediate Zones,MSOAIZ,TS,7370,3586,3784,1462,1531
E02004335,County Durham 049,Middle Super Output Areas and Intermediate Zones,MSOAIZ,DL,6289,3031,3258,1200,1233
E02004336,County Durham 050,Middle Super Output Areas and Intermediate Zones,MSOAIZ,DL,6876,3351,3525,1284,1285
E02004337,County Durham 052,Middle Super Output Areas and Intermediate Zones,MSOAIZ,DL,9106,4499,4607,1852,1881
E02004338,County Durham 053,Middle Super Output Areas and Intermediate Zones,MSOAIZ,DL,6761,3308,3453,1326,1369
E02004339,County Durham 054,Middle Super Output Areas and Intermediate Zones,MSOAIZ,TS,6879,3371,3508,1255,1357
E02004340,County Durham 059,Middle Super Output Areas and Intermediate Zones,MSOAIZ,DL,10363,5067,5296,1981,2034
E02004341,County Durham 060,Middle Super Output Areas and Intermediate Zones,MSOAIZ,DL,8417,4177,4240,1720,1853
E02004342,County Durham 061,Middle Super Output Areas and Intermediate Zones,MSOAIZ,DL,5967,2870,3097,1108,1219
E02004343,County Durham 062,Middle Super Output Areas and Intermediate Zones,MSOAIZ,DL,5527,2599,2928,987,1112
E02004344,County Durham 063,Middle Super Output Areas and Intermediate Zones,MSOAIZ,DL,7034,3347,3687,1253,1341
E02004345,County Durham 064,Middle Super Output Areas and Intermediate Zones,MSOAIZ,DL,12759,6262,6497,2307,2484
E02004346,County Durham 065,Middle Super Output Areas and Intermediate Zones,MSOAIZ,DL,5241,2595,2646,976,952
E02004347,County Durham 066,Middle Super Output Areas and Intermediate Zones,MSOAIZ,DL,7040,3585,3455,1122,1153
E02004348,County Durham 042,Middle Super Output Areas and Intermediate Zones,MSOAIZ,DL,8063,3967,4096,1482,1507
E02004349,County Durham 045,Middle Super Output Areas and Intermediate Zones,MSOAIZ,DL,9228,4525,4703,1809,1881
E02004350,County Durham 046,Middle Super Output Areas and Intermediate Zones,MSOAIZ,DL,9614,4720,4894,1964,1985
E02004351,County Durham 051,Middle Super Output Areas and Intermediate Zones,MSOAIZ,DL,7025,3453,3572,1321,1384
E02004352,County Durham 055,Middle Super Output Areas and Intermediate Zones,MSOAIZ,DL,7566,3722,3844,1529,1562
E02004353,County Durham 056,Middle Super Output Areas and Intermediate Zones,MSOAIZ,DL,7549,3560,3989,1422,1515
E02004354,County Durham 057,Middle Super Output Areas and Intermediate Zones,MSOAIZ,DL,8755,4276,4479,1821,1825
E02004355,County Durham 058,Middle Super Output Areas and Intermediate Zones,MSOAIZ,DL,7257,3397,3860,1325,1464
E02004356,Eastbourne 001,Middle Super Output Areas and Intermediate Zones,MSOAIZ,BN,7492,3562,3930,1339,1617
E02004357,Eastbourne 002,Middle Super Output Areas and Intermediate Zones,MSOAIZ,BN,7695,3688,4007,1392,1607
E02004358,Eastbourne 003,Middle Super Output Areas and Intermediate Zones,MSOAIZ,BN,7779,3704,4075,1208,1381
E02004359,Eastbourne 004,Middle Super Output Areas and Intermediate Zones,MSOAIZ,BN,7938,3715,4223,1288,1445
E02004361,Eastbourne 006,Middle Super Output Areas and Intermediate Zones,MSOAIZ,BN,7984,3754,4230,1259,1498
E02004362,Eastbourne 007,Middle Super Output Areas and Intermediate Zones,MSOAIZ,BN,8723,4203,4520,1704,1835
E02004363,Eastbourne 008,Middle Super Output Areas and Intermediate Zones,MSOAIZ,BN,6728,3186,3542,1305,1236
E02004364,Eastbourne 009,Middle Super Output Areas and Intermediate Zones,MSOAIZ,BN,8214,3814,4400,1438,1603
E02004365,Eastbourne 010,Middle Super Output Areas and Intermediate Zones,MSOAIZ,BN,7420,3792,3628,1872,1589
E02004366,Eastbourne 011,Middle Super Output Areas and Intermediate Zones,MSOAIZ,BN,6898,3378,3520,1461,1168
E02004367,Eastbourne 012,Middle Super Output Areas and Intermediate Zones,MSOAIZ,BN,7070,3216,3854,880,910
E02004368,Hastings 001,Middle Super Output Areas and Intermediate Zones,MSOAIZ,TN,8042,3911,4131,1571,1682
E02004369,Hastings 002,Middle Super Output Areas and Intermediate Zones,MSOAIZ,TN,9682,4614,5068,1483,1621
E02004370,Hastings 003,Middle Super Output Areas and Intermediate Zones,MSOAIZ,TN,7706,3725,3981,1367,1630
E02004371,Hastings 004,Middle Super Output Areas and Intermediate Zones,MSOAIZ,TN,7022,3392,3630,1279,1422
E02004372,Hastings 005,Middle Super Output Areas and Intermediate Zones,MSOAIZ,TN,6495,3063,3432,1204,1401
E02004373,Hastings 006,Middle Super Output Areas and Intermediate Zones,MSOAIZ,TN,8548,4045,4503,1631,1741
E02004374,Hastings 007,Middle Super Output Areas and Intermediate Zones,MSOAIZ,TN,7746,3743,4003,1546,1583
E02004375,Hastings 008,Middle Super Output Areas and Intermediate Zones,MSOAIZ,TN,8552,4261,4291,1830,1781
E02004376,Hastings 009,Middle Super Output Areas and Intermediate Zones,MSOAIZ,TN,6987,3577,3410,1764,1451
E02004377,Hastings 010,Middle Super Output Areas and Intermediate Zones,MSOAIZ,TN,10580,4996,5584,1967,2068
E02004378,Hastings 011,Middle Super Output Areas and Intermediate Zones,MSOAIZ,TN,8894,4687,4207,2382,1775
E02004379,Lewes 001,Middle Super Output Areas and Intermediate Zones,MSOAIZ,TN,7650,3763,3887,1370,1451
E02004380,Lewes 002,Middle Super Output Areas and Intermediate Zones,MSOAIZ,RH,8786,4231,4555,1449,1608
E02004381,Lewes 003,Middle Super Output Areas and Intermediate Zones,MSOAIZ,BN,9595,4658,4937,1944,2095
E02004382,Lewes 004,Middle Super Output Areas and Intermediate Zones,MSOAIZ,TN,6422,3112,3310,1121,1172
E02004383,Lewes 005,Middle Super Output Areas and Intermediate Zones,MSOAIZ,BN,7702,3790,3912,1482,1526
E02004384,Lewes 006,Middle Super Output Areas and Intermediate Zones,MSOAIZ,BN,7477,3630,3847,1420,1451
E02004385,Lewes 007,Middle Super Output Areas and Intermediate Zones,MSOAIZ,BN,7590,3720,3870,1407,1451
E02004386,Lewes 008,Middle Super Output Areas and Intermediate Zones,MSOAIZ,BN,6286,3139,3147,1185,1187
E02004387,Lewes 009,Middle Super Output Areas and Intermediate Zones,MSOAIZ,BN,5946,2955,2991,1226,1275
E02004388,Lewes 010,Middle Super Output Areas and Intermediate Zones,MSOAIZ,BN,6477,3099,3378,1150,1197
E02004389,Lewes 011,Middle Super Output Areas and Intermediate Zones,MSOAIZ,BN,9480,4572,4908,1431,1452
E02004390,Lewes 012,Middle Super Output Areas and Intermediate Zones,MSOAIZ,BN,7853,3725,4128,1106,1220
E02004391,Lewes 013,Middle Super Output Areas and Intermediate Zones,MSOAIZ,BN,6238,2969,3269,1174,1103
E02004392,Rother 001,Middle Super Output Areas and Intermediate Zones,MSOAIZ,TN,9281,4594,4687,1668,1802
E02004393,Rother 002,Middle Super Output Areas and Intermediate Zones,MSOAIZ,TN,6129,2942,3187,927,1024
E02004394,Rother 003,Middle Super Output Areas and Intermediate Zones,MSOAIZ,TN,7826,3845,3981,1288,1405
E02004395,Rother 004,Middle Super Output Areas and Intermediate Zones,MSOAIZ,TN,7584,3681,3903,1251,1287
E02004396,Rother 005,Middle Super Output Areas and Intermediate Zones,MSOAIZ,TN,8663,4190,4473,1196,1300
E02004397,Rother 006,Middle Super Output Areas and Intermediate Zones,MSOAIZ,TN,7998,3801,4197,1274,1415
E02004398,Rother 007,Middle Super Output Areas and Intermediate Zones,MSOAIZ,TN,8736,4074,4662,1407,1690
E02004399,Rother 008,Middle Super Output Areas and Intermediate Zones,MSOAIZ,TN,7757,3605,4152,1107,1203
E02004400,Rother 009,Middle Super Output Areas and Intermediate Zones,MSOAIZ,TN,10232,4736,5496,1240,1385
E02004401,Rother 010,Middle Super Output Areas and Intermediate Zones,MSOAIZ,TN,7672,3522,4150,964,1028
E02004402,Rother 011,Middle Super Output Areas and Intermediate Zones,MSOAIZ,TN,8710,4031,4679,1643,1458
E02004403,Wealden 001,Middle Super Output Areas and Intermediate Zones,MSOAIZ,TN,6483,3119,3364,1125,1235
E02004404,Wealden 002,Middle Super Output Areas and Intermediate Zones,MSOAIZ,TN,6421,3116,3305,1171,1248
E02004405,Wealden 003,Middle Super Output Areas and Intermediate Zones,MSOAIZ,TN,5801,2853,2948,1038,1105
E02004406,Wealden 004,Middle Super Output Areas and Intermediate Zones,MSOAIZ,TN,7168,3486,3682,1180,1184
E02004407,Wealden 005,Middle Super Output Areas and Intermediate Zones,MSOAIZ,TN,7795,3716,4079,1322,1457
E02004408,Wealden 006,Middle Super Output Areas and Intermediate Zones,MSOAIZ,TN,7982,3959,4023,1686,1702
E02004409,Wealden 007,Middle Super Output Areas and Intermediate Zones,MSOAIZ,TN,5588,2749,2839,992,1008
E02004410,Wealden 008,Middle Super Output Areas and Intermediate Zones,MSOAIZ,TN,7824,3827,3997,1383,1438
E02004411,Wealden 009,Middle Super Output Areas and Intermediate Zones,MSOAIZ,TN,8511,4067,4444,1620,1693
E02004412,Wealden 010,Middle Super Output Areas and Intermediate Zones,MSOAIZ,TN,7772,3751,4021,1446,1498
E02004413,Wealden 011,Middle Super Output Areas and Intermediate Zones,MSOAIZ,TN,6831,3340,3491,1215,1245
E02004414,Wealden 012,Middle Super Output Areas and Intermediate Zones,MSOAIZ,TN,5982,2894,3088,1235,1342
E02004415,Wealden 013,Middle Super Output Areas and Intermediate Zones,MSOAIZ,TN,6149,3044,3105,1077,1183
E02004416,Wealden 014,Middle Super Output Areas and Intermediate Zones,MSOAIZ,TN,6441,3118,3323,1075,1159
E02004417,Wealden 015,Middle Super Output Areas and Intermediate Zones,MSOAIZ,BN,5630,2672,2958,999,996
E02004418,Wealden 016,Middle Super Output Areas and Intermediate Zones,MSOAIZ,BN,5525,2626,2899,903,1021
E02004419,Wealden 017,Middle Super Output Areas and Intermediate Zones,MSOAIZ,BN,5931,2752,3179,936,1101
E02004420,Wealden 018,Middle Super Output Areas and Intermediate Zones,MSOAIZ,TN,10519,5088,5431,1612,1714
E02004421,Wealden 019,Middle Super Output Areas and Intermediate Zones,MSOAIZ,BN,7655,3589,4066,1265,1345
E02004422,Wealden 020,Middle Super Output Areas and Intermediate Zones,MSOAIZ,BN,9467,4546,4921,1597,1702
E02004423,Wealden 021,Middle Super Output Areas and Intermediate Zones,MSOAIZ,BN,7440,3495,3945,1111,1203
E02004424,Basildon 001,Middle Super Output Areas and Intermediate Zones,MSOAIZ,CM,7133,3528,3605,1381,1473
E02004425,Basildon 002,Middle Super Output Areas and Intermediate Zones,MSOAIZ,CM,7347,3554,3793,1544,1682
E02004426,Basildon 003,Middle Super Output Areas and Intermediate Zones,MSOAIZ,CM,7815,3840,3975,1586,1609
E02004427,Basildon 004,Middle Super Output Areas and Intermediate Zones,MSOAIZ,CM,7562,3641,3921,1384,1433
E02004428,Basildon 005,Middle Super Output Areas and Intermediate Zones,MSOAIZ,SS,6176,2957,3219,1174,1172
E02004429,Basildon 006,Middle Super Output Areas and Intermediate Zones,MSOAIZ,SS,7513,3659,3854,1309,1356
E02004430,Basildon 007,Middle Super Output Areas and Intermediate Zones,MSOAIZ,SS,8062,3977,4085,1731,1781
E02004431,Basildon 008,Middle Super Output Areas and Intermediate Zones,MSOAIZ,SS,9071,4448,4623,2104,2194
E02004432,Basildon 009,Middle Super Output Areas and Intermediate Zones,MSOAIZ,SS,6892,3353,3539,1292,1394
E02004433,Basildon 010,Middle Super Output Areas and Intermediate Zones,MSOAIZ,SS,8611,4165,4446,1876,1972
E02004434,Basildon 011,Middle Super Output Areas and Intermediate Zones,MSOAIZ,SS,8385,4128,4257,1843,1909
E02004435,Basildon 012,Middle Super Output Areas and Intermediate Zones,MSOAIZ,SS,8036,3811,4225,1566,1712
E02004436,Basildon 013,Middle Super Output Areas and Intermediate Zones,MSOAIZ,SS,7700,3732,3968,1478,1597
E02004437,Basildon 014,Middle Super Output Areas and Intermediate Zones,MSOAIZ,SS,7863,3805,4058,1564,1630
E02004438,Basildon 015,Middle Super Output Areas and Intermediate Zones,MSOAIZ,SS,8621,3980,4641,1646,1799
E02004439,Basildon 016,Middle Super Output Areas and Intermediate Zones,MSOAIZ,SS,8779,4133,4646,1691,2018
E02004440,Basildon 017,Middle Super Output Areas and Intermediate Zones,MSOAIZ,SS,7880,3777,4103,1645,1677
E02004441,Basildon 018,Middle Super Output Areas and Intermediate Zones,MSOAIZ,SS,7455,3628,3827,1418,1485
E02004442,Basildon 019,Middle Super Output Areas and Intermediate Zones,MSOAIZ,SS,8187,3977,4210,1556,1761
E02004443,Basildon 020,Middle Super Output Areas and Intermediate Zones,MSOAIZ,SS,8171,4016,4155,1638,1657
E02004444,Basildon 021,Middle Super Output Areas and Intermediate Zones,MSOAIZ,SS,9064,4460,4604,2031,2040
E02004445,Basildon 022,Middle Super Output Areas and Intermediate Zones,MSOAIZ,SS,8174,4076,4098,1754,1730
E02004446,Braintree 001,Middle Super Output Areas and Intermediate Zones,MSOAIZ,CO,6878,3414,3464,1287,1377
E02004447,Braintree 002,Middle Super Output Areas and Intermediate Zones,MSOAIZ,CO,5839,2936,2903,1012,1072
E02004448,Braintree 003,Middle Super Output Areas and Intermediate Zones,MSOAIZ,CO,6349,3119,3230,1133,1205
E02004449,Braintree 004,Middle Super Output Areas and Intermediate Zones,MSOAIZ,CO,8483,4114,4369,1764,1760
E02004450,Braintree 005,Middle Super Output Areas and Intermediate Zones,MSOAIZ,CO,6030,2998,3032,1115,1205
E02004451,Braintree 006,Middle Super Output Areas and Intermediate Zones,MSOAIZ,CO,8664,4202,4462,1588,1731
E02004452,Braintree 007,Middle Super Output Areas and Intermediate Zones,MSOAIZ,CO,9291,4534,4757,1837,1883
E02004453,Braintree 008,Middle Super Output Areas and Intermediate Zones,MSOAIZ,CM,7091,3396,3695,1354,1484
E02004454,Braintree 009,Middle Super Output Areas and Intermediate Zones,MSOAIZ,CM,8921,4462,4459,2144,1870
E02004455,Braintree 010,Middle Super Output Areas and Intermediate Zones,MSOAIZ,CM,7634,3718,3916,1467,1631
E02004456,Braintree 011,Middle Super Output Areas and Intermediate Zones,MSOAIZ,CM,8913,4415,4498,1925,1970
E02004457,Braintree 012,Middle Super Output Areas and Intermediate Zones,MSOAIZ,CO,10331,5075,5256,2070,2239
E02004458,Braintree 013,Middle Super Output Areas and Intermediate Zones,MSOAIZ,CM,9519,4604,4915,1974,2124
E02004459,Braintree 014,Middle Super Output Areas and Intermediate Zones,MSOAIZ,CO,10349,5093,5256,1985,2046
E02004460,Braintree 015,Middle Super Output Areas and Intermediate Zones,MSOAIZ,CM,8855,4349,4506,1732,1800
E02004461,Braintree 016,Middle Super Output Areas and Intermediate Zones,MSOAIZ,CM,5820,2864,2956,1251,1281
E02004462,Braintree 017,Middle Super Output Areas and Intermediate Zones,MSOAIZ,CM,10135,4934,5201,2269,2165
E02004463,Braintree 018,Middle Super Output Areas and Intermediate Zones,MSOAIZ,CM,7982,3910,4072,1548,1593
E02004464,Brentwood 001,Middle Super Output Areas and Intermediate Zones,MSOAIZ,RM,9765,4738,5027,1635,1811
E02004465,Brentwood 002,Middle Super Output Areas and Intermediate Zones,MSOAIZ,CM,5966,2828,3138,1068,1126
E02004466,Brentwood 003,Middle Super Output Areas and Intermediate Zones,MSOAIZ,CM,8084,3869,4215,1493,1658
E02004467,Brentwood 004,Middle Super Output Areas and Intermediate Zones,MSOAIZ,CM,7574,3619,3955,1474,1587
E02004468,Brentwood 005,Middle Super Output Areas and Intermediate Zones,MSOAIZ,CM,10452,5196,5256,1926,1990
E02004469,Brentwood 006,Middle Super Output Areas and Intermediate Zones,MSOAIZ,CM,6862,3334,3528,1307,1391
E02004470,Brentwood 007,Middle Super Output Areas and Intermediate Zones,MSOAIZ,CM,10667,5179,5488,2702,2713
E02004471,Brentwood 008,Middle Super Output Areas and Intermediate Zones,MSOAIZ,RM,8045,3785,4260,1573,1712
E02004472,Brentwood 009,Middle Super Output Areas and Intermediate Zones,MSOAIZ,CM,6186,3034,3152,1265,1297
E02004473,Castle Point 001,Middle Super Output Areas and Intermediate Zones,MSOAIZ,SS,7674,3745,3929,1426,1482
E02004474,Castle Point 002,Middle Super Output Areas and Intermediate Zones,MSOAIZ,SS,7129,3455,3674,1274,1270
E02004475,Castle Point 003,Middle Super Output Areas and Intermediate Zones,MSOAIZ,SS,6533,3182,3351,1175,1233
E02004476,Castle Point 004,Middle Super Output Areas and Intermediate Zones,MSOAIZ,SS,8002,3903,4099,1444,1495
E02004477,Castle Point 005,Middle Super Output Areas and Intermediate Zones,MSOAIZ,SS,5949,2891,3058,958,994
E02004478,Castle Point 006,Middle Super Output Areas and Intermediate Zones,MSOAIZ,SS,6605,3148,3457,1223,1255
E02004479,Castle Point 007,Middle Super Output Areas and Intermediate Zones,MSOAIZ,SS,7949,3919,4030,1535,1465
E02004480,Castle Point 008,Middle Super Output Areas and Intermediate Zones,MSOAIZ,SS,7112,3507,3605,1439,1469
E02004481,Castle Point 009,Middle Super Output Areas and Intermediate Zones,MSOAIZ,SS,6735,3245,3490,1045,1021
E02004482,Castle Point 010,Middle Super Output Areas and Intermediate Zones,MSOAIZ,SS,8394,4040,4354,1506,1675
E02004483,Castle Point 011,Middle Super Output Areas and Intermediate Zones,MSOAIZ,SS,8166,4063,4103,1557,1435
E02004484,Castle Point 012,Middle Super Output Areas and Intermediate Zones,MSOAIZ,SS,7763,3809,3954,1447,1436
E02004485,Chelmsford 001,Middle Super Output Areas and Intermediate Zones,MSOAIZ,CM,7006,3454,3552,1307,1435
E02004486,Chelmsford 002,Middle Super Output Areas and Intermediate Zones,MSOAIZ,CM,8197,3957,4240,1601,1629
E02004487,Chelmsford 003,Middle Super Output Areas and Intermediate Zones,MSOAIZ,CM,7077,3472,3605,1330,1429
E02004488,Chelmsford 004,Middle Super Output Areas and Intermediate Zones,MSOAIZ,CM,8254,4079,4175,1698,1765
E02004489,Chelmsford 005,Middle Super Output Areas and Intermediate Zones,MSOAIZ,CM,9209,4511,4698,1912,2045
E02004490,Chelmsford 006,Middle Super Output Areas and Intermediate Zones,MSOAIZ,CM,7716,3672,4044,1458,1627
E02004491,Chelmsford 007,Middle Super Output Areas and Intermediate Zones,MSOAIZ,CM,7370,3655,3715,1523,1594
E02004492,Chelmsford 008,Middle Super Output Areas and Intermediate Zones,MSOAIZ,CM,9290,4561,4729,2259,2326
E02004493,Chelmsford 009,Middle Super Output Areas and Intermediate Zones,MSOAIZ,CM,10127,5022,5105,2380,2251
E02004494,Chelmsford 010,Middle Super Output Areas and Intermediate Zones,MSOAIZ,CM,9565,5064,4501,2990,2281
E02004495,Chelmsford 011,Middle Super Output Areas and Intermediate Zones,MSOAIZ,CM,8186,3956,4230,1365,1474
E02004496,Chelmsford 012,Middle Super Output Areas and Intermediate Zones,MSOAIZ,CM,7403,3648,3755,1581,1587
E02004497,Chelmsford 013,Middle Super Output Areas and Intermediate Zones,MSOAIZ,CM,7848,3841,4007,1448,1492
E02004498,Chelmsford 014,Middle Super Output Areas and Intermediate Zones,MSOAIZ,CM,9720,4738,4982,2000,2107
E02004499,Chelmsford 015,Middle Super Output Areas and Intermediate Zones,MSOAIZ,CM,6927,3379,3548,1390,1445
E02004500,Chelmsford 016,Middle Super Output Areas and Intermediate Zones,MSOAIZ,CM,9147,4505,4642,1607,1775
E02004501,Chelmsford 017,Middle Super Output Areas and Intermediate Zones,MSOAIZ,CM,7243,3538,3705,1339,1353
E02004502,Chelmsford 018,Middle Super Output Areas and Intermediate Zones,MSOAIZ,SS,6551,3265,3286,1160,1201
E02004503,Chelmsford 019,Middle Super Output Areas and Intermediate Zones,MSOAIZ,CM,8087,4018,4069,1615,1656
E02004504,Chelmsford 020,Middle Super Output Areas and Intermediate Zones,MSOAIZ,CM,8366,4105,4261,1788,1865
E02004505,Chelmsford 021,Middle Super Output Areas and Intermediate Zones,MSOAIZ,SS,5021,2474,2547,912,872
E02004506,Colchester 001,Middle Super Output Areas and Intermediate Zones,MSOAIZ,CO,6798,3346,3452,1246,1292
E02004507,Colchester 002,Middle Super Output Areas and Intermediate Zones,MSOAIZ,CO,9987,4928,5059,2399,2507
E02004508,Colchester 003,Middle Super Output Areas and Intermediate Zones,MSOAIZ,CO,6551,3228,3323,1229,1314
E02004509,Colchester 004,Middle Super Output Areas and Intermediate Zones,MSOAIZ,CO,10565,5238,5327,2645,2677
E02004512,Colchester 007,Middle Super Output Areas and Intermediate Zones,MSOAIZ,CO,9996,4975,5021,2566,2245
E02004513,Colchester 008,Middle Super Output Areas and Intermediate Zones,MSOAIZ,CO,10991,5345,5646,1774,1897
E02004514,Colchester 009,Middle Super Output Areas and Intermediate Zones,MSOAIZ,CO,5549,2626,2923,962,1027
E02004515,Colchester 010,Middle Super Output Areas and Intermediate Zones,MSOAIZ,CO,7161,3577,3584,1368,1420
E02004516,Colchester 011,Middle Super Output Areas and Intermediate Zones,MSOAIZ,CO,10682,5807,4875,3169,2363
E02004517,Colchester 012,Middle Super Output Areas and Intermediate Zones,MSOAIZ,CO,8283,3979,4304,1575,1653
E02004518,Colchester 013,Middle Super Output Areas and Intermediate Zones,MSOAIZ,CO,6208,3125,3083,1389,1396
E02004519,Colchester 014,Middle Super Output Areas and Intermediate Zones,MSOAIZ,CO,7396,3556,3840,1217,1377
E02004520,Colchester 015,Middle Super Output Areas and Intermediate Zones,MSOAIZ,CO,8360,4110,4250,1761,1874
E02004521,Colchester 016,Middle Super Output Areas and Intermediate Zones,MSOAIZ,CO,8814,4239,4575,1806,1956
E02004522,Colchester 017,Middle Super Output Areas and Intermediate Zones,MSOAIZ,CO,10025,4887,5138,1520,1603
E02004523,Colchester 018,Middle Super Output Areas and Intermediate Zones,MSOAIZ,CO,9014,4544,4470,1936,1940
E02004524,Colchester 019,Middle Super Output Areas and Intermediate Zones,MSOAIZ,CO,8247,4082,4165,1518,1610
E02004525,Colchester 020,Middle Super Output Areas and Intermediate Zones,MSOAIZ,CO,7583,3671,3912,1278,1334
E02004526,Colchester 021,Middle Super Output Areas and Intermediate Zones,MSOAIZ,CO,7183,3404,3779,1060,1145
E02004527,Epping Forest 001,Middle Super Output Areas and Intermediate Zones,MSOAIZ,CM,8629,4251,4378,1787,1840
E02004528,Epping Forest 002,Middle Super Output Areas and Intermediate Zones,MSOAIZ,EN,8037,3968,4069,1424,1527
E02004529,Epping Forest 003,Middle Super Output Areas and Intermediate Zones,MSOAIZ,RM,6615,3304,3311,1217,1284
E02004530,Epping Forest 004,Middle Super Output Areas and Intermediate Zones,MSOAIZ,CM,6251,3009,3242,1121,1185
E02004531,Epping Forest 005,Middle Super Output Areas and Intermediate Zones,MSOAIZ,CM,6238,2971,3267,1200,1285
E02004532,Epping Forest 006,Middle Super Output Areas and Intermediate Zones,MSOAIZ,CM,6192,2968,3224,1282,1314
E02004533,Epping Forest 007,Middle Super Output Areas and Intermediate Zones,MSOAIZ,EN,7156,3417,3739,1343,1463
E02004534,Epping Forest 008,Middle Super Output Areas and Intermediate Zones,MSOAIZ,EN,8758,4313,4445,1895,2024
E02004535,Epping Forest 009,Middle Super Output Areas and Intermediate Zones,MSOAIZ,IG,5235,2616,2619,1060,1005
E02004536,Epping Forest 010,Middle Super Output Areas and Intermediate Zones,MSOAIZ,RM,6075,2939,3136,1062,1168
E02004537,Epping Forest 011,Middle Super Output Areas and Intermediate Zones,MSOAIZ,IG,8550,4135,4415,1812,1920
E02004538,Epping Forest 012,Middle Super Output Areas and Intermediate Zones,MSOAIZ,IG,8971,4356,4615,1782,1892
E02004539,Epping Forest 013,Middle Super Output Areas and Intermediate Zones,MSOAIZ,IG,7612,3621,3991,1493,1754
E02004540,Epping Forest 014,Middle Super Output Areas and Intermediate Zones,MSOAIZ,IG,5973,2890,3083,1232,1349
E02004541,Epping Forest 015,Middle Super Output Areas and Intermediate Zones,MSOAIZ,IG,11380,5422,5958,2353,2556
E02004542,Epping Forest 016,Middle Super Output Areas and Intermediate Zones,MSOAIZ,IG,6367,3117,3250,1160,1252
E02004543,Epping Forest 017,Middle Super Output Areas and Intermediate Zones,MSOAIZ,IG,6620,3143,3477,1252,1423
E02004544,Harlow 001,Middle Super Output Areas and Intermediate Zones,MSOAIZ,CM,6968,3360,3608,1442,1440
E02004545,Harlow 002,Middle Super Output Areas and Intermediate Zones,MSOAIZ,CM,7184,3418,3766,1377,1501
E02004546,Harlow 003,Middle Super Output Areas and Intermediate Zones,MSOAIZ,CM,7423,3628,3795,1552,1587
E02004547,Harlow 004,Middle Super Output Areas and Intermediate Zones,MSOAIZ,CM,7957,3819,4138,1713,1834
E02004548,Harlow 005,Middle Super Output Areas and Intermediate Zones,MSOAIZ,CM,8895,4327,4568,2123,2339
E02004549,Harlow 006,Middle Super Output Areas and Intermediate Zones,MSOAIZ,CM,7694,3691,4003,1502,1632
E02004550,Harlow 007,Middle Super Output Areas and Intermediate Zones,MSOAIZ,CM,7662,3698,3964,1558,1602
E02004551,Harlow 008,Middle Super Output Areas and Intermediate Zones,MSOAIZ,CM,7206,3432,3774,1408,1543
E02004552,Harlow 009,Middle Super Output Areas and Intermediate Zones,MSOAIZ,CM,6455,3172,3283,1332,1357
E02004553,Harlow 010,Middle Super Output Areas and Intermediate Zones,MSOAIZ,CM,7270,3530,3740,1506,1590
E02004554,Harlow 011,Middle Super Output Areas and Intermediate Zones,MSOAIZ,CM,7230,3599,3631,1562,1595
E02004555,Maldon 001,Middle Super Output Areas and Intermediate Zones,MSOAIZ,CO,6042,2997,3045,1098,1184
E02004556,Maldon 002,Middle Super Output Areas and Intermediate Zones,MSOAIZ,CO,7160,3538,3622,1208,1277
E02004557,Maldon 003,Middle Super Output Areas and Intermediate Zones,MSOAIZ,CM,8175,4045,4130,1699,1718
E02004558,Maldon 004,Middle Super Output Areas and Intermediate Zones,MSOAIZ,CM,6428,3060,3368,1166,1211
E02004559,Maldon 005,Middle Super Output Areas and Intermediate Zones,MSOAIZ,CM,7792,3788,4004,1426,1549
E02004560,Maldon 006,Middle Super Output Areas and Intermediate Zones,MSOAIZ,CM,8332,4173,4159,1606,1608
E02004561,Maldon 007,Middle Super Output Areas and Intermediate Zones,MSOAIZ,CM,10029,5051,4978,1876,1937
E02004562,Maldon 008,Middle Super Output Areas and Intermediate Zones,MSOAIZ,CM,7671,3806,3865,1384,1409
E02004563,Rochford 001,Middle Super Output Areas and Intermediate Zones,MSOAIZ,SS,6527,3217,3310,1071,1079
E02004564,Rochford 002,Middle Super Output Areas and Intermediate Zones,MSOAIZ,SS,7969,3906,4063,1453,1555
E02004565,Rochford 003,Middle Super Output Areas and Intermediate Zones,MSOAIZ,SS,14876,7299,7577,2691,2843
E02004566,Rochford 004,Middle Super Output Areas and Intermediate Zones,MSOAIZ,SS,5725,2748,2977,1122,1124
E02004567,Rochford 005,Middle Super Output Areas and Intermediate Zones,MSOAIZ,SS,8151,4069,4082,1624,1473
E02004568,Rochford 006,Middle Super Output Areas and Intermediate Zones,MSOAIZ,SS,8543,4187,4356,1963,1983
E02004569,Rochford 007,Middle Super Output Areas and Intermediate Zones,MSOAIZ,SS,7300,3562,3738,1524,1500
E02004570,Rochford 008,Middle Super Output Areas and Intermediate Zones,MSOAIZ,SS,8683,4133,4550,1586,1641
E02004571,Rochford 009,Middle Super Output Areas and Intermediate Zones,MSOAIZ,SS,7899,3905,3994,1442,1449
E02004572,Rochford 010,Middle Super Output Areas and Intermediate Zones,MSOAIZ,SS,7614,3761,3853,1418,1507
E02004573,Tendring 001,Middle Super Output Areas and Intermediate Zones,MSOAIZ,CO,6072,3012,3060,1151,1129
E02004574,Tendring 002,Middle Super Output Areas and Intermediate Zones,MSOAIZ,CO,7312,3533,3779,1281,1387
E02004575,Tendring 003,Middle Super Output Areas and Intermediate Zones,MSOAIZ,CO,11138,5382,5756,2068,2197
E02004576,Tendring 004,Middle Super Output Areas and Intermediate Zones,MSOAIZ,CO,8831,4289,4542,1468,1588
E02004577,Tendring 005,Middle Super Output Areas and Intermediate Zones,MSOAIZ,CO,5203,2623,2580,993,987
E02004578,Tendring 006,Middle Super Output Areas and Intermediate Zones,MSOAIZ,CO,7149,3256,3893,914,1044
E02004579,Tendring 007,Middle Super Output Areas and Intermediate Zones,MSOAIZ,CO,6890,3398,3492,1098,1166
E02004580,Tendring 008,Middle Super Output Areas and Intermediate Zones,MSOAIZ,CO,11696,5390,6306,1476,1667
E02004581,Tendring 009,Middle Super Output Areas and Intermediate Zones,MSOAIZ,CO,7410,3667,3743,1242,1310
E02004582,Tendring 010,Middle Super Output Areas and Intermediate Zones,MSOAIZ,CO,6689,3114,3575,882,1018
E02004583,Tendring 011,Middle Super Output Areas and Intermediate Zones,MSOAIZ,CO,8299,4055,4244,1391,1481
E02004584,Tendring 012,Middle Super Output Areas and Intermediate Zones,MSOAIZ,CO,6441,3015,3426,750,789
E02004585,Tendring 013,Middle Super Output Areas and Intermediate Zones,MSOAIZ,CO,7652,3676,3976,1176,1343
E02004586,Tendring 014,Middle Super Output Areas and Intermediate Zones,MSOAIZ,CO,8145,3841,4304,1203,1304
E02004587,Tendring 015,Middle Super Output Areas and Intermediate Zones,MSOAIZ,CO,7744,3643,4101,1177,1407
E02004588,Tendring 016,Middle Super Output Areas and Intermediate Zones,MSOAIZ,CO,6475,3122,3353,1213,1123
E02004589,Tendring 017,Middle Super Output Areas and Intermediate Zones,MSOAIZ,CO,7402,3430,3972,1142,1296
E02004590,Tendring 018,Middle Super Output Areas and Intermediate Zones,MSOAIZ,CO,7500,3625,3875,1134,1102
E02004591,Uttlesford 001,Middle Super Output Areas and Intermediate Zones,MSOAIZ,CB,6847,3354,3493,1287,1404
E02004592,Uttlesford 002,Middle Super Output Areas and Intermediate Zones,MSOAIZ,CB,12102,5878,6224,2448,2501
E02004593,Uttlesford 003,Middle Super Output Areas and Intermediate Zones,MSOAIZ,SG,8132,4020,4112,1452,1630
E02004594,Uttlesford 004,Middle Super Output Areas and Intermediate Zones,MSOAIZ,CM,7819,3982,3837,1523,1499
E02004595,Uttlesford 005,Middle Super Output Areas and Intermediate Zones,MSOAIZ,CM,11911,5903,6008,2487,2526
E02004596,Uttlesford 006,Middle Super Output Areas and Intermediate Zones,MSOAIZ,CM,7662,3844,3818,1642,1650
E02004597,Uttlesford 007,Middle Super Output Areas and Intermediate Zones,MSOAIZ,CM,7267,3504,3763,1503,1583
E02004598,Uttlesford 008,Middle Super Output Areas and Intermediate Zones,MSOAIZ,CM,10349,5110,5239,1927,2044
E02004599,Uttlesford 009,Middle Super Output Areas and Intermediate Zones,MSOAIZ,CM,7354,3608,3746,1394,1509
E02004600,Cheltenham 001,Middle Super Output Areas and Intermediate Zones,MSOAIZ,GL,5700,2830,2870,1260,1223
E02004601,Cheltenham 002,Middle Super Output Areas and Intermediate Zones,MSOAIZ,GL,5165,2431,2734,832,937
E02004602,Cheltenham 003,Middle Super Output Areas and Intermediate Zones,MSOAIZ,GL,6432,3016,3416,1310,1467
E02004603,Cheltenham 004,Middle Super Output Areas and Intermediate Zones,MSOAIZ,GL,7675,3665,4010,1461,1289
E02004604,Cheltenham 005,Middle Super Output Areas and Intermediate Zones,MSOAIZ,GL,7955,3875,4080,1712,1728
E02004605,Cheltenham 006,Middle Super Output Areas and Intermediate Zones,MSOAIZ,GL,5731,2793,2938,1157,1193
E02004606,Cheltenham 007,Middle Super Output Areas and Intermediate Zones,MSOAIZ,GL,9788,5021,4767,2413,2096
E02004607,Cheltenham 008,Middle Super Output Areas and Intermediate Zones,MSOAIZ,GL,9449,4858,4591,2632,2133
E02004608,Cheltenham 009,Middle Super Output Areas and Intermediate Zones,MSOAIZ,GL,10461,5095,5366,2710,2105
E02004609,Cheltenham 010,Middle Super Output Areas and Intermediate Zones,MSOAIZ,GL,7276,3641,3635,1613,1491
E02004610,Cheltenham 011,Middle Super Output Areas and Intermediate Zones,MSOAIZ,GL,8036,3883,4153,1625,1527
E02004611,Cheltenham 012,Middle Super Output Areas and Intermediate Zones,MSOAIZ,GL,11088,5317,5771,2155,2316
E02004612,Cheltenham 013,Middle Super Output Areas and Intermediate Zones,MSOAIZ,GL,9437,4566,4871,1850,2022
E02004613,Cheltenham 014,Middle Super Output Areas and Intermediate Zones,MSOAIZ,GL,6264,2971,3293,1114,1167
E02004614,Cheltenham 015,Middle Super Output Areas and Intermediate Zones,MSOAIZ,GL,5275,2550,2725,1023,1077
E02004615,Cotswold 001,Middle Super Output Areas and Intermediate Zones,MSOAIZ,WR,7929,3780,4149,1212,1390
E02004616,Cotswold 002,Middle Super Output Areas and Intermediate Zones,MSOAIZ,OX,8652,4096,4556,1499,1623
E02004617,Cotswold 003,Middle Super Output Areas and Intermediate Zones,MSOAIZ,OX,7679,3699,3980,1389,1491
E02004618,Cotswold 004,Middle Super Output Areas and Intermediate Zones,MSOAIZ,GL,7297,3650,3647,1296,1430
E02004619,Cotswold 005,Middle Super Output Areas and Intermediate Zones,MSOAIZ,SN,7293,3543,3750,1324,1463
E02004620,Cotswold 006,Middle Super Output Areas and Intermediate Zones,MSOAIZ,GL,7686,3774,3912,1454,1570
E02004621,Cotswold 007,Middle Super Output Areas and Intermediate Zones,MSOAIZ,GL,6305,2974,3331,1175,1068
E02004622,Cotswold 008,Middle Super Output Areas and Intermediate Zones,MSOAIZ,GL,6871,3370,3501,1368,1319
E02004623,Cotswold 009,Middle Super Output Areas and Intermediate Zones,MSOAIZ,GL,8004,3866,4138,1397,1445
E02004624,Cotswold 010,Middle Super Output Areas and Intermediate Zones,MSOAIZ,GL,5876,2856,3020,1120,1191
E02004625,Cotswold 011,Middle Super Output Areas and Intermediate Zones,MSOAIZ,SN,9289,4496,4793,1749,1818
E02004626,Forest of Dean 001,Middle Super Output Areas and Intermediate Zones,MSOAIZ,WR,9677,4726,4951,1496,1601
E02004627,Forest of Dean 002,Middle Super Output Areas and Intermediate Zones,MSOAIZ,HR,5350,2593,2757,984,971
E02004628,Forest of Dean 003,Middle Super Output Areas and Intermediate Zones,MSOAIZ,HR,7759,3869,3890,1474,1495
E02004629,Forest of Dean 004,Middle Super Output Areas and Intermediate Zones,MSOAIZ,GL,12262,6059,6203,2387,2397
E02004630,Forest of Dean 005,Middle Super Output Areas and Intermediate Zones,MSOAIZ,GL,6556,3246,3310,1170,1193
E02004631,Forest of Dean 006,Middle Super Output Areas and Intermediate Zones,MSOAIZ,NP,5009,2475,2534,894,929
E02004632,Forest of Dean 007,Middle Super Output Areas and Intermediate Zones,MSOAIZ,NP,10011,4885,5126,1908,1891
E02004633,Forest of Dean 008,Middle Super Output Areas and Intermediate Zones,MSOAIZ,NP,8168,4021,4147,1496,1594
E02004634,Forest of Dean 009,Middle Super Output Areas and Intermediate Zones,MSOAIZ,GL,9993,4858,5135,1835,1896
E02004635,Forest of Dean 010,Middle Super Output Areas and Intermediate Zones,MSOAIZ,NP,7176,3540,3636,1282,1330
E02004636,Gloucester 001,Middle Super Output Areas and Intermediate Zones,MSOAIZ,GL,8081,4015,4066,1598,1621
E02004637,Gloucester 002,Middle Super Output Areas and Intermediate Zones,MSOAIZ,GL,8862,4441,4421,1918,1697
E02004638,Gloucester 003,Middle Super Output Areas and Intermediate Zones,MSOAIZ,GL,5776,2814,2962,1133,1175
E02004639,Gloucester 004,Middle Super Output Areas and Intermediate Zones,MSOAIZ,GL,8219,4406,3813,2207,1608
E02004640,Gloucester 005,Middle Super Output Areas and Intermediate Zones,MSOAIZ,GL,7846,3935,3911,1748,1683
E02004641,Gloucester 006,Middle Super Output Areas and Intermediate Zones,MSOAIZ,GL,7273,3483,3790,1280,1277
E02004642,Gloucester 007,Middle Super Output Areas and Intermediate Zones,MSOAIZ,GL,11875,5839,6036,2481,2637
E02004643,Gloucester 008,Middle Super Output Areas and Intermediate Zones,MSOAIZ,GL,7817,3817,4000,1607,1750
E02004644,Gloucester 009,Middle Super Output Areas and Intermediate Zones,MSOAIZ,GL,8702,4284,4418,1872,1884
E02004645,Gloucester 010,Middle Super Output Areas and Intermediate Zones,MSOAIZ,GL,9490,4666,4824,2083,2210
E02004646,Gloucester 011,Middle Super Output Areas and Intermediate Zones,MSOAIZ,GL,8500,4183,4317,1720,1682
E02004647,Gloucester 012,Middle Super Output Areas and Intermediate Zones,MSOAIZ,GL,5889,2832,3057,1001,1047
E02004648,Gloucester 013,Middle Super Output Areas and Intermediate Zones,MSOAIZ,GL,5839,2842,2997,1032,1076
E02004649,Gloucester 014,Middle Super Output Areas and Intermediate Zones,MSOAIZ,GL,7098,3419,3679,1744,1846
E02004650,Gloucester 015,Middle Super Output Areas and Intermediate Zones,MSOAIZ,GL,10421,5128,5293,2397,2504
E02004651,Stroud 001,Middle Super Output Areas and Intermediate Zones,MSOAIZ,GL,7628,3762,3866,1615,1569
E02004652,Stroud 002,Middle Super Output Areas and Intermediate Zones,MSOAIZ,GL,6300,3043,3257,1001,1036
E02004653,Stroud 003,Middle Super Output Areas and Intermediate Zones,MSOAIZ,GL,6554,3245,3309,1246,1278
E02004654,Stroud 004,Middle Super Output Areas and Intermediate Zones,MSOAIZ,GL,11229,5526,5703,2163,2243
E02004655,Stroud 005,Middle Super Output Areas and Intermediate Zones,MSOAIZ,GL,7725,3847,3878,1508,1524
E02004656,Stroud 006,Middle Super Output Areas and Intermediate Zones,MSOAIZ,GL,11093,5512,5581,2439,2370
E02004657,Stroud 007,Middle Super Output Areas and Intermediate Zones,MSOAIZ,GL,6870,3439,3431,1388,1414
E02004658,Stroud 008,Middle Super Output Areas and Intermediate Zones,MSOAIZ,GL,6509,3193,3316,1258,1363
E02004659,Stroud 009,Middle Super Output Areas and Intermediate Zones,MSOAIZ,GL,6259,3080,3179,1067,1119
E02004660,Stroud 010,Middle Super Output Areas and Intermediate Zones,MSOAIZ,GL,6473,3098,3375,1014,1090
E02004661,Stroud 011,Middle Super Output Areas and Intermediate Zones,MSOAIZ,GL,8162,4035,4127,1530,1545
E02004662,Stroud 012,Middle Super Output Areas and Intermediate Zones,MSOAIZ,GL,6060,3018,3042,1166,1170
E02004663,Stroud 013,Middle Super Output Areas and Intermediate Zones,MSOAIZ,GL,6614,3172,3442,1209,1311
E02004664,Stroud 014,Middle Super Output Areas and Intermediate Zones,MSOAIZ,GL,6697,3305,3392,1462,1378
E02004665,Stroud 015,Middle Super Output Areas and Intermediate Zones,MSOAIZ,GL,8606,4239,4367,1528,1634
E02004666,Tewkesbury 001,Middle Super Output Areas and Intermediate Zones,MSOAIZ,GL,11583,5849,5734,2643,2633
E02004667,Tewkesbury 002,Middle Super Output Areas and Intermediate Zones,MSOAIZ,WR,10295,5075,5220,2063,1971
E02004668,Tewkesbury 003,Middle Super Output Areas and Intermediate Zones,MSOAIZ,WR,8250,4033,4217,1376,1444
E02004669,Tewkesbury 004,Middle Super Output Areas and Intermediate Zones,MSOAIZ,GL,6603,3228,3375,1170,1211
E02004670,Tewkesbury 005,Middle Super Output Areas and Intermediate Zones,MSOAIZ,GL,12693,6028,6665,2396,2635
E02004671,Tewkesbury 006,Middle Super Output Areas and Intermediate Zones,MSOAIZ,GL,5863,2888,2975,1062,1108
E02004672,Tewkesbury 007,Middle Super Output Areas and Intermediate Zones,MSOAIZ,GL,12520,6191,6329,2540,2605
E02004673,Tewkesbury 008,Middle Super Output Areas and Intermediate Zones,MSOAIZ,GL,5417,2600,2817,881,939
E02004674,Tewkesbury 009,Middle Super Output Areas and Intermediate Zones,MSOAIZ,GL,8719,4188,4531,1751,1851
E02004675,Basingstoke and Deane 001,Middle Super Output Areas and Intermediate Zones,MSOAIZ,RG,7417,3741,3676,1551,1524
E02004676,Basingstoke and Deane 002,Middle Super Output Areas and Intermediate Zones,MSOAIZ,RG,8007,4035,3972,1625,1573
E02004677,Basingstoke and Deane 003,Middle Super Output Areas and Intermediate Zones,MSOAIZ,SO,7239,3590,3649,1357,1478
E02004678,Basingstoke and Deane 004,Middle Super Output Areas and Intermediate Zones,MSOAIZ,RG,7423,3671,3752,1442,1520
E02004679,Basingstoke and Deane 005,Middle Super Output Areas and Intermediate Zones,MSOAIZ,RG,8424,4170,4254,1782,1877
E02004680,Basingstoke and Deane 006,Middle Super Output Areas and Intermediate Zones,MSOAIZ,RG,6806,3376,3430,1767,1780
E02004681,Basingstoke and Deane 007,Middle Super Output Areas and Intermediate Zones,MSOAIZ,RG,11249,5518,5731,2613,2606
E02004682,Basingstoke and Deane 008,Middle Super Output Areas and Intermediate Zones,MSOAIZ,RG,7898,3909,3989,1887,1979
E02004683,Basingstoke and Deane 009,Middle Super Output Areas and Intermediate Zones,MSOAIZ,RG,6898,3362,3536,1487,1504
E02004684,Basingstoke and Deane 010,Middle Super Output Areas and Intermediate Zones,MSOAIZ,RG,9141,4534,4607,2150,2157
E02004685,Basingstoke and Deane 011,Middle Super Output Areas and Intermediate Zones,MSOAIZ,RG,6950,3582,3368,1886,1678
E02004686,Basingstoke and Deane 012,Middle Super Output Areas and Intermediate Zones,MSOAIZ,RG,7985,4059,3926,2101,1899
E02004687,Basingstoke and Deane 013,Middle Super Output Areas and Intermediate Zones,MSOAIZ,RG,7075,3444,3631,1525,1593
E02004688,Basingstoke and Deane 014,Middle Super Output Areas and Intermediate Zones,MSOAIZ,RG,7679,3728,3951,1586,1592
E02004689,Basingstoke and Deane 015,Middle Super Output Areas and Intermediate Zones,MSOAIZ,RG,5476,2687,2789,952,994
E02004690,Basingstoke and Deane 016,Middle Super Output Areas and Intermediate Zones,MSOAIZ,RG,7873,3955,3918,1769,1751
E02004691,Basingstoke and Deane 017,Middle Super Output Areas and Intermediate Zones,MSOAIZ,SO,7818,3834,3984,1436,1526
E02004692,Basingstoke and Deane 018,Middle Super Output Areas and Intermediate Zones,MSOAIZ,RG,7285,3608,3677,1261,1277
E02004693,Basingstoke and Deane 019,Middle Super Output Areas and Intermediate Zones,MSOAIZ,RG,7164,3462,3702,1596,1717
E02004694,Basingstoke and Deane 020,Middle Super Output Areas and Intermediate Zones,MSOAIZ,SP,6748,3279,3469,1324,1415
E02004695,Basingstoke and Deane 021,Middle Super Output Areas and Intermediate Zones,MSOAIZ,RG,8971,4435,4536,2277,2402
E02004696,Basingstoke and Deane 022,Middle Super Output Areas and Intermediate Zones,MSOAIZ,SO,6273,3137,3136,1233,1276
E02004697,East Hampshire 001,Middle Super Output Areas and Intermediate Zones,MSOAIZ,RG,5856,2809,3047,1000,1142
E02004698,East Hampshire 002,Middle Super Output Areas and Intermediate Zones,MSOAIZ,GU,5565,2693,2872,1096,1141
E02004699,East Hampshire 003,Middle Super Output Areas and Intermediate Zones,MSOAIZ,GU,10633,5172,5461,2140,2161
E02004700,East Hampshire 004,Middle Super Output Areas and Intermediate Zones,MSOAIZ,GU,5858,3018,2840,1406,1345
E02004702,East Hampshire 006,Middle Super Output Areas and Intermediate Zones,MSOAIZ,GU,8199,4067,4132,1743,1858
E02004703,East Hampshire 007,Middle Super Output Areas and Intermediate Zones,MSOAIZ,SO,10669,5268,5401,1837,2027
E02004704,East Hampshire 008,Middle Super Output Areas and Intermediate Zones,MSOAIZ,GU,5672,2802,2870,1119,1199
E02004705,East Hampshire 009,Middle Super Output Areas and Intermediate Zones,MSOAIZ,GU,8491,4103,4388,1556,1646
E02004706,East Hampshire 010,Middle Super Output Areas and Intermediate Zones,MSOAIZ,SO,7583,3579,4004,1378,1464
E02004707,East Hampshire 011,Middle Super Output Areas and Intermediate Zones,MSOAIZ,PO,11539,5563,5976,1983,2135
E02004708,East Hampshire 012,Middle Super Output Areas and Intermediate Zones,MSOAIZ,GU,8621,4101,4520,1682,1756
E02004709,East Hampshire 013,Middle Super Output Areas and Intermediate Zones,MSOAIZ,PO,7388,3633,3755,1361,1500
E02004710,East Hampshire 014,Middle Super Output Areas and Intermediate Zones,MSOAIZ,PO,6387,3094,3293,1195,1296
E02004712,Eastleigh 001,Middle Super Output Areas and Intermediate Zones,MSOAIZ,SO,8801,4264,4537,1488,1567
E02004713,Eastleigh 002,Middle Super Output Areas and Intermediate Zones,MSOAIZ,SO,7845,3849,3996,1483,1541
E02004714,Eastleigh 003,Middle Super Output Areas and Intermediate Zones,MSOAIZ,SO,7705,3760,3945,1459,1515
E02004715,Eastleigh 004,Middle Super Output Areas and Intermediate Zones,MSOAIZ,SO,8055,4038,4017,1746,1725
E02004716,Eastleigh 005,Middle Super Output Areas and Intermediate Zones,MSOAIZ,SO,8816,4353,4463,1704,1889
E02004717,Eastleigh 006,Middle Super Output Areas and Intermediate Zones,MSOAIZ,SO,9682,4647,5035,1999,2104
E02004718,Eastleigh 007,Middle Super Output Areas and Intermediate Zones,MSOAIZ,SO,8883,4483,4400,2206,2068
E02004719,Eastleigh 008,Middle Super Output Areas and Intermediate Zones,MSOAIZ,SO,10081,5049,5032,2016,2065
E02004720,Eastleigh 009,Middle Super Output Areas and Intermediate Zones,MSOAIZ,SO,10761,5234,5527,2125,2267
E02004721,Eastleigh 010,Middle Super Output Areas and Intermediate Zones,MSOAIZ,SO,9233,4522,4711,2212,2310
E02004722,Eastleigh 011,Middle Super Output Areas and Intermediate Zones,MSOAIZ,SO,7221,3437,3784,1318,1422
E02004723,Eastleigh 012,Middle Super Output Areas and Intermediate Zones,MSOAIZ,SO,9419,4591,4828,1778,1927
E02004724,Eastleigh 013,Middle Super Output Areas and Intermediate Zones,MSOAIZ,SO,7664,3714,3950,1562,1684
E02004725,Eastleigh 014,Middle Super Output Areas and Intermediate Zones,MSOAIZ,SO,5332,2578,2754,1044,1111
E02004726,Eastleigh 015,Middle Super Output Areas and Intermediate Zones,MSOAIZ,SO,5701,2865,2836,1169,1228
E02004727,Fareham 001,Middle Super Output Areas and Intermediate Zones,MSOAIZ,SO,9013,4519,4494,1998,2088
E02004728,Fareham 002,Middle Super Output Areas and Intermediate Zones,MSOAIZ,SO,8559,4200,4359,1842,1865
E02004729,Fareham 003,Middle Super Output Areas and Intermediate Zones,MSOAIZ,PO,7401,3569,3832,1424,1531
E02004730,Fareham 004,Middle Super Output Areas and Intermediate Zones,MSOAIZ,PO,8740,4299,4441,1538,1565
E02004731,Fareham 005,Middle Super Output Areas and Intermediate Zones,MSOAIZ,SO,7900,3883,4017,1570,1657
E02004732,Fareham 006,Middle Super Output Areas and Intermediate Zones,MSOAIZ,SO,8168,4080,4088,1505,1571
E02004733,Fareham 007,Middle Super Output Areas and Intermediate Zones,MSOAIZ,SO,7364,3657,3707,1484,1579
E02004734,Fareham 008,Middle Super Output Areas and Intermediate Zones,MSOAIZ,PO,10202,5014,5188,2096,2141
E02004735,Fareham 009,Middle Super Output Areas and Intermediate Zones,MSOAIZ,PO,7518,3677,3841,1383,1329
E02004736,Fareham 010,Middle Super Output Areas and Intermediate Zones,MSOAIZ,PO,7847,3855,3992,1377,1422
E02004737,Fareham 011,Middle Super Output Areas and Intermediate Zones,MSOAIZ,PO,7430,3632,3798,1610,1548
E02004738,Fareham 012,Middle Super Output Areas and Intermediate Zones,MSOAIZ,PO,7362,3587,3775,1313,1390
E02004739,Fareham 013,Middle Super Output Areas and Intermediate Zones,MSOAIZ,PO,6907,3304,3603,1082,1154
E02004740,Fareham 014,Middle Super Output Areas and Intermediate Zones,MSOAIZ,PO,7170,3358,3812,1150,1280
E02004741,Gosport 001,Middle Super Output Areas and Intermediate Zones,MSOAIZ,PO,7755,3804,3951,1442,1469
E02004742,Gosport 002,Middle Super Output Areas and Intermediate Zones,MSOAIZ,PO,7494,3671,3823,1455,1447
E02004743,Gosport 003,Middle Super Output Areas and Intermediate Zones,MSOAIZ,PO,7631,3799,3832,1634,1614
E02004744,Gosport 004,Middle Super Output Areas and Intermediate Zones,MSOAIZ,PO,8667,4227,4440,1795,1992
E02004745,Gosport 005,Middle Super Output Areas and Intermediate Zones,MSOAIZ,PO,9024,4535,4489,2098,2010
E02004746,Gosport 006,Middle Super Output Areas and Intermediate Zones,MSOAIZ,PO,10860,5253,5607,2000,2141
E02004747,Gosport 007,Middle Super Output Areas and Intermediate Zones,MSOAIZ,PO,6591,3293,3298,1428,1421
E02004748,Gosport 008,Middle Super Output Areas and Intermediate Zones,MSOAIZ,PO,9594,4860,4734,2184,1947
E02004749,Gosport 009,Middle Super Output Areas and Intermediate Zones,MSOAIZ,PO,7149,3451,3698,1144,1202
E02004750,Gosport 010,Middle Super Output Areas and Intermediate Zones,MSOAIZ,PO,7857,3843,4014,1595,1548
E02004751,Hart 001,Middle Super Output Areas and Intermediate Zones,MSOAIZ,GU,8164,3956,4208,1546,1663
E02004752,Hart 002,Middle Super Output Areas and Intermediate Zones,MSOAIZ,RG,8318,4094,4224,1620,1770
E02004753,Hart 003,Middle Super Output Areas and Intermediate Zones,MSOAIZ,GU,10115,5099,5016,2086,2043
E02004754,Hart 004,Middle Super Output Areas and Intermediate Zones,MSOAIZ,RG,6054,2959,3095,1140,1200
E02004755,Hart 005,Middle Super Output Areas and Intermediate Zones,MSOAIZ,RG,11608,5775,5833,2963,2877
E02004756,Hart 006,Middle Super Output Areas and Intermediate Zones,MSOAIZ,RG,8334,4124,4210,1771,1867
E02004757,Hart 007,Middle Super Output Areas and Intermediate Zones,MSOAIZ,GU,8057,4030,4027,1481,1509
E02004758,Hart 008,Middle Super Output Areas and Intermediate Zones,MSOAIZ,RG,7884,3898,3986,1529,1492
E02004759,Hart 009,Middle Super Output Areas and Intermediate Zones,MSOAIZ,GU,8107,3924,4183,1622,1663
E02004760,Hart 010,Middle Super Output Areas and Intermediate Zones,MSOAIZ,GU,7751,3770,3981,1636,1780
E02004761,Hart 011,Middle Super Output Areas and Intermediate Zones,MSOAIZ,RG,6641,3545,3096,1594,1287
E02004764,Havant 003,Middle Super Output Areas and Intermediate Zones,MSOAIZ,PO,7850,3848,4002,1301,1371
E02004765,Havant 004,Middle Super Output Areas and Intermediate Zones,MSOAIZ,PO,6016,2944,3072,1168,1244
E02004766,Havant 005,Middle Super Output Areas and Intermediate Zones,MSOAIZ,PO,6424,3052,3372,1197,1270
E02004767,Havant 006,Middle Super Output Areas and Intermediate Zones,MSOAIZ,PO,5896,2832,3064,1095,1209
E02004768,Havant 007,Middle Super Output Areas and Intermediate Zones,MSOAIZ,PO,5591,2748,2843,1101,1191
E02004769,Havant 008,Middle Super Output Areas and Intermediate Zones,MSOAIZ,PO,6407,3088,3319,1192,1368
E02004770,Havant 009,Middle Super Output Areas and Intermediate Zones,MSOAIZ,PO,6910,3392,3518,1385,1413
E02004771,Havant 010,Middle Super Output Areas and Intermediate Zones,MSOAIZ,PO,8968,4326,4642,1706,1839
E02004772,Havant 011,Middle Super Output Areas and Intermediate Zones,MSOAIZ,PO,9171,4504,4667,1732,1815
E02004774,Havant 013,Middle Super Output Areas and Intermediate Zones,MSOAIZ,PO,9492,4522,4970,1490,1617
E02004775,Havant 014,Middle Super Output Areas and Intermediate Zones,MSOAIZ,PO,8882,4299,4583,1627,1696
E02004776,Havant 015,Middle Super Output Areas and Intermediate Zones,MSOAIZ,PO,5977,2935,3042,968,976
E02004777,Havant 016,Middle Super Output Areas and Intermediate Zones,MSOAIZ,PO,5384,2521,2863,840,878
E02004778,Havant 017,Middle Super Output Areas and Intermediate Zones,MSOAIZ,PO,6018,2934,3084,995,958
E02004779,New Forest 001,Middle Super Output Areas and Intermediate Zones,MSOAIZ,SP,10876,5293,5583,1766,1951
E02004780,New Forest 002,Middle Super Output Areas and Intermediate Zones,MSOAIZ,SO,6023,2947,3076,1136,1210
E02004781,New Forest 003,Middle Super Output Areas and Intermediate Zones,MSOAIZ,SO,8258,4092,4166,1814,1913
E02004782,New Forest 004,Middle Super Output Areas and Intermediate Zones,MSOAIZ,SO,7650,3769,3881,1511,1482
E02004783,New Forest 005,Middle Super Output Areas and Intermediate Zones,MSOAIZ,SO,7039,3412,3627,1470,1625
E02004784,New Forest 006,Middle Super Output Areas and Intermediate Zones,MSOAIZ,SO,5764,2810,2954,961,959
E02004785,New Forest 007,Middle Super Output Areas and Intermediate Zones,MSOAIZ,SP,5544,2706,2838,952,968
E02004786,New Forest 008,Middle Super Output Areas and Intermediate Zones,MSOAIZ,SO,8817,4335,4482,1882,1991
E02004787,New Forest 009,Middle Super Output Areas and Intermediate Zones,MSOAIZ,SO,7377,3582,3795,1246,1252
E02004788,New Forest 010,Middle Super Output Areas and Intermediate Zones,MSOAIZ,SP,7195,3505,3690,1241,1360
E02004789,New Forest 011,Middle Super Output Areas and Intermediate Zones,MSOAIZ,SO,10473,5096,5377,1846,1981
E02004790,New Forest 012,Middle Super Output Areas and Intermediate Zones,MSOAIZ,BH,7688,3635,4053,1362,1472
E02004791,New Forest 013,Middle Super Output Areas and Intermediate Zones,MSOAIZ,SO,5602,2652,2950,984,1147
E02004792,New Forest 014,Middle Super Output Areas and Intermediate Zones,MSOAIZ,SO,8685,4297,4388,1468,1547
E02004793,New Forest 015,Middle Super Output Areas and Intermediate Zones,MSOAIZ,SO,7433,3520,3913,1099,1196
E02004794,New Forest 016,Middle Super Output Areas and Intermediate Zones,MSOAIZ,BH,6919,3306,3613,1082,1208
E02004795,New Forest 017,Middle Super Output Areas and Intermediate Zones,MSOAIZ,SO,8426,4002,4424,1315,1436
E02004796,New Forest 018,Middle Super Output Areas and Intermediate Zones,MSOAIZ,SO,9641,4568,5073,1392,1568
E02004797,New Forest 019,Middle Super Output Areas and Intermediate Zones,MSOAIZ,SO,7853,3742,4111,1438,1557
E02004798,New Forest 020,Middle Super Output Areas and Intermediate Zones,MSOAIZ,BH,6135,2908,3227,1048,1213
E02004799,New Forest 021,Middle Super Output Areas and Intermediate Zones,MSOAIZ,SO,7960,3656,4304,1185,1220
E02004800,New Forest 022,Middle Super Output Areas and Intermediate Zones,MSOAIZ,SO,7457,3385,4072,827,920
E02004801,New Forest 023,Middle Super Output Areas and Intermediate Zones,MSOAIZ,SO,7647,3566,4081,883,958
E02004802,Rushmoor 001,Middle Super Output Areas and Intermediate Zones,MSOAIZ,GU,6854,3294,3560,1360,1455
E02004803,Rushmoor 002,Middle Super Output Areas and Intermediate Zones,MSOAIZ,GU,7552,3611,3941,1533,1734
E02004804,Rushmoor 003,Middle Super Output Areas and Intermediate Zones,MSOAIZ,GU,7213,3618,3595,1582,1618
E02004805,Rushmoor 004,Middle Super Output Areas and Intermediate Zones,MSOAIZ,GU,8260,4062,4198,1815,1761
E02004806,Rushmoor 005,Middle Super Output Areas and Intermediate Zones,MSOAIZ,GU,8173,3997,4176,1897,1998
E02004807,Rushmoor 006,Middle Super Output Areas and Intermediate Zones,MSOAIZ,GU,9052,4471,4581,2048,2004
E02004808,Rushmoor 007,Middle Super Output Areas and Intermediate Zones,MSOAIZ,GU,10382,5243,5139,2577,2424
E02004809,Rushmoor 008,Middle Super Output Areas and Intermediate Zones,MSOAIZ,GU,8816,4918,3898,2538,1988
E02004810,Rushmoor 009,Middle Super Output Areas and Intermediate Zones,MSOAIZ,GU,7539,3767,3772,1814,1868
E02004811,Rushmoor 010,Middle Super Output Areas and Intermediate Zones,MSOAIZ,GU,7449,3635,3814,1627,1648
E02004812,Rushmoor 011,Middle Super Output Areas and Intermediate Zones,MSOAIZ,GU,6474,3203,3271,1419,1453
E02004813,Rushmoor 012,Middle Super Output Areas and Intermediate Zones,MSOAIZ,GU,6043,2938,3105,1246,1320
E02004814,Test Valley 001,Middle Super Output Areas and Intermediate Zones,MSOAIZ,SP,7043,3449,3594,1519,1559
E02004815,Test Valley 002,Middle Super Output Areas and Intermediate Zones,MSOAIZ,SP,7623,3719,3904,1578,1736
E02004816,Test Valley 003,Middle Super Output Areas and Intermediate Zones,MSOAIZ,SP,9139,4440,4699,1875,1864
E02004817,Test Valley 004,Middle Super Output Areas and Intermediate Zones,MSOAIZ,SP,7762,3813,3949,1626,1602
E02004818,Test Valley 005,Middle Super Output Areas and Intermediate Zones,MSOAIZ,SP,10164,4976,5188,2052,2072
E02004819,Test Valley 006,Middle Super Output Areas and Intermediate Zones,MSOAIZ,SP,7898,3862,4036,1655,1669
E02004820,Test Valley 007,Middle Super Output Areas and Intermediate Zones,MSOAIZ,SP,7371,3722,3649,1573,1522
E02004821,Test Valley 008,Middle Super Output Areas and Intermediate Zones,MSOAIZ,SP,5238,2572,2666,919,985
E02004822,Test Valley 009,Middle Super Output Areas and Intermediate Zones,MSOAIZ,SP,7898,3899,3999,1389,1484
E02004823,Test Valley 010,Middle Super Output Areas and Intermediate Zones,MSOAIZ,SO,8969,4332,4637,1615,1772
E02004824,Test Valley 011,Middle Super Output Areas and Intermediate Zones,MSOAIZ,SO,5799,2642,3157,945,990
E02004825,Test Valley 012,Middle Super Output Areas and Intermediate Zones,MSOAIZ,SO,10631,5162,5469,1887,2006
E02004826,Test Valley 013,Middle Super Output Areas and Intermediate Zones,MSOAIZ,SO,6809,3375,3434,1123,1196
E02004827,Test Valley 014,Middle Super Output Areas and Intermediate Zones,MSOAIZ,SO,7713,3805,3908,1721,1880
E02004828,Test Valley 015,Middle Super Output Areas and Intermediate Zones,MSOAIZ,SO,6341,3112,3229,1132,1217
E02004829,Winchester 001,Middle Super Output Areas and Intermediate Zones,MSOAIZ,SO,5644,2745,2899,1152,1269
E02004830,Winchester 002,Middle Super Output Areas and Intermediate Zones,MSOAIZ,SO,6331,3117,3214,1228,1331
E02004831,Winchester 003,Middle Super Output Areas and Intermediate Zones,MSOAIZ,SO,8784,4255,4529,1418,1489
E02004832,Winchester 004,Middle Super Output Areas and Intermediate Zones,MSOAIZ,SO,8630,4163,4467,1468,1614
E02004833,Winchester 005,Middle Super Output Areas and Intermediate Zones,MSOAIZ,SO,9725,4718,5007,1904,1759
E02004834,Winchester 006,Middle Super Output Areas and Intermediate Zones,MSOAIZ,SO,7446,3342,4104,1380,1451
E02004835,Winchester 007,Middle Super Output Areas and Intermediate Zones,MSOAIZ,SO,10086,5307,4779,2133,2002
E02004836,Winchester 008,Middle Super Output Areas and Intermediate Zones,MSOAIZ,SO,6336,2868,3468,934,926
E02004837,Winchester 009,Middle Super Output Areas and Intermediate Zones,MSOAIZ,SO,7594,3708,3886,1404,1473
E02004838,Winchester 010,Middle Super Output Areas and Intermediate Zones,MSOAIZ,SO,9053,4393,4660,1690,1806
E02004839,Winchester 011,Middle Super Output Areas and Intermediate Zones,MSOAIZ,SO,8151,3957,4194,1402,1565
E02004840,Winchester 012,Middle Super Output Areas and Intermediate Zones,MSOAIZ,SO,9459,4536,4923,1752,1904
E02004841,Winchester 013,Middle Super Output Areas and Intermediate Zones,MSOAIZ,SO,11131,5511,5620,2453,2422
E02004842,Winchester 014,Middle Super Output Areas and Intermediate Zones,MSOAIZ,SO,8225,4009,4216,1534,1666
E02004843,Broxbourne 001,Middle Super Output Areas and Intermediate Zones,MSOAIZ,SG,7181,3502,3679,1325,1448
E02004844,Broxbourne 002,Middle Super Output Areas and Intermediate Zones,MSOAIZ,EN,7187,3498,3689,1498,1595
E02004845,Broxbourne 003,Middle Super Output Areas and Intermediate Zones,MSOAIZ,EN,7240,3584,3656,1582,1494
E02004846,Broxbourne 004,Middle Super Output Areas and Intermediate Zones,MSOAIZ,EN,6238,3072,3166,1115,1176
E02004847,Broxbourne 005,Middle Super Output Areas and Intermediate Zones,MSOAIZ,EN,9763,4678,5085,2040,2259
E02004848,Broxbourne 006,Middle Super Output Areas and Intermediate Zones,MSOAIZ,EN,7192,3454,3738,1368,1544
E02004849,Broxbourne 007,Middle Super Output Areas and Intermediate Zones,MSOAIZ,EN,6836,3369,3467,1345,1457
E02004850,Broxbourne 008,Middle Super Output Areas and Intermediate Zones,MSOAIZ,EN,7446,3587,3859,1489,1616
E02004851,Broxbourne 009,Middle Super Output Areas and Intermediate Zones,MSOAIZ,EN,5800,2755,3045,1145,1238
E02004852,Broxbourne 010,Middle Super Output Areas and Intermediate Zones,MSOAIZ,EN,7646,3697,3949,1578,1605
E02004853,Broxbourne 011,Middle Super Output Areas and Intermediate Zones,MSOAIZ,EN,6336,3032,3304,1178,1300
E02004854,Broxbourne 012,Middle Super Output Areas and Intermediate Zones,MSOAIZ,EN,7337,3562,3775,1453,1551
E02004855,Broxbourne 013,Middle Super Output Areas and Intermediate Zones,MSOAIZ,EN,7407,3567,3840,1652,1787
E02004856,Dacorum 001,Middle Super Output Areas and Intermediate Zones,MSOAIZ,LU,5413,2699,2714,1119,1225
E02004857,Dacorum 002,Middle Super Output Areas and Intermediate Zones,MSOAIZ,HP,5663,2693,2970,1130,1184
E02004858,Dacorum 003,Middle Super Output Areas and Intermediate Zones,MSOAIZ,HP,5078,2482,2596,1025,1090
E02004859,Dacorum 004,Middle Super Output Areas and Intermediate Zones,MSOAIZ,HP,5195,2563,2632,979,1050
E02004860,Dacorum 005,Middle Super Output Areas and Intermediate Zones,MSOAIZ,HP,5765,2880,2885,1423,1429
E02004861,Dacorum 006,Middle Super Output Areas and Intermediate Zones,MSOAIZ,HP,5484,2665,2819,942,1018
E02004862,Dacorum 007,Middle Super Output Areas and Intermediate Zones,MSOAIZ,HP,7574,3821,3753,1620,1609
E02004863,Dacorum 008,Middle Super Output Areas and Intermediate Zones,MSOAIZ,HP,7764,3752,4012,1617,1681
E02004864,Dacorum 009,Middle Super Output Areas and Intermediate Zones,MSOAIZ,HP,6282,3061,3221,1373,1390
E02004865,Dacorum 010,Middle Super Output Areas and Intermediate Zones,MSOAIZ,HP,5332,2607,2725,1160,1178
E02004866,Dacorum 011,Middle Super Output Areas and Intermediate Zones,MSOAIZ,HP,6577,3176,3401,1307,1435
E02004867,Dacorum 012,Middle Super Output Areas and Intermediate Zones,MSOAIZ,HP,6083,2947,3136,1175,1278
E02004868,Dacorum 013,Middle Super Output Areas and Intermediate Zones,MSOAIZ,HP,5848,2796,3052,1165,1198
E02004869,Dacorum 014,Middle Super Output Areas and Intermediate Zones,MSOAIZ,HP,5650,2742,2908,1213,1238
E02004870,Dacorum 015,Middle Super Output Areas and Intermediate Zones,MSOAIZ,HP,9390,4599,4791,2066,2056
E02004871,Dacorum 016,Middle Super Output Areas and Intermediate Zones,MSOAIZ,HP,5068,2500,2568,1044,1100
E02004872,Dacorum 017,Middle Super Output Areas and Intermediate Zones,MSOAIZ,HP,6961,3428,3533,1319,1368
E02004873,Dacorum 018,Middle Super Output Areas and Intermediate Zones,MSOAIZ,HP,10069,5070,4999,2436,2303
E02004874,Dacorum 019,Middle Super Output Areas and Intermediate Zones,MSOAIZ,HP,6183,3015,3168,1271,1359
E02004875,Dacorum 020,Middle Super Output Areas and Intermediate Zones,MSOAIZ,HP,9255,4541,4714,1908,1992
E02004876,Dacorum 021,Middle Super Output Areas and Intermediate Zones,MSOAIZ,WD,8999,4769,4230,2080,1620
E02004877,Dacorum 022,Middle Super Output Areas and Intermediate Zones,MSOAIZ,WD,5214,2501,2713,977,1076
E02004878,East Hertfordshire 001,Middle Super Output Areas and Intermediate Zones,MSOAIZ,SG,6715,3352,3363,1249,1314
E02004879,East Hertfordshire 002,Middle Super Output Areas and Intermediate Zones,MSOAIZ,SG,7720,3847,3873,1494,1511
E02004880,East Hertfordshire 003,Middle Super Output Areas and Intermediate Zones,MSOAIZ,SG,9178,4497,4681,1927,1981
E02004881,East Hertfordshire 004,Middle Super Output Areas and Intermediate Zones,MSOAIZ,CM,5698,2794,2904,1299,1247
E02004882,East Hertfordshire 005,Middle Super Output Areas and Intermediate Zones,MSOAIZ,CM,8000,3896,4104,1680,1713
E02004883,East Hertfordshire 006,Middle Super Output Areas and Intermediate Zones,MSOAIZ,SG,5741,2871,2870,1153,1171
E02004884,East Hertfordshire 007,Middle Super Output Areas and Intermediate Zones,MSOAIZ,CM,9829,4785,5044,2289,2401
E02004885,East Hertfordshire 008,Middle Super Output Areas and Intermediate Zones,MSOAIZ,CM,8804,4354,4450,1935,1987
E02004886,East Hertfordshire 009,Middle Super Output Areas and Intermediate Zones,MSOAIZ,SG,5633,2738,2895,1049,1156
E02004887,East Hertfordshire 010,Middle Super Output Areas and Intermediate Zones,MSOAIZ,SG,7129,3486,3643,1361,1473
E02004888,East Hertfordshire 011,Middle Super Output Areas and Intermediate Zones,MSOAIZ,CM,8458,4173,4285,1660,1735
E02004889,East Hertfordshire 012,Middle Super Output Areas and Intermediate Zones,MSOAIZ,SG,10528,5119,5409,2278,2334
E02004890,East Hertfordshire 013,Middle Super Output Areas and Intermediate Zones,MSOAIZ,SG,8271,4107,4164,1937,1951
E02004891,East Hertfordshire 014,Middle Super Output Areas and Intermediate Zones,MSOAIZ,SG,7456,3589,3867,1584,1669
E02004892,East Hertfordshire 015,Middle Super Output Areas and Intermediate Zones,MSOAIZ,SG,5564,2690,2874,1176,1249
E02004893,East Hertfordshire 016,Middle Super Output Areas and Intermediate Zones,MSOAIZ,SG,5453,2683,2770,1274,1366
E02004894,East Hertfordshire 017,Middle Super Output Areas and Intermediate Zones,MSOAIZ,SG,8310,4166,4144,2034,1966
E02004895,East Hertfordshire 018,Middle Super Output Areas and Intermediate Zones,MSOAIZ,SG,9200,4543,4657,1867,1924
E02004896,Hertsmere 001,Middle Super Output Areas and Intermediate Zones,MSOAIZ,EN,7875,3681,4194,1324,1453
E02004897,Hertsmere 002,Middle Super Output Areas and Intermediate Zones,MSOAIZ,EN,6663,3185,3478,1200,1358
E02004898,Hertsmere 003,Middle Super Output Areas and Intermediate Zones,MSOAIZ,EN,7344,3450,3894,1320,1515
E02004899,Hertsmere 004,Middle Super Output Areas and Intermediate Zones,MSOAIZ,WD,5506,2633,2873,1075,1254
E02004900,Hertsmere 005,Middle Super Output Areas and Intermediate Zones,MSOAIZ,WD,8163,4038,4125,1538,1652
E02004901,Hertsmere 006,Middle Super Output Areas and Intermediate Zones,MSOAIZ,WD,8439,4020,4419,1719,1869
E02004902,Hertsmere 007,Middle Super Output Areas and Intermediate Zones,MSOAIZ,WD,7928,3831,4097,1704,1801
E02004903,Hertsmere 008,Middle Super Output Areas and Intermediate Zones,MSOAIZ,WD,6727,3283,3444,1464,1473
E02004904,Hertsmere 009,Middle Super Output Areas and Intermediate Zones,MSOAIZ,WD,5906,2918,2988,1378,1449
E02004905,Hertsmere 010,Middle Super Output Areas and Intermediate Zones,MSOAIZ,WD,6762,3326,3436,1316,1414
E02004906,Hertsmere 011,Middle Super Output Areas and Intermediate Zones,MSOAIZ,WD,9682,4802,4880,2222,2292
E02004907,Hertsmere 012,Middle Super Output Areas and Intermediate Zones,MSOAIZ,WD,9263,4410,4853,1879,1981
E02004908,Hertsmere 013,Middle Super Output Areas and Intermediate Zones,MSOAIZ,WD,9773,4713,5060,1820,1901
E02004909,North Hertfordshire 001,Middle Super Output Areas and Intermediate Zones,MSOAIZ,SG,5119,2518,2601,1155,1139
E02004910,North Hertfordshire 002,Middle Super Output Areas and Intermediate Zones,MSOAIZ,SG,10662,5311,5351,2261,2215
E02004911,North Hertfordshire 003,Middle Super Output Areas and Intermediate Zones,MSOAIZ,SG,6538,3173,3365,1268,1339
E02004912,North Hertfordshire 004,Middle Super Output Areas and Intermediate Zones,MSOAIZ,SG,10280,5126,5154,2199,2220
E02004913,North Hertfordshire 005,Middle Super Output Areas and Intermediate Zones,MSOAIZ,SG,14741,7306,7435,3328,3387
E02004914,North Hertfordshire 006,Middle Super Output Areas and Intermediate Zones,MSOAIZ,SG,7373,3542,3831,1583,1592
E02004915,North Hertfordshire 007,Middle Super Output Areas and Intermediate Zones,MSOAIZ,SG,5411,2611,2800,1165,1236
E02004916,North Hertfordshire 008,Middle Super Output Areas and Intermediate Zones,MSOAIZ,SG,7337,3525,3812,1257,1349
E02004917,North Hertfordshire 009,Middle Super Output Areas and Intermediate Zones,MSOAIZ,SG,6590,3220,3370,1194,1247
E02004918,North Hertfordshire 010,Middle Super Output Areas and Intermediate Zones,MSOAIZ,SG,8097,4103,3994,2139,2038
E02004919,North Hertfordshire 011,Middle Super Output Areas and Intermediate Zones,MSOAIZ,SG,7288,3633,3655,1624,1651
E02004920,North Hertfordshire 012,Middle Super Output Areas and Intermediate Zones,MSOAIZ,SG,10654,5159,5495,2186,2235
E02004921,North Hertfordshire 013,Middle Super Output Areas and Intermediate Zones,MSOAIZ,SG,7562,3657,3905,1575,1628
E02004922,North Hertfordshire 014,Middle Super Output Areas and Intermediate Zones,MSOAIZ,SG,9455,4623,4832,1748,1893
E02004923,North Hertfordshire 015,Middle Super Output Areas and Intermediate Zones,MSOAIZ,SG,10007,4873,5134,1918,2049
E02004924,St Albans 001,Middle Super Output Areas and Intermediate Zones,MSOAIZ,AL,7239,3499,3740,1428,1528
E02004925,St Albans 002,Middle Super Output Areas and Intermediate Zones,MSOAIZ,AL,7691,3802,3889,1557,1625
E02004926,St Albans 003,Middle Super Output Areas and Intermediate Zones,MSOAIZ,AL,7743,3715,4028,1559,1607
E02004927,St Albans 004,Middle Super Output Areas and Intermediate Zones,MSOAIZ,LU,6410,3059,3351,1158,1274
E02004928,St Albans 005,Middle Super Output Areas and Intermediate Zones,MSOAIZ,AL,6775,3368,3407,1245,1350
E02004929,St Albans 006,Middle Super Output Areas and Intermediate Zones,MSOAIZ,HP,6226,3027,3199,1162,1234
E02004930,St Albans 007,Middle Super Output Areas and Intermediate Zones,MSOAIZ,AL,6826,3310,3516,1468,1494
E02004931,St Albans 008,Middle Super Output Areas and Intermediate Zones,MSOAIZ,AL,6497,3170,3327,1253,1350
E02004932,St Albans 009,Middle Super Output Areas and Intermediate Zones,MSOAIZ,AL,7703,3602,4101,1617,1757
E02004933,St Albans 010,Middle Super Output Areas and Intermediate Zones,MSOAIZ,AL,6907,3384,3523,1401,1477
E02004934,St Albans 011,Middle Super Output Areas and Intermediate Zones,MSOAIZ,AL,7158,3566,3592,1867,1821
E02004935,St Albans 012,Middle Super Output Areas and Intermediate Zones,MSOAIZ,AL,7602,3885,3717,2320,2084
E02004936,St Albans 013,Middle Super Output Areas and Intermediate Zones,MSOAIZ,AL,6178,3113,3065,1417,1439
E02004937,St Albans 014,Middle Super Output Areas and Intermediate Zones,MSOAIZ,AL,6404,3177,3227,1250,1214
E02004938,St Albans 015,Middle Super Output Areas and Intermediate Zones,MSOAIZ,AL,5962,3014,2948,1310,1382
E02004939,St Albans 016,Middle Super Output Areas and Intermediate Zones,MSOAIZ,AL,6614,3274,3340,1422,1403
E02004940,St Albans 017,Middle Super Output Areas and Intermediate Zones,MSOAIZ,AL,7357,3597,3760,1733,1691
E02004941,St Albans 018,Middle Super Output Areas and Intermediate Zones,MSOAIZ,WD,9507,4661,4846,2077,2156
E02004942,St Albans 019,Middle Super Output Areas and Intermediate Zones,MSOAIZ,WD,6130,3058,3072,1274,1219
E02004943,St Albans 020,Middle Super Output Areas and Intermediate Zones,MSOAIZ,WD,7735,3759,3976,1366,1455
E02004944,Stevenage 001,Middle Super Output Areas and Intermediate Zones,MSOAIZ,SG,6746,3379,3367,1471,1485
E02004945,Stevenage 002,Middle Super Output Areas and Intermediate Zones,MSOAIZ,SG,11794,5775,6019,2546,2728
E02004946,Stevenage 003,Middle Super Output Areas and Intermediate Zones,MSOAIZ,SG,6329,3182,3147,1377,1432
E02004947,Stevenage 004,Middle Super Output Areas and Intermediate Zones,MSOAIZ,SG,6326,3187,3139,1450,1458
E02004948,Stevenage 005,Middle Super Output Areas and Intermediate Zones,MSOAIZ,SG,5795,2870,2925,1253,1228
E02004949,Stevenage 006,Middle Super Output Areas and Intermediate Zones,MSOAIZ,SG,8000,4023,3977,1757,1646
E02004950,Stevenage 007,Middle Super Output Areas and Intermediate Zones,MSOAIZ,SG,6779,3320,3459,1373,1494
E02004951,Stevenage 008,Middle Super Output Areas and Intermediate Zones,MSOAIZ,SG,7015,3450,3565,1478,1452
E02004952,Stevenage 009,Middle Super Output Areas and Intermediate Zones,MSOAIZ,SG,6658,3259,3399,1427,1488
E02004953,Stevenage 010,Middle Super Output Areas and Intermediate Zones,MSOAIZ,SG,6210,3017,3193,1261,1368
E02004954,Stevenage 011,Middle Super Output Areas and Intermediate Zones,MSOAIZ,SG,6395,3135,3260,1385,1384
E02004955,Stevenage 012,Middle Super Output Areas and Intermediate Zones,MSOAIZ,SG,5910,2886,3024,1174,1300
E02004956,Three Rivers 001,Middle Super Output Areas and Intermediate Zones,MSOAIZ,WD,8815,4411,4404,1838,1849
E02004957,Three Rivers 002,Middle Super Output Areas and Intermediate Zones,MSOAIZ,WD,8732,4255,4477,1944,2017
E02004958,Three Rivers 003,Middle Super Output Areas and Intermediate Zones,MSOAIZ,WD,7197,3411,3786,1352,1472
E02004959,Three Rivers 004,Middle Super Output Areas and Intermediate Zones,MSOAIZ,WD,5808,2702,3106,1076,1140
E02004960,Three Rivers 005,Middle Super Output Areas and Intermediate Zones,MSOAIZ,WD,5567,2718,2849,1060,1063
E02004961,Three Rivers 006,Middle Super Output Areas and Intermediate Zones,MSOAIZ,WD,9241,4531,4710,1878,1972
E02004962,Three Rivers 007,Middle Super Output Areas and Intermediate Zones,MSOAIZ,WD,8521,4180,4341,1844,1882
E02004963,Three Rivers 008,Middle Super Output Areas and Intermediate Zones,MSOAIZ,WD,7029,3429,3600,1372,1528
E02004964,Three Rivers 009,Middle Super Output Areas and Intermediate Zones,MSOAIZ,WD,5602,2677,2925,1166,1299
E02004965,Three Rivers 010,Middle Super Output Areas and Intermediate Zones,MSOAIZ,WD,6532,3117,3415,1190,1248
E02004966,Three Rivers 011,Middle Super Output Areas and Intermediate Zones,MSOAIZ,WD,6967,3459,3508,1369,1357
E02004967,Three Rivers 012,Middle Super Output Areas and Intermediate Zones,MSOAIZ,WD,7306,3481,3825,1518,1715
E02004968,Watford 001,Middle Super Output Areas and Intermediate Zones,MSOAIZ,WD,7083,3441,3642,1529,1591
E02004969,Watford 002,Middle Super Output Areas and Intermediate Zones,MSOAIZ,WD,7195,3473,3722,1445,1632
E02004970,Watford 003,Middle Super Output Areas and Intermediate Zones,MSOAIZ,WD,7832,3723,4109,1586,1709
E02004971,Watford 004,Middle Super Output Areas and Intermediate Zones,MSOAIZ,WD,7484,3714,3770,1645,1668
E02004972,Watford 005,Middle Super Output Areas and Intermediate Zones,MSOAIZ,WD,6100,3075,3025,1342,1374
E02004973,Watford 006,Middle Super Output Areas and Intermediate Zones,MSOAIZ,WD,7444,3776,3668,2099,1966
E02004974,Watford 007,Middle Super Output Areas and Intermediate Zones,MSOAIZ,WD,7606,3735,3871,1727,1677
E02004975,Watford 008,Middle Super Output Areas and Intermediate Zones,MSOAIZ,WD,7778,3895,3883,1644,1649
E02004976,Watford 009,Middle Super Output Areas and Intermediate Zones,MSOAIZ,WD,8143,4259,3884,2560,2154
E02004977,Watford 010,Middle Super Output Areas and Intermediate Zones,MSOAIZ,WD,8258,4229,4029,2206,2035
E02004978,Watford 011,Middle Super Output Areas and Intermediate Zones,MSOAIZ,WD,8626,4194,4432,2045,2083
E02004979,Watford 012,Middle Super Output Areas and Intermediate Zones,MSOAIZ,WD,6752,3314,3438,1441,1485
E02004980,Welwyn Hatfield 001,Middle Super Output Areas and Intermediate Zones,MSOAIZ,SG,5995,2942,3053,1101,1155
E02004981,Welwyn Hatfield 002,Middle Super Output Areas and Intermediate Zones,MSOAIZ,SG,7189,3553,3636,1479,1546
E02004982,Welwyn Hatfield 003,Middle Super Output Areas and Intermediate Zones,MSOAIZ,AL,5923,2797,3126,1117,1224
E02004983,Welwyn Hatfield 004,Middle Super Output Areas and Intermediate Zones,MSOAIZ,AL,5964,2888,3076,1245,1280
E02004984,Welwyn Hatfield 005,Middle Super Output Areas and Intermediate Zones,MSOAIZ,AL,6314,3176,3138,1501,1470
E02004985,Welwyn Hatfield 006,Middle Super Output Areas and Intermediate Zones,MSOAIZ,AL,6806,3182,3624,1259,1304
E02004986,Welwyn Hatfield 007,Middle Super Output Areas and Intermediate Zones,MSOAIZ,AL,7431,3538,3893,1582,1775
E02004987,Welwyn Hatfield 008,Middle Super Output Areas and Intermediate Zones,MSOAIZ,AL,6740,3281,3459,1417,1540
E02004988,Welwyn Hatfield 009,Middle Super Output Areas and Intermediate Zones,MSOAIZ,AL,7441,3619,3822,1672,1748
E02004989,Welwyn Hatfield 010,Middle Super Output Areas and Intermediate Zones,MSOAIZ,AL,12612,6325,6287,2266,1990
E02004990,Welwyn Hatfield 011,Middle Super Output Areas and Intermediate Zones,MSOAIZ,SG,6371,3240,3131,1437,1278
E02004991,Welwyn Hatfield 012,Middle Super Output Areas and Intermediate Zones,MSOAIZ,AL,7324,3719,3605,1585,1365
E02004992,Welwyn Hatfield 013,Middle Super Output Areas and Intermediate Zones,MSOAIZ,AL,8119,4279,3840,1365,1281
E02004993,Welwyn Hatfield 014,Middle Super Output Areas and Intermediate Zones,MSOAIZ,AL,5251,2543,2708,1008,1005
E02004994,Welwyn Hatfield 015,Middle Super Output Areas and Intermediate Zones,MSOAIZ,SG,5874,2715,3159,986,1090
E02004995,Welwyn Hatfield 016,Middle Super Output Areas and Intermediate Zones,MSOAIZ,EN,5181,2567,2614,881,916
E02004996,Ashford 001,Middle Super Output Areas and Intermediate Zones,MSOAIZ,TN,7956,3848,4108,1521,1604
E02004997,Ashford 002,Middle Super Output Areas and Intermediate Zones,MSOAIZ,TN,7545,3635,3910,1296,1365
E02004998,Ashford 003,Middle Super Output Areas and Intermediate Zones,MSOAIZ,TN,6680,3245,3435,1234,1308
E02004999,Ashford 004,Middle Super Output Areas and Intermediate Zones,MSOAIZ,TN,12536,6073,6463,2522,2724
E02005000,Ashford 005,Middle Super Output Areas and Intermediate Zones,MSOAIZ,TN,9580,4756,4824,2068,2052
E02005001,Ashford 006,Middle Super Output Areas and Intermediate Zones,MSOAIZ,TN,8890,4293,4597,1688,1831
E02005002,Ashford 007,Middle Super Output Areas and Intermediate Zones,MSOAIZ,TN,8958,4344,4614,1872,1910
E02005003,Ashford 008,Middle Super Output Areas and Intermediate Zones,MSOAIZ,TN,8553,4141,4412,1680,1872
E02005004,Ashford 009,Middle Super Output Areas and Intermediate Zones,MSOAIZ,TN,12098,5957,6141,2687,2861
E02005005,Ashford 010,Middle Super Output Areas and Intermediate Zones,MSOAIZ,TN,7432,3619,3813,1316,1452
E02005006,Ashford 011,Middle Super Output Areas and Intermediate Zones,MSOAIZ,TN,5459,2701,2758,952,1056
E02005007,Ashford 012,Middle Super Output Areas and Intermediate Zones,MSOAIZ,TN,8552,4166,4386,1654,1734
E02005008,Ashford 013,Middle Super Output Areas and Intermediate Zones,MSOAIZ,TN,8110,3762,4348,1184,1332
E02005009,Ashford 014,Middle Super Output Areas and Intermediate Zones,MSOAIZ,TN,5607,2692,2915,924,1028
E02005010,Canterbury 001,Middle Super Output Areas and Intermediate Zones,MSOAIZ,CT,7470,3542,3928,1438,1384
E02005011,Canterbury 002,Middle Super Output Areas and Intermediate Zones,MSOAIZ,CT,7353,3459,3894,1062,1194
E02005012,Canterbury 003,Middle Super Output Areas and Intermediate Zones,MSOAIZ,CT,8682,4161,4521,1430,1632
E02005013,Canterbury 004,Middle Super Output Areas and Intermediate Zones,MSOAIZ,CT,8147,3906,4241,1257,1426
E02005014,Canterbury 005,Middle Super Output Areas and Intermediate Zones,MSOAIZ,CT,8463,4012,4451,1254,1424
E02005015,Canterbury 006,Middle Super Output Areas and Intermediate Zones,MSOAIZ,CT,8440,4144,4296,1545,1701
E02005016,Canterbury 007,Middle Super Output Areas and Intermediate Zones,MSOAIZ,CT,7748,3644,4104,1297,1440
E02005017,Canterbury 008,Middle Super Output Areas and Intermediate Zones,MSOAIZ,CT,7208,3386,3822,1412,1573
E02005018,Canterbury 009,Middle Super Output Areas and Intermediate Zones,MSOAIZ,CT,7945,3861,4084,1372,1449
E02005019,Canterbury 010,Middle Super Output Areas and Intermediate Zones,MSOAIZ,CT,6020,2890,3130,1082,1227
E02005020,Canterbury 011,Middle Super Output Areas and Intermediate Zones,MSOAIZ,CT,7129,3476,3653,1239,1334
E02005021,Canterbury 012,Middle Super Output Areas and Intermediate Zones,MSOAIZ,CT,10478,5052,5426,1165,1152
E02005022,Canterbury 013,Middle Super Output Areas and Intermediate Zones,MSOAIZ,CT,8317,4061,4256,987,1064
E02005023,Canterbury 014,Middle Super Output Areas and Intermediate Zones,MSOAIZ,CT,8971,4388,4583,1510,1337
E02005025,Canterbury 016,Middle Super Output Areas and Intermediate Zones,MSOAIZ,CT,9015,4374,4641,1689,1486
E02005026,Canterbury 017,Middle Super Output Areas and Intermediate Zones,MSOAIZ,CT,7430,3634,3796,1443,1542
E02005027,Canterbury 018,Middle Super Output Areas and Intermediate Zones,MSOAIZ,CT,5515,2615,2900,932,1021
E02005028,Dartford 001,Middle Super Output Areas and Intermediate Zones,MSOAIZ,DA,7404,3536,3868,1493,1600
E02005029,Dartford 002,Middle Super Output Areas and Intermediate Zones,MSOAIZ,DA,9352,4710,4642,2512,2407
E02005030,Dartford 003,Middle Super Output Areas and Intermediate Zones,MSOAIZ,DA,9811,4949,4862,2472,2265
E02005031,Dartford 004,Middle Super Output Areas and Intermediate Zones,MSOAIZ,DA,7468,3707,3761,1656,1732
E02005032,Dartford 005,Middle Super Output Areas and Intermediate Zones,MSOAIZ,DA,8962,4591,4371,2371,2127
E02005033,Dartford 006,Middle Super Output Areas and Intermediate Zones,MSOAIZ,DA,6553,3276,3277,1523,1485
E02005034,Dartford 007,Middle Super Output Areas and Intermediate Zones,MSOAIZ,DA,7666,3783,3883,1523,1598
E02005035,Dartford 008,Middle Super Output Areas and Intermediate Zones,MSOAIZ,DA,7999,3967,4032,1677,1696
E02005036,Dartford 009,Middle Super Output Areas and Intermediate Zones,MSOAIZ,DA,6307,3011,3296,1248,1359
E02005037,Dartford 010,Middle Super Output Areas and Intermediate Zones,MSOAIZ,DA,7012,3425,3587,1239,1300
E02005038,Dartford 011,Middle Super Output Areas and Intermediate Zones,MSOAIZ,DA,5793,2799,2994,1068,1100
E02005039,Dartford 012,Middle Super Output Areas and Intermediate Zones,MSOAIZ,DA,6792,3306,3486,1317,1451
E02005040,Dartford 013,Middle Super Output Areas and Intermediate Zones,MSOAIZ,DA,6246,3001,3245,1019,1148
E02005041,Dover 001,Middle Super Output Areas and Intermediate Zones,MSOAIZ,CT,7011,3452,3559,1253,1336
E02005042,Dover 002,Middle Super Output Areas and Intermediate Zones,MSOAIZ,CT,8957,4327,4630,1462,1615
E02005043,Dover 003,Middle Super Output Areas and Intermediate Zones,MSOAIZ,CT,7445,3519,3926,1296,1407
E02005044,Dover 004,Middle Super Output Areas and Intermediate Zones,MSOAIZ,CT,6847,3393,3454,1410,1272
E02005045,Dover 005,Middle Super Output Areas and Intermediate Zones,MSOAIZ,CT,7988,3845,4143,1481,1567
E02005046,Dover 006,Middle Super Output Areas and Intermediate Zones,MSOAIZ,CT,6498,3143,3355,1212,1268
E02005047,Dover 007,Middle Super Output Areas and Intermediate Zones,MSOAIZ,CT,7610,3615,3995,1319,1370
E02005048,Dover 008,Middle Super Output Areas and Intermediate Zones,MSOAIZ,CT,6531,3197,3334,1091,1201
E02005049,Dover 009,Middle Super Output Areas and Intermediate Zones,MSOAIZ,CT,6929,3335,3594,1015,1094
E02005050,Dover 010,Middle Super Output Areas and Intermediate Zones,MSOAIZ,CT,9126,4459,4667,1647,1740
E02005051,Dover 011,Middle Super Output Areas and Intermediate Zones,MSOAIZ,CT,13316,6557,6759,2676,2885
E02005052,Dover 012,Middle Super Output Areas and Intermediate Zones,MSOAIZ,CT,7884,4051,3833,1678,1412
E02005053,Dover 013,Middle Super Output Areas and Intermediate Zones,MSOAIZ,CT,8901,4576,4325,2059,1765
E02005054,Dover 014,Middle Super Output Areas and Intermediate Zones,MSOAIZ,CT,6631,3296,3335,1214,1254
E02005055,Gravesham 001,Middle Super Output Areas and Intermediate Zones,MSOAIZ,DA,7803,3849,3954,1751,1757
E02005056,Gravesham 002,Middle Super Output Areas and Intermediate Zones,MSOAIZ,DA,10022,5239,4783,2665,2074
E02005057,Gravesham 003,Middle Super Output Areas and Intermediate Zones,MSOAIZ,DA,10609,5335,5274,2427,2295
E02005058,Gravesham 004,Middle Super Output Areas and Intermediate Zones,MSOAIZ,DA,7717,3762,3955,1661,1710
E02005059,Gravesham 005,Middle Super Output Areas and Intermediate Zones,MSOAIZ,DA,9908,4918,4990,2069,2019
E02005060,Gravesham 006,Middle Super Output Areas and Intermediate Zones,MSOAIZ,DA,7364,3524,3840,1309,1451
E02005061,Gravesham 007,Middle Super Output Areas and Intermediate Zones,MSOAIZ,DA,7126,3468,3658,1283,1418
E02005062,Gravesham 008,Middle Super Output Areas and Intermediate Zones,MSOAIZ,DA,6982,3420,3562,1287,1420
E02005063,Gravesham 009,Middle Super Output Areas and Intermediate Zones,MSOAIZ,DA,6606,3181,3425,1256,1353
E02005064,Gravesham 010,Middle Super Output Areas and Intermediate Zones,MSOAIZ,ME,6672,3228,3444,1102,1180
E02005065,Gravesham 011,Middle Super Output Areas and Intermediate Zones,MSOAIZ,DA,7221,3499,3722,1398,1542
E02005066,Gravesham 012,Middle Super Output Areas and Intermediate Zones,MSOAIZ,DA,7794,3781,4013,1301,1374
E02005067,Gravesham 013,Middle Super Output Areas and Intermediate Zones,MSOAIZ,TN,5896,2935,2961,1060,1150
E02005068,Maidstone 001,Middle Super Output Areas and Intermediate Zones,MSOAIZ,ME,7042,3490,3552,1512,1600
E02005069,Maidstone 002,Middle Super Output Areas and Intermediate Zones,MSOAIZ,ME,8569,4214,4355,1785,1820
E02005070,Maidstone 003,Middle Super Output Areas and Intermediate Zones,MSOAIZ,ME,8593,4145,4448,1481,1533
E02005071,Maidstone 004,Middle Super Output Areas and Intermediate Zones,MSOAIZ,ME,10403,5689,4714,3048,2302
E02005072,Maidstone 005,Middle Super Output Areas and Intermediate Zones,MSOAIZ,ME,7623,3745,3878,1422,1557
E02005073,Maidstone 006,Middle Super Output Areas and Intermediate Zones,MSOAIZ,ME,10603,5295,5308,2659,2477
E02005074,Maidstone 007,Middle Super Output Areas and Intermediate Zones,MSOAIZ,ME,7979,3850,4129,1480,1606
E02005075,Maidstone 008,Middle Super Output Areas and Intermediate Zones,MSOAIZ,ME,9461,4612,4849,2054,2214
E02005076,Maidstone 009,Middle Super Output Areas and Intermediate Zones,MSOAIZ,ME,8579,4156,4423,1975,2038
E02005077,Maidstone 010,Middle Super Output Areas and Intermediate Zones,MSOAIZ,ME,7831,3854,3977,1461,1559
E02005078,Maidstone 011,Middle Super Output Areas and Intermediate Zones,MSOAIZ,TN,7928,3930,3998,1466,1548
E02005079,Maidstone 012,Middle Super Output Areas and Intermediate Zones,MSOAIZ,ME,7870,3814,4056,1450,1500
E02005080,Maidstone 013,Middle Super Output Areas and Intermediate Zones,MSOAIZ,ME,11004,5222,5782,1931,2147
E02005081,Maidstone 014,Middle Super Output Areas and Intermediate Zones,MSOAIZ,TN,6599,3233,3366,1091,1157
E02005082,Maidstone 015,Middle Super Output Areas and Intermediate Zones,MSOAIZ,TN,9543,4702,4841,1879,2029
E02005083,Maidstone 016,Middle Super Output Areas and Intermediate Zones,MSOAIZ,ME,6741,3316,3425,1244,1267
E02005084,Maidstone 017,Middle Super Output Areas and Intermediate Zones,MSOAIZ,TN,6443,3119,3324,1151,1320
E02005085,Maidstone 018,Middle Super Output Areas and Intermediate Zones,MSOAIZ,TN,6385,3196,3189,1208,1307
E02005086,Maidstone 019,Middle Super Output Areas and Intermediate Zones,MSOAIZ,TN,5947,2910,3037,1064,1155
E02005087,Sevenoaks 001,Middle Super Output Areas and Intermediate Zones,MSOAIZ,DA,6972,3388,3584,1249,1368
E02005088,Sevenoaks 002,Middle Super Output Areas and Intermediate Zones,MSOAIZ,BR,8998,4283,4715,1703,1826
E02005089,Sevenoaks 003,Middle Super Output Areas and Intermediate Zones,MSOAIZ,TN,6257,3067,3190,1205,1238
E02005090,Sevenoaks 004,Middle Super Output Areas and Intermediate Zones,MSOAIZ,TN,5835,2816,3019,933,977
E02005091,Sevenoaks 005,Middle Super Output Areas and Intermediate Zones,MSOAIZ,TN,6625,3194,3431,1268,1338
E02005093,Sevenoaks 007,Middle Super Output Areas and Intermediate Zones,MSOAIZ,TN,6062,2992,3070,1037,1077
E02005094,Sevenoaks 008,Middle Super Output Areas and Intermediate Zones,MSOAIZ,TN,8457,4160,4297,1744,1785
E02005095,Sevenoaks 009,Middle Super Output Areas and Intermediate Zones,MSOAIZ,TN,7420,3585,3835,1292,1402
E02005096,Sevenoaks 010,Middle Super Output Areas and Intermediate Zones,MSOAIZ,TN,9508,4606,4902,2057,2102
E02005097,Sevenoaks 011,Middle Super Output Areas and Intermediate Zones,MSOAIZ,TN,9395,4609,4786,1703,1846
E02005098,Sevenoaks 012,Middle Super Output Areas and Intermediate Zones,MSOAIZ,TN,9791,4729,5062,1893,1909
E02005099,Sevenoaks 013,Middle Super Output Areas and Intermediate Zones,MSOAIZ,TN,7781,3802,3979,1519,1582
E02005100,Sevenoaks 014,Middle Super Output Areas and Intermediate Zones,MSOAIZ,TN,8907,4274,4633,1759,1871
E02005101,Sevenoaks 015,Middle Super Output Areas and Intermediate Zones,MSOAIZ,TN,6720,3270,3450,1262,1370
E02005102,Shepway 001,Middle Super Output Areas and Intermediate Zones,MSOAIZ,TN,6275,3053,3222,993,1113
E02005103,Shepway 002,Middle Super Output Areas and Intermediate Zones,MSOAIZ,CT,9524,4675,4849,1909,2087
E02005104,Shepway 003,Middle Super Output Areas and Intermediate Zones,MSOAIZ,CT,8348,4003,4345,1412,1635
E02005105,Shepway 004,Middle Super Output Areas and Intermediate Zones,MSOAIZ,CT,7745,3831,3914,1589,1638
E02005106,Shepway 005,Middle Super Output Areas and Intermediate Zones,MSOAIZ,CT,9093,4398,4695,1757,1906
E02005107,Shepway 006,Middle Super Output Areas and Intermediate Zones,MSOAIZ,CT,12263,6088,6175,2271,2270
E02005109,Shepway 008,Middle Super Output Areas and Intermediate Zones,MSOAIZ,CT,6562,3069,3493,975,1038
E02005110,Shepway 009,Middle Super Output Areas and Intermediate Zones,MSOAIZ,TN,6772,3293,3479,1131,1233
E02005111,Shepway 010,Middle Super Output Areas and Intermediate Zones,MSOAIZ,CT,7260,3402,3858,1176,1204
E02005112,Shepway 011,Middle Super Output Areas and Intermediate Zones,MSOAIZ,TN,6946,3379,3567,1078,1124
E02005113,Shepway 012,Middle Super Output Areas and Intermediate Zones,MSOAIZ,TN,6996,3384,3612,1135,1177
E02005114,Shepway 013,Middle Super Output Areas and Intermediate Zones,MSOAIZ,TN,6567,3337,3230,1204,1160
E02005115,Swale 001,Middle Super Output Areas and Intermediate Zones,MSOAIZ,ME,5842,2888,2954,1171,1205
E02005116,Swale 002,Middle Super Output Areas and Intermediate Zones,MSOAIZ,ME,6096,2970,3126,1092,1176
E02005117,Swale 003,Middle Super Output Areas and Intermediate Zones,MSOAIZ,ME,5889,2859,3030,943,1032
E02005118,Swale 004,Middle Super Output Areas and Intermediate Zones,MSOAIZ,ME,9097,4477,4620,1807,1861
E02005119,Swale 005,Middle Super Output Areas and Intermediate Zones,MSOAIZ,ME,5702,2819,2883,992,1052
E02005120,Swale 006,Middle Super Output Areas and Intermediate Zones,MSOAIZ,ME,7665,4431,3234,1977,1201
E02005121,Swale 007,Middle Super Output Areas and Intermediate Zones,MSOAIZ,ME,12384,6059,6325,2738,3008
E02005122,Swale 008,Middle Super Output Areas and Intermediate Zones,MSOAIZ,ME,6958,3361,3597,1241,1399
E02005123,Swale 009,Middle Super Output Areas and Intermediate Zones,MSOAIZ,ME,10927,5417,5510,2251,2362
E02005124,Swale 010,Middle Super Output Areas and Intermediate Zones,MSOAIZ,ME,8239,4028,4211,1699,1645
E02005125,Swale 011,Middle Super Output Areas and Intermediate Zones,MSOAIZ,ME,7541,3716,3825,1534,1532
E02005126,Swale 012,Middle Super Output Areas and Intermediate Zones,MSOAIZ,ME,7723,3748,3975,1354,1456
E02005127,Swale 013,Middle Super Output Areas and Intermediate Zones,MSOAIZ,ME,8719,4298,4421,1645,1718
E02005128,Swale 014,Middle Super Output Areas and Intermediate Zones,MSOAIZ,ME,8300,4039,4261,1601,1684
E02005129,Swale 015,Middle Super Output Areas and Intermediate Zones,MSOAIZ,ME,11016,5257,5759,2119,2270
E02005130,Swale 016,Middle Super Output Areas and Intermediate Zones,MSOAIZ,TN,8111,4059,4052,1516,1584
E02005131,Swale 017,Middle Super Output Areas and Intermediate Zones,MSOAIZ,ME,5626,2726,2900,1006,1132
E02005132,Thanet 001,Middle Super Output Areas and Intermediate Zones,MSOAIZ,CT,9553,4804,4749,1965,1756
E02005133,Thanet 002,Middle Super Output Areas and Intermediate Zones,MSOAIZ,CT,8415,3989,4426,1219,1310
E02005134,Thanet 003,Middle Super Output Areas and Intermediate Zones,MSOAIZ,CT,7174,3604,3570,1406,1501
E02005135,Thanet 004,Middle Super Output Areas and Intermediate Zones,MSOAIZ,CT,7698,3712,3986,1440,1568
E02005136,Thanet 005,Middle Super Output Areas and Intermediate Zones,MSOAIZ,CT,7844,3799,4045,1315,1464
E02005137,Thanet 006,Middle Super Output Areas and Intermediate Zones,MSOAIZ,CT,7769,3644,4125,1287,1542
E02005138,Thanet 007,Middle Super Output Areas and Intermediate Zones,MSOAIZ,CT,8453,3939,4514,1409,1609
E02005139,Thanet 008,Middle Super Output Areas and Intermediate Zones,MSOAIZ,CT,8504,3939,4565,1140,1233
E02005140,Thanet 009,Middle Super Output Areas and Intermediate Zones,MSOAIZ,CT,7524,3499,4025,1078,1293
E02005141,Thanet 010,Middle Super Output Areas and Intermediate Zones,MSOAIZ,CT,6920,3357,3563,1187,1227
E02005142,Thanet 011,Middle Super Output Areas and Intermediate Zones,MSOAIZ,CT,7227,3423,3804,1103,1280
E02005143,Thanet 012,Middle Super Output Areas and Intermediate Zones,MSOAIZ,CT,8143,3875,4268,1441,1671
E02005144,Thanet 013,Middle Super Output Areas and Intermediate Zones,MSOAIZ,CT,8355,3991,4364,1454,1724
E02005145,Thanet 014,Middle Super Output Areas and Intermediate Zones,MSOAIZ,CT,6738,3291,3447,1177,1250
E02005146,Thanet 015,Middle Super Output Areas and Intermediate Zones,MSOAIZ,CT,7789,3814,3975,1476,1636
E02005147,Thanet 016,Middle Super Output Areas and Intermediate Zones,MSOAIZ,CT,8516,4226,4290,1753,1687
E02005148,Thanet 017,Middle Super Output Areas and Intermediate Zones,MSOAIZ,CT,7564,3649,3915,1275,1343
E02005149,Tonbridge and Malling 001,Middle Super Output Areas and Intermediate Zones,MSOAIZ,ME,10405,5122,5283,2180,2282
E02005150,Tonbridge and Malling 002,Middle Super Output Areas and Intermediate Zones,MSOAIZ,ME,10211,4941,5270,2165,2250
E02005151,Tonbridge and Malling 003,Middle Super Output Areas and Intermediate Zones,MSOAIZ,ME,12594,6184,6410,2521,2702
E02005153,Tonbridge and Malling 005,Middle Super Output Areas and Intermediate Zones,MSOAIZ,ME,8551,4104,4447,1559,1678
E02005154,Tonbridge and Malling 006,Middle Super Output Areas and Intermediate Zones,MSOAIZ,TN,10943,5355,5588,1980,2120
E02005155,Tonbridge and Malling 007,Middle Super Output Areas and Intermediate Zones,MSOAIZ,TN,10957,5456,5501,2366,2590
E02005156,Tonbridge and Malling 008,Middle Super Output Areas and Intermediate Zones,MSOAIZ,TN,7289,3590,3699,1305,1345
E02005157,Tonbridge and Malling 009,Middle Super Output Areas and Intermediate Zones,MSOAIZ,TN,6578,3141,3437,1111,1214
E02005158,Tonbridge and Malling 010,Middle Super Output Areas and Intermediate Zones,MSOAIZ,TN,6567,3228,3339,1201,1268
E02005159,Tonbridge and Malling 011,Middle Super Output Areas and Intermediate Zones,MSOAIZ,TN,7774,3703,4071,1254,1365
E02005160,Tonbridge and Malling 012,Middle Super Output Areas and Intermediate Zones,MSOAIZ,TN,10525,5412,5113,2301,2228
E02005161,Tonbridge and Malling 013,Middle Super Output Areas and Intermediate Zones,MSOAIZ,TN,8204,4038,4166,1894,1905
E02005162,Tunbridge Wells 001,Middle Super Output Areas and Intermediate Zones,MSOAIZ,TN,10720,5283,5437,2123,2141
E02005163,Tunbridge Wells 002,Middle Super Output Areas and Intermediate Zones,MSOAIZ,TN,8200,4062,4138,1704,1705
E02005164,Tunbridge Wells 003,Middle Super Output Areas and Intermediate Zones,MSOAIZ,TN,7845,3799,4046,1641,1657
E02005165,Tunbridge Wells 004,Middle Super Output Areas and Intermediate Zones,MSOAIZ,TN,7810,3829,3981,1418,1479
E02005166,Tunbridge Wells 005,Middle Super Output Areas and Intermediate Zones,MSOAIZ,TN,7039,3458,3581,1517,1501
E02005167,Tunbridge Wells 006,Middle Super Output Areas and Intermediate Zones,MSOAIZ,TN,7799,3774,4025,1382,1449
E02005168,Tunbridge Wells 007,Middle Super Output Areas and Intermediate Zones,MSOAIZ,TN,7533,3676,3857,1729,1685
E02005169,Tunbridge Wells 008,Middle Super Output Areas and Intermediate Zones,MSOAIZ,TN,8862,4677,4185,2759,2216
E02005170,Tunbridge Wells 009,Middle Super Output Areas and Intermediate Zones,MSOAIZ,TN,9453,4490,4963,2075,2116
E02005171,Tunbridge Wells 010,Middle Super Output Areas and Intermediate Zones,MSOAIZ,TN,6181,3056,3125,1383,1261
E02005172,Tunbridge Wells 011,Middle Super Output Areas and Intermediate Zones,MSOAIZ,TN,8649,4389,4260,1720,1672
E02005173,Tunbridge Wells 012,Middle Super Output Areas and Intermediate Zones,MSOAIZ,TN,8590,4217,4373,1897,1794
E02005174,Tunbridge Wells 013,Middle Super Output Areas and Intermediate Zones,MSOAIZ,TN,7605,3665,3940,1238,1399
E02005175,Tunbridge Wells 014,Middle Super Output Areas and Intermediate Zones,MSOAIZ,TN,8763,4119,4644,1527,1622
E02005176,Burnley 001,Middle Super Output Areas and Intermediate Zones,MSOAIZ,BB,8832,4246,4586,1653,1830
E02005177,Burnley 002,Middle Super Output Areas and Intermediate Zones,MSOAIZ,BB,5797,2839,2958,1117,1153
E02005178,Burnley 003,Middle Super Output Areas and Intermediate Zones,MSOAIZ,BB,8945,4663,4282,1943,1647
E02005179,Burnley 004,Middle Super Output Areas and Intermediate Zones,MSOAIZ,BB,8907,4342,4565,1773,1780
E02005180,Burnley 005,Middle Super Output Areas and Intermediate Zones,MSOAIZ,BB,7006,3426,3580,1359,1427
E02005181,Burnley 006,Middle Super Output Areas and Intermediate Zones,MSOAIZ,BB,6181,3019,3162,1310,1300
E02005182,Burnley 007,Middle Super Output Areas and Intermediate Zones,MSOAIZ,BB,5875,2855,3020,1253,1123
E02005183,Burnley 008,Middle Super Output Areas and Intermediate Zones,MSOAIZ,BB,6086,2964,3122,1099,1145
E02005184,Burnley 009,Middle Super Output Areas and Intermediate Zones,MSOAIZ,OL,5024,2500,2524,907,925
E02005185,Burnley 010,Middle Super Output Areas and Intermediate Zones,MSOAIZ,BB,8408,4126,4282,1712,1714
E02005186,Burnley 011,Middle Super Output Areas and Intermediate Zones,MSOAIZ,BB,6037,2992,3045,1261,1349
E02005189,Chorley 001,Middle Super Output Areas and Intermediate Zones,MSOAIZ,PR,5300,2669,2631,1117,1077
E02005190,Chorley 002,Middle Super Output Areas and Intermediate Zones,MSOAIZ,PR,6234,3026,3208,1202,1305
E02005191,Chorley 003,Middle Super Output Areas and Intermediate Zones,MSOAIZ,PR,8320,4110,4210,1679,1735
E02005192,Chorley 004,Middle Super Output Areas and Intermediate Zones,MSOAIZ,PR,7347,3659,3688,1650,1723
E02005193,Chorley 005,Middle Super Output Areas and Intermediate Zones,MSOAIZ,PR,8487,4146,4341,1646,1751
E02005194,Chorley 006,Middle Super Output Areas and Intermediate Zones,MSOAIZ,PR,8139,4000,4139,1593,1657
E02005195,Chorley 007,Middle Super Output Areas and Intermediate Zones,MSOAIZ,PR,7720,4731,2989,2472,1171
E02005196,Chorley 008,Middle Super Output Areas and Intermediate Zones,MSOAIZ,PR,7438,3617,3821,1392,1426
E02005197,Chorley 009,Middle Super Output Areas and Intermediate Zones,MSOAIZ,PR,6823,3279,3544,1418,1414
E02005198,Chorley 010,Middle Super Output Areas and Intermediate Zones,MSOAIZ,PR,8181,4169,4012,1777,1590
E02005199,Chorley 011,Middle Super Output Areas and Intermediate Zones,MSOAIZ,WN,7149,3560,3589,1326,1352
E02005200,Chorley 012,Middle Super Output Areas and Intermediate Zones,MSOAIZ,PR,8597,4198,4399,1903,1934
E02005201,Chorley 013,Middle Super Output Areas and Intermediate Zones,MSOAIZ,PR,7959,3899,4060,1632,1632
E02005202,Chorley 014,Middle Super Output Areas and Intermediate Zones,MSOAIZ,PR,9461,4645,4816,1866,1894
E02005203,Fylde 001,Middle Super Output Areas and Intermediate Zones,MSOAIZ,PR,7158,3508,3650,1265,1393
E02005204,Fylde 002,Middle Super Output Areas and Intermediate Zones,MSOAIZ,PR,10318,4967,5351,2017,2103
E02005205,Fylde 003,Middle Super Output Areas and Intermediate Zones,MSOAIZ,PR,6859,3599,3260,1615,1248
E02005206,Fylde 004,Middle Super Output Areas and Intermediate Zones,MSOAIZ,FY,6816,3278,3538,1233,1315
E02005207,Fylde 005,Middle Super Output Areas and Intermediate Zones,MSOAIZ,FY,8057,3806,4251,1278,1420
E02005208,Fylde 006,Middle Super Output Areas and Intermediate Zones,MSOAIZ,FY,9955,4969,4986,2002,1756
E02005209,Fylde 007,Middle Super Output Areas and Intermediate Zones,MSOAIZ,PR,7816,3800,4016,1412,1484
E02005210,Fylde 008,Middle Super Output Areas and Intermediate Zones,MSOAIZ,FY,10232,4847,5385,1652,1701
E02005211,Fylde 009,Middle Super Output Areas and Intermediate Zones,MSOAIZ,FY,8546,4007,4539,1585,1647
E02005212,Hyndburn 001,Middle Super Output Areas and Intermediate Zones,MSOAIZ,BB,10800,5324,5476,2127,2186
E02005213,Hyndburn 002,Middle Super Output Areas and Intermediate Zones,MSOAIZ,BB,11714,5764,5950,2432,2540
E02005214,Hyndburn 003,Middle Super Output Areas and Intermediate Zones,MSOAIZ,BB,6625,3296,3329,1328,1316
E02005215,Hyndburn 004,Middle Super Output Areas and Intermediate Zones,MSOAIZ,BB,11836,5801,6035,2386,2394
E02005216,Hyndburn 005,Middle Super Output Areas and Intermediate Zones,MSOAIZ,BB,5398,2630,2768,1060,1108
E02005217,Hyndburn 006,Middle Super Output Areas and Intermediate Zones,MSOAIZ,BB,12126,5996,6130,2321,2326
E02005218,Hyndburn 007,Middle Super Output Areas and Intermediate Zones,MSOAIZ,BB,7450,3696,3754,1551,1553
E02005219,Hyndburn 008,Middle Super Output Areas and Intermediate Zones,MSOAIZ,BB,8466,4274,4192,1753,1714
E02005220,Hyndburn 009,Middle Super Output Areas and Intermediate Zones,MSOAIZ,BB,6319,3196,3123,1222,1178
E02005221,Lancaster 001,Middle Super Output Areas and Intermediate Zones,MSOAIZ,LA,9955,4791,5164,1703,1914
E02005222,Lancaster 002,Middle Super Output Areas and Intermediate Zones,MSOAIZ,LA,6009,2991,3018,981,1063
E02005223,Lancaster 003,Middle Super Output Areas and Intermediate Zones,MSOAIZ,LA,7253,3443,3810,1147,1251
E02005224,Lancaster 004,Middle Super Output Areas and Intermediate Zones,MSOAIZ,LA,5190,2331,2859,732,785
E02005225,Lancaster 005,Middle Super Output Areas and Intermediate Zones,MSOAIZ,LA,5231,2513,2718,907,1006
E02005226,Lancaster 006,Middle Super Output Areas and Intermediate Zones,MSOAIZ,LA,7813,3834,3979,1547,1544
E02005228,Lancaster 008,Middle Super Output Areas and Intermediate Zones,MSOAIZ,LA,5789,2785,3004,1115,1202
E02005229,Lancaster 009,Middle Super Output Areas and Intermediate Zones,MSOAIZ,LA,5631,2854,2777,1221,1176
E02005230,Lancaster 010,Middle Super Output Areas and Intermediate Zones,MSOAIZ,LA,6565,3054,3511,1074,1254
E02005231,Lancaster 011,Middle Super Output Areas and Intermediate Zones,MSOAIZ,LA,8007,3851,4156,1641,1780
E02005233,Lancaster 013,Middle Super Output Areas and Intermediate Zones,MSOAIZ,LA,6069,3072,2997,1190,1271
E02005234,Lancaster 014,Middle Super Output Areas and Intermediate Zones,MSOAIZ,LA,7546,3891,3655,1627,1334
E02005235,Lancaster 015,Middle Super Output Areas and Intermediate Zones,MSOAIZ,LA,5367,2528,2839,1001,951
E02005236,Lancaster 016,Middle Super Output Areas and Intermediate Zones,MSOAIZ,LA,12755,6182,6573,2346,2576
E02005237,Lancaster 017,Middle Super Output Areas and Intermediate Zones,MSOAIZ,LA,9839,4610,5229,1857,1975
E02005238,Lancaster 018,Middle Super Output Areas and Intermediate Zones,MSOAIZ,LA,5739,2697,3042,1026,1155
E02005239,Lancaster 019,Middle Super Output Areas and Intermediate Zones,MSOAIZ,PR,11690,5673,6017,1312,1401
E02005240,Pendle 001,Middle Super Output Areas and Intermediate Zones,MSOAIZ,BB,5445,2679,2766,1111,1139
E02005241,Pendle 002,Middle Super Output Areas and Intermediate Zones,MSOAIZ,BD,5551,2768,2783,1143,1094
E02005242,Pendle 003,Middle Super Output Areas and Intermediate Zones,MSOAIZ,BD,6183,3039,3144,1182,1259
E02005243,Pendle 004,Middle Super Output Areas and Intermediate Zones,MSOAIZ,BB,5089,2463,2626,1021,962
E02005244,Pendle 005,Middle Super Output Areas and Intermediate Zones,MSOAIZ,BB,5827,2805,3022,1076,1211
E02005245,Pendle 006,Middle Super Output Areas and Intermediate Zones,MSOAIZ,BB,6945,3417,3528,1353,1464
E02005246,Pendle 007,Middle Super Output Areas and Intermediate Zones,MSOAIZ,BB,5180,2598,2582,1149,1081
E02005247,Pendle 008,Middle Super Output Areas and Intermediate Zones,MSOAIZ,BB,9944,4831,5113,1959,1969
E02005248,Pendle 009,Middle Super Output Areas and Intermediate Zones,MSOAIZ,BB,6489,3173,3316,1263,1293
E02005249,Pendle 010,Middle Super Output Areas and Intermediate Zones,MSOAIZ,BB,9452,4711,4741,1970,1832
E02005250,Pendle 011,Middle Super Output Areas and Intermediate Zones,MSOAIZ,BB,7702,3814,3888,1537,1586
E02005251,Pendle 012,Middle Super Output Areas and Intermediate Zones,MSOAIZ,BB,6916,3344,3572,1214,1311
E02005252,Pendle 013,Middle Super Output Areas and Intermediate Zones,MSOAIZ,BB,8729,4370,4359,1639,1634
E02005253,Preston 001,Middle Super Output Areas and Intermediate Zones,MSOAIZ,PR,5886,2881,3005,1098,1135
E02005254,Preston 002,Middle Super Output Areas and Intermediate Zones,MSOAIZ,PR,6372,3121,3251,1138,1227
E02005255,Preston 003,Middle Super Output Areas and Intermediate Zones,MSOAIZ,PR,8865,4275,4590,1638,1750
E02005256,Preston 004,Middle Super Output Areas and Intermediate Zones,MSOAIZ,PR,7058,3477,3581,1654,1654
E02005257,Preston 005,Middle Super Output Areas and Intermediate Zones,MSOAIZ,PR,5951,2877,3074,1181,1193
E02005258,Preston 006,Middle Super Output Areas and Intermediate Zones,MSOAIZ,PR,8070,3963,4107,1540,1534
E02005259,Preston 007,Middle Super Output Areas and Intermediate Zones,MSOAIZ,PR,10244,4935,5309,1969,2091
E02005260,Preston 008,Middle Super Output Areas and Intermediate Zones,MSOAIZ,PR,6837,3354,3483,1270,1357
E02005261,Preston 009,Middle Super Output Areas and Intermediate Zones,MSOAIZ,PR,10003,4978,5025,1956,2037
E02005262,Preston 010,Middle Super Output Areas and Intermediate Zones,MSOAIZ,PR,6197,3190,3007,1536,1441
E02005263,Preston 011,Middle Super Output Areas and Intermediate Zones,MSOAIZ,PR,7093,3641,3452,1575,1409
E02005264,Preston 012,Middle Super Output Areas and Intermediate Zones,MSOAIZ,PR,12533,6171,6362,2633,2364
E02005265,Preston 013,Middle Super Output Areas and Intermediate Zones,MSOAIZ,PR,10850,5360,5490,2232,2240
E02005266,Preston 014,Middle Super Output Areas and Intermediate Zones,MSOAIZ,PR,8187,4460,3727,2151,1561
E02005267,Preston 015,Middle Super Output Areas and Intermediate Zones,MSOAIZ,PR,6892,3537,3355,1180,962
E02005268,Preston 016,Middle Super Output Areas and Intermediate Zones,MSOAIZ,PR,9270,4631,4639,1947,1936
E02005269,Preston 017,Middle Super Output Areas and Intermediate Zones,MSOAIZ,PR,9894,5433,4461,2546,1857
E02005270,Ribble Valley 001,Middle Super Output Areas and Intermediate Zones,MSOAIZ,PR,7400,3712,3688,1283,1340
E02005271,Ribble Valley 002,Middle Super Output Areas and Intermediate Zones,MSOAIZ,BB,7540,3674,3866,1477,1504
E02005272,Ribble Valley 003,Middle Super Output Areas and Intermediate Zones,MSOAIZ,BB,7225,3516,3709,1400,1357
E02005273,Ribble Valley 004,Middle Super Output Areas and Intermediate Zones,MSOAIZ,PR,5751,2814,2937,1079,1139
E02005274,Ribble Valley 005,Middle Super Output Areas and Intermediate Zones,MSOAIZ,BB,6627,3213,3414,1219,1300
E02005275,Ribble Valley 006,Middle Super Output Areas and Intermediate Zones,MSOAIZ,PR,5392,2586,2806,1018,1042
E02005276,Ribble Valley 007,Middle Super Output Areas and Intermediate Zones,MSOAIZ,BB,8261,4087,4174,1604,1644
E02005277,Ribble Valley 008,Middle Super Output Areas and Intermediate Zones,MSOAIZ,PR,8936,4371,4565,1517,1637
E02005278,Rossendale 001,Middle Super Output Areas and Intermediate Zones,MSOAIZ,OL,7711,3764,3947,1640,1730
E02005279,Rossendale 002,Middle Super Output Areas and Intermediate Zones,MSOAIZ,BB,10264,5041,5223,2088,2084
E02005280,Rossendale 003,Middle Super Output Areas and Intermediate Zones,MSOAIZ,OL,10107,4986,5121,2066,2126
E02005281,Rossendale 004,Middle Super Output Areas and Intermediate Zones,MSOAIZ,BB,8251,4086,4165,1659,1662
E02005284,Rossendale 007,Middle Super Output Areas and Intermediate Zones,MSOAIZ,BL,5805,2819,2986,1088,1199
E02005285,Rossendale 008,Middle Super Output Areas and Intermediate Zones,MSOAIZ,BL,6263,3008,3255,1270,1353
E02005286,Rossendale 009,Middle Super Output Areas and Intermediate Zones,MSOAIZ,OL,7500,3708,3792,1508,1540
E02005287,South Ribble 001,Middle Super Output Areas and Intermediate Zones,MSOAIZ,PR,5354,2617,2737,1000,1072
E02005288,South Ribble 002,Middle Super Output Areas and Intermediate Zones,MSOAIZ,PR,6054,2960,3094,1135,1194
E02005289,South Ribble 003,Middle Super Output Areas and Intermediate Zones,MSOAIZ,PR,6176,2969,3207,1149,1228
E02005290,South Ribble 004,Middle Super Output Areas and Intermediate Zones,MSOAIZ,PR,7210,3575,3635,1599,1630
E02005291,South Ribble 005,Middle Super Output Areas and Intermediate Zones,MSOAIZ,PR,5700,2787,2913,1167,1192
E02005292,South Ribble 006,Middle Super Output Areas and Intermediate Zones,MSOAIZ,PR,5817,2817,3000,1204,1193
E02005293,South Ribble 007,Middle Super Output Areas and Intermediate Zones,MSOAIZ,PR,5593,2705,2888,1064,1082
E02005294,South Ribble 008,Middle Super Output Areas and Intermediate Zones,MSOAIZ,PR,6331,3045,3286,1295,1355
E02005295,South Ribble 009,Middle Super Output Areas and Intermediate Zones,MSOAIZ,PR,7432,3703,3729,1586,1564
E02005296,South Ribble 010,Middle Super Output Areas and Intermediate Zones,MSOAIZ,PR,5790,2816,2974,964,1005
E02005297,South Ribble 011,Middle Super Output Areas and Intermediate Zones,MSOAIZ,PR,8206,4042,4164,1532,1526
E02005298,South Ribble 012,Middle Super Output Areas and Intermediate Zones,MSOAIZ,PR,7177,3533,3644,1455,1515
E02005299,South Ribble 013,Middle Super Output Areas and Intermediate Zones,MSOAIZ,PR,7211,3551,3660,1650,1640
E02005300,South Ribble 014,Middle Super Output Areas and Intermediate Zones,MSOAIZ,PR,5228,2600,2628,1055,1102
E02005301,South Ribble 015,Middle Super Output Areas and Intermediate Zones,MSOAIZ,PR,6438,3123,3315,1226,1252
E02005302,South Ribble 016,Middle Super Output Areas and Intermediate Zones,MSOAIZ,PR,6971,3417,3554,1405,1485
E02005303,South Ribble 017,Middle Super Output Areas and Intermediate Zones,MSOAIZ,PR,6369,3084,3285,1191,1301
E02005304,West Lancashire 001,Middle Super Output Areas and Intermediate Zones,MSOAIZ,PR,8583,4264,4319,1628,1702
E02005305,West Lancashire 002,Middle Super Output Areas and Intermediate Zones,MSOAIZ,PR,7305,3619,3686,1305,1330
E02005306,West Lancashire 003,Middle Super Output Areas and Intermediate Zones,MSOAIZ,PR,7048,3499,3549,1274,1296
E02005307,West Lancashire 004,Middle Super Output Areas and Intermediate Zones,MSOAIZ,L,9182,4508,4674,1778,1906
E02005308,West Lancashire 005,Middle Super Output Areas and Intermediate Zones,MSOAIZ,WN,6670,3185,3485,1143,1270
E02005309,West Lancashire 006,Middle Super Output Areas and Intermediate Zones,MSOAIZ,L,8381,4049,4332,1442,1523
E02005310,West Lancashire 007,Middle Super Output Areas and Intermediate Zones,MSOAIZ,L,7961,3662,4299,1141,1118
E02005311,West Lancashire 008,Middle Super Output Areas and Intermediate Zones,MSOAIZ,WN,5576,2725,2851,932,974
E02005312,West Lancashire 009,Middle Super Output Areas and Intermediate Zones,MSOAIZ,WN,5927,2911,3016,1237,1241
E02005313,West Lancashire 010,Middle Super Output Areas and Intermediate Zones,MSOAIZ,WN,8794,4245,4549,1720,1886
E02005314,West Lancashire 011,Middle Super Output Areas and Intermediate Zones,MSOAIZ,WN,6458,3160,3298,1344,1344
E02005315,West Lancashire 012,Middle Super Output Areas and Intermediate Zones,MSOAIZ,L,8068,3898,4170,1280,1382
E02005316,West Lancashire 013,Middle Super Output Areas and Intermediate Zones,MSOAIZ,WN,6266,3132,3134,1235,1313
E02005317,West Lancashire 014,Middle Super Output Areas and Intermediate Zones,MSOAIZ,WN,7090,3423,3667,1301,1508
E02005318,West Lancashire 015,Middle Super Output Areas and Intermediate Zones,MSOAIZ,WN,7376,3560,3816,1410,1480
E02005319,Wyre 001,Middle Super Output Areas and Intermediate Zones,MSOAIZ,FY,8340,4187,4153,1672,1614
E02005320,Wyre 002,Middle Super Output Areas and Intermediate Zones,MSOAIZ,FY,5906,2832,3074,1035,1114
E02005321,Wyre 003,Middle Super Output Areas and Intermediate Zones,MSOAIZ,FY,6381,3082,3299,930,1045
E02005322,Wyre 004,Middle Super Output Areas and Intermediate Zones,MSOAIZ,PR,9921,4820,5101,1528,1601
E02005323,Wyre 005,Middle Super Output Areas and Intermediate Zones,MSOAIZ,PR,6863,3289,3574,1163,1351
E02005324,Wyre 006,Middle Super Output Areas and Intermediate Zones,MSOAIZ,PR,6117,3083,3034,1074,1123
E02005325,Wyre 007,Middle Super Output Areas and Intermediate Zones,MSOAIZ,PR,8968,4329,4639,1513,1526
E02005326,Wyre 008,Middle Super Output Areas and Intermediate Zones,MSOAIZ,FY,8559,4160,4399,1378,1419
E02005327,Wyre 009,Middle Super Output Areas and Intermediate Zones,MSOAIZ,PR,5874,2897,2977,1063,1085
E02005328,Wyre 010,Middle Super Output Areas and Intermediate Zones,MSOAIZ,FY,7484,3584,3900,1237,1374
E02005329,Wyre 011,Middle Super Output Areas and Intermediate Zones,MSOAIZ,PR,8757,4185,4572,1652,1805
E02005330,Wyre 012,Middle Super Output Areas and Intermediate Zones,MSOAIZ,FY,8881,4284,4597,1511,1650
E02005331,Wyre 013,Middle Super Output Areas and Intermediate Zones,MSOAIZ,FY,7627,3601,4026,1338,1408
E02005332,Wyre 014,Middle Super Output Areas and Intermediate Zones,MSOAIZ,FY,8071,3892,4179,1405,1444
E02005334,Blaby 002,Middle Super Output Areas and Intermediate Zones,MSOAIZ,LE,5640,2758,2882,1148,1236
E02005335,Blaby 003,Middle Super Output Areas and Intermediate Zones,MSOAIZ,LE,6891,3299,3592,1222,1313
E02005336,Blaby 004,Middle Super Output Areas and Intermediate Zones,MSOAIZ,LE,7106,3552,3554,1782,1725
E02005337,Blaby 005,Middle Super Output Areas and Intermediate Zones,MSOAIZ,LE,9744,4819,4925,2015,1981
E02005338,Blaby 006,Middle Super Output Areas and Intermediate Zones,MSOAIZ,LE,9853,4805,5048,1980,2074
E02005339,Blaby 007,Middle Super Output Areas and Intermediate Zones,MSOAIZ,LE,8448,4170,4278,1747,1871
E02005340,Blaby 008,Middle Super Output Areas and Intermediate Zones,MSOAIZ,LE,8844,4560,4284,1592,1615
E02005341,Blaby 009,Middle Super Output Areas and Intermediate Zones,MSOAIZ,LE,6913,3336,3577,1457,1582
E02005342,Blaby 010,Middle Super Output Areas and Intermediate Zones,MSOAIZ,LE,6725,3249,3476,1249,1313
E02005343,Blaby 011,Middle Super Output Areas and Intermediate Zones,MSOAIZ,LE,6647,3238,3409,1183,1293
E02005344,Blaby 012,Middle Super Output Areas and Intermediate Zones,MSOAIZ,LE,7461,3671,3790,1440,1450
E02005345,Charnwood 001,Middle Super Output Areas and Intermediate Zones,MSOAIZ,LE,6061,3014,3047,1302,1326
E02005346,Charnwood 002,Middle Super Output Areas and Intermediate Zones,MSOAIZ,LE,11278,5843,5435,2785,2320
E02005347,Charnwood 003,Middle Super Output Areas and Intermediate Zones,MSOAIZ,LE,9882,5257,4625,1326,1190
E02005348,Charnwood 004,Middle Super Output Areas and Intermediate Zones,MSOAIZ,LE,5829,2936,2893,1123,1104
E02005349,Charnwood 005,Middle Super Output Areas and Intermediate Zones,MSOAIZ,LE,6986,3420,3566,1363,1443
E02005350,Charnwood 006,Middle Super Output Areas and Intermediate Zones,MSOAIZ,LE,6519,3203,3316,1374,1368
E02005351,Charnwood 007,Middle Super Output Areas and Intermediate Zones,MSOAIZ,LE,10662,6040,4622,1136,1082
E02005352,Charnwood 008,Middle Super Output Areas and Intermediate Zones,MSOAIZ,LE,6156,3034,3122,1139,1218
E02005353,Charnwood 009,Middle Super Output Areas and Intermediate Zones,MSOAIZ,LE,9433,4623,4810,1816,1934
E02005354,Charnwood 010,Middle Super Output Areas and Intermediate Zones,MSOAIZ,LE,9088,4491,4597,1620,1691
E02005355,Charnwood 011,Middle Super Output Areas and Intermediate Zones,MSOAIZ,LE,6534,3147,3387,1273,1377
E02005356,Charnwood 012,Middle Super Output Areas and Intermediate Zones,MSOAIZ,LE,6493,3154,3339,1326,1339
E02005357,Charnwood 013,Middle Super Output Areas and Intermediate Zones,MSOAIZ,LE,7257,3585,3672,1569,1636
E02005358,Charnwood 014,Middle Super Output Areas and Intermediate Zones,MSOAIZ,LE,10175,4985,5190,2115,2254
E02005359,Charnwood 015,Middle Super Output Areas and Intermediate Zones,MSOAIZ,LE,5884,2838,3046,1055,1113
E02005360,Charnwood 016,Middle Super Output Areas and Intermediate Zones,MSOAIZ,LE,6342,3168,3174,1031,1117
E02005361,Charnwood 017,Middle Super Output Areas and Intermediate Zones,MSOAIZ,LE,6561,3174,3387,1375,1445
E02005362,Charnwood 018,Middle Super Output Areas and Intermediate Zones,MSOAIZ,LE,6243,3062,3181,1239,1310
E02005363,Charnwood 019,Middle Super Output Areas and Intermediate Zones,MSOAIZ,LE,7221,3479,3742,1273,1381
E02005364,Charnwood 020,Middle Super Output Areas and Intermediate Zones,MSOAIZ,LE,5300,2555,2745,1043,1109
E02005365,Charnwood 021,Middle Super Output Areas and Intermediate Zones,MSOAIZ,LE,9668,4768,4900,1911,1972
E02005366,Charnwood 022,Middle Super Output Areas and Intermediate Zones,MSOAIZ,LE,6528,3137,3391,1266,1336
E02005368,Harborough 002,Middle Super Output Areas and Intermediate Zones,MSOAIZ,LE,6201,3053,3148,1165,1229
E02005369,Harborough 003,Middle Super Output Areas and Intermediate Zones,MSOAIZ,LE,9799,4677,5122,1746,1922
E02005370,Harborough 004,Middle Super Output Areas and Intermediate Zones,MSOAIZ,LE,8940,4477,4463,1871,2004
E02005371,Harborough 005,Middle Super Output Areas and Intermediate Zones,MSOAIZ,NN,10045,4954,5091,1954,2143
E02005372,Harborough 006,Middle Super Output Areas and Intermediate Zones,MSOAIZ,LE,9416,4752,4664,1810,1872
E02005373,Harborough 007,Middle Super Output Areas and Intermediate Zones,MSOAIZ,LE,9720,5084,4636,2184,1778
E02005374,Harborough 008,Middle Super Output Areas and Intermediate Zones,MSOAIZ,LE,6532,3178,3354,1274,1285
E02005375,Harborough 009,Middle Super Output Areas and Intermediate Zones,MSOAIZ,LE,8396,4095,4301,1818,1897
E02005376,Harborough 010,Middle Super Output Areas and Intermediate Zones,MSOAIZ,LE,9353,4647,4706,1779,1787
E02005377,Hinckley and Bosworth 001,Middle Super Output Areas and Intermediate Zones,MSOAIZ,LE,8286,4054,4232,1569,1625
E02005378,Hinckley and Bosworth 002,Middle Super Output Areas and Intermediate Zones,MSOAIZ,LE,5199,2535,2664,1001,1104
E02005379,Hinckley and Bosworth 003,Middle Super Output Areas and Intermediate Zones,MSOAIZ,LE,6065,2943,3122,1160,1209
E02005380,Hinckley and Bosworth 004,Middle Super Output Areas and Intermediate Zones,MSOAIZ,LE,8373,4124,4249,1518,1602
E02005381,Hinckley and Bosworth 005,Middle Super Output Areas and Intermediate Zones,MSOAIZ,LE,8009,3925,4084,1414,1519
E02005382,Hinckley and Bosworth 006,Middle Super Output Areas and Intermediate Zones,MSOAIZ,LE,10047,4949,5098,2053,2000
E02005383,Hinckley and Bosworth 007,Middle Super Output Areas and Intermediate Zones,MSOAIZ,LE,9022,4434,4588,1867,1894
E02005384,Hinckley and Bosworth 008,Middle Super Output Areas and Intermediate Zones,MSOAIZ,LE,6419,3239,3180,1254,1276
E02005385,Hinckley and Bosworth 009,Middle Super Output Areas and Intermediate Zones,MSOAIZ,LE,5953,2935,3018,1142,1172
E02005386,Hinckley and Bosworth 010,Middle Super Output Areas and Intermediate Zones,MSOAIZ,LE,8375,4226,4149,1987,1761
E02005387,Hinckley and Bosworth 011,Middle Super Output Areas and Intermediate Zones,MSOAIZ,LE,9072,4480,4592,2030,2123
E02005388,Hinckley and Bosworth 012,Middle Super Output Areas and Intermediate Zones,MSOAIZ,LE,5690,2810,2880,1211,1217
E02005389,Hinckley and Bosworth 013,Middle Super Output Areas and Intermediate Zones,MSOAIZ,LE,5706,2733,2973,973,1017
E02005390,Hinckley and Bosworth 014,Middle Super Output Areas and Intermediate Zones,MSOAIZ,LE,8862,4313,4549,1725,1775
E02005391,Melton 001,Middle Super Output Areas and Intermediate Zones,MSOAIZ,NG,9616,4709,4907,1798,1937
E02005392,Melton 002,Middle Super Output Areas and Intermediate Zones,MSOAIZ,LE,8906,4344,4562,1780,1765
E02005393,Melton 003,Middle Super Output Areas and Intermediate Zones,MSOAIZ,LE,6996,3381,3615,1387,1466
E02005394,Melton 004,Middle Super Output Areas and Intermediate Zones,MSOAIZ,LE,9383,4570,4813,1857,1944
E02005395,Melton 005,Middle Super Output Areas and Intermediate Zones,MSOAIZ,LE,8869,4399,4470,1796,1790
E02005396,Melton 006,Middle Super Output Areas and Intermediate Zones,MSOAIZ,NG,6606,3315,3291,1253,1304
E02005397,North West Leicestershire 001,Middle Super Output Areas and Intermediate Zones,MSOAIZ,NG,8283,4188,4095,1733,1771
E02005398,North West Leicestershire 002,Middle Super Output Areas and Intermediate Zones,MSOAIZ,LE,6095,2982,3113,1155,1172
E02005399,North West Leicestershire 003,Middle Super Output Areas and Intermediate Zones,MSOAIZ,LE,6363,3168,3195,1330,1333
E02005400,North West Leicestershire 004,Middle Super Output Areas and Intermediate Zones,MSOAIZ,LE,5637,2812,2825,1050,1065
E02005401,North West Leicestershire 005,Middle Super Output Areas and Intermediate Zones,MSOAIZ,LE,5712,2810,2902,1078,1152
E02005402,North West Leicestershire 006,Middle Super Output Areas and Intermediate Zones,MSOAIZ,LE,6167,2976,3191,1109,1164
E02005403,North West Leicestershire 007,Middle Super Output Areas and Intermediate Zones,MSOAIZ,LE,6867,3363,3504,1375,1396
E02005404,North West Leicestershire 008,Middle Super Output Areas and Intermediate Zones,MSOAIZ,LE,7559,3721,3838,1508,1551
E02005405,North West Leicestershire 009,Middle Super Output Areas and Intermediate Zones,MSOAIZ,LE,6907,3365,3542,1199,1289
E02005406,North West Leicestershire 010,Middle Super Output Areas and Intermediate Zones,MSOAIZ,LE,7393,3663,3730,1687,1646
E02005407,North West Leicestershire 011,Middle Super Output Areas and Intermediate Zones,MSOAIZ,LE,8676,4309,4367,1934,1959
E02005408,North West Leicestershire 012,Middle Super Output Areas and Intermediate Zones,MSOAIZ,LE,7461,3824,3637,1537,1480
E02005409,North West Leicestershire 013,Middle Super Output Areas and Intermediate Zones,MSOAIZ,LE,10348,5154,5194,2164,2170
E02005412,Oadby and Wigston 003,Middle Super Output Areas and Intermediate Zones,MSOAIZ,LE,8178,3886,4292,1411,1537
E02005414,Oadby and Wigston 005,Middle Super Output Areas and Intermediate Zones,MSOAIZ,LE,7774,3662,4112,1409,1509
E02005415,Oadby and Wigston 006,Middle Super Output Areas and Intermediate Zones,MSOAIZ,LE,7490,3612,3878,1558,1609
E02005416,Oadby and Wigston 007,Middle Super Output Areas and Intermediate Zones,MSOAIZ,LE,8802,4309,4493,1648,1694
E02005417,Boston 001,Middle Super Output Areas and Intermediate Zones,MSOAIZ,PE,7296,3775,3521,1412,1259
E02005418,Boston 002,Middle Super Output Areas and Intermediate Zones,MSOAIZ,PE,10021,4843,5178,2069,2196
E02005419,Boston 003,Middle Super Output Areas and Intermediate Zones,MSOAIZ,PE,8131,4051,4080,1928,1794
E02005420,Boston 004,Middle Super Output Areas and Intermediate Zones,MSOAIZ,PE,8229,3900,4329,1559,1673
E02005422,Boston 006,Middle Super Output Areas and Intermediate Zones,MSOAIZ,PE,6085,3021,3064,1050,1144
E02005423,Boston 007,Middle Super Output Areas and Intermediate Zones,MSOAIZ,PE,9541,4586,4955,1664,1783
E02005424,East Lindsey 001,Middle Super Output Areas and Intermediate Zones,MSOAIZ,LN,9904,4846,5058,1671,1795
E02005425,East Lindsey 002,Middle Super Output Areas and Intermediate Zones,MSOAIZ,LN,6338,3130,3208,1041,1136
E02005426,East Lindsey 003,Middle Super Output Areas and Intermediate Zones,MSOAIZ,LN,9633,4573,5060,1651,1880
E02005427,East Lindsey 004,Middle Super Output Areas and Intermediate Zones,MSOAIZ,LN,6786,3266,3520,1307,1305
E02005428,East Lindsey 005,Middle Super Output Areas and Intermediate Zones,MSOAIZ,LN,8082,3922,4160,1127,1196
E02005429,East Lindsey 006,Middle Super Output Areas and Intermediate Zones,MSOAIZ,LN,6515,3089,3426,687,766
E02005430,East Lindsey 007,Middle Super Output Areas and Intermediate Zones,MSOAIZ,LN,6867,3368,3499,1073,1179
E02005431,East Lindsey 008,Middle Super Output Areas and Intermediate Zones,MSOAIZ,PE,8384,4090,4294,1287,1397
E02005432,East Lindsey 009,Middle Super Output Areas and Intermediate Zones,MSOAIZ,PE,7515,3703,3812,1198,1302
E02005433,East Lindsey 010,Middle Super Output Areas and Intermediate Zones,MSOAIZ,PE,7066,3476,3590,998,1039
E02005434,East Lindsey 011,Middle Super Output Areas and Intermediate Zones,MSOAIZ,LN,7073,3409,3664,1244,1295
E02005435,East Lindsey 012,Middle Super Output Areas and Intermediate Zones,MSOAIZ,PE,7279,3443,3836,1086,1256
E02005436,East Lindsey 013,Middle Super Output Areas and Intermediate Zones,MSOAIZ,PE,7676,3710,3966,1242,1339
E02005437,East Lindsey 014,Middle Super Output Areas and Intermediate Zones,MSOAIZ,PE,5861,2916,2945,1168,1136
E02005438,East Lindsey 015,Middle Super Output Areas and Intermediate Zones,MSOAIZ,PE,6439,2992,3447,992,1194
E02005439,East Lindsey 016,Middle Super Output Areas and Intermediate Zones,MSOAIZ,PE,11241,5713,5528,2026,1978
E02005440,East Lindsey 017,Middle Super Output Areas and Intermediate Zones,MSOAIZ,PE,5363,2638,2725,845,970
E02005441,East Lindsey 018,Middle Super Output Areas and Intermediate Zones,MSOAIZ,PE,8379,4143,4236,1396,1538
E02005442,Lincoln 001,Middle Super Output Areas and Intermediate Zones,MSOAIZ,LN,5736,2724,3012,1089,1197
E02005443,Lincoln 002,Middle Super Output Areas and Intermediate Zones,MSOAIZ,LN,6811,3246,3565,1406,1470
E02005444,Lincoln 003,Middle Super Output Areas and Intermediate Zones,MSOAIZ,LN,11954,6032,5922,2705,2330
E02005445,Lincoln 004,Middle Super Output Areas and Intermediate Zones,MSOAIZ,LN,11600,5823,5777,2569,2475
E02005446,Lincoln 005,Middle Super Output Areas and Intermediate Zones,MSOAIZ,LN,8473,4009,4464,1244,1046
E02005447,Lincoln 006,Middle Super Output Areas and Intermediate Zones,MSOAIZ,LN,6759,3412,3347,1597,1371
E02005448,Lincoln 007,Middle Super Output Areas and Intermediate Zones,MSOAIZ,LN,7192,3468,3724,1451,1547
E02005449,Lincoln 008,Middle Super Output Areas and Intermediate Zones,MSOAIZ,LN,7918,3930,3988,1463,1364
E02005450,Lincoln 009,Middle Super Output Areas and Intermediate Zones,MSOAIZ,LN,8486,4112,4374,1683,1817
E02005451,Lincoln 010,Middle Super Output Areas and Intermediate Zones,MSOAIZ,LN,7639,3740,3899,1569,1620
E02005452,Lincoln 011,Middle Super Output Areas and Intermediate Zones,MSOAIZ,LN,10973,5277,5696,2093,2220
E02005453,North Kesteven 001,Middle Super Output Areas and Intermediate Zones,MSOAIZ,LN,10568,5159,5409,1954,2085
E02005455,North Kesteven 003,Middle Super Output Areas and Intermediate Zones,MSOAIZ,NG,12280,5992,6288,2499,2610
E02005456,North Kesteven 004,Middle Super Output Areas and Intermediate Zones,MSOAIZ,LN,9781,4821,4960,2014,1944
E02005457,North Kesteven 005,Middle Super Output Areas and Intermediate Zones,MSOAIZ,LN,8344,4036,4308,1480,1656
E02005458,North Kesteven 006,Middle Super Output Areas and Intermediate Zones,MSOAIZ,NG,6527,3144,3383,1111,1250
E02005459,North Kesteven 007,Middle Super Output Areas and Intermediate Zones,MSOAIZ,NG,8005,3895,4110,1383,1508
E02005460,North Kesteven 008,Middle Super Output Areas and Intermediate Zones,MSOAIZ,NG,6247,3208,3039,1481,1353
E02005461,North Kesteven 009,Middle Super Output Areas and Intermediate Zones,MSOAIZ,NG,6261,3016,3245,984,1120
E02005462,North Kesteven 010,Middle Super Output Areas and Intermediate Zones,MSOAIZ,NG,9064,4374,4690,1826,1826
E02005463,North Kesteven 011,Middle Super Output Areas and Intermediate Zones,MSOAIZ,NG,8607,4175,4432,1746,1921
E02005464,North Kesteven 012,Middle Super Output Areas and Intermediate Zones,MSOAIZ,PE,8198,4036,4162,1411,1528
E02005465,South Holland 001,Middle Super Output Areas and Intermediate Zones,MSOAIZ,PE,8440,4126,4314,1459,1523
E02005466,South Holland 002,Middle Super Output Areas and Intermediate Zones,MSOAIZ,PE,6507,3194,3313,1084,1169
E02005467,South Holland 003,Middle Super Output Areas and Intermediate Zones,MSOAIZ,PE,7110,3428,3682,1240,1329
E02005468,South Holland 004,Middle Super Output Areas and Intermediate Zones,MSOAIZ,PE,7492,3703,3789,1271,1380
E02005469,South Holland 005,Middle Super Output Areas and Intermediate Zones,MSOAIZ,PE,7416,3666,3750,1440,1455
E02005470,South Holland 006,Middle Super Output Areas and Intermediate Zones,MSOAIZ,PE,10379,5067,5312,2245,2149
E02005471,South Holland 007,Middle Super Output Areas and Intermediate Zones,MSOAIZ,PE,9080,4409,4671,1768,1742
E02005472,South Holland 008,Middle Super Output Areas and Intermediate Zones,MSOAIZ,PE,9828,4778,5050,1654,1729
E02005473,South Holland 009,Middle Super Output Areas and Intermediate Zones,MSOAIZ,PE,9263,4479,4784,1894,1969
E02005474,South Holland 010,Middle Super Output Areas and Intermediate Zones,MSOAIZ,PE,6546,3217,3329,1149,1228
E02005475,South Holland 011,Middle Super Output Areas and Intermediate Zones,MSOAIZ,PE,6209,3052,3157,1150,1237
E02005476,South Kesteven 001,Middle Super Output Areas and Intermediate Zones,MSOAIZ,NG,7239,3528,3711,1317,1440
E02005477,South Kesteven 002,Middle Super Output Areas and Intermediate Zones,MSOAIZ,NG,8844,4289,4555,1365,1565
E02005478,South Kesteven 003,Middle Super Output Areas and Intermediate Zones,MSOAIZ,NG,9908,4684,5224,1657,1880
E02005479,South Kesteven 004,Middle Super Output Areas and Intermediate Zones,MSOAIZ,NG,8277,4012,4265,1676,1659
E02005480,South Kesteven 005,Middle Super Output Areas and Intermediate Zones,MSOAIZ,NG,7332,3538,3794,1395,1564
E02005481,South Kesteven 006,Middle Super Output Areas and Intermediate Zones,MSOAIZ,NG,10963,5378,5585,2477,2420
E02005482,South Kesteven 007,Middle Super Output Areas and Intermediate Zones,MSOAIZ,PE,9774,4816,4958,1888,2000
E02005483,South Kesteven 008,Middle Super Output Areas and Intermediate Zones,MSOAIZ,PE,7829,3788,4041,1440,1590
E02005484,South Kesteven 009,Middle Super Output Areas and Intermediate Zones,MSOAIZ,NG,6952,3443,3509,1314,1412
E02005485,South Kesteven 010,Middle Super Output Areas and Intermediate Zones,MSOAIZ,PE,6055,2920,3135,1057,1125
E02005486,South Kesteven 011,Middle Super Output Areas and Intermediate Zones,MSOAIZ,PE,8401,3995,4406,1634,1720
E02005487,South Kesteven 012,Middle Super Output Areas and Intermediate Zones,MSOAIZ,PE,9199,4529,4670,1728,1917
E02005488,South Kesteven 013,Middle Super Output Areas and Intermediate Zones,MSOAIZ,PE,6263,3028,3235,1114,1243
E02005489,South Kesteven 014,Middle Super Output Areas and Intermediate Zones,MSOAIZ,PE,7051,3371,3680,1401,1532
E02005490,South Kesteven 015,Middle Super Output Areas and Intermediate Zones,MSOAIZ,PE,9132,4334,4798,1796,1991
E02005491,South Kesteven 016,Middle Super Output Areas and Intermediate Zones,MSOAIZ,PE,10569,5003,5566,2122,2229
E02005492,West Lindsey 001,Middle Super Output Areas and Intermediate Zones,MSOAIZ,LN,9425,4635,4790,1651,1844
E02005493,West Lindsey 002,Middle Super Output Areas and Intermediate Zones,MSOAIZ,DN,9304,4529,4775,1717,1855
E02005494,West Lindsey 003,Middle Super Output Areas and Intermediate Zones,MSOAIZ,LN,9452,4631,4821,1623,1725
E02005495,West Lindsey 004,Middle Super Output Areas and Intermediate Zones,MSOAIZ,DN,9645,4745,4900,1990,1933
E02005496,West Lindsey 005,Middle Super Output Areas and Intermediate Zones,MSOAIZ,LN,6456,3233,3223,1247,1289
E02005497,West Lindsey 006,Middle Super Output Areas and Intermediate Zones,MSOAIZ,DN,7031,3354,3677,1218,1405
E02005498,West Lindsey 007,Middle Super Output Areas and Intermediate Zones,MSOAIZ,LN,7152,3482,3670,1195,1296
E02005499,West Lindsey 008,Middle Super Output Areas and Intermediate Zones,MSOAIZ,LN,8068,3894,4174,1411,1643
E02005500,West Lindsey 009,Middle Super Output Areas and Intermediate Zones,MSOAIZ,NG,6795,3350,3445,1307,1407
E02005501,West Lindsey 010,Middle Super Output Areas and Intermediate Zones,MSOAIZ,LN,7358,3492,3866,1158,1317
E02005502,West Lindsey 011,Middle Super Output Areas and Intermediate Zones,MSOAIZ,LN,8564,4146,4418,1422,1607
E02005503,Breckland 001,Middle Super Output Areas and Intermediate Zones,MSOAIZ,NR,7111,3631,3480,1315,1261
E02005504,Breckland 002,Middle Super Output Areas and Intermediate Zones,MSOAIZ,PE,8735,4305,4430,1407,1511
E02005505,Breckland 003,Middle Super Output Areas and Intermediate Zones,MSOAIZ,NR,7184,3432,3752,1227,1311
E02005506,Breckland 004,Middle Super Output Areas and Intermediate Zones,MSOAIZ,PE,6849,3399,3450,1195,1230
E02005507,Breckland 005,Middle Super Output Areas and Intermediate Zones,MSOAIZ,NR,11425,5541,5884,2197,2110
E02005508,Breckland 006,Middle Super Output Areas and Intermediate Zones,MSOAIZ,NR,6640,3249,3391,1142,1225
E02005509,Breckland 007,Middle Super Output Areas and Intermediate Zones,MSOAIZ,PE,7258,3359,3899,1089,1158
E02005510,Breckland 008,Middle Super Output Areas and Intermediate Zones,MSOAIZ,PE,6641,3192,3449,1023,1067
E02005511,Breckland 009,Middle Super Output Areas and Intermediate Zones,MSOAIZ,IP,7202,3507,3695,1236,1160
E02005512,Breckland 010,Middle Super Output Areas and Intermediate Zones,MSOAIZ,NR,8810,4828,3982,2150,1579
E02005513,Breckland 011,Middle Super Output Areas and Intermediate Zones,MSOAIZ,NR,9009,4403,4606,1750,1745
E02005514,Breckland 012,Middle Super Output Areas and Intermediate Zones,MSOAIZ,PE,6554,3272,3282,1205,1221
E02005515,Breckland 013,Middle Super Output Areas and Intermediate Zones,MSOAIZ,NR,6223,3103,3120,1138,1242
E02005516,Breckland 014,Middle Super Output Areas and Intermediate Zones,MSOAIZ,NR,6510,3246,3264,1113,1193
E02005517,Breckland 015,Middle Super Output Areas and Intermediate Zones,MSOAIZ,IP,5910,2910,3000,1194,1233
E02005518,Breckland 016,Middle Super Output Areas and Intermediate Zones,MSOAIZ,IP,10635,5346,5289,2437,2280
E02005519,Breckland 017,Middle Super Output Areas and Intermediate Zones,MSOAIZ,IP,7795,3843,3952,1541,1593
E02005520,Broadland 001,Middle Super Output Areas and Intermediate Zones,MSOAIZ,NR,7378,3552,3826,1195,1225
E02005521,Broadland 002,Middle Super Output Areas and Intermediate Zones,MSOAIZ,NR,8519,4217,4302,1502,1600
E02005522,Broadland 003,Middle Super Output Areas and Intermediate Zones,MSOAIZ,NR,5302,2594,2708,996,981
E02005523,Broadland 004,Middle Super Output Areas and Intermediate Zones,MSOAIZ,NR,7737,3824,3913,1552,1603
E02005524,Broadland 005,Middle Super Output Areas and Intermediate Zones,MSOAIZ,NR,5442,2697,2745,1014,1055
E02005525,Broadland 006,Middle Super Output Areas and Intermediate Zones,MSOAIZ,NR,10142,4984,5158,2025,2164
E02005526,Broadland 007,Middle Super Output Areas and Intermediate Zones,MSOAIZ,NR,5489,2632,2857,1063,1125
E02005527,Broadland 008,Middle Super Output Areas and Intermediate Zones,MSOAIZ,NR,8229,4022,4207,1468,1552
E02005528,Broadland 009,Middle Super Output Areas and Intermediate Zones,MSOAIZ,NR,8458,4123,4335,1659,1714
E02005529,Broadland 010,Middle Super Output Areas and Intermediate Zones,MSOAIZ,NR,5807,2772,3035,949,981
E02005530,Broadland 011,Middle Super Output Areas and Intermediate Zones,MSOAIZ,NR,5150,2565,2585,964,932
E02005531,Broadland 012,Middle Super Output Areas and Intermediate Zones,MSOAIZ,NR,5483,2626,2857,1056,1140
E02005532,Broadland 013,Middle Super Output Areas and Intermediate Zones,MSOAIZ,NR,6858,3359,3499,1212,1103
E02005533,Broadland 014,Middle Super Output Areas and Intermediate Zones,MSOAIZ,NR,8237,3944,4293,1416,1525
E02005534,Broadland 015,Middle Super Output Areas and Intermediate Zones,MSOAIZ,NR,7296,3518,3778,1313,1382
E02005535,Broadland 016,Middle Super Output Areas and Intermediate Zones,MSOAIZ,NR,7260,3580,3680,1574,1622
E02005536,Broadland 017,Middle Super Output Areas and Intermediate Zones,MSOAIZ,NR,5790,2814,2976,1023,1074
E02005537,Broadland 018,Middle Super Output Areas and Intermediate Zones,MSOAIZ,NR,6069,2971,3098,1042,1117
E02005538,Great Yarmouth 001,Middle Super Output Areas and Intermediate Zones,MSOAIZ,NR,9118,4415,4703,1427,1502
E02005539,Great Yarmouth 002,Middle Super Output Areas and Intermediate Zones,MSOAIZ,NR,7544,3696,3848,1271,1408
E02005540,Great Yarmouth 003,Middle Super Output Areas and Intermediate Zones,MSOAIZ,NR,9076,4375,4701,1434,1543
E02005541,Great Yarmouth 004,Middle Super Output Areas and Intermediate Zones,MSOAIZ,NR,6078,2954,3124,1026,1087
E02005542,Great Yarmouth 005,Middle Super Output Areas and Intermediate Zones,MSOAIZ,NR,6866,3348,3518,1375,1300
E02005543,Great Yarmouth 006,Middle Super Output Areas and Intermediate Zones,MSOAIZ,NR,8681,4475,4206,1878,1650
E02005544,Great Yarmouth 007,Middle Super Output Areas and Intermediate Zones,MSOAIZ,NR,7134,3587,3547,1461,1441
E02005545,Great Yarmouth 008,Middle Super Output Areas and Intermediate Zones,MSOAIZ,NR,6448,3190,3258,1152,1181
E02005546,Great Yarmouth 009,Middle Super Output Areas and Intermediate Zones,MSOAIZ,NR,7888,3827,4061,1447,1500
E02005547,Great Yarmouth 010,Middle Super Output Areas and Intermediate Zones,MSOAIZ,NR,9003,4388,4615,1599,1720
E02005548,Great Yarmouth 011,Middle Super Output Areas and Intermediate Zones,MSOAIZ,NR,7256,3515,3741,1220,1320
E02005549,Great Yarmouth 012,Middle Super Output Areas and Intermediate Zones,MSOAIZ,NR,5479,2730,2749,973,1059
E02005550,Great Yarmouth 013,Middle Super Output Areas and Intermediate Zones,MSOAIZ,NR,6706,3262,3444,1174,1244
E02005551,King's Lynn and West Norfolk 001,Middle Super Output Areas and Intermediate Zones,MSOAIZ,PE,5420,2521,2899,685,716
E02005552,King's Lynn and West Norfolk 002,Middle Super Output Areas and Intermediate Zones,MSOAIZ,PE,7072,3459,3613,1059,1105
E02005553,King's Lynn and West Norfolk 003,Middle Super Output Areas and Intermediate Zones,MSOAIZ,PE,8782,4142,4640,1170,1302
E02005554,King's Lynn and West Norfolk 004,Middle Super Output Areas and Intermediate Zones,MSOAIZ,PE,6896,3240,3656,1011,1107
E02005555,King's Lynn and West Norfolk 005,Middle Super Output Areas and Intermediate Zones,MSOAIZ,PE,6908,3337,3571,1158,1276
E02005556,King's Lynn and West Norfolk 006,Middle Super Output Areas and Intermediate Zones,MSOAIZ,PE,7681,3741,3940,1516,1580
E02005557,King's Lynn and West Norfolk 007,Middle Super Output Areas and Intermediate Zones,MSOAIZ,PE,6072,2958,3114,1188,1240
E02005558,King's Lynn and West Norfolk 008,Middle Super Output Areas and Intermediate Zones,MSOAIZ,PE,6869,3363,3506,1194,1276
E02005559,King's Lynn and West Norfolk 009,Middle Super Output Areas and Intermediate Zones,MSOAIZ,PE,7022,3433,3589,1419,1373
E02005560,King's Lynn and West Norfolk 010,Middle Super Output Areas and Intermediate Zones,MSOAIZ,PE,8506,4129,4377,1808,1864
E02005561,King's Lynn and West Norfolk 011,Middle Super Output Areas and Intermediate Zones,MSOAIZ,PE,9832,4906,4926,2276,2006
E02005562,King's Lynn and West Norfolk 012,Middle Super Output Areas and Intermediate Zones,MSOAIZ,PE,7008,3396,3612,1238,1298
E02005563,King's Lynn and West Norfolk 013,Middle Super Output Areas and Intermediate Zones,MSOAIZ,PE,7448,3717,3731,1337,1383
E02005564,King's Lynn and West Norfolk 014,Middle Super Output Areas and Intermediate Zones,MSOAIZ,PE,10270,5355,4915,2101,1852
E02005565,King's Lynn and West Norfolk 015,Middle Super Output Areas and Intermediate Zones,MSOAIZ,PE,7024,3442,3582,1328,1354
E02005566,King's Lynn and West Norfolk 016,Middle Super Output Areas and Intermediate Zones,MSOAIZ,PE,9527,4697,4830,1720,1807
E02005567,King's Lynn and West Norfolk 017,Middle Super Output Areas and Intermediate Zones,MSOAIZ,PE,9994,4752,5242,1679,1638
E02005568,King's Lynn and West Norfolk 018,Middle Super Output Areas and Intermediate Zones,MSOAIZ,PE,7189,3535,3654,1289,1345
E02005569,King's Lynn and West Norfolk 019,Middle Super Output Areas and Intermediate Zones,MSOAIZ,PE,7931,3930,4001,1505,1537
E02005570,North Norfolk 001,Middle Super Output Areas and Intermediate Zones,MSOAIZ,NR,7367,3453,3914,972,1061
E02005571,North Norfolk 002,Middle Super Output Areas and Intermediate Zones,MSOAIZ,NR,5952,2856,3096,829,874
E02005572,North Norfolk 003,Middle Super Output Areas and Intermediate Zones,MSOAIZ,NR,7683,3634,4049,1214,1216
E02005573,North Norfolk 004,Middle Super Output Areas and Intermediate Zones,MSOAIZ,NR,5704,2667,3037,643,718
E02005574,North Norfolk 005,Middle Super Output Areas and Intermediate Zones,MSOAIZ,NR,6757,3322,3435,1057,1054
E02005575,North Norfolk 006,Middle Super Output Areas and Intermediate Zones,MSOAIZ,NR,6981,3411,3570,1048,1132
E02005576,North Norfolk 007,Middle Super Output Areas and Intermediate Zones,MSOAIZ,NR,6647,3184,3463,934,1017
E02005577,North Norfolk 008,Middle Super Output Areas and Intermediate Zones,MSOAIZ,NR,5948,2939,3009,999,1067
E02005578,North Norfolk 009,Middle Super Output Areas and Intermediate Zones,MSOAIZ,PE,5728,2808,2920,1041,1052
E02005579,North Norfolk 010,Middle Super Output Areas and Intermediate Zones,MSOAIZ,NR,12634,6015,6619,2126,2204
E02005580,North Norfolk 011,Middle Super Output Areas and Intermediate Zones,MSOAIZ,NR,7617,3647,3970,1271,1340
E02005581,North Norfolk 012,Middle Super Output Areas and Intermediate Zones,MSOAIZ,NR,7704,4067,3637,1673,1364
E02005582,North Norfolk 013,Middle Super Output Areas and Intermediate Zones,MSOAIZ,NR,6502,3184,3318,1125,1142
E02005583,North Norfolk 014,Middle Super Output Areas and Intermediate Zones,MSOAIZ,NR,8275,4016,4259,1167,1175
E02005584,Norwich 001,Middle Super Output Areas and Intermediate Zones,MSOAIZ,NR,10596,5349,5247,2497,2294
E02005585,Norwich 002,Middle Super Output Areas and Intermediate Zones,MSOAIZ,NR,10655,5293,5362,2341,2313
E02005586,Norwich 003,Middle Super Output Areas and Intermediate Zones,MSOAIZ,NR,9934,4951,4983,2709,2499
E02005587,Norwich 004,Middle Super Output Areas and Intermediate Zones,MSOAIZ,NR,9855,4976,4879,2039,1830
E02005588,Norwich 005,Middle Super Output Areas and Intermediate Zones,MSOAIZ,NR,11683,5672,6011,2273,2427
E02005589,Norwich 006,Middle Super Output Areas and Intermediate Zones,MSOAIZ,NR,11504,5675,5829,2351,2335
E02005590,Norwich 007,Middle Super Output Areas and Intermediate Zones,MSOAIZ,NR,9641,4881,4760,2520,1962
E02005592,Norwich 009,Middle Super Output Areas and Intermediate Zones,MSOAIZ,NR,9297,4441,4856,1967,2027
E02005593,Norwich 010,Middle Super Output Areas and Intermediate Zones,MSOAIZ,NR,10279,4792,5487,1177,1372
E02005594,Norwich 011,Middle Super Output Areas and Intermediate Zones,MSOAIZ,NR,10404,5117,5287,2314,2137
E02005595,Norwich 012,Middle Super Output Areas and Intermediate Zones,MSOAIZ,NR,8781,4198,4583,1425,1504
E02005596,Norwich 013,Middle Super Output Areas and Intermediate Zones,MSOAIZ,NR,9326,4454,4872,1830,1924
E02005597,South Norfolk 001,Middle Super Output Areas and Intermediate Zones,MSOAIZ,NR,12463,6171,6292,2493,2545
E02005598,South Norfolk 002,Middle Super Output Areas and Intermediate Zones,MSOAIZ,NR,7769,3751,4018,1447,1554
E02005599,South Norfolk 003,Middle Super Output Areas and Intermediate Zones,MSOAIZ,NR,5691,2713,2978,1007,1095
E02005600,South Norfolk 004,Middle Super Output Areas and Intermediate Zones,MSOAIZ,NR,6216,3047,3169,974,1059
E02005601,South Norfolk 005,Middle Super Output Areas and Intermediate Zones,MSOAIZ,NR,5714,2733,2981,1003,1071
E02005602,South Norfolk 006,Middle Super Output Areas and Intermediate Zones,MSOAIZ,NR,10355,4958,5397,1779,1981
E02005603,South Norfolk 007,Middle Super Output Areas and Intermediate Zones,MSOAIZ,NR,8691,4232,4459,1700,1869
E02005604,South Norfolk 008,Middle Super Output Areas and Intermediate Zones,MSOAIZ,NR,8200,4026,4174,1393,1500
E02005605,South Norfolk 009,Middle Super Output Areas and Intermediate Zones,MSOAIZ,NR,10178,4924,5254,1832,2110
E02005606,South Norfolk 010,Middle Super Output Areas and Intermediate Zones,MSOAIZ,NR,5597,2793,2804,994,1026
E02005607,South Norfolk 011,Middle Super Output Areas and Intermediate Zones,MSOAIZ,NR,10957,5422,5535,2088,2223
E02005608,South Norfolk 012,Middle Super Output Areas and Intermediate Zones,MSOAIZ,NR,7337,3586,3751,1258,1355
E02005609,South Norfolk 013,Middle Super Output Areas and Intermediate Zones,MSOAIZ,NR,6841,3355,3486,1209,1199
E02005610,South Norfolk 014,Middle Super Output Areas and Intermediate Zones,MSOAIZ,NR,7981,3956,4025,1420,1516
E02005611,South Norfolk 015,Middle Super Output Areas and Intermediate Zones,MSOAIZ,IP,10022,4848,5174,1929,1882
E02005612,Corby 001,Middle Super Output Areas and Intermediate Zones,MSOAIZ,NN,6676,3250,3426,1349,1403
E02005613,Corby 002,Middle Super Output Areas and Intermediate Zones,MSOAIZ,NN,8833,4357,4476,1910,1881
E02005614,Corby 003,Middle Super Output Areas and Intermediate Zones,MSOAIZ,NN,6706,3372,3334,1478,1413
E02005615,Corby 004,Middle Super Output Areas and Intermediate Zones,MSOAIZ,NN,8507,4118,4389,1661,1682
E02005616,Corby 005,Middle Super Output Areas and Intermediate Zones,MSOAIZ,NN,5299,2632,2667,1133,1099
E02005617,Corby 006,Middle Super Output Areas and Intermediate Zones,MSOAIZ,NN,9738,4746,4992,2000,2073
E02005619,Daventry 001,Middle Super Output Areas and Intermediate Zones,MSOAIZ,NN,5844,2918,2926,1069,1164
E02005620,Daventry 002,Middle Super Output Areas and Intermediate Zones,MSOAIZ,NN,7980,3962,4018,1497,1676
E02005621,Daventry 003,Middle Super Output Areas and Intermediate Zones,MSOAIZ,NN,7958,4480,3478,2013,1299
E02005622,Daventry 004,Middle Super Output Areas and Intermediate Zones,MSOAIZ,NN,8785,4310,4475,1652,1803
E02005623,Daventry 005,Middle Super Output Areas and Intermediate Zones,MSOAIZ,NN,8025,3861,4164,1325,1509
E02005624,Daventry 006,Middle Super Output Areas and Intermediate Zones,MSOAIZ,NN,9242,4578,4664,2101,2112
E02005625,Daventry 007,Middle Super Output Areas and Intermediate Zones,MSOAIZ,NN,9122,4493,4629,1847,1762
E02005626,Daventry 008,Middle Super Output Areas and Intermediate Zones,MSOAIZ,NN,6662,3277,3385,1391,1466
E02005627,Daventry 009,Middle Super Output Areas and Intermediate Zones,MSOAIZ,NN,6711,3291,3420,1303,1345
E02005628,Daventry 010,Middle Super Output Areas and Intermediate Zones,MSOAIZ,NN,7514,3729,3785,1487,1571
E02005629,East Northamptonshire 001,Middle Super Output Areas and Intermediate Zones,MSOAIZ,PE,5703,2840,2863,1019,1094
E02005630,East Northamptonshire 002,Middle Super Output Areas and Intermediate Zones,MSOAIZ,PE,9917,4957,4960,1659,1766
E02005631,East Northamptonshire 003,Middle Super Output Areas and Intermediate Zones,MSOAIZ,PE,10006,4983,5023,2060,2142
E02005632,East Northamptonshire 004,Middle Super Output Areas and Intermediate Zones,MSOAIZ,NN,6042,3010,3032,1137,1207
E02005633,East Northamptonshire 005,Middle Super Output Areas and Intermediate Zones,MSOAIZ,NN,8641,4303,4338,1744,1681
E02005634,East Northamptonshire 006,Middle Super Output Areas and Intermediate Zones,MSOAIZ,NN,8535,4251,4284,1802,1846
E02005635,East Northamptonshire 007,Middle Super Output Areas and Intermediate Zones,MSOAIZ,NN,8649,4272,4377,1794,1881
E02005636,East Northamptonshire 008,Middle Super Output Areas and Intermediate Zones,MSOAIZ,PE,11136,5414,5722,2178,2312
E02005637,East Northamptonshire 009,Middle Super Output Areas and Intermediate Zones,MSOAIZ,NN,8302,4127,4175,1847,1719
E02005638,East Northamptonshire 010,Middle Super Output Areas and Intermediate Zones,MSOAIZ,NN,9834,4901,4933,1973,2012
E02005639,Kettering 001,Middle Super Output Areas and Intermediate Zones,MSOAIZ,NN,5276,2586,2690,926,1027
E02005640,Kettering 002,Middle Super Output Areas and Intermediate Zones,MSOAIZ,NN,10697,5251,5446,2146,2256
E02005641,Kettering 003,Middle Super Output Areas and Intermediate Zones,MSOAIZ,NN,7694,3752,3942,1453,1524
E02005642,Kettering 004,Middle Super Output Areas and Intermediate Zones,MSOAIZ,NN,8266,4036,4230,1737,1780
E02005643,Kettering 005,Middle Super Output Areas and Intermediate Zones,MSOAIZ,NN,8047,3975,4072,1603,1739
E02005644,Kettering 006,Middle Super Output Areas and Intermediate Zones,MSOAIZ,NN,8251,4242,4009,2117,1872
E02005645,Kettering 007,Middle Super Output Areas and Intermediate Zones,MSOAIZ,NN,10992,5381,5611,2495,2283
E02005646,Kettering 008,Middle Super Output Areas and Intermediate Zones,MSOAIZ,NN,6423,3100,3323,1186,1228
E02005647,Kettering 009,Middle Super Output Areas and Intermediate Zones,MSOAIZ,NN,7032,3466,3566,1501,1441
E02005648,Kettering 010,Middle Super Output Areas and Intermediate Zones,MSOAIZ,NN,7215,3570,3645,1330,1426
E02005649,Kettering 011,Middle Super Output Areas and Intermediate Zones,MSOAIZ,NN,13582,6537,7045,2765,2993
E02005650,Northampton 001,Middle Super Output Areas and Intermediate Zones,MSOAIZ,NN,6852,3261,3591,1114,1158
E02005651,Northampton 002,Middle Super Output Areas and Intermediate Zones,MSOAIZ,NN,6277,3024,3253,1162,1140
E02005652,Northampton 003,Middle Super Output Areas and Intermediate Zones,MSOAIZ,NN,5965,2902,3063,1067,1100
E02005653,Northampton 004,Middle Super Output Areas and Intermediate Zones,MSOAIZ,NN,8119,3961,4158,1696,1810
E02005654,Northampton 005,Middle Super Output Areas and Intermediate Zones,MSOAIZ,NN,8223,3900,4323,1615,1928
E02005655,Northampton 006,Middle Super Output Areas and Intermediate Zones,MSOAIZ,NN,5811,2764,3047,1040,1058
E02005656,Northampton 007,Middle Super Output Areas and Intermediate Zones,MSOAIZ,NN,5901,2854,3047,1084,1278
E02005657,Northampton 008,Middle Super Output Areas and Intermediate Zones,MSOAIZ,NN,6093,2994,3099,1251,1210
E02005658,Northampton 009,Middle Super Output Areas and Intermediate Zones,MSOAIZ,NN,6286,2992,3294,1269,1369
E02005659,Northampton 010,Middle Super Output Areas and Intermediate Zones,MSOAIZ,NN,5063,2441,2622,913,926
E02005660,Northampton 011,Middle Super Output Areas and Intermediate Zones,MSOAIZ,NN,5660,2698,2962,1014,1176
E02005661,Northampton 012,Middle Super Output Areas and Intermediate Zones,MSOAIZ,NN,6481,3192,3289,1320,1420
E02005662,Northampton 013,Middle Super Output Areas and Intermediate Zones,MSOAIZ,NN,6732,3308,3424,1478,1445
E02005663,Northampton 014,Middle Super Output Areas and Intermediate Zones,MSOAIZ,NN,5448,2656,2792,1150,1217
E02005664,Northampton 015,Middle Super Output Areas and Intermediate Zones,MSOAIZ,NN,6007,2941,3066,1443,1237
E02005665,Northampton 016,Middle Super Output Areas and Intermediate Zones,MSOAIZ,NN,7365,3596,3769,1550,1632
E02005666,Northampton 017,Middle Super Output Areas and Intermediate Zones,MSOAIZ,NN,8173,3934,4239,1708,1762
E02005667,Northampton 018,Middle Super Output Areas and Intermediate Zones,MSOAIZ,NN,6029,2901,3128,1167,1233
E02005668,Northampton 019,Middle Super Output Areas and Intermediate Zones,MSOAIZ,NN,6108,2957,3151,1144,1156
E02005669,Northampton 020,Middle Super Output Areas and Intermediate Zones,MSOAIZ,NN,5693,2825,2868,1035,1101
E02005670,Northampton 021,Middle Super Output Areas and Intermediate Zones,MSOAIZ,NN,8177,4347,3830,2347,1724
E02005671,Northampton 022,Middle Super Output Areas and Intermediate Zones,MSOAIZ,NN,7285,3707,3578,1944,1734
E02005672,Northampton 023,Middle Super Output Areas and Intermediate Zones,MSOAIZ,NN,7327,3859,3468,2141,1729
E02005673,Northampton 024,Middle Super Output Areas and Intermediate Zones,MSOAIZ,NN,7166,3565,3601,1739,1564
E02005674,Northampton 025,Middle Super Output Areas and Intermediate Zones,MSOAIZ,NN,7051,3675,3376,2006,1618
E02005675,Northampton 026,Middle Super Output Areas and Intermediate Zones,MSOAIZ,NN,5733,2674,3059,1175,1364
E02005676,Northampton 027,Middle Super Output Areas and Intermediate Zones,MSOAIZ,NN,5913,2894,3019,1287,1352
E02005677,Northampton 028,Middle Super Output Areas and Intermediate Zones,MSOAIZ,NN,8053,4036,4017,1997,1866
E02005678,Northampton 029,Middle Super Output Areas and Intermediate Zones,MSOAIZ,NN,9717,4756,4961,2245,2298
E02005679,Northampton 030,Middle Super Output Areas and Intermediate Zones,MSOAIZ,NN,8828,4367,4461,2109,2200
E02005680,Northampton 031,Middle Super Output Areas and Intermediate Zones,MSOAIZ,NN,8533,4187,4346,1866,2100
E02005681,South Northamptonshire 001,Middle Super Output Areas and Intermediate Zones,MSOAIZ,NN,8128,3954,4174,1364,1553
E02005682,South Northamptonshire 002,Middle Super Output Areas and Intermediate Zones,MSOAIZ,NN,6358,3113,3245,1119,1270
E02005683,South Northamptonshire 003,Middle Super Output Areas and Intermediate Zones,MSOAIZ,NN,13255,6545,6710,2847,2920
E02005684,South Northamptonshire 004,Middle Super Output Areas and Intermediate Zones,MSOAIZ,NN,7984,3988,3996,1559,1632
E02005685,South Northamptonshire 005,Middle Super Output Areas and Intermediate Zones,MSOAIZ,NN,8066,3986,4080,1632,1792
E02005686,South Northamptonshire 006,Middle Super Output Areas and Intermediate Zones,MSOAIZ,OX,7461,3639,3822,1376,1463
E02005687,South Northamptonshire 007,Middle Super Output Areas and Intermediate Zones,MSOAIZ,OX,5920,2939,2981,1167,1250
E02005688,South Northamptonshire 008,Middle Super Output Areas and Intermediate Zones,MSOAIZ,NN,8671,4336,4335,1753,1896
E02005689,South Northamptonshire 009,Middle Super Output Areas and Intermediate Zones,MSOAIZ,NN,7641,3773,3868,1640,1755
E02005690,South Northamptonshire 010,Middle Super Output Areas and Intermediate Zones,MSOAIZ,NN,5377,2703,2674,1190,1122
E02005691,South Northamptonshire 011,Middle Super Output Areas and Intermediate Zones,MSOAIZ,OX,6328,3122,3206,1238,1268
E02005692,Wellingborough 001,Middle Super Output Areas and Intermediate Zones,MSOAIZ,NN,6572,3271,3301,1230,1246
E02005693,Wellingborough 002,Middle Super Output Areas and Intermediate Zones,MSOAIZ,NN,8272,4020,4252,1621,1774
E02005694,Wellingborough 003,Middle Super Output Areas and Intermediate Zones,MSOAIZ,NN,7647,3781,3866,1558,1629
E02005695,Wellingborough 004,Middle Super Output Areas and Intermediate Zones,MSOAIZ,NN,7321,3700,3621,1849,1636
E02005696,Wellingborough 005,Middle Super Output Areas and Intermediate Zones,MSOAIZ,NN,5818,2754,3064,1037,1226
E02005697,Wellingborough 006,Middle Super Output Areas and Intermediate Zones,MSOAIZ,NN,6047,3005,3042,1308,1187
E02005698,Wellingborough 007,Middle Super Output Areas and Intermediate Zones,MSOAIZ,NN,5743,2723,3020,1074,1164
E02005699,Wellingborough 008,Middle Super Output Areas and Intermediate Zones,MSOAIZ,NN,8239,4121,4118,1847,1776
E02005700,Wellingborough 009,Middle Super Output Areas and Intermediate Zones,MSOAIZ,NN,8865,4342,4523,1624,1741
E02005701,Wellingborough 010,Middle Super Output Areas and Intermediate Zones,MSOAIZ,NN,10832,5359,5473,2133,2178
E02005702,Northumberland 004,Middle Super Output Areas and Intermediate Zones,MSOAIZ,NE,6554,3235,3319,1167,1202
E02005703,Northumberland 005,Middle Super Output Areas and Intermediate Zones,MSOAIZ,NE,6766,3206,3560,1262,1399
E02005704,Northumberland 006,Middle Super Output Areas and Intermediate Zones,MSOAIZ,NE,12408,6039,6369,2220,2410
E02005705,Northumberland 007,Middle Super Output Areas and Intermediate Zones,MSOAIZ,NE,7509,3708,3801,1308,1362
E02005706,Northumberland 001,Middle Super Output Areas and Intermediate Zones,MSOAIZ,TD,9620,4560,5060,1781,1892
E02005707,Northumberland 002,Middle Super Output Areas and Intermediate Zones,MSOAIZ,TD,6897,3364,3533,1106,1239
E02005708,Northumberland 003,Middle Super Output Areas and Intermediate Zones,MSOAIZ,TD,10450,5141,5309,1731,1800
E02005709,Northumberland 022,Middle Super Output Areas and Intermediate Zones,MSOAIZ,NE,6860,3276,3584,1185,1345
E02005710,Northumberland 023,Middle Super Output Areas and Intermediate Zones,MSOAIZ,NE,8431,4164,4267,1819,1689
E02005711,Northumberland 024,Middle Super Output Areas and Intermediate Zones,MSOAIZ,NE,8341,3999,4342,1463,1582
E02005712,Northumberland 025,Middle Super Output Areas and Intermediate Zones,MSOAIZ,NE,7030,3433,3597,1384,1516
E02005713,Northumberland 026,Middle Super Output Areas and Intermediate Zones,MSOAIZ,NE,6677,3300,3377,1384,1403
E02005714,Northumberland 027,Middle Super Output Areas and Intermediate Zones,MSOAIZ,NE,5380,2646,2734,1127,1281
E02005715,Northumberland 029,Middle Super Output Areas and Intermediate Zones,MSOAIZ,NE,8633,4077,4556,1562,1755
E02005716,Northumberland 028,Middle Super Output Areas and Intermediate Zones,MSOAIZ,NE,8783,4192,4591,1721,1939
E02005717,Northumberland 030,Middle Super Output Areas and Intermediate Zones,MSOAIZ,NE,7805,3715,4090,1401,1510
E02005718,Northumberland 031,Middle Super Output Areas and Intermediate Zones,MSOAIZ,NE,6617,3231,3386,1170,1205
E02005719,Northumberland 032,Middle Super Output Areas and Intermediate Zones,MSOAIZ,NE,7617,3784,3833,1557,1559
E02005720,Northumberland 008,Middle Super Output Areas and Intermediate Zones,MSOAIZ,NE,12092,6458,5634,2818,2239
E02005721,Northumberland 011,Middle Super Output Areas and Intermediate Zones,MSOAIZ,NE,5180,2586,2594,1116,1083
E02005722,Northumberland 015,Middle Super Output Areas and Intermediate Zones,MSOAIZ,NE,7115,3488,3627,1263,1433
E02005723,Northumberland 016,Middle Super Output Areas and Intermediate Zones,MSOAIZ,NE,6281,2917,3364,1114,1232
E02005724,Northumberland 018,Middle Super Output Areas and Intermediate Zones,MSOAIZ,NE,6146,3035,3111,1013,1104
E02005725,Northumberland 033,Middle Super Output Areas and Intermediate Zones,MSOAIZ,NE,6516,3086,3430,1014,1164
E02005726,Northumberland 034,Middle Super Output Areas and Intermediate Zones,MSOAIZ,NE,7708,3912,3796,1325,1333
E02005727,Northumberland 019,Middle Super Output Areas and Intermediate Zones,MSOAIZ,NE,6398,3193,3205,1233,1256
E02005728,Northumberland 037,Middle Super Output Areas and Intermediate Zones,MSOAIZ,NE,7102,3519,3583,1319,1302
E02005729,Northumberland 036,Middle Super Output Areas and Intermediate Zones,MSOAIZ,NE,5620,2696,2924,987,1142
E02005730,Northumberland 035,Middle Super Output Areas and Intermediate Zones,MSOAIZ,NE,13097,6224,6873,2272,2454
E02005731,Northumberland 038,Middle Super Output Areas and Intermediate Zones,MSOAIZ,NE,10853,5242,5611,2174,2336
E02005732,Northumberland 039,Middle Super Output Areas and Intermediate Zones,MSOAIZ,NE,9052,4366,4686,1545,1657
E02005733,Northumberland 040,Middle Super Output Areas and Intermediate Zones,MSOAIZ,NE,8136,4031,4105,1467,1556
E02005734,Northumberland 009,Middle Super Output Areas and Intermediate Zones,MSOAIZ,NE,6308,3034,3274,1100,1175
E02005735,Northumberland 010,Middle Super Output Areas and Intermediate Zones,MSOAIZ,NE,7940,3928,4012,1684,1641
E02005736,Northumberland 013,Middle Super Output Areas and Intermediate Zones,MSOAIZ,NE,7555,3732,3823,1521,1517
E02005737,Northumberland 012,Middle Super Output Areas and Intermediate Zones,MSOAIZ,NE,7227,3469,3758,1346,1495
E02005738,Northumberland 014,Middle Super Output Areas and Intermediate Zones,MSOAIZ,NE,5067,2477,2590,1039,1074
E02005739,Northumberland 017,Middle Super Output Areas and Intermediate Zones,MSOAIZ,NE,9464,4535,4929,1760,1982
E02005740,Northumberland 020,Middle Super Output Areas and Intermediate Zones,MSOAIZ,NE,10275,5024,5251,2072,2113
E02005741,Northumberland 021,Middle Super Output Areas and Intermediate Zones,MSOAIZ,NE,8518,4102,4416,1596,1804
E02005742,Craven 001,Middle Super Output Areas and Intermediate Zones,MSOAIZ,LA,7414,3628,3786,1295,1322
E02005743,Craven 002,Middle Super Output Areas and Intermediate Zones,MSOAIZ,BD,5126,2492,2634,797,818
E02005744,Craven 003,Middle Super Output Areas and Intermediate Zones,MSOAIZ,BD,7678,3762,3916,1248,1357
E02005745,Craven 004,Middle Super Output Areas and Intermediate Zones,MSOAIZ,LS,5119,2486,2633,867,874
E02005746,Craven 005,Middle Super Output Areas and Intermediate Zones,MSOAIZ,BD,6406,3057,3349,1197,1281
E02005747,Craven 006,Middle Super Output Areas and Intermediate Zones,MSOAIZ,BD,6650,3197,3453,1337,1399
E02005748,Craven 007,Middle Super Output Areas and Intermediate Zones,MSOAIZ,BD,7375,3578,3797,1383,1469
E02005749,Craven 008,Middle Super Output Areas and Intermediate Zones,MSOAIZ,BD,9641,4554,5087,1738,1822
E02005750,Hambleton 001,Middle Super Output Areas and Intermediate Zones,MSOAIZ,YO,7838,3768,4070,1332,1451
E02005751,Hambleton 002,Middle Super Output Areas and Intermediate Zones,MSOAIZ,TS,8582,4201,4381,1347,1439
E02005752,Hambleton 003,Middle Super Output Areas and Intermediate Zones,MSOAIZ,YO,6663,3350,3313,1270,1276
E02005753,Hambleton 004,Middle Super Output Areas and Intermediate Zones,MSOAIZ,DL,13083,6373,6710,2523,2599
E02005754,Hambleton 005,Middle Super Output Areas and Intermediate Zones,MSOAIZ,DL,7476,3627,3849,1266,1344
E02005755,Hambleton 006,Middle Super Output Areas and Intermediate Zones,MSOAIZ,HG,6329,3089,3240,1157,1177
E02005756,Hambleton 007,Middle Super Output Areas and Intermediate Zones,MSOAIZ,YO,7217,3847,3370,1533,1387
E02005757,Hambleton 008,Middle Super Output Areas and Intermediate Zones,MSOAIZ,YO,8452,4117,4335,1620,1651
E02005758,Hambleton 009,Middle Super Output Areas and Intermediate Zones,MSOAIZ,YO,8330,4225,4105,1636,1541
E02005759,Hambleton 010,Middle Super Output Areas and Intermediate Zones,MSOAIZ,YO,8486,3992,4494,1424,1534
E02005760,Hambleton 011,Middle Super Output Areas and Intermediate Zones,MSOAIZ,YO,6684,3393,3291,1388,1405
E02005761,Harrogate 001,Middle Super Output Areas and Intermediate Zones,MSOAIZ,HG,5459,2658,2801,980,1038
E02005762,Harrogate 002,Middle Super Output Areas and Intermediate Zones,MSOAIZ,HG,6287,3258,3029,1314,1145
E02005763,Harrogate 003,Middle Super Output Areas and Intermediate Zones,MSOAIZ,YO,6518,3263,3255,1290,1206
E02005764,Harrogate 004,Middle Super Output Areas and Intermediate Zones,MSOAIZ,HG,10415,5123,5292,1997,2080
E02005765,Harrogate 005,Middle Super Output Areas and Intermediate Zones,MSOAIZ,YO,6211,3039,3172,1160,1213
E02005766,Harrogate 006,Middle Super Output Areas and Intermediate Zones,MSOAIZ,HG,6118,3005,3113,1147,1155
E02005767,Harrogate 007,Middle Super Output Areas and Intermediate Zones,MSOAIZ,HG,6732,3282,3450,1222,1313
E02005768,Harrogate 008,Middle Super Output Areas and Intermediate Zones,MSOAIZ,HG,6028,2965,3063,1228,1264
E02005769,Harrogate 009,Middle Super Output Areas and Intermediate Zones,MSOAIZ,HG,6902,3351,3551,1320,1357
E02005770,Harrogate 010,Middle Super Output Areas and Intermediate Zones,MSOAIZ,HG,9326,4521,4805,1978,1983
E02005771,Harrogate 011,Middle Super Output Areas and Intermediate Zones,MSOAIZ,HG,7363,3597,3766,1600,1730
E02005772,Harrogate 012,Middle Super Output Areas and Intermediate Zones,MSOAIZ,HG,6150,2991,3159,1010,1177
E02005773,Harrogate 013,Middle Super Output Areas and Intermediate Zones,MSOAIZ,HG,8831,4281,4550,1943,1975
E02005774,Harrogate 014,Middle Super Output Areas and Intermediate Zones,MSOAIZ,HG,9370,4496,4874,1910,2024
E02005775,Harrogate 015,Middle Super Output Areas and Intermediate Zones,MSOAIZ,HG,9287,4606,4681,2449,2029
E02005776,Harrogate 016,Middle Super Output Areas and Intermediate Zones,MSOAIZ,YO,8407,4174,4233,1512,1583
E02005777,Harrogate 017,Middle Super Output Areas and Intermediate Zones,MSOAIZ,HG,8465,4052,4413,1528,1677
E02005778,Harrogate 018,Middle Super Output Areas and Intermediate Zones,MSOAIZ,LS,6169,3060,3109,1136,1170
E02005779,Harrogate 019,Middle Super Output Areas and Intermediate Zones,MSOAIZ,HG,7581,3601,3980,1567,1580
E02005780,Harrogate 020,Middle Super Output Areas and Intermediate Zones,MSOAIZ,HG,10603,4980,5623,1771,2083
E02005781,Harrogate 021,Middle Super Output Areas and Intermediate Zones,MSOAIZ,LS,5647,2734,2913,957,1060
E02005782,Richmondshire 001,Middle Super Output Areas and Intermediate Zones,MSOAIZ,DL,7578,3756,3822,1350,1419
E02005783,Richmondshire 002,Middle Super Output Areas and Intermediate Zones,MSOAIZ,DL,8413,4039,4374,1460,1588
E02005784,Richmondshire 003,Middle Super Output Areas and Intermediate Zones,MSOAIZ,DL,6229,3322,2907,1307,1206
E02005785,Richmondshire 004,Middle Super Output Areas and Intermediate Zones,MSOAIZ,DL,15280,9122,6158,3541,2775
E02005786,Richmondshire 005,Middle Super Output Areas and Intermediate Zones,MSOAIZ,LA,6115,3033,3082,1117,1086
E02005787,Richmondshire 006,Middle Super Output Areas and Intermediate Zones,MSOAIZ,HG,8350,4135,4215,1437,1546
E02005788,Ryedale 001,Middle Super Output Areas and Intermediate Zones,MSOAIZ,YO,6399,3162,3237,1065,1058
E02005789,Ryedale 002,Middle Super Output Areas and Intermediate Zones,MSOAIZ,YO,10086,4744,5342,1583,1711
E02005790,Ryedale 003,Middle Super Output Areas and Intermediate Zones,MSOAIZ,YO,6904,3532,3372,1083,1119
E02005791,Ryedale 004,Middle Super Output Areas and Intermediate Zones,MSOAIZ,YO,6689,3355,3334,1243,1288
E02005794,Ryedale 007,Middle Super Output Areas and Intermediate Zones,MSOAIZ,YO,9398,4615,4783,1665,1791
E02005795,Scarborough 001,Middle Super Output Areas and Intermediate Zones,MSOAIZ,YO,7044,3354,3690,1274,1242
E02005796,Scarborough 002,Middle Super Output Areas and Intermediate Zones,MSOAIZ,YO,6891,3418,3473,1180,1183
E02005797,Scarborough 003,Middle Super Output Areas and Intermediate Zones,MSOAIZ,YO,6169,3065,3104,1123,1168
E02005798,Scarborough 004,Middle Super Output Areas and Intermediate Zones,MSOAIZ,YO,8525,4092,4433,1275,1424
E02005799,Scarborough 005,Middle Super Output Areas and Intermediate Zones,MSOAIZ,YO,8991,4249,4742,1344,1545
E02005800,Scarborough 006,Middle Super Output Areas and Intermediate Zones,MSOAIZ,YO,8057,4100,3957,1759,1553
E02005801,Scarborough 007,Middle Super Output Areas and Intermediate Zones,MSOAIZ,YO,5625,2716,2909,927,1042
E02005802,Scarborough 008,Middle Super Output Areas and Intermediate Zones,MSOAIZ,YO,8357,3971,4386,1639,1817
E02005803,Scarborough 009,Middle Super Output Areas and Intermediate Zones,MSOAIZ,YO,9084,4317,4767,1636,1718
E02005804,Scarborough 010,Middle Super Output Areas and Intermediate Zones,MSOAIZ,YO,8200,4057,4143,1644,1281
E02005805,Scarborough 011,Middle Super Output Areas and Intermediate Zones,MSOAIZ,YO,7084,3369,3715,1086,1227
E02005806,Scarborough 012,Middle Super Output Areas and Intermediate Zones,MSOAIZ,YO,7166,3466,3700,1270,1434
E02005807,Scarborough 013,Middle Super Output Areas and Intermediate Zones,MSOAIZ,YO,6206,2955,3251,1000,1115
E02005808,Scarborough 014,Middle Super Output Areas and Intermediate Zones,MSOAIZ,YO,11394,5441,5953,1642,1791
E02005809,Selby 001,Middle Super Output Areas and Intermediate Zones,MSOAIZ,LS,7261,3564,3697,1424,1442
E02005810,Selby 002,Middle Super Output Areas and Intermediate Zones,MSOAIZ,YO,8842,4353,4489,1803,1917
E02005811,Selby 003,Middle Super Output Areas and Intermediate Zones,MSOAIZ,YO,9109,4351,4758,1777,1937
E02005812,Selby 004,Middle Super Output Areas and Intermediate Zones,MSOAIZ,LS,9025,4438,4587,1892,1917
E02005813,Selby 005,Middle Super Output Areas and Intermediate Zones,MSOAIZ,YO,10886,5371,5515,2447,2386
E02005814,Selby 006,Middle Super Output Areas and Intermediate Zones,MSOAIZ,YO,6418,3054,3364,1171,1214
E02005815,Selby 007,Middle Super Output Areas and Intermediate Zones,MSOAIZ,YO,8214,4095,4119,1575,1668
E02005816,Selby 008,Middle Super Output Areas and Intermediate Zones,MSOAIZ,YO,8415,4159,4256,1680,1776
E02005817,Selby 009,Middle Super Output Areas and Intermediate Zones,MSOAIZ,YO,7125,3497,3628,1416,1477
E02005818,Selby 010,Middle Super Output Areas and Intermediate Zones,MSOAIZ,YO,8154,4065,4089,1643,1715
E02005819,Ashfield 001,Middle Super Output Areas and Intermediate Zones,MSOAIZ,NG,6146,3016,3130,1148,1185
E02005820,Ashfield 002,Middle Super Output Areas and Intermediate Zones,MSOAIZ,NG,5728,2845,2883,1161,1141
E02005821,Ashfield 003,Middle Super Output Areas and Intermediate Zones,MSOAIZ,NG,6388,3133,3255,1328,1330
E02005822,Ashfield 004,Middle Super Output Areas and Intermediate Zones,MSOAIZ,NG,9531,4749,4782,2109,2097
E02005823,Ashfield 005,Middle Super Output Areas and Intermediate Zones,MSOAIZ,NG,7518,3561,3957,1372,1457
E02005824,Ashfield 006,Middle Super Output Areas and Intermediate Zones,MSOAIZ,NG,9727,4838,4889,2067,2111
E02005825,Ashfield 007,Middle Super Output Areas and Intermediate Zones,MSOAIZ,NG,8012,3922,4090,1531,1608
E02005826,Ashfield 008,Middle Super Output Areas and Intermediate Zones,MSOAIZ,NG,6072,2982,3090,1199,1215
E02005827,Ashfield 009,Middle Super Output Areas and Intermediate Zones,MSOAIZ,NG,8303,4107,4196,1753,1752
E02005828,Ashfield 010,Middle Super Output Areas and Intermediate Zones,MSOAIZ,NG,7109,3500,3609,1397,1442
E02005829,Ashfield 011,Middle Super Output Areas and Intermediate Zones,MSOAIZ,NG,6753,3329,3424,1337,1318
E02005830,Ashfield 012,Middle Super Output Areas and Intermediate Zones,MSOAIZ,NG,6111,2987,3124,1160,1205
E02005831,Ashfield 013,Middle Super Output Areas and Intermediate Zones,MSOAIZ,NG,8570,4176,4394,1796,1849
E02005832,Ashfield 014,Middle Super Output Areas and Intermediate Zones,MSOAIZ,NG,8924,4320,4604,1956,1987
E02005833,Ashfield 015,Middle Super Output Areas and Intermediate Zones,MSOAIZ,NG,7427,3654,3773,1428,1526
E02005834,Ashfield 016,Middle Super Output Areas and Intermediate Zones,MSOAIZ,NG,7178,3546,3632,1417,1459
E02005835,Bassetlaw 001,Middle Super Output Areas and Intermediate Zones,MSOAIZ,S,10180,5002,5178,1923,2032
E02005836,Bassetlaw 002,Middle Super Output Areas and Intermediate Zones,MSOAIZ,DN,8933,4431,4502,1583,1676
E02005837,Bassetlaw 003,Middle Super Output Areas and Intermediate Zones,MSOAIZ,S,7809,4384,3425,1956,1282
E02005838,Bassetlaw 004,Middle Super Output Areas and Intermediate Zones,MSOAIZ,S,8095,3909,4186,1437,1523
E02005839,Bassetlaw 005,Middle Super Output Areas and Intermediate Zones,MSOAIZ,DN,6162,2975,3187,1107,1181
E02005840,Bassetlaw 006,Middle Super Output Areas and Intermediate Zones,MSOAIZ,S,9050,4499,4551,1980,2032
E02005842,Bassetlaw 008,Middle Super Output Areas and Intermediate Zones,MSOAIZ,DN,8622,4212,4410,1653,1746
E02005843,Bassetlaw 009,Middle Super Output Areas and Intermediate Zones,MSOAIZ,S,6403,3177,3226,1440,1449
E02005844,Bassetlaw 010,Middle Super Output Areas and Intermediate Zones,MSOAIZ,DN,7566,3730,3836,1520,1519
E02005846,Bassetlaw 012,Middle Super Output Areas and Intermediate Zones,MSOAIZ,S,6491,3156,3335,1375,1376
E02005847,Bassetlaw 013,Middle Super Output Areas and Intermediate Zones,MSOAIZ,S,6634,3220,3414,1382,1366
E02005848,Bassetlaw 014,Middle Super Output Areas and Intermediate Zones,MSOAIZ,S,6799,3366,3433,1184,1266
E02005849,Bassetlaw 015,Middle Super Output Areas and Intermediate Zones,MSOAIZ,NG,9055,4649,4406,1797,1715
E02005850,Broxtowe 001,Middle Super Output Areas and Intermediate Zones,MSOAIZ,NG,6892,3387,3505,1309,1325
E02005851,Broxtowe 002,Middle Super Output Areas and Intermediate Zones,MSOAIZ,NG,5927,2908,3019,1139,1216
E02005852,Broxtowe 003,Middle Super Output Areas and Intermediate Zones,MSOAIZ,NG,7930,3935,3995,1503,1512
E02005853,Broxtowe 004,Middle Super Output Areas and Intermediate Zones,MSOAIZ,NG,8976,4388,4588,1751,1890
E02005856,Broxtowe 007,Middle Super Output Areas and Intermediate Zones,MSOAIZ,NG,7270,3588,3682,1283,1314
E02005857,Broxtowe 008,Middle Super Output Areas and Intermediate Zones,MSOAIZ,NG,6238,3050,3188,1256,1308
E02005858,Broxtowe 009,Middle Super Output Areas and Intermediate Zones,MSOAIZ,NG,7450,3719,3731,1588,1594
E02005859,Broxtowe 010,Middle Super Output Areas and Intermediate Zones,MSOAIZ,NG,9003,4435,4568,1831,1868
E02005860,Broxtowe 011,Middle Super Output Areas and Intermediate Zones,MSOAIZ,NG,8339,4197,4142,1930,1719
E02005861,Broxtowe 012,Middle Super Output Areas and Intermediate Zones,MSOAIZ,NG,5516,2786,2730,1317,1274
E02005862,Broxtowe 013,Middle Super Output Areas and Intermediate Zones,MSOAIZ,NG,7823,3843,3980,1652,1537
E02005863,Broxtowe 014,Middle Super Output Areas and Intermediate Zones,MSOAIZ,NG,7369,3615,3754,1423,1429
E02005864,Broxtowe 015,Middle Super Output Areas and Intermediate Zones,MSOAIZ,NG,8238,4011,4227,1758,1828
E02005865,Gedling 001,Middle Super Output Areas and Intermediate Zones,MSOAIZ,NG,7929,3892,4037,1392,1450
E02005866,Gedling 002,Middle Super Output Areas and Intermediate Zones,MSOAIZ,NG,8948,4340,4608,1688,1758
E02005868,Gedling 004,Middle Super Output Areas and Intermediate Zones,MSOAIZ,NG,6451,3100,3351,1155,1290
E02005869,Gedling 005,Middle Super Output Areas and Intermediate Zones,MSOAIZ,NG,5837,2750,3087,1060,1202
E02005870,Gedling 006,Middle Super Output Areas and Intermediate Zones,MSOAIZ,NG,6593,3185,3408,1346,1457
E02005871,Gedling 007,Middle Super Output Areas and Intermediate Zones,MSOAIZ,NG,7132,3443,3689,1364,1443
E02005872,Gedling 008,Middle Super Output Areas and Intermediate Zones,MSOAIZ,NG,5777,2802,2975,999,1027
E02005873,Gedling 009,Middle Super Output Areas and Intermediate Zones,MSOAIZ,NG,10034,4882,5152,1815,1926
E02005874,Gedling 010,Middle Super Output Areas and Intermediate Zones,MSOAIZ,NG,8384,4139,4245,1745,1788
E02005875,Gedling 011,Middle Super Output Areas and Intermediate Zones,MSOAIZ,NG,7209,3512,3697,1372,1520
E02005876,Gedling 012,Middle Super Output Areas and Intermediate Zones,MSOAIZ,NG,9055,4457,4598,1742,1823
E02005877,Gedling 013,Middle Super Output Areas and Intermediate Zones,MSOAIZ,NG,7365,3680,3685,1600,1629
E02005878,Gedling 014,Middle Super Output Areas and Intermediate Zones,MSOAIZ,NG,9548,4729,4819,1966,2020
E02005879,Gedling 015,Middle Super Output Areas and Intermediate Zones,MSOAIZ,NG,7398,3595,3803,1788,1838
E02005880,Mansfield 001,Middle Super Output Areas and Intermediate Zones,MSOAIZ,NG,6237,3071,3166,1149,1200
E02005881,Mansfield 002,Middle Super Output Areas and Intermediate Zones,MSOAIZ,NG,5762,2808,2954,1104,1148
E02005882,Mansfield 003,Middle Super Output Areas and Intermediate Zones,MSOAIZ,NG,7891,3893,3998,1462,1604
E02005883,Mansfield 004,Middle Super Output Areas and Intermediate Zones,MSOAIZ,NG,7718,3821,3897,1553,1630
E02005884,Mansfield 005,Middle Super Output Areas and Intermediate Zones,MSOAIZ,NG,6124,3033,3091,1287,1329
E02005885,Mansfield 006,Middle Super Output Areas and Intermediate Zones,MSOAIZ,NG,8282,4011,4271,1567,1596
E02005886,Mansfield 007,Middle Super Output Areas and Intermediate Zones,MSOAIZ,NG,10348,5002,5346,2020,2162
E02005887,Mansfield 008,Middle Super Output Areas and Intermediate Zones,MSOAIZ,NG,9110,4581,4529,2133,1908
E02005888,Mansfield 009,Middle Super Output Areas and Intermediate Zones,MSOAIZ,NG,8171,4009,4162,1789,1763
E02005889,Mansfield 010,Middle Super Output Areas and Intermediate Zones,MSOAIZ,NG,10174,4928,5246,2029,2105
E02005890,Mansfield 011,Middle Super Output Areas and Intermediate Zones,MSOAIZ,NG,6703,3334,3369,1346,1369
E02005891,Mansfield 012,Middle Super Output Areas and Intermediate Zones,MSOAIZ,NG,6323,3149,3174,1313,1284
E02005892,Mansfield 013,Middle Super Output Areas and Intermediate Zones,MSOAIZ,NG,11623,5668,5955,2473,2470
E02005893,Newark and Sherwood 001,Middle Super Output Areas and Intermediate Zones,MSOAIZ,NG,10023,4920,5103,1967,1973
E02005894,Newark and Sherwood 002,Middle Super Output Areas and Intermediate Zones,MSOAIZ,NG,9853,4786,5067,1907,2008
E02005895,Newark and Sherwood 003,Middle Super Output Areas and Intermediate Zones,MSOAIZ,NG,7986,3946,4040,1392,1478
E02005896,Newark and Sherwood 004,Middle Super Output Areas and Intermediate Zones,MSOAIZ,NG,7342,3612,3730,1251,1324
E02005897,Newark and Sherwood 005,Middle Super Output Areas and Intermediate Zones,MSOAIZ,NG,8926,4423,4503,1603,1704
E02005898,Newark and Sherwood 006,Middle Super Output Areas and Intermediate Zones,MSOAIZ,NG,10772,5262,5510,2232,2354
E02005899,Newark and Sherwood 007,Middle Super Output Areas and Intermediate Zones,MSOAIZ,NG,10647,5365,5282,2447,2291
E02005900,Newark and Sherwood 008,Middle Super Output Areas and Intermediate Zones,MSOAIZ,NG,7297,3418,3879,1072,1175
E02005901,Newark and Sherwood 009,Middle Super Output Areas and Intermediate Zones,MSOAIZ,NG,8872,4320,4552,1866,1916
E02005902,Newark and Sherwood 010,Middle Super Output Areas and Intermediate Zones,MSOAIZ,NG,8181,3895,4286,1403,1613
E02005903,Newark and Sherwood 011,Middle Super Output Areas and Intermediate Zones,MSOAIZ,NG,9757,4735,5022,1838,1928
E02005904,Newark and Sherwood 012,Middle Super Output Areas and Intermediate Zones,MSOAIZ,NG,8283,4090,4193,1640,1685
E02005905,Newark and Sherwood 013,Middle Super Output Areas and Intermediate Zones,MSOAIZ,NG,6878,3784,3094,1760,1119
E02005906,Rushcliffe 001,Middle Super Output Areas and Intermediate Zones,MSOAIZ,NG,7035,3849,3186,1626,1181
E02005907,Rushcliffe 002,Middle Super Output Areas and Intermediate Zones,MSOAIZ,NG,9131,4418,4713,1790,1914
E02005908,Rushcliffe 003,Middle Super Output Areas and Intermediate Zones,MSOAIZ,NG,8878,4269,4609,1557,1686
E02005909,Rushcliffe 004,Middle Super Output Areas and Intermediate Zones,MSOAIZ,NG,8192,4120,4072,1844,1853
E02005910,Rushcliffe 005,Middle Super Output Areas and Intermediate Zones,MSOAIZ,NG,8991,4526,4465,2086,1897
E02005911,Rushcliffe 006,Middle Super Output Areas and Intermediate Zones,MSOAIZ,NG,8573,4178,4395,1903,2006
E02005912,Rushcliffe 007,Middle Super Output Areas and Intermediate Zones,MSOAIZ,NG,8846,4283,4563,1772,1867
E02005913,Rushcliffe 008,Middle Super Output Areas and Intermediate Zones,MSOAIZ,NG,6828,3352,3476,1218,1296
E02005914,Rushcliffe 009,Middle Super Output Areas and Intermediate Zones,MSOAIZ,NG,7203,3502,3701,1441,1551
E02005915,Rushcliffe 010,Middle Super Output Areas and Intermediate Zones,MSOAIZ,NG,5705,2843,2862,1049,1084
E02005916,Rushcliffe 011,Middle Super Output Areas and Intermediate Zones,MSOAIZ,NG,7216,3495,3721,1488,1561
E02005917,Rushcliffe 012,Middle Super Output Areas and Intermediate Zones,MSOAIZ,NG,5741,2865,2876,920,950
E02005918,Rushcliffe 013,Middle Super Output Areas and Intermediate Zones,MSOAIZ,NG,5096,2451,2645,847,935
E02005919,Rushcliffe 014,Middle Super Output Areas and Intermediate Zones,MSOAIZ,NG,6379,3029,3350,1085,1179
E02005920,Rushcliffe 015,Middle Super Output Areas and Intermediate Zones,MSOAIZ,NG,7315,3523,3792,1282,1362
E02005921,Cherwell 001,Middle Super Output Areas and Intermediate Zones,MSOAIZ,OX,5334,2631,2703,976,1044
E02005922,Cherwell 002,Middle Super Output Areas and Intermediate Zones,MSOAIZ,OX,8450,4175,4275,2045,2079
E02005923,Cherwell 003,Middle Super Output Areas and Intermediate Zones,MSOAIZ,OX,5868,2851,3017,1245,1289
E02005924,Cherwell 004,Middle Super Output Areas and Intermediate Zones,MSOAIZ,OX,10880,5364,5516,2799,2603
E02005925,Cherwell 005,Middle Super Output Areas and Intermediate Zones,MSOAIZ,OX,8470,4122,4348,1605,1794
E02005926,Cherwell 006,Middle Super Output Areas and Intermediate Zones,MSOAIZ,OX,7776,3656,4120,1387,1478
E02005927,Cherwell 007,Middle Super Output Areas and Intermediate Zones,MSOAIZ,OX,5409,2650,2759,1146,1129
E02005928,Cherwell 008,Middle Super Output Areas and Intermediate Zones,MSOAIZ,OX,7542,3687,3855,1298,1429
E02005929,Cherwell 009,Middle Super Output Areas and Intermediate Zones,MSOAIZ,OX,6852,3362,3490,1196,1350
E02005930,Cherwell 010,Middle Super Output Areas and Intermediate Zones,MSOAIZ,OX,7634,3716,3918,1428,1552
E02005931,Cherwell 011,Middle Super Output Areas and Intermediate Zones,MSOAIZ,OX,9149,4628,4521,2091,2030
E02005932,Cherwell 012,Middle Super Output Areas and Intermediate Zones,MSOAIZ,OX,7014,3444,3570,1764,1870
E02005933,Cherwell 013,Middle Super Output Areas and Intermediate Zones,MSOAIZ,OX,7427,3659,3768,1633,1706
E02005934,Cherwell 014,Middle Super Output Areas and Intermediate Zones,MSOAIZ,OX,9155,4485,4670,1898,1984
E02005935,Cherwell 015,Middle Super Output Areas and Intermediate Zones,MSOAIZ,OX,7258,3579,3679,1840,1796
E02005936,Cherwell 016,Middle Super Output Areas and Intermediate Zones,MSOAIZ,OX,9276,5054,4222,2229,1710
E02005937,Cherwell 017,Middle Super Output Areas and Intermediate Zones,MSOAIZ,OX,6544,3187,3357,1276,1350
E02005938,Cherwell 018,Middle Super Output Areas and Intermediate Zones,MSOAIZ,OX,5598,2720,2878,1066,1162
E02005939,Cherwell 019,Middle Super Output Areas and Intermediate Zones,MSOAIZ,OX,6232,3156,3076,1389,1273
E02005940,Oxford 001,Middle Super Output Areas and Intermediate Zones,MSOAIZ,OX,5866,2809,3057,1150,1209
E02005941,Oxford 002,Middle Super Output Areas and Intermediate Zones,MSOAIZ,OX,7209,3587,3622,1444,1496
E02005942,Oxford 003,Middle Super Output Areas and Intermediate Zones,MSOAIZ,OX,6750,3278,3472,1371,1413
E02005943,Oxford 004,Middle Super Output Areas and Intermediate Zones,MSOAIZ,OX,6259,2977,3282,1289,1372
E02005944,Oxford 005,Middle Super Output Areas and Intermediate Zones,MSOAIZ,OX,7013,3339,3674,1384,1633
E02005945,Oxford 006,Middle Super Output Areas and Intermediate Zones,MSOAIZ,OX,10495,4909,5586,2004,2087
E02005946,Oxford 007,Middle Super Output Areas and Intermediate Zones,MSOAIZ,OX,7990,3849,4141,1788,1816
E02005947,Oxford 008,Middle Super Output Areas and Intermediate Zones,MSOAIZ,OX,16342,9030,7312,2525,1897
E02005948,Oxford 009,Middle Super Output Areas and Intermediate Zones,MSOAIZ,OX,6820,3547,3273,1883,1596
E02005949,Oxford 010,Middle Super Output Areas and Intermediate Zones,MSOAIZ,OX,7303,3473,3830,1355,1378
E02005950,Oxford 011,Middle Super Output Areas and Intermediate Zones,MSOAIZ,OX,11282,5618,5664,2349,2043
E02005951,Oxford 012,Middle Super Output Areas and Intermediate Zones,MSOAIZ,OX,5944,2992,2952,1560,1490
E02005952,Oxford 013,Middle Super Output Areas and Intermediate Zones,MSOAIZ,OX,14349,7190,7159,3598,3347
E02005953,Oxford 014,Middle Super Output Areas and Intermediate Zones,MSOAIZ,OX,5713,2843,2870,1387,1343
E02005954,Oxford 015,Middle Super Output Areas and Intermediate Zones,MSOAIZ,OX,9640,4800,4840,2299,2208
E02005955,Oxford 016,Middle Super Output Areas and Intermediate Zones,MSOAIZ,OX,9863,4874,4989,2289,2303
E02005956,Oxford 017,Middle Super Output Areas and Intermediate Zones,MSOAIZ,OX,6131,2970,3161,1251,1323
E02005957,Oxford 018,Middle Super Output Areas and Intermediate Zones,MSOAIZ,OX,6937,3250,3687,1409,1668
E02005958,South Oxfordshire 001,Middle Super Output Areas and Intermediate Zones,MSOAIZ,OX,5675,2765,2910,1201,1310
E02005959,South Oxfordshire 002,Middle Super Output Areas and Intermediate Zones,MSOAIZ,OX,5556,2765,2791,1035,1090
E02005960,South Oxfordshire 003,Middle Super Output Areas and Intermediate Zones,MSOAIZ,OX,5886,2828,3058,1111,1175
E02005961,South Oxfordshire 004,Middle Super Output Areas and Intermediate Zones,MSOAIZ,OX,6640,3229,3411,1266,1350
E02005962,South Oxfordshire 005,Middle Super Output Areas and Intermediate Zones,MSOAIZ,OX,8294,4054,4240,1580,1656
E02005963,South Oxfordshire 006,Middle Super Output Areas and Intermediate Zones,MSOAIZ,OX,8166,4019,4147,1595,1640
E02005964,South Oxfordshire 007,Middle Super Output Areas and Intermediate Zones,MSOAIZ,OX,7261,3609,3652,1379,1454
E02005965,South Oxfordshire 008,Middle Super Output Areas and Intermediate Zones,MSOAIZ,RG,5451,2598,2853,975,1133
E02005966,South Oxfordshire 009,Middle Super Output Areas and Intermediate Zones,MSOAIZ,OX,8043,3996,4047,2240,2213
E02005967,South Oxfordshire 010,Middle Super Output Areas and Intermediate Zones,MSOAIZ,OX,5731,2819,2912,1190,1188
E02005968,South Oxfordshire 011,Middle Super Output Areas and Intermediate Zones,MSOAIZ,RG,7670,4161,3509,2068,1517
E02005969,South Oxfordshire 012,Middle Super Output Areas and Intermediate Zones,MSOAIZ,OX,9141,4367,4774,1799,1893
E02005970,South Oxfordshire 013,Middle Super Output Areas and Intermediate Zones,MSOAIZ,OX,5635,2878,2757,1442,1308
E02005971,South Oxfordshire 014,Middle Super Output Areas and Intermediate Zones,MSOAIZ,OX,5731,2788,2943,1133,1192
E02005972,South Oxfordshire 015,Middle Super Output Areas and Intermediate Zones,MSOAIZ,RG,7982,3942,4040,1481,1601
E02005973,South Oxfordshire 016,Middle Super Output Areas and Intermediate Zones,MSOAIZ,RG,5550,2531,3019,1019,1103
E02005974,South Oxfordshire 017,Middle Super Output Areas and Intermediate Zones,MSOAIZ,RG,6069,2883,3186,1187,1341
E02005975,South Oxfordshire 018,Middle Super Output Areas and Intermediate Zones,MSOAIZ,RG,7910,3930,3980,1281,1433
E02005976,South Oxfordshire 019,Middle Super Output Areas and Intermediate Zones,MSOAIZ,RG,6130,3066,3064,997,1141
E02005977,South Oxfordshire 020,Middle Super Output Areas and Intermediate Zones,MSOAIZ,RG,5736,2777,2959,1039,1095
E02005978,Vale of White Horse 001,Middle Super Output Areas and Intermediate Zones,MSOAIZ,OX,6670,3245,3425,1250,1273
E02005979,Vale of White Horse 002,Middle Super Output Areas and Intermediate Zones,MSOAIZ,OX,9140,4512,4628,1823,1783
E02005980,Vale of White Horse 003,Middle Super Output Areas and Intermediate Zones,MSOAIZ,OX,11518,6334,5184,2163,2017
E02005981,Vale of White Horse 004,Middle Super Output Areas and Intermediate Zones,MSOAIZ,OX,8985,4466,4519,1940,2010
E02005982,Vale of White Horse 005,Middle Super Output Areas and Intermediate Zones,MSOAIZ,OX,5849,2925,2924,1269,1248
E02005983,Vale of White Horse 006,Middle Super Output Areas and Intermediate Zones,MSOAIZ,OX,10740,5154,5586,2382,2456
E02005984,Vale of White Horse 007,Middle Super Output Areas and Intermediate Zones,MSOAIZ,SN,6881,3398,3483,1264,1401
E02005985,Vale of White Horse 008,Middle Super Output Areas and Intermediate Zones,MSOAIZ,OX,7556,3643,3913,1482,1557
E02005986,Vale of White Horse 009,Middle Super Output Areas and Intermediate Zones,MSOAIZ,SN,8991,4417,4574,1827,1931
E02005987,Vale of White Horse 010,Middle Super Output Areas and Intermediate Zones,MSOAIZ,OX,7640,3719,3921,1469,1567
E02005988,Vale of White Horse 011,Middle Super Output Areas and Intermediate Zones,MSOAIZ,OX,7178,3642,3536,1474,1472
E02005991,Vale of White Horse 014,Middle Super Output Areas and Intermediate Zones,MSOAIZ,OX,9803,4783,5020,1960,1932
E02005992,Vale of White Horse 015,Middle Super Output Areas and Intermediate Zones,MSOAIZ,OX,9014,4321,4693,1664,1804
E02005993,West Oxfordshire 001,Middle Super Output Areas and Intermediate Zones,MSOAIZ,OX,6337,3056,3281,1201,1332
E02005994,West Oxfordshire 002,Middle Super Output Areas and Intermediate Zones,MSOAIZ,OX,6078,2945,3133,1099,1191
E02005995,West Oxfordshire 003,Middle Super Output Areas and Intermediate Zones,MSOAIZ,OX,5907,2850,3057,1022,1116
E02005996,West Oxfordshire 004,Middle Super Output Areas and Intermediate Zones,MSOAIZ,OX,8027,3826,4201,1472,1601
E02005997,West Oxfordshire 005,Middle Super Output Areas and Intermediate Zones,MSOAIZ,OX,5555,2713,2842,961,1044
E02005998,West Oxfordshire 006,Middle Super Output Areas and Intermediate Zones,MSOAIZ,OX,5816,2815,3001,1046,1098
E02005999,West Oxfordshire 007,Middle Super Output Areas and Intermediate Zones,MSOAIZ,OX,6169,3047,3122,1157,1197
E02006000,West Oxfordshire 008,Middle Super Output Areas and Intermediate Zones,MSOAIZ,OX,11829,5707,6122,2595,2752
E02006001,West Oxfordshire 009,Middle Super Output Areas and Intermediate Zones,MSOAIZ,OX,5613,2769,2844,1272,1316
E02006002,West Oxfordshire 010,Middle Super Output Areas and Intermediate Zones,MSOAIZ,OX,10080,4864,5216,2089,2089
E02006003,West Oxfordshire 011,Middle Super Output Areas and Intermediate Zones,MSOAIZ,OX,5416,2650,2766,990,1032
E02006004,West Oxfordshire 012,Middle Super Output Areas and Intermediate Zones,MSOAIZ,OX,5574,2746,2828,1027,1066
E02006005,West Oxfordshire 013,Middle Super Output Areas and Intermediate Zones,MSOAIZ,OX,9100,4463,4637,2317,2378
E02006006,West Oxfordshire 014,Middle Super Output Areas and Intermediate Zones,MSOAIZ,OX,6669,3728,2941,1617,1262
E02006007,West Oxfordshire 015,Middle Super Output Areas and Intermediate Zones,MSOAIZ,OX,6609,3268,3341,1226,1299
E02006008,Shropshire 025,Middle Super Output Areas and Intermediate Zones,MSOAIZ,TF,7498,3711,3787,1484,1450
E02006009,Shropshire 027,Middle Super Output Areas and Intermediate Zones,MSOAIZ,WV,7124,3783,3341,1405,1223
E02006010,Shropshire 029,Middle Super Output Areas and Intermediate Zones,MSOAIZ,WV,11150,5435,5715,2078,2136
E02006011,Shropshire 031,Middle Super Output Areas and Intermediate Zones,MSOAIZ,WV,5941,2921,3020,1122,1083
E02006012,Shropshire 033,Middle Super Output Areas and Intermediate Zones,MSOAIZ,WV,6138,3006,3132,1210,1178
E02006013,Shropshire 034,Middle Super Output Areas and Intermediate Zones,MSOAIZ,WV,7743,3845,3898,1366,1388
E02006014,Shropshire 035,Middle Super Output Areas and Intermediate Zones,MSOAIZ,WV,9211,4618,4593,1623,1606
E02006015,Shropshire 001,Middle Super Output Areas and Intermediate Zones,MSOAIZ,SY,9871,4870,5001,1996,1918
E02006016,Shropshire 002,Middle Super Output Areas and Intermediate Zones,MSOAIZ,TF,7503,3735,3768,1346,1391
E02006017,Shropshire 004,Middle Super Output Areas and Intermediate Zones,MSOAIZ,SY,7463,3693,3770,1357,1336
E02006018,Shropshire 005,Middle Super Output Areas and Intermediate Zones,MSOAIZ,TF,11773,5750,6023,2341,2230
E02006019,Shropshire 008,Middle Super Output Areas and Intermediate Zones,MSOAIZ,SY,5870,2805,3065,1084,1055
E02006020,Shropshire 009,Middle Super Output Areas and Intermediate Zones,MSOAIZ,TF,7108,3922,3186,1354,1283
E02006021,Shropshire 010,Middle Super Output Areas and Intermediate Zones,MSOAIZ,SY,7942,3954,3988,1508,1518
E02006022,Shropshire 013,Middle Super Output Areas and Intermediate Zones,MSOAIZ,TF,5973,3068,2905,1217,1169
E02006023,Shropshire 003,Middle Super Output Areas and Intermediate Zones,MSOAIZ,SY,9722,4702,5020,1735,1813
E02006024,Shropshire 006,Middle Super Output Areas and Intermediate Zones,MSOAIZ,SY,9575,4549,5026,1920,2003
E02006025,Shropshire 007,Middle Super Output Areas and Intermediate Zones,MSOAIZ,SY,9168,4548,4620,1904,1767
E02006026,Shropshire 011,Middle Super Output Areas and Intermediate Zones,MSOAIZ,SY,6992,3462,3530,1318,1318
E02006027,Shropshire 012,Middle Super Output Areas and Intermediate Zones,MSOAIZ,SY,5308,2642,2666,945,922
E02006028,Shropshire 014,Middle Super Output Areas and Intermediate Zones,MSOAIZ,SY,9174,4467,4707,1695,1724
E02006029,Shropshire 015,Middle Super Output Areas and Intermediate Zones,MSOAIZ,SY,8240,4028,4212,1591,1602
E02006030,Shropshire 016,Middle Super Output Areas and Intermediate Zones,MSOAIZ,SY,7142,3551,3591,1480,1552
E02006031,Shropshire 017,Middle Super Output Areas and Intermediate Zones,MSOAIZ,SY,7381,3615,3766,1769,1663
E02006032,Shropshire 018,Middle Super Output Areas and Intermediate Zones,MSOAIZ,SY,9022,4358,4664,1772,1839
E02006033,Shropshire 019,Middle Super Output Areas and Intermediate Zones,MSOAIZ,SY,8036,4219,3817,2063,1511
E02006034,Shropshire 020,Middle Super Output Areas and Intermediate Zones,MSOAIZ,SY,8520,4138,4382,1708,1735
E02006035,Shropshire 021,Middle Super Output Areas and Intermediate Zones,MSOAIZ,SY,5710,2776,2934,955,960
E02006036,Shropshire 022,Middle Super Output Areas and Intermediate Zones,MSOAIZ,SY,6107,2971,3136,1331,1243
E02006037,Shropshire 023,Middle Super Output Areas and Intermediate Zones,MSOAIZ,SY,10093,5056,5037,1803,1850
E02006038,Shropshire 024,Middle Super Output Areas and Intermediate Zones,MSOAIZ,TF,7612,3771,3841,1416,1440
E02006039,Shropshire 026,Middle Super Output Areas and Intermediate Zones,MSOAIZ,SY,7839,3897,3942,1406,1376
E02006040,Shropshire 028,Middle Super Output Areas and Intermediate Zones,MSOAIZ,TF,7506,3700,3806,1272,1373
E02006041,Shropshire 030,Middle Super Output Areas and Intermediate Zones,MSOAIZ,WV,5872,2954,2918,1100,1029
E02006042,Shropshire 032,Middle Super Output Areas and Intermediate Zones,MSOAIZ,TF,5878,2818,3060,876,897
E02006043,Shropshire 036,Middle Super Output Areas and Intermediate Zones,MSOAIZ,WV,6876,3444,3432,1251,1221
E02006044,Shropshire 037,Middle Super Output Areas and Intermediate Zones,MSOAIZ,SY,6242,3122,3120,990,999
E02006045,Shropshire 038,Middle Super Output Areas and Intermediate Zones,MSOAIZ,SY,10939,5290,5649,1918,1925
E02006046,Shropshire 039,Middle Super Output Areas and Intermediate Zones,MSOAIZ,WR,8867,4412,4455,1544,1576
E02006047,Mendip 001,Middle Super Output Areas and Intermediate Zones,MSOAIZ,BA,8183,4081,4102,1503,1562
E02006048,Mendip 002,Middle Super Output Areas and Intermediate Zones,MSOAIZ,BA,6971,3509,3462,1202,1248
E02006049,Mendip 003,Middle Super Output Areas and Intermediate Zones,MSOAIZ,BA,7418,3603,3815,1326,1442
E02006050,Mendip 004,Middle Super Output Areas and Intermediate Zones,MSOAIZ,BA,8265,4005,4260,1628,1756
E02006051,Mendip 005,Middle Super Output Areas and Intermediate Zones,MSOAIZ,BS,7665,3697,3968,1190,1331
E02006052,Mendip 006,Middle Super Output Areas and Intermediate Zones,MSOAIZ,BS,7792,3887,3905,1533,1476
E02006053,Mendip 007,Middle Super Output Areas and Intermediate Zones,MSOAIZ,BA,9187,4469,4718,1806,1928
E02006054,Mendip 008,Middle Super Output Areas and Intermediate Zones,MSOAIZ,BA,7666,3550,4116,1319,1379
E02006055,Mendip 009,Middle Super Output Areas and Intermediate Zones,MSOAIZ,BA,8781,4343,4438,1859,1884
E02006056,Mendip 010,Middle Super Output Areas and Intermediate Zones,MSOAIZ,BA,7358,3597,3761,1314,1427
E02006057,Mendip 011,Middle Super Output Areas and Intermediate Zones,MSOAIZ,BA,7434,3602,3832,1345,1433
E02006058,Mendip 012,Middle Super Output Areas and Intermediate Zones,MSOAIZ,BS,8456,4225,4231,1406,1505
E02006059,Mendip 013,Middle Super Output Areas and Intermediate Zones,MSOAIZ,TA,6479,3193,3286,1119,1173
E02006060,Mendip 014,Middle Super Output Areas and Intermediate Zones,MSOAIZ,BA,7624,3626,3998,1409,1550
E02006061,Sedgemoor 001,Middle Super Output Areas and Intermediate Zones,MSOAIZ,BS,8899,4281,4618,1586,1699
E02006062,Sedgemoor 002,Middle Super Output Areas and Intermediate Zones,MSOAIZ,TA,10644,5172,5472,1767,1857
E02006063,Sedgemoor 003,Middle Super Output Areas and Intermediate Zones,MSOAIZ,TA,7000,3482,3518,1132,1249
E02006064,Sedgemoor 004,Middle Super Output Areas and Intermediate Zones,MSOAIZ,TA,7807,3658,4149,1298,1277
E02006065,Sedgemoor 005,Middle Super Output Areas and Intermediate Zones,MSOAIZ,TA,8463,4136,4327,1564,1577
E02006066,Sedgemoor 006,Middle Super Output Areas and Intermediate Zones,MSOAIZ,TA,7681,3725,3956,1291,1392
E02006067,Sedgemoor 007,Middle Super Output Areas and Intermediate Zones,MSOAIZ,TA,6991,3420,3571,1134,1231
E02006068,Sedgemoor 008,Middle Super Output Areas and Intermediate Zones,MSOAIZ,TA,7579,3761,3818,1449,1502
E02006069,Sedgemoor 009,Middle Super Output Areas and Intermediate Zones,MSOAIZ,TA,9745,4888,4857,2258,2034
E02006070,Sedgemoor 010,Middle Super Output Areas and Intermediate Zones,MSOAIZ,TA,6772,3317,3455,1386,1436
E02006071,Sedgemoor 011,Middle Super Output Areas and Intermediate Zones,MSOAIZ,TA,8473,4108,4365,1628,1677
E02006072,Sedgemoor 012,Middle Super Output Areas and Intermediate Zones,MSOAIZ,TA,9147,4522,4625,1501,1650
E02006073,Sedgemoor 013,Middle Super Output Areas and Intermediate Zones,MSOAIZ,TA,7029,3471,3558,1346,1366
E02006074,Sedgemoor 014,Middle Super Output Areas and Intermediate Zones,MSOAIZ,TA,8358,4107,4251,1617,1700
E02006075,South Somerset 001,Middle Super Output Areas and Intermediate Zones,MSOAIZ,BA,5349,2585,2764,824,925
E02006076,South Somerset 002,Middle Super Output Areas and Intermediate Zones,MSOAIZ,TA,8507,4100,4407,1387,1523
E02006077,South Somerset 003,Middle Super Output Areas and Intermediate Zones,MSOAIZ,TA,5402,2556,2846,855,941
E02006078,South Somerset 004,Middle Super Output Areas and Intermediate Zones,MSOAIZ,TA,5702,2761,2941,946,982
E02006079,South Somerset 005,Middle Super Output Areas and Intermediate Zones,MSOAIZ,DT,7057,3445,3612,1252,1264
E02006080,South Somerset 006,Middle Super Output Areas and Intermediate Zones,MSOAIZ,DT,7061,3906,3155,1483,1169
E02006081,South Somerset 007,Middle Super Output Areas and Intermediate Zones,MSOAIZ,TA,5299,2558,2741,866,902
E02006082,South Somerset 008,Middle Super Output Areas and Intermediate Zones,MSOAIZ,DT,6467,3171,3296,1155,1177
E02006083,South Somerset 009,Middle Super Output Areas and Intermediate Zones,MSOAIZ,TA,5724,2784,2940,1037,1093
E02006084,South Somerset 010,Middle Super Output Areas and Intermediate Zones,MSOAIZ,TA,7077,3382,3695,1177,1260
E02006085,South Somerset 011,Middle Super Output Areas and Intermediate Zones,MSOAIZ,BA,5875,2859,3016,1077,1142
E02006086,South Somerset 012,Middle Super Output Areas and Intermediate Zones,MSOAIZ,BA,6917,3464,3453,1358,1371
E02006087,South Somerset 013,Middle Super Output Areas and Intermediate Zones,MSOAIZ,BA,6137,2967,3170,1301,1326
E02006088,South Somerset 014,Middle Super Output Areas and Intermediate Zones,MSOAIZ,BA,7357,3622,3735,1427,1443
E02006089,South Somerset 015,Middle Super Output Areas and Intermediate Zones,MSOAIZ,BA,6392,3234,3158,1517,1329
E02006090,South Somerset 016,Middle Super Output Areas and Intermediate Zones,MSOAIZ,BA,7021,3355,3666,1424,1434
E02006091,South Somerset 017,Middle Super Output Areas and Intermediate Zones,MSOAIZ,TA,9775,4804,4971,1627,1738
E02006092,South Somerset 018,Middle Super Output Areas and Intermediate Zones,MSOAIZ,BA,6182,3072,3110,1258,1182
E02006093,South Somerset 019,Middle Super Output Areas and Intermediate Zones,MSOAIZ,TA,8445,4077,4368,1455,1482
E02006094,South Somerset 020,Middle Super Output Areas and Intermediate Zones,MSOAIZ,TA,5310,2613,2697,911,943
E02006095,South Somerset 021,Middle Super Output Areas and Intermediate Zones,MSOAIZ,TA,7826,3748,4078,1420,1386
E02006096,South Somerset 022,Middle Super Output Areas and Intermediate Zones,MSOAIZ,TA,6704,3289,3415,1275,1281
E02006097,South Somerset 023,Middle Super Output Areas and Intermediate Zones,MSOAIZ,TA,6370,3170,3200,1201,1095
E02006098,South Somerset 024,Middle Super Output Areas and Intermediate Zones,MSOAIZ,TA,7287,3584,3703,1149,1216
E02006099,Taunton Deane 001,Middle Super Output Areas and Intermediate Zones,MSOAIZ,TA,6829,3276,3553,1236,1421
E02006100,Taunton Deane 002,Middle Super Output Areas and Intermediate Zones,MSOAIZ,TA,7468,3673,3795,1366,1451
E02006101,Taunton Deane 003,Middle Super Output Areas and Intermediate Zones,MSOAIZ,TA,5602,2709,2893,932,1037
E02006102,Taunton Deane 004,Middle Super Output Areas and Intermediate Zones,MSOAIZ,TA,7141,3370,3771,1278,1386
E02006103,Taunton Deane 005,Middle Super Output Areas and Intermediate Zones,MSOAIZ,TA,7234,3491,3743,1154,1268
E02006104,Taunton Deane 006,Middle Super Output Areas and Intermediate Zones,MSOAIZ,TA,7544,3613,3931,1559,1630
E02006105,Taunton Deane 007,Middle Super Output Areas and Intermediate Zones,MSOAIZ,TA,10305,5015,5290,2483,2337
E02006106,Taunton Deane 008,Middle Super Output Areas and Intermediate Zones,MSOAIZ,TA,7704,3943,3761,1582,1486
E02006107,Taunton Deane 009,Middle Super Output Areas and Intermediate Zones,MSOAIZ,TA,8164,3833,4331,1488,1724
E02006108,Taunton Deane 010,Middle Super Output Areas and Intermediate Zones,MSOAIZ,TA,8561,4161,4400,1541,1508
E02006109,Taunton Deane 011,Middle Super Output Areas and Intermediate Zones,MSOAIZ,TA,7855,3744,4111,1259,1378
E02006110,Taunton Deane 012,Middle Super Output Areas and Intermediate Zones,MSOAIZ,TA,7892,3798,4094,1478,1619
E02006111,Taunton Deane 013,Middle Super Output Areas and Intermediate Zones,MSOAIZ,TA,10451,5068,5383,1703,1847
E02006112,Taunton Deane 014,Middle Super Output Areas and Intermediate Zones,MSOAIZ,TA,7437,3586,3851,1261,1398
E02006113,West Somerset 001,Middle Super Output Areas and Intermediate Zones,MSOAIZ,TA,7327,3413,3914,1162,1193
E02006114,West Somerset 002,Middle Super Output Areas and Intermediate Zones,MSOAIZ,TA,6728,3204,3524,1038,1018
E02006115,West Somerset 003,Middle Super Output Areas and Intermediate Zones,MSOAIZ,TA,7218,3464,3754,1106,1221
E02006116,West Somerset 004,Middle Super Output Areas and Intermediate Zones,MSOAIZ,TA,7856,3857,3999,1182,1301
E02006117,West Somerset 005,Middle Super Output Areas and Intermediate Zones,MSOAIZ,TA,5546,2637,2909,787,912
E02006118,Cannock Chase 001,Middle Super Output Areas and Intermediate Zones,MSOAIZ,WS,7404,3691,3713,1425,1424
E02006119,Cannock Chase 002,Middle Super Output Areas and Intermediate Zones,MSOAIZ,WS,8269,4079,4190,1709,1690
E02006120,Cannock Chase 003,Middle Super Output Areas and Intermediate Zones,MSOAIZ,WS,8887,4322,4565,1749,1841
E02006121,Cannock Chase 004,Middle Super Output Areas and Intermediate Zones,MSOAIZ,WS,5548,2781,2767,1164,1214
E02006122,Cannock Chase 005,Middle Super Output Areas and Intermediate Zones,MSOAIZ,WS,6495,3271,3224,1418,1378
E02006123,Cannock Chase 006,Middle Super Output Areas and Intermediate Zones,MSOAIZ,WS,6744,3364,3380,1484,1487
E02006124,Cannock Chase 007,Middle Super Output Areas and Intermediate Zones,MSOAIZ,WS,7286,3590,3696,1428,1466
E02006125,Cannock Chase 008,Middle Super Output Areas and Intermediate Zones,MSOAIZ,WS,7331,3645,3686,1524,1463
E02006126,Cannock Chase 009,Middle Super Output Areas and Intermediate Zones,MSOAIZ,WS,8319,4139,4180,1800,1757
E02006127,Cannock Chase 010,Middle Super Output Areas and Intermediate Zones,MSOAIZ,WS,7628,3737,3891,1886,1987
E02006128,Cannock Chase 011,Middle Super Output Areas and Intermediate Zones,MSOAIZ,WS,8399,4052,4347,1560,1555
E02006129,Cannock Chase 012,Middle Super Output Areas and Intermediate Zones,MSOAIZ,WS,7673,3759,3914,1610,1586
E02006130,Cannock Chase 013,Middle Super Output Areas and Intermediate Zones,MSOAIZ,WS,7479,3696,3783,1469,1565
E02006131,East Staffordshire 001,Middle Super Output Areas and Intermediate Zones,MSOAIZ,ST,7837,3910,3927,1482,1530
E02006132,East Staffordshire 002,Middle Super Output Areas and Intermediate Zones,MSOAIZ,ST,6198,3039,3159,1228,1269
E02006133,East Staffordshire 003,Middle Super Output Areas and Intermediate Zones,MSOAIZ,ST,6891,3422,3469,1499,1436
E02006134,East Staffordshire 004,Middle Super Output Areas and Intermediate Zones,MSOAIZ,DE,9164,4489,4675,1666,1758
E02006135,East Staffordshire 005,Middle Super Output Areas and Intermediate Zones,MSOAIZ,DE,7849,3796,4053,1511,1626
E02006136,East Staffordshire 006,Middle Super Output Areas and Intermediate Zones,MSOAIZ,WS,8648,4629,4019,1993,1462
E02006137,East Staffordshire 007,Middle Super Output Areas and Intermediate Zones,MSOAIZ,DE,8751,4206,4545,1738,1850
E02006138,East Staffordshire 008,Middle Super Output Areas and Intermediate Zones,MSOAIZ,DE,6202,3069,3133,1355,1363
E02006139,East Staffordshire 009,Middle Super Output Areas and Intermediate Zones,MSOAIZ,DE,7061,3509,3552,1572,1468
E02006140,East Staffordshire 010,Middle Super Output Areas and Intermediate Zones,MSOAIZ,DE,8466,4127,4339,1621,1682
E02006141,East Staffordshire 011,Middle Super Output Areas and Intermediate Zones,MSOAIZ,DE,10330,5383,4947,2645,2207
E02006142,East Staffordshire 012,Middle Super Output Areas and Intermediate Zones,MSOAIZ,DE,5385,2629,2756,1098,1160
E02006143,East Staffordshire 013,Middle Super Output Areas and Intermediate Zones,MSOAIZ,DE,7231,3578,3653,1593,1619
E02006144,East Staffordshire 014,Middle Super Output Areas and Intermediate Zones,MSOAIZ,DE,7977,3895,4082,1607,1577
E02006145,East Staffordshire 015,Middle Super Output Areas and Intermediate Zones,MSOAIZ,DE,5593,2704,2889,984,1070
E02006146,Lichfield 001,Middle Super Output Areas and Intermediate Zones,MSOAIZ,WS,7134,3525,3609,1411,1409
E02006147,Lichfield 002,Middle Super Output Areas and Intermediate Zones,MSOAIZ,WS,7626,3720,3906,1458,1551
E02006148,Lichfield 003,Middle Super Output Areas and Intermediate Zones,MSOAIZ,WS,7245,3631,3614,1339,1380
E02006149,Lichfield 004,Middle Super Output Areas and Intermediate Zones,MSOAIZ,WS,10486,5100,5386,2114,2167
E02006150,Lichfield 005,Middle Super Output Areas and Intermediate Zones,MSOAIZ,WS,11610,5782,5828,2199,2228
E02006151,Lichfield 006,Middle Super Output Areas and Intermediate Zones,MSOAIZ,WS,8792,4309,4483,1764,1808
E02006152,Lichfield 007,Middle Super Output Areas and Intermediate Zones,MSOAIZ,WS,10123,4910,5213,2109,2177
E02006153,Lichfield 008,Middle Super Output Areas and Intermediate Zones,MSOAIZ,WS,7050,3504,3546,1306,1383
E02006154,Lichfield 009,Middle Super Output Areas and Intermediate Zones,MSOAIZ,WS,9886,4934,4952,1817,1714
E02006155,Lichfield 010,Middle Super Output Areas and Intermediate Zones,MSOAIZ,WS,5767,2858,2909,1199,1214
E02006156,Lichfield 011,Middle Super Output Areas and Intermediate Zones,MSOAIZ,WS,7792,3769,4023,1277,1351
E02006157,Lichfield 012,Middle Super Output Areas and Intermediate Zones,MSOAIZ,WS,7143,3878,3265,1246,1256
E02006158,Newcastle-under-Lyme 001,Middle Super Output Areas and Intermediate Zones,MSOAIZ,ST,8486,4240,4246,1736,1771
E02006159,Newcastle-under-Lyme 002,Middle Super Output Areas and Intermediate Zones,MSOAIZ,ST,5754,2857,2897,1127,1150
E02006160,Newcastle-under-Lyme 003,Middle Super Output Areas and Intermediate Zones,MSOAIZ,ST,8356,4119,4237,1559,1586
E02006161,Newcastle-under-Lyme 004,Middle Super Output Areas and Intermediate Zones,MSOAIZ,ST,7032,3544,3488,1529,1450
E02006162,Newcastle-under-Lyme 005,Middle Super Output Areas and Intermediate Zones,MSOAIZ,ST,8437,4187,4250,1669,1674
E02006163,Newcastle-under-Lyme 006,Middle Super Output Areas and Intermediate Zones,MSOAIZ,ST,8032,3962,4070,1567,1592
E02006164,Newcastle-under-Lyme 007,Middle Super Output Areas and Intermediate Zones,MSOAIZ,ST,7421,3634,3787,1501,1545
E02006165,Newcastle-under-Lyme 008,Middle Super Output Areas and Intermediate Zones,MSOAIZ,ST,7384,3657,3727,1642,1594
E02006166,Newcastle-under-Lyme 009,Middle Super Output Areas and Intermediate Zones,MSOAIZ,ST,7193,3563,3630,1523,1457
E02006167,Newcastle-under-Lyme 010,Middle Super Output Areas and Intermediate Zones,MSOAIZ,ST,8722,4242,4480,1641,1756
E02006168,Newcastle-under-Lyme 011,Middle Super Output Areas and Intermediate Zones,MSOAIZ,ST,8446,4291,4155,1865,1482
E02006169,Newcastle-under-Lyme 012,Middle Super Output Areas and Intermediate Zones,MSOAIZ,ST,8077,4013,4064,1025,977
E02006170,Newcastle-under-Lyme 013,Middle Super Output Areas and Intermediate Zones,MSOAIZ,ST,5145,2483,2662,932,986
E02006171,Newcastle-under-Lyme 014,Middle Super Output Areas and Intermediate Zones,MSOAIZ,ST,8914,4344,4570,1647,1695
E02006172,Newcastle-under-Lyme 015,Middle Super Output Areas and Intermediate Zones,MSOAIZ,ST,9524,4593,4931,1707,1766
E02006173,Newcastle-under-Lyme 016,Middle Super Output Areas and Intermediate Zones,MSOAIZ,TF,6948,3477,3471,1192,1238
E02006174,South Staffordshire 001,Middle Super Output Areas and Intermediate Zones,MSOAIZ,WV,10349,5105,5244,1866,1963
E02006175,South Staffordshire 002,Middle Super Output Areas and Intermediate Zones,MSOAIZ,WV,6616,3266,3350,1423,1453
E02006176,South Staffordshire 003,Middle Super Output Areas and Intermediate Zones,MSOAIZ,WV,7342,3560,3782,1275,1344
E02006177,South Staffordshire 004,Middle Super Output Areas and Intermediate Zones,MSOAIZ,WS,9837,4893,4944,1854,1896
E02006178,South Staffordshire 005,Middle Super Output Areas and Intermediate Zones,MSOAIZ,WS,7866,3856,4010,1487,1535
E02006179,South Staffordshire 006,Middle Super Output Areas and Intermediate Zones,MSOAIZ,WV,7356,4054,3302,1653,1334
E02006180,South Staffordshire 007,Middle Super Output Areas and Intermediate Zones,MSOAIZ,WV,6700,3245,3455,1265,1348
E02006181,South Staffordshire 008,Middle Super Output Areas and Intermediate Zones,MSOAIZ,WV,5745,2711,3034,1028,1118
E02006182,South Staffordshire 009,Middle Super Output Areas and Intermediate Zones,MSOAIZ,WV,6750,3253,3497,1178,1249
E02006183,South Staffordshire 010,Middle Super Output Areas and Intermediate Zones,MSOAIZ,WV,7502,3692,3810,1466,1535
E02006184,South Staffordshire 011,Middle Super Output Areas and Intermediate Zones,MSOAIZ,WV,5430,2636,2794,1068,1185
E02006185,South Staffordshire 012,Middle Super Output Areas and Intermediate Zones,MSOAIZ,WV,7196,3459,3737,1261,1358
E02006186,South Staffordshire 013,Middle Super Output Areas and Intermediate Zones,MSOAIZ,WV,12217,6047,6170,2258,2250
E02006187,South Staffordshire 014,Middle Super Output Areas and Intermediate Zones,MSOAIZ,DY,7225,3466,3759,1201,1276
E02006188,Stafford 001,Middle Super Output Areas and Intermediate Zones,MSOAIZ,ST,5931,2911,3020,1011,1081
E02006189,Stafford 002,Middle Super Output Areas and Intermediate Zones,MSOAIZ,ST,7170,3478,3692,1256,1303
E02006190,Stafford 003,Middle Super Output Areas and Intermediate Zones,MSOAIZ,ST,10334,5039,5295,2150,2047
E02006191,Stafford 004,Middle Super Output Areas and Intermediate Zones,MSOAIZ,ST,8005,3921,4084,1522,1636
E02006192,Stafford 005,Middle Super Output Areas and Intermediate Zones,MSOAIZ,TF,8110,3917,4193,1451,1646
E02006193,Stafford 006,Middle Super Output Areas and Intermediate Zones,MSOAIZ,ST,6471,3223,3248,1217,1243
E02006194,Stafford 007,Middle Super Output Areas and Intermediate Zones,MSOAIZ,ST,7659,3686,3973,1447,1625
E02006195,Stafford 008,Middle Super Output Areas and Intermediate Zones,MSOAIZ,WS,8315,4071,4244,1471,1621
E02006196,Stafford 009,Middle Super Output Areas and Intermediate Zones,MSOAIZ,ST,7187,4279,2908,1897,1258
E02006197,Stafford 010,Middle Super Output Areas and Intermediate Zones,MSOAIZ,ST,8235,4410,3825,2237,1765
E02006198,Stafford 011,Middle Super Output Areas and Intermediate Zones,MSOAIZ,ST,8477,4512,3965,1694,1576
E02006199,Stafford 012,Middle Super Output Areas and Intermediate Zones,MSOAIZ,ST,8209,4061,4148,1650,1613
E02006200,Stafford 013,Middle Super Output Areas and Intermediate Zones,MSOAIZ,ST,7983,3844,4139,1591,1624
E02006201,Stafford 014,Middle Super Output Areas and Intermediate Zones,MSOAIZ,WS,12199,5963,6236,2085,2214
E02006202,Stafford 015,Middle Super Output Areas and Intermediate Zones,MSOAIZ,TF,8670,4332,4338,1604,1633
E02006203,Stafford 016,Middle Super Output Areas and Intermediate Zones,MSOAIZ,ST,7914,3907,4007,1695,1645
E02006204,Staffordshire Moorlands 001,Middle Super Output Areas and Intermediate Zones,MSOAIZ,ST,7318,3559,3759,1316,1431
E02006205,Staffordshire Moorlands 002,Middle Super Output Areas and Intermediate Zones,MSOAIZ,ST,7038,3557,3481,1301,1271
E02006206,Staffordshire Moorlands 003,Middle Super Output Areas and Intermediate Zones,MSOAIZ,ST,8358,3988,4370,1695,1805
E02006207,Staffordshire Moorlands 004,Middle Super Output Areas and Intermediate Zones,MSOAIZ,ST,6305,3077,3228,1077,1054
E02006208,Staffordshire Moorlands 005,Middle Super Output Areas and Intermediate Zones,MSOAIZ,ST,8157,4009,4148,1821,1726
E02006209,Staffordshire Moorlands 006,Middle Super Output Areas and Intermediate Zones,MSOAIZ,ST,10869,5292,5577,2059,2085
E02006210,Staffordshire Moorlands 007,Middle Super Output Areas and Intermediate Zones,MSOAIZ,ST,5486,2771,2715,1013,1052
E02006211,Staffordshire Moorlands 008,Middle Super Output Areas and Intermediate Zones,MSOAIZ,ST,6472,3166,3306,1049,1123
E02006212,Staffordshire Moorlands 009,Middle Super Output Areas and Intermediate Zones,MSOAIZ,ST,7875,3865,4010,1404,1448
E02006213,Staffordshire Moorlands 010,Middle Super Output Areas and Intermediate Zones,MSOAIZ,ST,6555,3279,3276,1284,1249
E02006214,Staffordshire Moorlands 011,Middle Super Output Areas and Intermediate Zones,MSOAIZ,ST,6119,3004,3115,1174,1172
E02006215,Staffordshire Moorlands 012,Middle Super Output Areas and Intermediate Zones,MSOAIZ,ST,7844,3889,3955,1443,1488
E02006216,Staffordshire Moorlands 013,Middle Super Output Areas and Intermediate Zones,MSOAIZ,ST,8710,4334,4376,1720,1708
E02006217,Tamworth 001,Middle Super Output Areas and Intermediate Zones,MSOAIZ,B,8817,4235,4582,1520,1608
E02006218,Tamworth 002,Middle Super Output Areas and Intermediate Zones,MSOAIZ,B,7851,3801,4050,1612,1541
E02006219,Tamworth 003,Middle Super Output Areas and Intermediate Zones,MSOAIZ,B,7887,3907,3980,1618,1703
E02006220,Tamworth 004,Middle Super Output Areas and Intermediate Zones,MSOAIZ,B,7398,3614,3784,1405,1453
E02006221,Tamworth 005,Middle Super Output Areas and Intermediate Zones,MSOAIZ,B,6087,3084,3003,1472,1428
E02006222,Tamworth 006,Middle Super Output Areas and Intermediate Zones,MSOAIZ,B,6859,3352,3507,1341,1389
E02006223,Tamworth 007,Middle Super Output Areas and Intermediate Zones,MSOAIZ,B,7170,3454,3716,1336,1487
E02006224,Tamworth 008,Middle Super Output Areas and Intermediate Zones,MSOAIZ,B,7692,3787,3905,1720,1842
E02006225,Tamworth 009,Middle Super Output Areas and Intermediate Zones,MSOAIZ,B,7375,3665,3710,1512,1568
E02006226,Tamworth 010,Middle Super Output Areas and Intermediate Zones,MSOAIZ,B,9677,4795,4882,2109,2240
E02006227,Babergh 001,Middle Super Output Areas and Intermediate Zones,MSOAIZ,IP,6065,3002,3063,968,1003
E02006228,Babergh 002,Middle Super Output Areas and Intermediate Zones,MSOAIZ,IP,5758,2879,2879,1078,1095
E02006229,Babergh 003,Middle Super Output Areas and Intermediate Zones,MSOAIZ,CO,5667,2764,2903,1020,988
E02006230,Babergh 004,Middle Super Output Areas and Intermediate Zones,MSOAIZ,IP,10444,5081,5363,1859,1955
E02006231,Babergh 005,Middle Super Output Areas and Intermediate Zones,MSOAIZ,IP,8350,4106,4244,1780,1836
E02006232,Babergh 006,Middle Super Output Areas and Intermediate Zones,MSOAIZ,CO,5674,2809,2865,986,1003
E02006233,Babergh 007,Middle Super Output Areas and Intermediate Zones,MSOAIZ,CO,11170,5328,5842,2184,2123
E02006234,Babergh 008,Middle Super Output Areas and Intermediate Zones,MSOAIZ,CO,8908,4388,4520,1732,1810
E02006235,Babergh 009,Middle Super Output Areas and Intermediate Zones,MSOAIZ,IP,7937,3902,4035,1385,1453
E02006236,Babergh 010,Middle Super Output Areas and Intermediate Zones,MSOAIZ,IP,10041,4981,5060,1674,1783
E02006237,Babergh 011,Middle Super Output Areas and Intermediate Zones,MSOAIZ,IP,7726,3764,3962,1226,1340
E02006238,Forest Heath 001,Middle Super Output Areas and Intermediate Zones,MSOAIZ,IP,9636,4819,4817,1881,1785
E02006239,Forest Heath 002,Middle Super Output Areas and Intermediate Zones,MSOAIZ,IP,6558,3506,3052,1418,1159
E02006240,Forest Heath 003,Middle Super Output Areas and Intermediate Zones,MSOAIZ,IP,8680,4436,4244,1929,1800
E02006241,Forest Heath 004,Middle Super Output Areas and Intermediate Zones,MSOAIZ,IP,8688,4326,4362,1819,1734
E02006242,Forest Heath 005,Middle Super Output Areas and Intermediate Zones,MSOAIZ,IP,7611,3831,3780,1746,1696
E02006243,Forest Heath 006,Middle Super Output Areas and Intermediate Zones,MSOAIZ,CB,8996,4489,4507,2132,2027
E02006245,Ipswich 001,Middle Super Output Areas and Intermediate Zones,MSOAIZ,IP,8039,3905,4134,1373,1508
E02006246,Ipswich 002,Middle Super Output Areas and Intermediate Zones,MSOAIZ,IP,7463,3664,3799,1390,1424
E02006247,Ipswich 003,Middle Super Output Areas and Intermediate Zones,MSOAIZ,IP,8879,4414,4465,1970,1965
E02006248,Ipswich 004,Middle Super Output Areas and Intermediate Zones,MSOAIZ,IP,8324,4053,4271,1562,1724
E02006249,Ipswich 005,Middle Super Output Areas and Intermediate Zones,MSOAIZ,IP,7876,3836,4040,1533,1529
E02006250,Ipswich 006,Middle Super Output Areas and Intermediate Zones,MSOAIZ,IP,9938,5270,4668,2699,2140
E02006251,Ipswich 007,Middle Super Output Areas and Intermediate Zones,MSOAIZ,IP,9700,4996,4704,2542,2128
E02006252,Ipswich 008,Middle Super Output Areas and Intermediate Zones,MSOAIZ,IP,9134,4420,4714,2010,2066
E02006253,Ipswich 009,Middle Super Output Areas and Intermediate Zones,MSOAIZ,IP,7055,3490,3565,1269,1248
E02006254,Ipswich 010,Middle Super Output Areas and Intermediate Zones,MSOAIZ,IP,8826,4525,4301,2080,1849
E02006255,Ipswich 011,Middle Super Output Areas and Intermediate Zones,MSOAIZ,IP,7799,4037,3762,2072,1807
E02006256,Ipswich 012,Middle Super Output Areas and Intermediate Zones,MSOAIZ,IP,8632,4344,4288,2028,1846
E02006257,Ipswich 013,Middle Super Output Areas and Intermediate Zones,MSOAIZ,IP,6660,3240,3420,1216,1218
E02006258,Ipswich 014,Middle Super Output Areas and Intermediate Zones,MSOAIZ,IP,8991,4388,4603,1945,2013
E02006259,Ipswich 015,Middle Super Output Areas and Intermediate Zones,MSOAIZ,IP,7276,3569,3707,1425,1422
E02006260,Ipswich 016,Middle Super Output Areas and Intermediate Zones,MSOAIZ,IP,8792,4277,4515,1724,1839
E02006261,Mid Suffolk 001,Middle Super Output Areas and Intermediate Zones,MSOAIZ,IP,7689,3756,3933,1285,1350
E02006262,Mid Suffolk 002,Middle Super Output Areas and Intermediate Zones,MSOAIZ,IP,8659,4272,4387,1535,1604
E02006263,Mid Suffolk 003,Middle Super Output Areas and Intermediate Zones,MSOAIZ,IP,7278,3643,3635,1249,1286
E02006264,Mid Suffolk 004,Middle Super Output Areas and Intermediate Zones,MSOAIZ,IP,8156,3986,4170,1568,1627
E02006265,Mid Suffolk 005,Middle Super Output Areas and Intermediate Zones,MSOAIZ,IP,6956,3467,3489,1258,1283
E02006266,Mid Suffolk 006,Middle Super Output Areas and Intermediate Zones,MSOAIZ,IP,9129,4497,4632,1549,1679
E02006267,Mid Suffolk 007,Middle Super Output Areas and Intermediate Zones,MSOAIZ,IP,8381,4152,4229,1516,1596
E02006268,Mid Suffolk 008,Middle Super Output Areas and Intermediate Zones,MSOAIZ,IP,6278,2933,3345,1026,1154
E02006269,Mid Suffolk 009,Middle Super Output Areas and Intermediate Zones,MSOAIZ,IP,6946,3411,3535,1361,1383
E02006270,Mid Suffolk 010,Middle Super Output Areas and Intermediate Zones,MSOAIZ,IP,11366,5616,5750,2637,2589
E02006271,Mid Suffolk 011,Middle Super Output Areas and Intermediate Zones,MSOAIZ,IP,8492,4553,3939,1805,1550
E02006272,Mid Suffolk 012,Middle Super Output Areas and Intermediate Zones,MSOAIZ,IP,7401,3638,3763,1308,1371
E02006273,St Edmundsbury 001,Middle Super Output Areas and Intermediate Zones,MSOAIZ,IP,6330,3139,3191,1074,1131
E02006274,St Edmundsbury 002,Middle Super Output Areas and Intermediate Zones,MSOAIZ,IP,7197,3829,3368,1544,1321
E02006275,St Edmundsbury 003,Middle Super Output Areas and Intermediate Zones,MSOAIZ,IP,7201,3529,3672,1371,1425
E02006276,St Edmundsbury 004,Middle Super Output Areas and Intermediate Zones,MSOAIZ,IP,6562,3236,3326,1077,1127
E02006277,St Edmundsbury 005,Middle Super Output Areas and Intermediate Zones,MSOAIZ,IP,7968,3997,3971,1953,1995
E02006278,St Edmundsbury 006,Middle Super Output Areas and Intermediate Zones,MSOAIZ,IP,8428,4220,4208,2019,1806
E02006279,St Edmundsbury 007,Middle Super Output Areas and Intermediate Zones,MSOAIZ,IP,9053,4401,4652,1655,1692
E02006280,St Edmundsbury 008,Middle Super Output Areas and Intermediate Zones,MSOAIZ,IP,9308,4557,4751,1601,1647
E02006281,St Edmundsbury 009,Middle Super Output Areas and Intermediate Zones,MSOAIZ,IP,8463,4064,4399,1598,1473
E02006282,St Edmundsbury 010,Middle Super Output Areas and Intermediate Zones,MSOAIZ,IP,6204,3027,3177,992,1056
E02006283,St Edmundsbury 011,Middle Super Output Areas and Intermediate Zones,MSOAIZ,CO,7253,4121,3132,1928,1165
E02006284,St Edmundsbury 012,Middle Super Output Areas and Intermediate Zones,MSOAIZ,CB,7796,3849,3947,1551,1569
E02006285,St Edmundsbury 013,Middle Super Output Areas and Intermediate Zones,MSOAIZ,CB,7974,3959,4015,1838,1803
E02006286,St Edmundsbury 014,Middle Super Output Areas and Intermediate Zones,MSOAIZ,CB,11271,5666,5605,2429,2250
E02006287,Suffolk Coastal 001,Middle Super Output Areas and Intermediate Zones,MSOAIZ,NR,5943,2908,3035,875,937
E02006288,Suffolk Coastal 002,Middle Super Output Areas and Intermediate Zones,MSOAIZ,IP,8865,4288,4577,1406,1553
E02006289,Suffolk Coastal 003,Middle Super Output Areas and Intermediate Zones,MSOAIZ,IP,8273,3970,4303,1334,1433
E02006290,Suffolk Coastal 004,Middle Super Output Areas and Intermediate Zones,MSOAIZ,IP,8136,3849,4287,1322,1326
E02006291,Suffolk Coastal 005,Middle Super Output Areas and Intermediate Zones,MSOAIZ,IP,7039,3386,3653,1127,1239
E02006292,Suffolk Coastal 006,Middle Super Output Areas and Intermediate Zones,MSOAIZ,IP,6543,3226,3317,1115,1171
E02006293,Suffolk Coastal 007,Middle Super Output Areas and Intermediate Zones,MSOAIZ,IP,10705,5662,5043,2250,2000
E02006294,Suffolk Coastal 008,Middle Super Output Areas and Intermediate Zones,MSOAIZ,IP,8096,3759,4337,1254,1350
E02006295,Suffolk Coastal 009,Middle Super Output Areas and Intermediate Zones,MSOAIZ,IP,9295,4521,4774,1676,1780
E02006296,Suffolk Coastal 010,Middle Super Output Areas and Intermediate Zones,MSOAIZ,IP,12773,6308,6465,2547,2662
E02006297,Suffolk Coastal 011,Middle Super Output Areas and Intermediate Zones,MSOAIZ,IP,8018,3987,4031,1498,1553
E02006298,Suffolk Coastal 012,Middle Super Output Areas and Intermediate Zones,MSOAIZ,IP,8865,4401,4464,1723,1749
E02006299,Suffolk Coastal 013,Middle Super Output Areas and Intermediate Zones,MSOAIZ,IP,8344,3952,4392,1164,1250
E02006300,Suffolk Coastal 014,Middle Super Output Areas and Intermediate Zones,MSOAIZ,IP,7507,3601,3906,1366,1501
E02006301,Suffolk Coastal 015,Middle Super Output Areas and Intermediate Zones,MSOAIZ,IP,5896,2845,3051,1137,1041
E02006302,Waveney 001,Middle Super Output Areas and Intermediate Zones,MSOAIZ,NR,6968,3631,3337,1416,1101
E02006303,Waveney 002,Middle Super Output Areas and Intermediate Zones,MSOAIZ,NR,7649,3672,3977,1347,1549
E02006304,Waveney 003,Middle Super Output Areas and Intermediate Zones,MSOAIZ,NR,7468,3629,3839,1166,1200
E02006305,Waveney 004,Middle Super Output Areas and Intermediate Zones,MSOAIZ,NR,9224,4512,4712,1931,1905
E02006306,Waveney 005,Middle Super Output Areas and Intermediate Zones,MSOAIZ,NR,7217,3568,3649,1247,1252
E02006307,Waveney 006,Middle Super Output Areas and Intermediate Zones,MSOAIZ,NR,7382,3565,3817,1150,1188
E02006308,Waveney 007,Middle Super Output Areas and Intermediate Zones,MSOAIZ,NR,7198,3581,3617,1517,1340
E02006309,Waveney 008,Middle Super Output Areas and Intermediate Zones,MSOAIZ,NR,6800,3205,3595,1008,1164
E02006310,Waveney 009,Middle Super Output Areas and Intermediate Zones,MSOAIZ,NR,8079,3887,4192,1583,1719
E02006311,Waveney 010,Middle Super Output Areas and Intermediate Zones,MSOAIZ,NR,8219,3875,4344,1330,1367
E02006312,Waveney 011,Middle Super Output Areas and Intermediate Zones,MSOAIZ,NR,8762,4308,4454,1484,1648
E02006313,Waveney 012,Middle Super Output Areas and Intermediate Zones,MSOAIZ,NR,10139,4922,5217,1687,1796
E02006314,Waveney 013,Middle Super Output Areas and Intermediate Zones,MSOAIZ,NR,7369,3601,3768,1212,1296
E02006315,Waveney 014,Middle Super Output Areas and Intermediate Zones,MSOAIZ,NR,5904,2776,3128,835,926
E02006316,Waveney 015,Middle Super Output Areas and Intermediate Zones,MSOAIZ,NR,6876,3289,3587,1047,1095
E02006317,Elmbridge 001,Middle Super Output Areas and Intermediate Zones,MSOAIZ,KT,6008,2860,3148,1152,1308
E02006318,Elmbridge 002,Middle Super Output Areas and Intermediate Zones,MSOAIZ,KT,6337,3103,3234,1365,1407
E02006319,Elmbridge 003,Middle Super Output Areas and Intermediate Zones,MSOAIZ,KT,6743,3241,3502,1446,1509
E02006320,Elmbridge 004,Middle Super Output Areas and Intermediate Zones,MSOAIZ,KT,6511,3219,3292,1523,1591
E02006321,Elmbridge 005,Middle Super Output Areas and Intermediate Zones,MSOAIZ,KT,6307,3030,3277,1321,1434
E02006322,Elmbridge 006,Middle Super Output Areas and Intermediate Zones,MSOAIZ,KT,6343,3093,3250,1349,1453
E02006323,Elmbridge 007,Middle Super Output Areas and Intermediate Zones,MSOAIZ,TW,6790,3296,3494,1575,1552
E02006324,Elmbridge 008,Middle Super Output Areas and Intermediate Zones,MSOAIZ,KT,7430,3551,3879,1553,1744
E02006325,Elmbridge 009,Middle Super Output Areas and Intermediate Zones,MSOAIZ,KT,8944,4420,4524,1759,1894
E02006326,Elmbridge 010,Middle Super Output Areas and Intermediate Zones,MSOAIZ,KT,6530,3156,3374,1391,1446
E02006327,Elmbridge 011,Middle Super Output Areas and Intermediate Zones,MSOAIZ,KT,6352,3086,3266,1297,1331
E02006328,Elmbridge 012,Middle Super Output Areas and Intermediate Zones,MSOAIZ,TW,8947,4400,4547,2094,2123
E02006329,Elmbridge 013,Middle Super Output Areas and Intermediate Zones,MSOAIZ,KT,6743,3266,3477,1298,1417
E02006330,Elmbridge 014,Middle Super Output Areas and Intermediate Zones,MSOAIZ,KT,9290,4435,4855,1778,1923
E02006331,Elmbridge 015,Middle Super Output Areas and Intermediate Zones,MSOAIZ,KT,7168,3461,3707,1350,1430
E02006332,Elmbridge 016,Middle Super Output Areas and Intermediate Zones,MSOAIZ,KT,6502,3149,3353,1387,1509
E02006333,Elmbridge 017,Middle Super Output Areas and Intermediate Zones,MSOAIZ,KT,9489,4597,4892,1784,1971
E02006334,Elmbridge 018,Middle Super Output Areas and Intermediate Zones,MSOAIZ,KT,8441,4099,4342,1525,1705
E02006335,Epsom and Ewell 001,Middle Super Output Areas and Intermediate Zones,MSOAIZ,KT,7834,3847,3987,1607,1591
E02006336,Epsom and Ewell 002,Middle Super Output Areas and Intermediate Zones,MSOAIZ,KT,6797,3258,3539,1396,1541
E02006337,Epsom and Ewell 003,Middle Super Output Areas and Intermediate Zones,MSOAIZ,KT,8741,4288,4453,1668,1709
E02006338,Epsom and Ewell 004,Middle Super Output Areas and Intermediate Zones,MSOAIZ,KT,6806,3330,3476,1350,1395
E02006339,Epsom and Ewell 005,Middle Super Output Areas and Intermediate Zones,MSOAIZ,KT,8969,4440,4529,2101,2160
E02006341,Epsom and Ewell 007,Middle Super Output Areas and Intermediate Zones,MSOAIZ,KT,9505,4581,4924,1959,1985
E02006342,Epsom and Ewell 008,Middle Super Output Areas and Intermediate Zones,MSOAIZ,KT,7216,3387,3829,1592,1495
E02006343,Epsom and Ewell 009,Middle Super Output Areas and Intermediate Zones,MSOAIZ,KT,8686,4171,4515,1551,1703
E02006344,Guildford 001,Middle Super Output Areas and Intermediate Zones,MSOAIZ,KT,8500,4067,4433,1548,1834
E02006345,Guildford 002,Middle Super Output Areas and Intermediate Zones,MSOAIZ,GU,6672,3508,3164,1487,1328
E02006346,Guildford 003,Middle Super Output Areas and Intermediate Zones,MSOAIZ,RH,9829,4704,5125,1640,1851
E02006347,Guildford 004,Middle Super Output Areas and Intermediate Zones,MSOAIZ,GU,7180,3554,3626,1607,1627
E02006348,Guildford 005,Middle Super Output Areas and Intermediate Zones,MSOAIZ,GU,8529,4177,4352,1721,1745
E02006349,Guildford 006,Middle Super Output Areas and Intermediate Zones,MSOAIZ,GU,8161,4130,4031,1969,1872
E02006350,Guildford 007,Middle Super Output Areas and Intermediate Zones,MSOAIZ,GU,6187,3155,3032,1419,1334
E02006351,Guildford 008,Middle Super Output Areas and Intermediate Zones,MSOAIZ,GU,8267,4006,4261,1739,1832
E02006352,Guildford 009,Middle Super Output Areas and Intermediate Zones,MSOAIZ,GU,6087,3120,2967,1251,1221
E02006353,Guildford 010,Middle Super Output Areas and Intermediate Zones,MSOAIZ,GU,6144,3051,3093,1331,1357
E02006354,Guildford 011,Middle Super Output Areas and Intermediate Zones,MSOAIZ,GU,8976,4347,4629,1738,1800
E02006355,Guildford 012,Middle Super Output Areas and Intermediate Zones,MSOAIZ,GU,7807,3849,3958,1410,1404
E02006356,Guildford 013,Middle Super Output Areas and Intermediate Zones,MSOAIZ,GU,10467,5522,4945,3166,2511
E02006357,Guildford 014,Middle Super Output Areas and Intermediate Zones,MSOAIZ,GU,6156,2975,3181,1256,1376
E02006358,Guildford 015,Middle Super Output Areas and Intermediate Zones,MSOAIZ,GU,8525,4256,4269,1528,1285
E02006359,Guildford 016,Middle Super Output Areas and Intermediate Zones,MSOAIZ,GU,5930,2940,2990,1260,1222
E02006360,Guildford 017,Middle Super Output Areas and Intermediate Zones,MSOAIZ,GU,8268,3877,4391,1505,1625
E02006361,Guildford 018,Middle Super Output Areas and Intermediate Zones,MSOAIZ,RH,5498,2685,2813,995,1073
E02006362,Mole Valley 001,Middle Super Output Areas and Intermediate Zones,MSOAIZ,KT,6654,3202,3452,1163,1249
E02006363,Mole Valley 002,Middle Super Output Areas and Intermediate Zones,MSOAIZ,KT,5887,2843,3044,1096,1139
E02006364,Mole Valley 003,Middle Super Output Areas and Intermediate Zones,MSOAIZ,KT,7035,3565,3470,1740,1625
E02006365,Mole Valley 004,Middle Super Output Areas and Intermediate Zones,MSOAIZ,KT,5909,2858,3051,1068,1103
E02006366,Mole Valley 005,Middle Super Output Areas and Intermediate Zones,MSOAIZ,KT,7996,3967,4029,1428,1484
E02006367,Mole Valley 006,Middle Super Output Areas and Intermediate Zones,MSOAIZ,KT,5779,2739,3040,927,1024
E02006368,Mole Valley 007,Middle Super Output Areas and Intermediate Zones,MSOAIZ,RH,5596,2676,2920,934,1021
E02006369,Mole Valley 008,Middle Super Output Areas and Intermediate Zones,MSOAIZ,RH,6489,3202,3287,1144,1160
E02006370,Mole Valley 009,Middle Super Output Areas and Intermediate Zones,MSOAIZ,RH,6152,2978,3174,1246,1283
E02006371,Mole Valley 010,Middle Super Output Areas and Intermediate Zones,MSOAIZ,RH,7001,3384,3617,1456,1431
E02006372,Mole Valley 011,Middle Super Output Areas and Intermediate Zones,MSOAIZ,RH,6417,3144,3273,1350,1328
E02006373,Mole Valley 012,Middle Super Output Areas and Intermediate Zones,MSOAIZ,RH,7561,3742,3819,1428,1529
E02006374,Mole Valley 013,Middle Super Output Areas and Intermediate Zones,MSOAIZ,RH,6899,3449,3450,1350,1358
E02006375,Reigate and Banstead 001,Middle Super Output Areas and Intermediate Zones,MSOAIZ,SM,6242,3058,3184,1198,1269
E02006376,Reigate and Banstead 002,Middle Super Output Areas and Intermediate Zones,MSOAIZ,SM,9110,4404,4706,1868,1764
E02006377,Reigate and Banstead 003,Middle Super Output Areas and Intermediate Zones,MSOAIZ,SM,5804,2821,2983,995,1103
E02006378,Reigate and Banstead 004,Middle Super Output Areas and Intermediate Zones,MSOAIZ,SM,8823,4354,4469,1830,1873
E02006379,Reigate and Banstead 005,Middle Super Output Areas and Intermediate Zones,MSOAIZ,KT,5830,2783,3047,1190,1339
E02006380,Reigate and Banstead 006,Middle Super Output Areas and Intermediate Zones,MSOAIZ,KT,7123,3471,3652,1246,1324
E02006381,Reigate and Banstead 007,Middle Super Output Areas and Intermediate Zones,MSOAIZ,SM,6891,3349,3542,1272,1323
E02006382,Reigate and Banstead 008,Middle Super Output Areas and Intermediate Zones,MSOAIZ,RH,6528,3175,3353,1365,1456
E02006383,Reigate and Banstead 009,Middle Super Output Areas and Intermediate Zones,MSOAIZ,RH,9433,4573,4860,1959,1915
E02006384,Reigate and Banstead 010,Middle Super Output Areas and Intermediate Zones,MSOAIZ,RH,10053,4951,5102,2220,2247
E02006385,Reigate and Banstead 011,Middle Super Output Areas and Intermediate Zones,MSOAIZ,RH,9978,5005,4973,2753,2637
E02006386,Reigate and Banstead 012,Middle Super Output Areas and Intermediate Zones,MSOAIZ,RH,7859,3805,4054,1689,1781
E02006387,Reigate and Banstead 013,Middle Super Output Areas and Intermediate Zones,MSOAIZ,RH,6427,3084,3343,1272,1393
E02006388,Reigate and Banstead 014,Middle Super Output Areas and Intermediate Zones,MSOAIZ,RH,8857,4330,4527,2046,2068
E02006389,Reigate and Banstead 015,Middle Super Output Areas and Intermediate Zones,MSOAIZ,RH,6801,3343,3458,1344,1398
E02006390,Reigate and Banstead 016,Middle Super Output Areas and Intermediate Zones,MSOAIZ,RH,7854,3852,4002,1595,1651
E02006391,Reigate and Banstead 017,Middle Super Output Areas and Intermediate Zones,MSOAIZ,RH,5925,2923,3002,1279,1338
E02006392,Reigate and Banstead 018,Middle Super Output Areas and Intermediate Zones,MSOAIZ,RH,8297,4141,4156,1933,1767
E02006393,Runnymede 001,Middle Super Output Areas and Intermediate Zones,MSOAIZ,TW,6384,3009,3375,1281,1169
E02006394,Runnymede 002,Middle Super Output Areas and Intermediate Zones,MSOAIZ,TW,10607,4958,5649,1513,1494
E02006395,Runnymede 003,Middle Super Output Areas and Intermediate Zones,MSOAIZ,TW,9120,4489,4631,2084,2111
E02006396,Runnymede 004,Middle Super Output Areas and Intermediate Zones,MSOAIZ,TW,5767,2899,2868,1130,1125
E02006397,Runnymede 005,Middle Super Output Areas and Intermediate Zones,MSOAIZ,TW,5940,2888,3052,1199,1228
E02006398,Runnymede 006,Middle Super Output Areas and Intermediate Zones,MSOAIZ,KT,7573,3773,3800,1755,1787
E02006399,Runnymede 007,Middle Super Output Areas and Intermediate Zones,MSOAIZ,KT,10652,5184,5468,2251,2289
E02006400,Runnymede 008,Middle Super Output Areas and Intermediate Zones,MSOAIZ,KT,5672,2754,2918,1136,1237
E02006401,Runnymede 009,Middle Super Output Areas and Intermediate Zones,MSOAIZ,KT,9208,4458,4750,1958,1990
E02006402,Runnymede 010,Middle Super Output Areas and Intermediate Zones,MSOAIZ,KT,9587,4736,4851,1863,1968
E02006403,Spelthorne 001,Middle Super Output Areas and Intermediate Zones,MSOAIZ,TW,6035,3036,2999,1427,1392
E02006404,Spelthorne 002,Middle Super Output Areas and Intermediate Zones,MSOAIZ,TW,6615,3271,3344,1434,1505
E02006405,Spelthorne 003,Middle Super Output Areas and Intermediate Zones,MSOAIZ,TW,10363,5101,5262,2216,2347
E02006406,Spelthorne 004,Middle Super Output Areas and Intermediate Zones,MSOAIZ,TW,7861,3951,3910,2111,1941
E02006407,Spelthorne 005,Middle Super Output Areas and Intermediate Zones,MSOAIZ,TW,8796,4302,4494,1767,1790
E02006408,Spelthorne 006,Middle Super Output Areas and Intermediate Zones,MSOAIZ,TW,8223,4067,4156,1845,1862
E02006409,Spelthorne 007,Middle Super Output Areas and Intermediate Zones,MSOAIZ,TW,6734,3262,3472,1359,1450
E02006410,Spelthorne 008,Middle Super Output Areas and Intermediate Zones,MSOAIZ,TW,8076,4000,4076,1773,1826
E02006411,Spelthorne 009,Middle Super Output Areas and Intermediate Zones,MSOAIZ,TW,7107,3485,3622,1459,1469
E02006412,Spelthorne 010,Middle Super Output Areas and Intermediate Zones,MSOAIZ,TW,6798,3331,3467,1343,1350
E02006413,Spelthorne 011,Middle Super Output Areas and Intermediate Zones,MSOAIZ,TW,6106,2952,3154,1109,1182
E02006414,Spelthorne 012,Middle Super Output Areas and Intermediate Zones,MSOAIZ,TW,6207,3039,3168,1182,1295
E02006415,Spelthorne 013,Middle Super Output Areas and Intermediate Zones,MSOAIZ,TW,6677,3256,3421,1271,1251
E02006416,Surrey Heath 001,Middle Super Output Areas and Intermediate Zones,MSOAIZ,SL,8191,4057,4134,1587,1669
E02006417,Surrey Heath 002,Middle Super Output Areas and Intermediate Zones,MSOAIZ,GU,5592,2791,2801,1223,1231
E02006418,Surrey Heath 003,Middle Super Output Areas and Intermediate Zones,MSOAIZ,GU,6791,3307,3484,1360,1430
E02006419,Surrey Heath 004,Middle Super Output Areas and Intermediate Zones,MSOAIZ,GU,7927,3861,4066,1712,1778
E02006420,Surrey Heath 005,Middle Super Output Areas and Intermediate Zones,MSOAIZ,GU,7411,3633,3778,1432,1481
E02006421,Surrey Heath 006,Middle Super Output Areas and Intermediate Zones,MSOAIZ,GU,8658,4578,4080,1986,1723
E02006422,Surrey Heath 007,Middle Super Output Areas and Intermediate Zones,MSOAIZ,GU,6049,2964,3085,1249,1308
E02006423,Surrey Heath 008,Middle Super Output Areas and Intermediate Zones,MSOAIZ,GU,10349,5165,5184,2361,2239
E02006424,Surrey Heath 009,Middle Super Output Areas and Intermediate Zones,MSOAIZ,GU,6180,3064,3116,1133,1193
E02006425,Surrey Heath 010,Middle Super Output Areas and Intermediate Zones,MSOAIZ,GU,6178,3030,3148,1277,1297
E02006426,Surrey Heath 011,Middle Super Output Areas and Intermediate Zones,MSOAIZ,GU,5717,2820,2897,1191,1230
E02006427,Surrey Heath 012,Middle Super Output Areas and Intermediate Zones,MSOAIZ,GU,7101,3598,3503,1571,1516
E02006429,Tandridge 002,Middle Super Output Areas and Intermediate Zones,MSOAIZ,CR,7217,3587,3630,1610,1579
E02006430,Tandridge 003,Middle Super Output Areas and Intermediate Zones,MSOAIZ,CR,8976,4327,4649,1903,2024
E02006431,Tandridge 004,Middle Super Output Areas and Intermediate Zones,MSOAIZ,RH,10489,5004,5485,2096,2172
E02006432,Tandridge 005,Middle Super Output Areas and Intermediate Zones,MSOAIZ,CR,5501,2658,2843,987,1048
E02006433,Tandridge 006,Middle Super Output Areas and Intermediate Zones,MSOAIZ,TN,9417,4515,4902,1647,1806
E02006434,Tandridge 007,Middle Super Output Areas and Intermediate Zones,MSOAIZ,RH,6129,2981,3148,1138,1229
E02006435,Tandridge 008,Middle Super Output Areas and Intermediate Zones,MSOAIZ,RH,5809,2807,3002,1112,1222
E02006436,Tandridge 009,Middle Super Output Areas and Intermediate Zones,MSOAIZ,RH,5949,2834,3115,1116,1209
E02006437,Tandridge 010,Middle Super Output Areas and Intermediate Zones,MSOAIZ,TN,8267,3995,4272,1521,1632
E02006438,Tandridge 011,Middle Super Output Areas and Intermediate Zones,MSOAIZ,RH,7797,3873,3924,1479,1499
E02006439,Waverley 001,Middle Super Output Areas and Intermediate Zones,MSOAIZ,GU,5851,2873,2978,1160,1210
E02006440,Waverley 002,Middle Super Output Areas and Intermediate Zones,MSOAIZ,GU,7126,3537,3589,1412,1430
E02006441,Waverley 003,Middle Super Output Areas and Intermediate Zones,MSOAIZ,GU,7617,3566,4051,1505,1509
E02006442,Waverley 004,Middle Super Output Areas and Intermediate Zones,MSOAIZ,GU,5927,2913,3014,1013,1085
E02006443,Waverley 005,Middle Super Output Areas and Intermediate Zones,MSOAIZ,GU,7271,3477,3794,1472,1546
E02006444,Waverley 006,Middle Super Output Areas and Intermediate Zones,MSOAIZ,GU,6737,3312,3425,1284,1363
E02006445,Waverley 007,Middle Super Output Areas and Intermediate Zones,MSOAIZ,GU,7233,3870,3363,1639,1527
E02006446,Waverley 008,Middle Super Output Areas and Intermediate Zones,MSOAIZ,GU,6771,3155,3616,1172,1302
E02006447,Waverley 009,Middle Super Output Areas and Intermediate Zones,MSOAIZ,GU,6230,3135,3095,1156,1194
E02006448,Waverley 010,Middle Super Output Areas and Intermediate Zones,MSOAIZ,GU,7300,3571,3729,1531,1618
E02006449,Waverley 011,Middle Super Output Areas and Intermediate Zones,MSOAIZ,GU,6898,3328,3570,1256,1357
E02006450,Waverley 012,Middle Super Output Areas and Intermediate Zones,MSOAIZ,GU,6979,3424,3555,1271,1338
E02006451,Waverley 013,Middle Super Output Areas and Intermediate Zones,MSOAIZ,GU,10692,5311,5381,1791,1873
E02006453,Waverley 015,Middle Super Output Areas and Intermediate Zones,MSOAIZ,RH,8025,3801,4224,1348,1427
E02006454,Waverley 016,Middle Super Output Areas and Intermediate Zones,MSOAIZ,GU,6553,3120,3433,1215,1259
E02006455,Waverley 017,Middle Super Output Areas and Intermediate Zones,MSOAIZ,GU,5981,2818,3163,1260,1336
E02006456,Woking 001,Middle Super Output Areas and Intermediate Zones,MSOAIZ,KT,7724,3737,3987,1680,1731
E02006457,Woking 002,Middle Super Output Areas and Intermediate Zones,MSOAIZ,KT,9124,4399,4725,1758,1818
E02006458,Woking 003,Middle Super Output Areas and Intermediate Zones,MSOAIZ,KT,9204,4506,4698,1809,1838
E02006459,Woking 004,Middle Super Output Areas and Intermediate Zones,MSOAIZ,GU,10574,5471,5103,2689,2392
E02006460,Woking 005,Middle Super Output Areas and Intermediate Zones,MSOAIZ,GU,9488,4600,4888,2154,2281
E02006461,Woking 006,Middle Super Output Areas and Intermediate Zones,MSOAIZ,GU,6735,3344,3391,1444,1358
E02006462,Woking 007,Middle Super Output Areas and Intermediate Zones,MSOAIZ,GU,8452,4196,4256,1978,1971
E02006463,Woking 008,Middle Super Output Areas and Intermediate Zones,MSOAIZ,GU,9534,4865,4669,2732,2354
E02006464,Woking 009,Middle Super Output Areas and Intermediate Zones,MSOAIZ,GU,6866,3384,3482,1494,1531
E02006465,Woking 010,Middle Super Output Areas and Intermediate Zones,MSOAIZ,GU,6188,2988,3200,1319,1367
E02006466,Woking 011,Middle Super Output Areas and Intermediate Zones,MSOAIZ,GU,8768,4409,4359,1938,1979
E02006467,Woking 012,Middle Super Output Areas and Intermediate Zones,MSOAIZ,GU,6541,3245,3296,1299,1403
E02006468,North Warwickshire 001,Middle Super Output Areas and Intermediate Zones,MSOAIZ,CV,10486,5182,5304,2002,2167
E02006469,North Warwickshire 002,Middle Super Output Areas and Intermediate Zones,MSOAIZ,CV,8708,4311,4397,1740,1814
E02006470,North Warwickshire 003,Middle Super Output Areas and Intermediate Zones,MSOAIZ,CV,11003,5430,5573,2213,2186
E02006471,North Warwickshire 004,Middle Super Output Areas and Intermediate Zones,MSOAIZ,B,6925,3444,3481,1310,1355
E02006472,North Warwickshire 005,Middle Super Output Areas and Intermediate Zones,MSOAIZ,CV,8940,4378,4562,1777,1819
E02006473,North Warwickshire 006,Middle Super Output Areas and Intermediate Zones,MSOAIZ,B,9925,4809,5116,1970,2055
E02006474,North Warwickshire 007,Middle Super Output Areas and Intermediate Zones,MSOAIZ,CV,6027,3050,2977,1253,1194
E02006475,Nuneaton and Bedworth 001,Middle Super Output Areas and Intermediate Zones,MSOAIZ,CV,7256,3521,3735,1302,1348
E02006476,Nuneaton and Bedworth 002,Middle Super Output Areas and Intermediate Zones,MSOAIZ,CV,7321,3529,3792,1460,1536
E02006477,Nuneaton and Bedworth 003,Middle Super Output Areas and Intermediate Zones,MSOAIZ,CV,6943,3452,3491,1288,1340
E02006478,Nuneaton and Bedworth 004,Middle Super Output Areas and Intermediate Zones,MSOAIZ,CV,8233,4106,4127,1819,1923
E02006479,Nuneaton and Bedworth 005,Middle Super Output Areas and Intermediate Zones,MSOAIZ,CV,8718,4374,4344,2097,1866
E02006480,Nuneaton and Bedworth 006,Middle Super Output Areas and Intermediate Zones,MSOAIZ,CV,7452,3687,3765,1531,1565
E02006481,Nuneaton and Bedworth 007,Middle Super Output Areas and Intermediate Zones,MSOAIZ,CV,6878,3379,3499,1388,1432
E02006482,Nuneaton and Bedworth 008,Middle Super Output Areas and Intermediate Zones,MSOAIZ,CV,6736,3334,3402,1503,1446
E02006483,Nuneaton and Bedworth 009,Middle Super Output Areas and Intermediate Zones,MSOAIZ,CV,7787,3785,4002,1507,1537
E02006484,Nuneaton and Bedworth 010,Middle Super Output Areas and Intermediate Zones,MSOAIZ,CV,7676,3713,3963,1589,1681
E02006485,Nuneaton and Bedworth 011,Middle Super Output Areas and Intermediate Zones,MSOAIZ,CV,6877,3393,3484,1279,1309
E02006486,Nuneaton and Bedworth 012,Middle Super Output Areas and Intermediate Zones,MSOAIZ,CV,7041,3500,3541,1479,1434
E02006487,Nuneaton and Bedworth 013,Middle Super Output Areas and Intermediate Zones,MSOAIZ,CV,6666,3196,3470,1246,1211
E02006488,Nuneaton and Bedworth 014,Middle Super Output Areas and Intermediate Zones,MSOAIZ,CV,6146,3002,3144,993,1009
E02006489,Nuneaton and Bedworth 015,Middle Super Output Areas and Intermediate Zones,MSOAIZ,CV,8043,4002,4041,1822,1809
E02006490,Nuneaton and Bedworth 016,Middle Super Output Areas and Intermediate Zones,MSOAIZ,CV,7473,3622,3851,1513,1565
E02006492,Rugby 001,Middle Super Output Areas and Intermediate Zones,MSOAIZ,LE,11104,5657,5447,2472,2311
E02006493,Rugby 002,Middle Super Output Areas and Intermediate Zones,MSOAIZ,CV,9047,4469,4578,2121,2167
E02006494,Rugby 003,Middle Super Output Areas and Intermediate Zones,MSOAIZ,CV,6754,3426,3328,1510,1359
E02006495,Rugby 004,Middle Super Output Areas and Intermediate Zones,MSOAIZ,CV,7685,3848,3837,1469,1554
E02006496,Rugby 005,Middle Super Output Areas and Intermediate Zones,MSOAIZ,CV,6937,3611,3326,1845,1595
E02006497,Rugby 006,Middle Super Output Areas and Intermediate Zones,MSOAIZ,CV,7760,3875,3885,1907,1809
E02006498,Rugby 007,Middle Super Output Areas and Intermediate Zones,MSOAIZ,CV,11324,5646,5678,2461,2600
E02006499,Rugby 008,Middle Super Output Areas and Intermediate Zones,MSOAIZ,CV,5915,2935,2980,1226,1255
E02006500,Rugby 009,Middle Super Output Areas and Intermediate Zones,MSOAIZ,CV,5865,2936,2929,1013,994
E02006501,Rugby 010,Middle Super Output Areas and Intermediate Zones,MSOAIZ,CV,9024,4501,4523,1748,1735
E02006502,Rugby 011,Middle Super Output Areas and Intermediate Zones,MSOAIZ,CV,10801,5152,5649,1832,1950
E02006503,Rugby 012,Middle Super Output Areas and Intermediate Zones,MSOAIZ,NN,7859,3828,4031,1290,1400
E02006504,Stratford-on-Avon 001,Middle Super Output Areas and Intermediate Zones,MSOAIZ,B,5679,2798,2881,936,1006
E02006505,Stratford-on-Avon 002,Middle Super Output Areas and Intermediate Zones,MSOAIZ,CV,6656,3182,3474,1051,1157
E02006506,Stratford-on-Avon 003,Middle Super Output Areas and Intermediate Zones,MSOAIZ,B,5879,2859,3020,1072,1136
E02006507,Stratford-on-Avon 004,Middle Super Output Areas and Intermediate Zones,MSOAIZ,NN,9058,4466,4592,1717,1826
E02006508,Stratford-on-Avon 005,Middle Super Output Areas and Intermediate Zones,MSOAIZ,OX,9442,4616,4826,1780,1894
E02006509,Stratford-on-Avon 006,Middle Super Output Areas and Intermediate Zones,MSOAIZ,B,6083,2932,3151,1110,1169
E02006510,Stratford-on-Avon 007,Middle Super Output Areas and Intermediate Zones,MSOAIZ,CV,6182,3023,3159,1000,1089
E02006511,Stratford-on-Avon 008,Middle Super Output Areas and Intermediate Zones,MSOAIZ,CV,9164,4400,4764,1562,1759
E02006512,Stratford-on-Avon 009,Middle Super Output Areas and Intermediate Zones,MSOAIZ,CV,10901,5377,5524,2343,2336
E02006513,Stratford-on-Avon 010,Middle Super Output Areas and Intermediate Zones,MSOAIZ,CV,7487,3624,3863,1431,1536
E02006514,Stratford-on-Avon 011,Middle Super Output Areas and Intermediate Zones,MSOAIZ,CV,9057,4217,4840,1640,1702
E02006515,Stratford-on-Avon 012,Middle Super Output Areas and Intermediate Zones,MSOAIZ,WR,9223,4504,4719,1669,1812
E02006516,Stratford-on-Avon 013,Middle Super Output Areas and Intermediate Zones,MSOAIZ,OX,9019,4449,4570,1724,1815
E02006517,Stratford-on-Avon 014,Middle Super Output Areas and Intermediate Zones,MSOAIZ,GL,7358,3585,3773,1320,1477
E02006518,Stratford-on-Avon 015,Middle Super Output Areas and Intermediate Zones,MSOAIZ,OX,9297,4465,4832,1589,1735
E02006519,Warwick 001,Middle Super Output Areas and Intermediate Zones,MSOAIZ,CV,7565,3665,3900,1395,1478
E02006520,Warwick 002,Middle Super Output Areas and Intermediate Zones,MSOAIZ,CV,8388,4115,4273,1678,1718
E02006521,Warwick 003,Middle Super Output Areas and Intermediate Zones,MSOAIZ,CV,7463,3668,3795,1288,1336
E02006522,Warwick 004,Middle Super Output Areas and Intermediate Zones,MSOAIZ,CV,5464,2731,2733,1017,1093
E02006523,Warwick 005,Middle Super Output Areas and Intermediate Zones,MSOAIZ,CV,11628,5722,5906,1941,2089
E02006524,Warwick 006,Middle Super Output Areas and Intermediate Zones,MSOAIZ,CV,5624,2779,2845,1120,1136
E02006525,Warwick 007,Middle Super Output Areas and Intermediate Zones,MSOAIZ,CV,12862,6428,6434,2922,2602
E02006526,Warwick 008,Middle Super Output Areas and Intermediate Zones,MSOAIZ,CV,8318,4137,4181,1710,1727
E02006527,Warwick 009,Middle Super Output Areas and Intermediate Zones,MSOAIZ,CV,9166,4595,4571,2061,1829
E02006528,Warwick 010,Middle Super Output Areas and Intermediate Zones,MSOAIZ,CV,11142,5645,5497,2520,2290
E02006529,Warwick 011,Middle Super Output Areas and Intermediate Zones,MSOAIZ,CV,11304,5628,5676,2766,2692
E02006530,Warwick 012,Middle Super Output Areas and Intermediate Zones,MSOAIZ,CV,10492,5210,5282,2288,2304
E02006531,Warwick 013,Middle Super Output Areas and Intermediate Zones,MSOAIZ,CV,9931,5326,4605,2061,1862
E02006532,Warwick 014,Middle Super Output Areas and Intermediate Zones,MSOAIZ,CV,8729,4300,4429,1860,1911
E02006533,Warwick 015,Middle Super Output Areas and Intermediate Zones,MSOAIZ,CV,9572,4701,4871,2073,2111
E02006534,Adur 001,Middle Super Output Areas and Intermediate Zones,MSOAIZ,BN,8524,4140,4384,1596,1671
E02006535,Adur 002,Middle Super Output Areas and Intermediate Zones,MSOAIZ,BN,6634,3218,3416,1243,1280
E02006536,Adur 003,Middle Super Output Areas and Intermediate Zones,MSOAIZ,BN,7100,3539,3561,1281,1335
E02006537,Adur 004,Middle Super Output Areas and Intermediate Zones,MSOAIZ,BN,10127,4809,5318,1898,2100
E02006538,Adur 005,Middle Super Output Areas and Intermediate Zones,MSOAIZ,BN,8526,4136,4390,1800,1771
E02006539,Adur 006,Middle Super Output Areas and Intermediate Zones,MSOAIZ,BN,7089,3459,3630,1302,1386
E02006540,Adur 007,Middle Super Output Areas and Intermediate Zones,MSOAIZ,BN,5665,2728,2937,982,1086
E02006541,Adur 008,Middle Super Output Areas and Intermediate Zones,MSOAIZ,BN,7517,3484,4033,1343,1352
E02006542,Arun 001,Middle Super Output Areas and Intermediate Zones,MSOAIZ,BN,5741,2772,2969,986,1065
E02006543,Arun 002,Middle Super Output Areas and Intermediate Zones,MSOAIZ,BN,5546,2633,2913,908,1048
E02006544,Arun 003,Middle Super Output Areas and Intermediate Zones,MSOAIZ,PO,10073,4869,5204,1716,1966
E02006545,Arun 004,Middle Super Output Areas and Intermediate Zones,MSOAIZ,BN,8259,3992,4267,1546,1737
E02006546,Arun 005,Middle Super Output Areas and Intermediate Zones,MSOAIZ,BN,9631,4544,5087,1544,1756
E02006547,Arun 006,Middle Super Output Areas and Intermediate Zones,MSOAIZ,PO,5926,3033,2893,1290,1153
E02006548,Arun 007,Middle Super Output Areas and Intermediate Zones,MSOAIZ,BN,9452,4346,5106,1724,1945
E02006549,Arun 008,Middle Super Output Areas and Intermediate Zones,MSOAIZ,BN,5870,2703,3167,694,770
E02006550,Arun 009,Middle Super Output Areas and Intermediate Zones,MSOAIZ,BN,9414,4481,4933,1441,1591
E02006551,Arun 010,Middle Super Output Areas and Intermediate Zones,MSOAIZ,BN,7785,3524,4261,872,937
E02006552,Arun 011,Middle Super Output Areas and Intermediate Zones,MSOAIZ,BN,7109,3585,3524,1604,1414
E02006553,Arun 012,Middle Super Output Areas and Intermediate Zones,MSOAIZ,PO,7298,3510,3788,1400,1432
E02006554,Arun 013,Middle Super Output Areas and Intermediate Zones,MSOAIZ,PO,6680,3141,3539,999,1140
E02006555,Arun 014,Middle Super Output Areas and Intermediate Zones,MSOAIZ,PO,7476,3584,3892,1439,1570
E02006556,Arun 015,Middle Super Output Areas and Intermediate Zones,MSOAIZ,PO,8249,3861,4388,1186,1337
E02006557,Arun 016,Middle Super Output Areas and Intermediate Zones,MSOAIZ,PO,7148,3459,3689,1463,1603
E02006558,Arun 017,Middle Super Output Areas and Intermediate Zones,MSOAIZ,PO,10638,5171,5467,2358,2017
E02006559,Arun 018,Middle Super Output Areas and Intermediate Zones,MSOAIZ,PO,8124,3796,4328,1016,1116
E02006560,Arun 019,Middle Super Output Areas and Intermediate Zones,MSOAIZ,PO,9099,4299,4800,1366,1458
E02006561,Chichester 001,Middle Super Output Areas and Intermediate Zones,MSOAIZ,GU,6740,3333,3407,1256,1369
E02006562,Chichester 002,Middle Super Output Areas and Intermediate Zones,MSOAIZ,RH,5855,2867,2988,987,1129
E02006563,Chichester 003,Middle Super Output Areas and Intermediate Zones,MSOAIZ,PO,5621,2763,2858,939,1060
E02006564,Chichester 004,Middle Super Output Areas and Intermediate Zones,MSOAIZ,PO,7238,3373,3865,1147,1322
E02006565,Chichester 005,Middle Super Output Areas and Intermediate Zones,MSOAIZ,RH,8077,3818,4259,1302,1451
E02006566,Chichester 006,Middle Super Output Areas and Intermediate Zones,MSOAIZ,PO,7639,3605,4034,1194,1299
E02006567,Chichester 007,Middle Super Output Areas and Intermediate Zones,MSOAIZ,PO,7446,3579,3867,1273,1437
E02006568,Chichester 008,Middle Super Output Areas and Intermediate Zones,MSOAIZ,PO,10705,4989,5716,1955,2052
E02006569,Chichester 009,Middle Super Output Areas and Intermediate Zones,MSOAIZ,PO,7818,3919,3899,1424,1393
E02006570,Chichester 010,Middle Super Output Areas and Intermediate Zones,MSOAIZ,PO,8374,3963,4411,1623,1641
E02006571,Chichester 011,Middle Super Output Areas and Intermediate Zones,MSOAIZ,PO,7652,3639,4013,1342,1401
E02006572,Chichester 012,Middle Super Output Areas and Intermediate Zones,MSOAIZ,PO,9132,4365,4767,1622,1899
E02006573,Chichester 013,Middle Super Output Areas and Intermediate Zones,MSOAIZ,PO,10760,5138,5622,1583,1786
E02006574,Chichester 014,Middle Super Output Areas and Intermediate Zones,MSOAIZ,PO,10737,5050,5687,1531,1663
E02006575,Crawley 001,Middle Super Output Areas and Intermediate Zones,MSOAIZ,RH,8255,4235,4020,1960,1809
E02006576,Crawley 002,Middle Super Output Areas and Intermediate Zones,MSOAIZ,RH,7958,3981,3977,1770,1769
E02006577,Crawley 003,Middle Super Output Areas and Intermediate Zones,MSOAIZ,RH,7922,3827,4095,1624,1680
E02006578,Crawley 004,Middle Super Output Areas and Intermediate Zones,MSOAIZ,RH,9673,4950,4723,2416,2154
E02006579,Crawley 005,Middle Super Output Areas and Intermediate Zones,MSOAIZ,RH,7877,3926,3951,1800,1714
E02006580,Crawley 006,Middle Super Output Areas and Intermediate Zones,MSOAIZ,RH,8007,3897,4110,1649,1764
E02006581,Crawley 007,Middle Super Output Areas and Intermediate Zones,MSOAIZ,RH,8589,4207,4382,2018,1902
E02006582,Crawley 008,Middle Super Output Areas and Intermediate Zones,MSOAIZ,RH,7943,3960,3983,2009,2002
E02006583,Crawley 009,Middle Super Output Areas and Intermediate Zones,MSOAIZ,RH,8945,4427,4518,2084,2029
E02006584,Crawley 010,Middle Super Output Areas and Intermediate Zones,MSOAIZ,RH,7442,3670,3772,1755,1819
E02006585,Crawley 011,Middle Super Output Areas and Intermediate Zones,MSOAIZ,RH,7770,3729,4041,1550,1647
E02006586,Crawley 012,Middle Super Output Areas and Intermediate Zones,MSOAIZ,RH,7836,3866,3970,1751,1917
E02006587,Crawley 013,Middle Super Output Areas and Intermediate Zones,MSOAIZ,RH,8380,4023,4357,1977,2093
E02006588,Horsham 001,Middle Super Output Areas and Intermediate Zones,MSOAIZ,RH,7481,3718,3763,1638,1687
E02006589,Horsham 002,Middle Super Output Areas and Intermediate Zones,MSOAIZ,RH,11206,5422,5784,2229,2473
E02006590,Horsham 003,Middle Super Output Areas and Intermediate Zones,MSOAIZ,RH,8598,4158,4440,1782,1928
E02006591,Horsham 004,Middle Super Output Areas and Intermediate Zones,MSOAIZ,RH,7986,3886,4100,1721,1791
E02006592,Horsham 005,Middle Super Output Areas and Intermediate Zones,MSOAIZ,RH,6342,3093,3249,1144,1232
E02006593,Horsham 006,Middle Super Output Areas and Intermediate Zones,MSOAIZ,RH,10460,5039,5421,2240,2259
E02006594,Horsham 007,Middle Super Output Areas and Intermediate Zones,MSOAIZ,RH,6701,3294,3407,1399,1439
E02006595,Horsham 008,Middle Super Output Areas and Intermediate Zones,MSOAIZ,RH,8519,4102,4417,1404,1539
E02006596,Horsham 009,Middle Super Output Areas and Intermediate Zones,MSOAIZ,RH,8692,4369,4323,1905,1973
E02006597,Horsham 010,Middle Super Output Areas and Intermediate Zones,MSOAIZ,RH,9379,4618,4761,1859,1954
E02006598,Horsham 011,Middle Super Output Areas and Intermediate Zones,MSOAIZ,RH,5500,2737,2763,1105,1147
E02006599,Horsham 012,Middle Super Output Areas and Intermediate Zones,MSOAIZ,RH,6984,3409,3575,1041,1093
E02006600,Horsham 013,Middle Super Output Areas and Intermediate Zones,MSOAIZ,RH,9278,4398,4880,1574,1725
E02006601,Horsham 014,Middle Super Output Areas and Intermediate Zones,MSOAIZ,RH,8133,3806,4327,1292,1517
E02006602,Horsham 015,Middle Super Output Areas and Intermediate Zones,MSOAIZ,RH,7466,3696,3770,1316,1483
E02006603,Horsham 016,Middle Super Output Areas and Intermediate Zones,MSOAIZ,BN,8576,4061,4515,1402,1571
E02006604,Mid Sussex 001,Middle Super Output Areas and Intermediate Zones,MSOAIZ,RH,12480,6052,6428,2677,2631
E02006605,Mid Sussex 002,Middle Super Output Areas and Intermediate Zones,MSOAIZ,RH,6527,3346,3181,1269,1294
E02006606,Mid Sussex 003,Middle Super Output Areas and Intermediate Zones,MSOAIZ,RH,8188,4075,4113,1669,1760
E02006607,Mid Sussex 004,Middle Super Output Areas and Intermediate Zones,MSOAIZ,RH,7548,3730,3818,1403,1492
E02006608,Mid Sussex 005,Middle Super Output Areas and Intermediate Zones,MSOAIZ,RH,5770,2838,2932,1004,1069
E02006609,Mid Sussex 006,Middle Super Output Areas and Intermediate Zones,MSOAIZ,RH,7178,3621,3557,1344,1337
E02006610,Mid Sussex 007,Middle Super Output Areas and Intermediate Zones,MSOAIZ,RH,7087,3510,3577,1428,1427
E02006611,Mid Sussex 008,Middle Super Output Areas and Intermediate Zones,MSOAIZ,RH,10153,4877,5276,1791,1934
E02006612,Mid Sussex 009,Middle Super Output Areas and Intermediate Zones,MSOAIZ,RH,10153,5016,5137,2527,2335
E02006613,Mid Sussex 010,Middle Super Output Areas and Intermediate Zones,MSOAIZ,RH,7218,3441,3777,1496,1613
E02006614,Mid Sussex 011,Middle Super Output Areas and Intermediate Zones,MSOAIZ,RH,10030,4893,5137,1963,2079
E02006615,Mid Sussex 012,Middle Super Output Areas and Intermediate Zones,MSOAIZ,RH,6773,3294,3479,1500,1612
E02006616,Mid Sussex 013,Middle Super Output Areas and Intermediate Zones,MSOAIZ,RH,8066,3946,4120,1552,1708
E02006617,Mid Sussex 014,Middle Super Output Areas and Intermediate Zones,MSOAIZ,RH,9083,4436,4647,1972,1996
E02006618,Mid Sussex 015,Middle Super Output Areas and Intermediate Zones,MSOAIZ,RH,6187,3010,3177,1127,1152
E02006619,Mid Sussex 016,Middle Super Output Areas and Intermediate Zones,MSOAIZ,RH,8226,4040,4186,1549,1715
E02006620,Mid Sussex 017,Middle Super Output Areas and Intermediate Zones,MSOAIZ,RH,9193,4337,4856,1570,1665
E02006621,Worthing 001,Middle Super Output Areas and Intermediate Zones,MSOAIZ,BN,7581,3648,3933,1195,1198
E02006622,Worthing 002,Middle Super Output Areas and Intermediate Zones,MSOAIZ,BN,7711,3767,3944,1410,1444
E02006623,Worthing 003,Middle Super Output Areas and Intermediate Zones,MSOAIZ,BN,7887,3748,4139,1430,1617
E02006624,Worthing 004,Middle Super Output Areas and Intermediate Zones,MSOAIZ,BN,7152,3506,3646,1368,1495
E02006625,Worthing 005,Middle Super Output Areas and Intermediate Zones,MSOAIZ,BN,8015,3895,4120,1747,1859
E02006626,Worthing 006,Middle Super Output Areas and Intermediate Zones,MSOAIZ,BN,7409,3571,3838,1465,1654
E02006627,Worthing 007,Middle Super Output Areas and Intermediate Zones,MSOAIZ,BN,8495,4107,4388,1586,1676
E02006628,Worthing 008,Middle Super Output Areas and Intermediate Zones,MSOAIZ,BN,9008,4336,4672,2003,2157
E02006629,Worthing 009,Middle Super Output Areas and Intermediate Zones,MSOAIZ,BN,7930,3806,4124,1556,1730
E02006630,Worthing 010,Middle Super Output Areas and Intermediate Zones,MSOAIZ,BN,8147,3860,4287,1798,1632
E02006631,Worthing 011,Middle Super Output Areas and Intermediate Zones,MSOAIZ,PO,9316,4644,4672,2446,2148
E02006632,Worthing 012,Middle Super Output Areas and Intermediate Zones,MSOAIZ,BN,7999,3783,4216,1434,1547
E02006633,Worthing 013,Middle Super Output Areas and Intermediate Zones,MSOAIZ,BN,7990,3713,4277,1151,1247
E02006634,Wiltshire 012,Middle Super Output Areas and Intermediate Zones,MSOAIZ,SN,8635,4239,4396,1634,1691
E02006635,Wiltshire 019,Middle Super Output Areas and Intermediate Zones,MSOAIZ,SN,8395,4039,4356,1397,1551
E02006636,Wiltshire 024,Middle Super Output Areas and Intermediate Zones,MSOAIZ,SN,6860,3306,3554,1340,1336
E02006637,Wiltshire 025,Middle Super Output Areas and Intermediate Zones,MSOAIZ,SN,10743,5190,5553,2226,2286
E02006638,Wiltshire 026,Middle Super Output Areas and Intermediate Zones,MSOAIZ,SN,6262,3023,3239,1165,1094
E02006639,Wiltshire 028,Middle Super Output Areas and Intermediate Zones,MSOAIZ,SN,8494,4320,4174,1711,1555
E02006640,Wiltshire 029,Middle Super Output Areas and Intermediate Zones,MSOAIZ,SP,7069,3503,3566,1336,1442
E02006641,Wiltshire 034,Middle Super Output Areas and Intermediate Zones,MSOAIZ,SN,7416,3620,3796,1325,1424
E02006642,Wiltshire 038,Middle Super Output Areas and Intermediate Zones,MSOAIZ,SP,5768,2832,2936,1161,1181
E02006643,Wiltshire 041,Middle Super Output Areas and Intermediate Zones,MSOAIZ,SP,15048,8767,6281,3762,2878
E02006644,Wiltshire 001,Middle Super Output Areas and Intermediate Zones,MSOAIZ,SN,6744,3314,3430,1221,1320
E02006645,Wiltshire 002,Middle Super Output Areas and Intermediate Zones,MSOAIZ,SN,7157,3560,3597,1459,1501
E02006646,Wiltshire 003,Middle Super Output Areas and Intermediate Zones,MSOAIZ,SN,5601,2719,2882,1011,1066
E02006647,Wiltshire 004,Middle Super Output Areas and Intermediate Zones,MSOAIZ,SN,5897,2956,2941,1087,1156
E02006648,Wiltshire 005,Middle Super Output Areas and Intermediate Zones,MSOAIZ,SN,5855,2849,3006,1123,1194
E02006649,Wiltshire 006,Middle Super Output Areas and Intermediate Zones,MSOAIZ,SN,6864,3382,3482,1401,1404
E02006650,Wiltshire 007,Middle Super Output Areas and Intermediate Zones,MSOAIZ,SN,11290,5729,5561,2494,2339
E02006651,Wiltshire 008,Middle Super Output Areas and Intermediate Zones,MSOAIZ,SN,7234,3658,3576,1426,1448
E02006652,Wiltshire 009,Middle Super Output Areas and Intermediate Zones,MSOAIZ,SN,9541,4689,4852,2026,2091
E02006653,Wiltshire 010,Middle Super Output Areas and Intermediate Zones,MSOAIZ,SN,9829,4843,4986,2032,2124
E02006654,Wiltshire 011,Middle Super Output Areas and Intermediate Zones,MSOAIZ,SN,9353,4570,4783,1905,1831
E02006655,Wiltshire 013,Middle Super Output Areas and Intermediate Zones,MSOAIZ,SN,7002,3422,3580,1302,1390
E02006656,Wiltshire 014,Middle Super Output Areas and Intermediate Zones,MSOAIZ,SN,7077,3560,3517,1674,1681
E02006657,Wiltshire 015,Middle Super Output Areas and Intermediate Zones,MSOAIZ,SN,10126,4855,5271,2085,2208
E02006658,Wiltshire 016,Middle Super Output Areas and Intermediate Zones,MSOAIZ,SN,7148,3472,3676,1411,1466
E02006659,Wiltshire 017,Middle Super Output Areas and Intermediate Zones,MSOAIZ,SN,7648,3885,3763,1563,1545
E02006660,Wiltshire 018,Middle Super Output Areas and Intermediate Zones,MSOAIZ,SN,13012,6248,6764,2428,2659
E02006661,Wiltshire 045,Middle Super Output Areas and Intermediate Zones,MSOAIZ,SP,9193,5220,3973,2430,1854
E02006662,Wiltshire 046,Middle Super Output Areas and Intermediate Zones,MSOAIZ,SP,5917,2950,2967,1162,1230
E02006663,Wiltshire 048,Middle Super Output Areas and Intermediate Zones,MSOAIZ,SP,10724,5250,5474,2295,2395
E02006664,Wiltshire 049,Middle Super Output Areas and Intermediate Zones,MSOAIZ,SP,6526,3211,3315,1169,1240
E02006665,Wiltshire 050,Middle Super Output Areas and Intermediate Zones,MSOAIZ,SP,6560,3185,3375,1007,1124
E02006666,Wiltshire 051,Middle Super Output Areas and Intermediate Zones,MSOAIZ,SP,5645,2667,2978,1061,1193
E02006667,Wiltshire 052,Middle Super Output Areas and Intermediate Zones,MSOAIZ,SP,6369,3065,3304,1239,1403
E02006668,Wiltshire 053,Middle Super Output Areas and Intermediate Zones,MSOAIZ,SP,6104,2965,3139,1094,1137
E02006669,Wiltshire 054,Middle Super Output Areas and Intermediate Zones,MSOAIZ,SP,9710,4623,5087,1731,1896
E02006670,Wiltshire 055,Middle Super Output Areas and Intermediate Zones,MSOAIZ,SP,6712,3343,3369,1617,1516
E02006671,Wiltshire 056,Middle Super Output Areas and Intermediate Zones,MSOAIZ,SP,6137,2912,3225,1363,1262
E02006672,Wiltshire 057,Middle Super Output Areas and Intermediate Zones,MSOAIZ,SP,6652,3122,3530,1164,1296
E02006673,Wiltshire 058,Middle Super Output Areas and Intermediate Zones,MSOAIZ,SP,5003,2356,2647,882,844
E02006674,Wiltshire 059,Middle Super Output Areas and Intermediate Zones,MSOAIZ,SP,5712,2674,3038,1098,1201
E02006675,Wiltshire 060,Middle Super Output Areas and Intermediate Zones,MSOAIZ,SP,7909,3789,4120,1374,1512
E02006676,Wiltshire 061,Middle Super Output Areas and Intermediate Zones,MSOAIZ,SP,6119,2869,3250,941,1042
E02006677,Wiltshire 062,Middle Super Output Areas and Intermediate Zones,MSOAIZ,SP,7792,3772,4020,1269,1376
E02006678,Wiltshire 020,Middle Super Output Areas and Intermediate Zones,MSOAIZ,SN,7344,3625,3719,1413,1486
E02006679,Wiltshire 021,Middle Super Output Areas and Intermediate Zones,MSOAIZ,SN,9744,4773,4971,1788,1901
E02006680,Wiltshire 022,Middle Super Output Areas and Intermediate Zones,MSOAIZ,SN,7333,3599,3734,1409,1397
E02006681,Wiltshire 023,Middle Super Output Areas and Intermediate Zones,MSOAIZ,SN,5936,2838,3098,948,1045
E02006682,Wiltshire 027,Middle Super Output Areas and Intermediate Zones,MSOAIZ,BA,9402,4431,4971,1585,1716
E02006683,Wiltshire 030,Middle Super Output Areas and Intermediate Zones,MSOAIZ,BA,7765,3817,3948,1616,1697
E02006684,Wiltshire 031,Middle Super Output Areas and Intermediate Zones,MSOAIZ,BA,6166,3060,3106,1404,1329
E02006685,Wiltshire 032,Middle Super Output Areas and Intermediate Zones,MSOAIZ,BA,7699,3718,3981,1531,1546
E02006686,Wiltshire 033,Middle Super Output Areas and Intermediate Zones,MSOAIZ,BA,5481,2652,2829,971,1034
E02006687,Wiltshire 035,Middle Super Output Areas and Intermediate Zones,MSOAIZ,BA,7289,3578,3711,1526,1641
E02006688,Wiltshire 036,Middle Super Output Areas and Intermediate Zones,MSOAIZ,BA,5669,2787,2882,1205,1206
E02006689,Wiltshire 037,Middle Super Output Areas and Intermediate Zones,MSOAIZ,SN,6267,3038,3229,1084,1149
E02006690,Wiltshire 039,Middle Super Output Areas and Intermediate Zones,MSOAIZ,BA,6716,3291,3425,1194,1233
E02006691,Wiltshire 040,Middle Super Output Areas and Intermediate Zones,MSOAIZ,BA,13490,6512,6978,2734,2878
E02006692,Wiltshire 042,Middle Super Output Areas and Intermediate Zones,MSOAIZ,BA,5697,2796,2901,1139,1093
E02006693,Wiltshire 043,Middle Super Output Areas and Intermediate Zones,MSOAIZ,BA,5728,2773,2955,1092,1184
E02006694,Wiltshire 044,Middle Super Output Areas and Intermediate Zones,MSOAIZ,BA,6065,2909,3156,1099,1138
E02006695,Wiltshire 047,Middle Super Output Areas and Intermediate Zones,MSOAIZ,SP,6338,3034,3304,1047,1178
E02006696,Bromsgrove 001,Middle Super Output Areas and Intermediate Zones,MSOAIZ,DY,6270,3022,3248,1060,1171
E02006697,Bromsgrove 002,Middle Super Output Areas and Intermediate Zones,MSOAIZ,DY,7266,3623,3643,1278,1342
E02006698,Bromsgrove 003,Middle Super Output Areas and Intermediate Zones,MSOAIZ,B,6491,3202,3289,1177,1225
E02006699,Bromsgrove 004,Middle Super Output Areas and Intermediate Zones,MSOAIZ,B,5939,2886,3053,1021,1066
E02006700,Bromsgrove 005,Middle Super Output Areas and Intermediate Zones,MSOAIZ,B,5739,2782,2957,957,1037
E02006701,Bromsgrove 006,Middle Super Output Areas and Intermediate Zones,MSOAIZ,B,6033,2956,3077,1036,1126
E02006702,Bromsgrove 007,Middle Super Output Areas and Intermediate Zones,MSOAIZ,B,5808,2849,2959,1121,1177
E02006703,Bromsgrove 008,Middle Super Output Areas and Intermediate Zones,MSOAIZ,B,7174,3532,3642,1324,1441
E02006704,Bromsgrove 009,Middle Super Output Areas and Intermediate Zones,MSOAIZ,B,6564,3193,3371,1176,1229
E02006705,Bromsgrove 010,Middle Super Output Areas and Intermediate Zones,MSOAIZ,B,6696,3242,3454,1367,1453
E02006706,Bromsgrove 011,Middle Super Output Areas and Intermediate Zones,MSOAIZ,B,6804,3290,3514,1206,1260
E02006707,Bromsgrove 012,Middle Super Output Areas and Intermediate Zones,MSOAIZ,B,6867,3317,3550,1369,1476
E02006708,Bromsgrove 013,Middle Super Output Areas and Intermediate Zones,MSOAIZ,B,8102,3950,4152,1711,1779
E02006709,Bromsgrove 014,Middle Super Output Areas and Intermediate Zones,MSOAIZ,B,7884,4456,3428,2096,1438
E02006710,Malvern Hills 001,Middle Super Output Areas and Intermediate Zones,MSOAIZ,WR,7867,3887,3980,1286,1354
E02006711,Malvern Hills 002,Middle Super Output Areas and Intermediate Zones,MSOAIZ,WR,7847,3886,3961,1309,1384
E02006712,Malvern Hills 003,Middle Super Output Areas and Intermediate Zones,MSOAIZ,WR,6929,3450,3479,1167,1250
E02006713,Malvern Hills 004,Middle Super Output Areas and Intermediate Zones,MSOAIZ,WR,6155,2933,3222,1144,1186
E02006714,Malvern Hills 005,Middle Super Output Areas and Intermediate Zones,MSOAIZ,WR,5262,2560,2702,844,908
E02006715,Malvern Hills 006,Middle Super Output Areas and Intermediate Zones,MSOAIZ,WR,8223,4080,4143,1596,1630
E02006716,Malvern Hills 007,Middle Super Output Areas and Intermediate Zones,MSOAIZ,WR,6425,3106,3319,1172,1242
E02006717,Malvern Hills 008,Middle Super Output Areas and Intermediate Zones,MSOAIZ,WR,5691,2712,2979,886,1028
E02006718,Malvern Hills 009,Middle Super Output Areas and Intermediate Zones,MSOAIZ,WR,6131,2810,3321,919,978
E02006719,Malvern Hills 010,Middle Super Output Areas and Intermediate Zones,MSOAIZ,WR,7273,3604,3669,1217,1169
E02006720,Malvern Hills 011,Middle Super Output Areas and Intermediate Zones,MSOAIZ,WR,6828,3308,3520,1132,1196
E02006721,Redditch 001,Middle Super Output Areas and Intermediate Zones,MSOAIZ,B,5705,2822,2883,1082,1143
E02006722,Redditch 002,Middle Super Output Areas and Intermediate Zones,MSOAIZ,B,5489,2702,2787,1180,1234
E02006723,Redditch 003,Middle Super Output Areas and Intermediate Zones,MSOAIZ,B,8282,4030,4252,1848,1879
E02006724,Redditch 004,Middle Super Output Areas and Intermediate Zones,MSOAIZ,B,6878,3600,3278,1667,1455
E02006725,Redditch 005,Middle Super Output Areas and Intermediate Zones,MSOAIZ,B,5662,2836,2826,1220,1237
E02006726,Redditch 006,Middle Super Output Areas and Intermediate Zones,MSOAIZ,B,6411,3247,3164,1410,1336
E02006727,Redditch 007,Middle Super Output Areas and Intermediate Zones,MSOAIZ,B,6083,3060,3023,1194,1177
E02006728,Redditch 008,Middle Super Output Areas and Intermediate Zones,MSOAIZ,B,7060,3404,3656,1400,1424
E02006729,Redditch 009,Middle Super Output Areas and Intermediate Zones,MSOAIZ,B,7282,3657,3625,1444,1545
E02006730,Redditch 010,Middle Super Output Areas and Intermediate Zones,MSOAIZ,B,6188,3081,3107,1282,1330
E02006731,Redditch 011,Middle Super Output Areas and Intermediate Zones,MSOAIZ,B,5829,2788,3041,1163,1249
E02006732,Redditch 012,Middle Super Output Areas and Intermediate Zones,MSOAIZ,B,7293,3639,3654,1466,1527
E02006733,Redditch 013,Middle Super Output Areas and Intermediate Zones,MSOAIZ,B,6052,2982,3070,1204,1238
E02006734,Worcester 001,Middle Super Output Areas and Intermediate Zones,MSOAIZ,WR,8175,3991,4184,1621,1647
E02006735,Worcester 002,Middle Super Output Areas and Intermediate Zones,MSOAIZ,WR,5205,2516,2689,1025,1043
E02006736,Worcester 003,Middle Super Output Areas and Intermediate Zones,MSOAIZ,WR,6734,3356,3378,1740,1735
E02006737,Worcester 004,Middle Super Output Areas and Intermediate Zones,MSOAIZ,WR,7803,3798,4005,1735,1742
E02006738,Worcester 005,Middle Super Output Areas and Intermediate Zones,MSOAIZ,WR,8966,4427,4539,1804,1955
E02006739,Worcester 006,Middle Super Output Areas and Intermediate Zones,MSOAIZ,WR,5912,2820,3092,853,837
E02006740,Worcester 007,Middle Super Output Areas and Intermediate Zones,MSOAIZ,WR,6979,3556,3423,1815,1544
E02006741,Worcester 008,Middle Super Output Areas and Intermediate Zones,MSOAIZ,WR,5639,2742,2897,1354,1432
E02006742,Worcester 009,Middle Super Output Areas and Intermediate Zones,MSOAIZ,WR,8420,4128,4292,1476,1520
E02006743,Worcester 010,Middle Super Output Areas and Intermediate Zones,MSOAIZ,WR,6560,3210,3350,1323,1371
E02006744,Worcester 011,Middle Super Output Areas and Intermediate Zones,MSOAIZ,WR,7015,3591,3424,1799,1524
E02006745,Worcester 012,Middle Super Output Areas and Intermediate Zones,MSOAIZ,WR,7890,3883,4007,1468,1488
E02006746,Worcester 013,Middle Super Output Areas and Intermediate Zones,MSOAIZ,WR,7619,3730,3889,1613,1591
E02006747,Worcester 014,Middle Super Output Areas and Intermediate Zones,MSOAIZ,WR,5851,2815,3036,1305,1427
E02006748,Wychavon 001,Middle Super Output Areas and Intermediate Zones,MSOAIZ,WR,6662,3279,3383,1199,1294
E02006749,Wychavon 002,Middle Super Output Areas and Intermediate Zones,MSOAIZ,WR,5384,2585,2799,1040,1156
E02006750,Wychavon 003,Middle Super Output Areas and Intermediate Zones,MSOAIZ,WR,5430,2611,2819,948,997
E02006751,Wychavon 004,Middle Super Output Areas and Intermediate Zones,MSOAIZ,WR,5927,2822,3105,1069,1151
E02006752,Wychavon 005,Middle Super Output Areas and Intermediate Zones,MSOAIZ,WR,6763,3323,3440,1240,1375
E02006753,Wychavon 006,Middle Super Output Areas and Intermediate Zones,MSOAIZ,WR,6301,3172,3129,1107,1178
E02006754,Wychavon 007,Middle Super Output Areas and Intermediate Zones,MSOAIZ,WR,5475,2705,2770,950,1068
E02006755,Wychavon 008,Middle Super Output Areas and Intermediate Zones,MSOAIZ,WR,5374,2673,2701,915,932
E02006756,Wychavon 009,Middle Super Output Areas and Intermediate Zones,MSOAIZ,WR,5366,2595,2771,1069,1170
E02006757,Wychavon 010,Middle Super Output Areas and Intermediate Zones,MSOAIZ,WR,6840,3355,3485,1095,1201
E02006758,Wychavon 011,Middle Super Output Areas and Intermediate Zones,MSOAIZ,WR,5628,2959,2669,1267,1051
E02006759,Wychavon 012,Middle Super Output Areas and Intermediate Zones,MSOAIZ,WR,7065,3438,3627,1201,1196
E02006760,Wychavon 013,Middle Super Output Areas and Intermediate Zones,MSOAIZ,WR,7923,3887,4036,1397,1498
E02006761,Wychavon 014,Middle Super Output Areas and Intermediate Zones,MSOAIZ,WR,5833,2886,2947,1362,1220
E02006762,Wychavon 015,Middle Super Output Areas and Intermediate Zones,MSOAIZ,WR,5713,2793,2920,1108,1120
E02006763,Wychavon 016,Middle Super Output Areas and Intermediate Zones,MSOAIZ,WR,6467,3202,3265,1292,1335
E02006764,Wychavon 017,Middle Super Output Areas and Intermediate Zones,MSOAIZ,WR,5415,2662,2753,1205,1193
E02006765,Wychavon 018,Middle Super Output Areas and Intermediate Zones,MSOAIZ,WR,5872,2810,3062,953,1020
E02006766,Wychavon 019,Middle Super Output Areas and Intermediate Zones,MSOAIZ,WR,7506,3688,3818,1278,1374
E02006767,Wyre Forest 001,Middle Super Output Areas and Intermediate Zones,MSOAIZ,WR,8848,4448,4400,1447,1567
E02006768,Wyre Forest 002,Middle Super Output Areas and Intermediate Zones,MSOAIZ,DY,6790,3333,3457,1254,1306
E02006769,Wyre Forest 003,Middle Super Output Areas and Intermediate Zones,MSOAIZ,DY,7171,3521,3650,1458,1468
E02006770,Wyre Forest 004,Middle Super Output Areas and Intermediate Zones,MSOAIZ,DY,7166,3562,3604,1564,1506
E02006771,Wyre Forest 005,Middle Super Output Areas and Intermediate Zones,MSOAIZ,DY,6576,3248,3328,1123,1180
E02006772,Wyre Forest 006,Middle Super Output Areas and Intermediate Zones,MSOAIZ,DY,6445,3118,3327,1158,1181
E02006773,Wyre Forest 007,Middle Super Output Areas and Intermediate Zones,MSOAIZ,DY,8301,4017,4284,1497,1560
E02006774,Wyre Forest 008,Middle Super Output Areas and Intermediate Zones,MSOAIZ,DY,7482,3737,3745,1601,1577
E02006775,Wyre Forest 009,Middle Super Output Areas and Intermediate Zones,MSOAIZ,DY,5164,2590,2574,993,1000
E02006776,Wyre Forest 010,Middle Super Output Areas and Intermediate Zones,MSOAIZ,WV,6579,3259,3320,1305,1396
E02006777,Wyre Forest 011,Middle Super Output Areas and Intermediate Zones,MSOAIZ,WR,7161,3551,3610,1192,1218
E02006778,Wyre Forest 012,Middle Super Output Areas and Intermediate Zones,MSOAIZ,DY,6879,3280,3599,1193,1256
E02006779,Wyre Forest 013,Middle Super Output Areas and Intermediate Zones,MSOAIZ,DY,7622,3806,3816,1560,1526
E02006780,Wyre Forest 014,Middle Super Output Areas and Intermediate Zones,MSOAIZ,DY,5791,2829,2962,965,993
E02006781,Isles of Scilly 001,Middle Super Output Areas and Intermediate Zones,MSOAIZ,TR,2203,1102,1101,443,449
E02006782,Bromley 040,Middle Super Output Areas and Intermediate Zones,MSOAIZ,BR,7648,3630,4018,1421,1638
E02006783,Lewisham 037,Middle Super Output Areas and Intermediate Zones,MSOAIZ,SE,7208,3333,3875,1362,1765
E02006784,Lewisham 038,Middle Super Output Areas and Intermediate Zones,MSOAIZ,SE,7359,3434,3925,1442,1642
E02006785,Bexley 029,Middle Super Output Areas and Intermediate Zones,MSOAIZ,DA,6384,3073,3311,1191,1325
E02006786,Greenwich 033,Middle Super Output Areas and Intermediate Zones,MSOAIZ,SE,6894,3445,3449,1501,1548
E02006787,Bromley 041,Middle Super Output Areas and Intermediate Zones,MSOAIZ,BR,7594,3632,3962,1600,1792
E02006788,Croydon 045,Middle Super Output Areas and Intermediate Zones,MSOAIZ,SE,7520,3438,4082,1404,1892
E02006789,Bromley 042,Middle Super Output Areas and Intermediate Zones,MSOAIZ,TN,6428,3137,3291,1111,1161
E02006790,Tandridge 012,Middle Super Output Areas and Intermediate Zones,MSOAIZ,TN,7447,3577,3870,1351,1469
E02006791,Ealing 040,Middle Super Output Areas and Intermediate Zones,MSOAIZ,W,6711,3314,3397,1850,1934
E02006792,Hounslow 029,Middle Super Output Areas and Intermediate Zones,MSOAIZ,W,8393,4166,4227,2436,2268
E02006793,Enfield 037,Middle Super Output Areas and Intermediate Zones,MSOAIZ,N,8908,4147,4761,1823,2188
E02006794,Haringey 037,Middle Super Output Areas and Intermediate Zones,MSOAIZ,N,7306,3558,3748,1593,1747
E02006795,Harrow 032,Middle Super Output Areas and Intermediate Zones,MSOAIZ,HA,8124,4040,4084,1836,1804
E02006796,Hillingdon 033,Middle Super Output Areas and Intermediate Zones,MSOAIZ,UB,8438,4082,4356,1849,1939
E02006798,Lewisham 039,Middle Super Output Areas and Intermediate Zones,MSOAIZ,SE,7548,3780,3768,1962,1859
E02006799,Barking and Dagenham 023,Middle Super Output Areas and Intermediate Zones,MSOAIZ,RM,9756,4653,5103,2012,2232
E02006800,Redbridge 034,Middle Super Output Areas and Intermediate Zones,MSOAIZ,RM,13069,6636,6433,3039,2888
E02006801,Lambeth 036,Middle Super Output Areas and Intermediate Zones,MSOAIZ,SE,8081,4238,3843,2351,1821
E02006802,Southwark 034,Middle Super Output Areas and Intermediate Zones,MSOAIZ,SE,7689,3960,3729,2016,1696
E02006803,Sheffield 072,Middle Super Output Areas and Intermediate Zones,MSOAIZ,S,8798,4368,4430,1946,2000
E02006804,North East Derbyshire 014,Middle Super Output Areas and Intermediate Zones,MSOAIZ,S,8153,3993,4160,1646,1655
E02006805,Coventry 043,Middle Super Output Areas and Intermediate Zones,MSOAIZ,CV,8230,3966,4264,1607,1862
E02006806,Nuneaton and Bedworth 018,Middle Super Output Areas and Intermediate Zones,MSOAIZ,CV,8006,3846,4160,1580,1609
E02006807,Birmingham 132,Middle Super Output Areas and Intermediate Zones,MSOAIZ,B,7903,3874,4029,1615,1714
E02006808,Solihull 030,Middle Super Output Areas and Intermediate Zones,MSOAIZ,B,6100,2952,3148,1233,1359
E02006809,Birmingham 133,Middle Super Output Areas and Intermediate Zones,MSOAIZ,B,10032,4890,5142,2078,2206
E02006810,Sandwell 039,Middle Super Output Areas and Intermediate Zones,MSOAIZ,B,10032,4950,5082,2029,1936
E02006811,Middlesbrough 020,Middle Super Output Areas and Intermediate Zones,MSOAIZ,TS,9594,4660,4934,1739,1800
E02006812,Redcar and Cleveland 021,Middle Super Output Areas and Intermediate Zones,MSOAIZ,TS,7353,3519,3834,1238,1406
E02006813,Kingston upon Hull 033,Middle Super Output Areas and Intermediate Zones,MSOAIZ,HU,8220,3939,4281,1498,1559
E02006814,East Riding of Yorkshire 043,Middle Super Output Areas and Intermediate Zones,MSOAIZ,HU,8283,4000,4283,1550,1694
E02006815,Leicester 037,Middle Super Output Areas and Intermediate Zones,MSOAIZ,LE,9184,4393,4791,1526,1817
E02006816,Harborough 011,Middle Super Output Areas and Intermediate Zones,MSOAIZ,LE,6980,3436,3544,1236,1262
E02006817,Leicester 038,Middle Super Output Areas and Intermediate Zones,MSOAIZ,LE,8111,3955,4156,1604,1653
E02006818,Oadby and Wigston 008,Middle Super Output Areas and Intermediate Zones,MSOAIZ,LE,8255,4014,4241,1573,1625
E02006819,Leicester 039,Middle Super Output Areas and Intermediate Zones,MSOAIZ,LE,8109,3897,4212,1527,1726
E02006820,Blaby 013,Middle Super Output Areas and Intermediate Zones,MSOAIZ,LE,9643,4771,4872,1751,1796
E02006821,Portsmouth 026,Middle Super Output Areas and Intermediate Zones,MSOAIZ,PO,6545,3225,3320,1273,1323
E02006822,Havant 018,Middle Super Output Areas and Intermediate Zones,MSOAIZ,PO,8763,4313,4450,1652,1667
E02006823,Chiltern 013,Middle Super Output Areas and Intermediate Zones,MSOAIZ,HP,8549,4116,4433,1467,1619
E02006824,Wycombe 024,Middle Super Output Areas and Intermediate Zones,MSOAIZ,HP,9623,4651,4972,1715,1905
E02006825,East Cambridgeshire 011,Middle Super Output Areas and Intermediate Zones,MSOAIZ,CB,6355,3155,3200,1219,1301
E02006826,Forest Heath 008,Middle Super Output Areas and Intermediate Zones,MSOAIZ,CB,9579,4746,4833,2176,2016
E02006827,Amber Valley 017,Middle Super Output Areas and Intermediate Zones,MSOAIZ,NG,7643,3721,3922,1403,1498
E02006828,Erewash 016,Middle Super Output Areas and Intermediate Zones,MSOAIZ,DE,6797,3354,3443,1552,1555
E02006829,East Hampshire 016,Middle Super Output Areas and Intermediate Zones,MSOAIZ,PO,6551,3155,3396,1111,1188
E02006830,Havant 019,Middle Super Output Areas and Intermediate Zones,MSOAIZ,PO,6711,3321,3390,1328,1345
E02006831,Havant 020,Middle Super Output Areas and Intermediate Zones,MSOAIZ,PO,6224,3028,3196,1089,1113
E02006832,Sevenoaks 016,Middle Super Output Areas and Intermediate Zones,MSOAIZ,TN,6165,2968,3197,1179,1231
E02006833,Tonbridge and Malling 014,Middle Super Output Areas and Intermediate Zones,MSOAIZ,TN,10207,4933,5274,1884,2014
E02006834,Nottingham 038,Middle Super Output Areas and Intermediate Zones,MSOAIZ,NG,7711,3658,4053,1462,1562
E02006835,Gedling 016,Middle Super Output Areas and Intermediate Zones,MSOAIZ,NG,5883,2842,3041,1161,1295
E02006836,Sutton 025,Middle Super Output Areas and Intermediate Zones,MSOAIZ,SM,8270,4003,4267,1624,1640
E02006837,Epsom and Ewell 010,Middle Super Output Areas and Intermediate Zones,MSOAIZ,SM,10548,5110,5438,2006,2032
E02006838,East Hampshire 017,Middle Super Output Areas and Intermediate Zones,MSOAIZ,GU,6596,3180,3416,1110,1202
E02006839,Waverley 018,Middle Super Output Areas and Intermediate Zones,MSOAIZ,GU,8381,4115,4266,1568,1618
E02006840,Torbay 019,Middle Super Output Areas and Intermediate Zones,MSOAIZ,TQ,10636,5086,5550,1852,1983
E02006841,Gateshead 027,Middle Super Output Areas and Intermediate Zones,MSOAIZ,NE,7487,3971,3516,2230,1581
E02006842,Gateshead 028,Middle Super Output Areas and Intermediate Zones,MSOAIZ,NE,5328,2690,2638,1171,1088
E02006843,Sheffield 073,Middle Super Output Areas and Intermediate Zones,MSOAIZ,S,9256,4925,4331,1662,1266
E02006844,Sheffield 074,Middle Super Output Areas and Intermediate Zones,MSOAIZ,S,8734,4615,4119,1444,1064
E02006845,North Somerset 026,Middle Super Output Areas and Intermediate Zones,MSOAIZ,BS,7970,3897,4073,1748,1836
E02006846,North Somerset 027,Middle Super Output Areas and Intermediate Zones,MSOAIZ,BS,7104,3456,3648,1689,1797
E02006847,Swindon 026,Middle Super Output Areas and Intermediate Zones,MSOAIZ,SN,9257,4659,4598,2624,2542
E02006848,Swindon 027,Middle Super Output Areas and Intermediate Zones,MSOAIZ,SN,6789,3431,3358,1980,1855
E02006849,Swindon 028,Middle Super Output Areas and Intermediate Zones,MSOAIZ,SN,9028,4525,4503,2401,2373
E02006850,Leicester 040,Middle Super Output Areas and Intermediate Zones,MSOAIZ,LE,9855,4769,5086,1733,1014
E02006851,Leicester 041,Middle Super Output Areas and Intermediate Zones,MSOAIZ,LE,6032,3213,2819,1557,867
E02006852,Leeds 109,Middle Super Output Areas and Intermediate Zones,MSOAIZ,LS,12417,6152,6265,2395,2084
E02006853,Tower Hamlets 032,Middle Super Output Areas and Intermediate Zones,MSOAIZ,E,7064,3680,3384,2217,1890
E02006854,Tower Hamlets 033,Middle Super Output Areas and Intermediate Zones,MSOAIZ,E,5883,3251,2632,2205,1661
E02006855,Canterbury 019,Middle Super Output Areas and Intermediate Zones,MSOAIZ,CT,5941,2843,3098,1168,1260
E02006856,Canterbury 020,Middle Super Output Areas and Intermediate Zones,MSOAIZ,CT,10873,5190,5683,1942,1843
E02006857,Eastbourne 013,Middle Super Output Areas and Intermediate Zones,MSOAIZ,BN,8500,4073,4427,1519,1568
E02006858,Eastbourne 014,Middle Super Output Areas and Intermediate Zones,MSOAIZ,BN,6971,3474,3497,1414,1472
E02006859,Thurrock 019,Middle Super Output Areas and Intermediate Zones,MSOAIZ,RM,7384,3646,3738,2062,2086
E02006860,Oldham 035,Middle Super Output Areas and Intermediate Zones,MSOAIZ,OL,13909,7017,6892,2871,2638
E02006861,Leeds 110,Middle Super Output Areas and Intermediate Zones,MSOAIZ,LS,12512,6126,6386,1660,1219
E02006862,Corby 008,Middle Super Output Areas and Intermediate Zones,MSOAIZ,NN,6112,3014,3098,1284,1351
E02006863,Corby 009,Middle Super Output Areas and Intermediate Zones,MSOAIZ,NN,9384,4658,4726,2485,2405
E02006864,Boston 008,Middle Super Output Areas and Intermediate Zones,MSOAIZ,PE,8003,3805,4198,1422,1558
E02006865,Boston 009,Middle Super Output Areas and Intermediate Zones,MSOAIZ,PE,7331,3555,3776,1312,1385
E02006866,North Kesteven 013,Middle Super Output Areas and Intermediate Zones,MSOAIZ,LN,6473,3143,3330,1188,1302
E02006867,North Kesteven 014,Middle Super Output Areas and Intermediate Zones,MSOAIZ,LN,7411,3604,3807,1278,1360
E02006868,Sheffield 075,Middle Super Output Areas and Intermediate Zones,MSOAIZ,S,12161,6481,5680,2894,2234
E02006869,Sheffield 076,Middle Super Output Areas and Intermediate Zones,MSOAIZ,S,11191,5392,5799,2217,2360
E02006870,Ryedale 008,Middle Super Output Areas and Intermediate Zones,MSOAIZ,YO,12275,6005,6270,2365,2363
E02006871,Lancaster 020,Middle Super Output Areas and Intermediate Zones,MSOAIZ,LA,11927,5741,6186,2154,2326
E02006872,High Peak 013,Middle Super Output Areas and Intermediate Zones,MSOAIZ,SK,12511,6206,6305,2369,2371
E02006873,South Cambridgeshire 020,Middle Super Output Areas and Intermediate Zones,MSOAIZ,CB,7185,3582,3603,1898,1951
E02006874,South Cambridgeshire 021,Middle Super Output Areas and Intermediate Zones,MSOAIZ,PE,8037,3977,4060,1779,1826
E02006875,Leeds 111,Middle Super Output Areas and Intermediate Zones,MSOAIZ,LS,7484,4122,3362,2255,1471
E02006876,Leeds 112,Middle Super Output Areas and Intermediate Zones,MSOAIZ,LS,7145,3646,3499,1894,1574
E02006877,Peterborough 022,Middle Super Output Areas and Intermediate Zones,MSOAIZ,PE,7901,3830,4071,1711,1792
E02006878,Peterborough 023,Middle Super Output Areas and Intermediate Zones,MSOAIZ,PE,9052,4514,4538,2215,2332
E02006879,Shepway 014,Middle Super Output Areas and Intermediate Zones,MSOAIZ,CT,6698,3730,2968,1858,1207
E02006880,Shepway 015,Middle Super Output Areas and Intermediate Zones,MSOAIZ,CT,6920,3493,3427,1615,1209
E02006881,Burnley 014,Middle Super Output Areas and Intermediate Zones,MSOAIZ,BB,9961,4822,5139,1914,1983
E02006882,Harrow 033,Middle Super Output Areas and Intermediate Zones,MSOAIZ,HA,14174,7009,7165,3029,3104
E02006883,Bournemouth 023,Middle Super Output Areas and Intermediate Zones,MSOAIZ,BH,5469,2717,2752,1518,1164
E02006884,Rossendale 010,Middle Super Output Areas and Intermediate Zones,MSOAIZ,OL,12081,5955,6126,2448,2438
E02006885,Bournemouth 024,Middle Super Output Areas and Intermediate Zones,MSOAIZ,BH,7007,3584,3423,1873,1464
E02006886,Vale of White Horse 016,Middle Super Output Areas and Intermediate Zones,MSOAIZ,SN,11023,5499,5524,2255,2285
E02006887,Bristol 054,Middle Super Output Areas and Intermediate Zones,MSOAIZ,BS,6634,3696,2938,1966,1214
E02006888,Bristol 055,Middle Super Output Areas and Intermediate Zones,MSOAIZ,BS,6824,3539,3285,1667,1439
E02006889,Bristol 056,Middle Super Output Areas and Intermediate Zones,MSOAIZ,BS,7347,3738,3609,1577,1506
E02006890,Bristol 057,Middle Super Output Areas and Intermediate Zones,MSOAIZ,BS,8568,4313,4255,2150,2067
E02006891,East Riding of Yorkshire 044,Middle Super Output Areas and Intermediate Zones,MSOAIZ,YO,7477,3629,3848,1443,1468
E02006892,East Riding of Yorkshire 045,Middle Super Output Areas and Intermediate Zones,MSOAIZ,YO,6474,3097,3377,1226,1226
E02006893,Newcastle upon Tyne 031,Middle Super Output Areas and Intermediate Zones,MSOAIZ,NE,10714,5151,5563,1860,1969
E02006894,Wolverhampton 035,Middle Super Output Areas and Intermediate Zones,MSOAIZ,WV,12100,6077,6023,2584,2443
E02006895,Birmingham 134,Middle Super Output Areas and Intermediate Zones,MSOAIZ,B,7273,3683,3590,1757,1459
E02006896,Birmingham 135,Middle Super Output Areas and Intermediate Zones,MSOAIZ,B,5268,3125,2143,1844,1074
E02006897,Birmingham 136,Middle Super Output Areas and Intermediate Zones,MSOAIZ,B,6376,3478,2898,1809,1344
E02006898,Birmingham 137,Middle Super Output Areas and Intermediate Zones,MSOAIZ,B,6184,3373,2811,1997,1541
E02006899,Birmingham 138,Middle Super Output Areas and Intermediate Zones,MSOAIZ,B,5547,3240,2307,2095,1284
E02006900,Birmingham 139,Middle Super Output Areas and Intermediate Zones,MSOAIZ,B,14713,7335,7378,2809,2845
E02006901,Birmingham 140,Middle Super Output Areas and Intermediate Zones,MSOAIZ,B,14402,7330,7072,2965,2886
E02006902,Manchester 054,Middle Super Output Areas and Intermediate Zones,MSOAIZ,M,6061,3339,2722,2140,1511
E02006903,Bassetlaw 016,Middle Super Output Areas and Intermediate Zones,MSOAIZ,S,11064,5314,5750,1989,2122
E02006904,Nottingham 039,Middle Super Output Areas and Intermediate Zones,MSOAIZ,NG,7050,4029,3021,2157,1337
E02006905,Nottingham 040,Middle Super Output Areas and Intermediate Zones,MSOAIZ,NG,7619,4008,3611,1884,1519
E02006906,Broxtowe 016,Middle Super Output Areas and Intermediate Zones,MSOAIZ,NG,12516,6256,6260,2552,2560
E02006907,Norwich 014,Middle Super Output Areas and Intermediate Zones,MSOAIZ,NR,5136,2738,2398,1677,1145
E02006908,Norwich 015,Middle Super Output Areas and Intermediate Zones,MSOAIZ,NR,5421,2730,2691,1453,1250
E02006909,Hartlepool 014,Middle Super Output Areas and Intermediate Zones,MSOAIZ,TS,11869,5777,6092,2161,2297
E02006910,Redcar and Cleveland 022,Middle Super Output Areas and Intermediate Zones,MSOAIZ,TS,10070,4862,5208,1815,2012
E02006911,Oadby and Wigston 009,Middle Super Output Areas and Intermediate Zones,MSOAIZ,LE,15671,7686,7985,2611,2925
E02006912,Manchester 055,Middle Super Output Areas and Intermediate Zones,MSOAIZ,WA,8827,4856,3971,2474,1486
E02006913,Manchester 056,Middle Super Output Areas and Intermediate Zones,MSOAIZ,M,6679,3579,3100,1874,1397
E02006914,Manchester 057,Middle Super Output Areas and Intermediate Zones,MSOAIZ,M,6935,3775,3160,1377,821
E02006915,Manchester 058,Middle Super Output Areas and Intermediate Zones,MSOAIZ,M,8720,4712,4008,2463,1856
E02006916,Manchester 059,Middle Super Output Areas and Intermediate Zones,MSOAIZ,M,5749,3219,2530,2116,1452
E02006917,Manchester 060,Middle Super Output Areas and Intermediate Zones,MSOAIZ,M,5063,2987,2076,2005,1304
E02006918,Hackney 028,Middle Super Output Areas and Intermediate Zones,MSOAIZ,E,7611,3724,3887,1836,1926
E02006919,South Derbyshire 012,Middle Super Output Areas and Intermediate Zones,MSOAIZ,DE,8529,4247,4282,2051,1954
E02006920,South Derbyshire 013,Middle Super Output Areas and Intermediate Zones,MSOAIZ,DE,7805,3906,3899,1790,1830
E02006921,Hackney 029,Middle Super Output Areas and Intermediate Zones,MSOAIZ,N,7744,3724,4020,1514,1675
E02006922,Colchester 022,Middle Super Output Areas and Intermediate Zones,MSOAIZ,CO,13681,6676,7005,2537,2687
E02006924,Redbridge 035,Middle Super Output Areas and Intermediate Zones,MSOAIZ,IG,12780,6574,6206,2959,2596
E02006925,Redbridge 036,Middle Super Output Areas and Intermediate Zones,MSOAIZ,IG,13241,6559,6682,2481,2703
E02006926,Thurrock 020,Middle Super Output Areas and Intermediate Zones,MSOAIZ,RM,8071,4049,4022,2099,2065
E02006927,Greenwich 034,Middle Super Output Areas and Intermediate Zones,MSOAIZ,SE,8315,4065,4250,1788,1825
E02006928,Greenwich 035,Middle Super Output Areas and Intermediate Zones,MSOAIZ,SE,7341,3632,3709,1876,1825
E02006929,Greenwich 036,Middle Super Output Areas and Intermediate Zones,MSOAIZ,SE,7490,3698,3792,2047,1980
E02006930,Greenwich 037,Middle Super Output Areas and Intermediate Zones,MSOAIZ,SE,6561,3315,3246,1933,1767
E02006931,Greenwich 038,Middle Super Output Areas and Intermediate Zones,MSOAIZ,SE,9186,4557,4629,2551,2466
E02006932,Liverpool 060,Middle Super Output Areas and Intermediate Zones,MSOAIZ,L,9949,5172,4777,1697,977
E02006933,Liverpool 061,Middle Super Output Areas and Intermediate Zones,MSOAIZ,L,5436,3072,2364,1742,1161
E02006934,Liverpool 062,Middle Super Output Areas and Intermediate Zones,MSOAIZ,L,5202,3117,2085,1867,1014
W02000001,Isle of Anglesey 001,Middle Super Output Areas and Intermediate Zones,MSOAIZ,LL,8632,4288,4344,1543,1547
W02000002,Isle of Anglesey 002,Middle Super Output Areas and Intermediate Zones,MSOAIZ,LL,6512,3205,3307,1045,1035
W02000003,Isle of Anglesey 003,Middle Super Output Areas and Intermediate Zones,MSOAIZ,LL,10277,5119,5158,2037,1976
W02000004,Isle of Anglesey 004,Middle Super Output Areas and Intermediate Zones,MSOAIZ,LL,7391,3628,3763,1223,1270
W02000005,Isle of Anglesey 005,Middle Super Output Areas and Intermediate Zones,MSOAIZ,LL,8803,4250,4553,1378,1481
W02000006,Isle of Anglesey 006,Middle Super Output Areas and Intermediate Zones,MSOAIZ,LL,6650,3214,3436,1234,1303
W02000007,Isle of Anglesey 007,Middle Super Output Areas and Intermediate Zones,MSOAIZ,LL,7206,3606,3600,1456,1350
W02000008,Isle of Anglesey 008,Middle Super Output Areas and Intermediate Zones,MSOAIZ,LL,6483,3138,3345,1211,1234
W02000009,Isle of Anglesey 009,Middle Super Output Areas and Intermediate Zones,MSOAIZ,LL,7797,3826,3971,1438,1459
W02000010,Gwynedd 001,Middle Super Output Areas and Intermediate Zones,MSOAIZ,LL,9810,4893,4917,1317,969
W02000011,Gwynedd 002,Middle Super Output Areas and Intermediate Zones,MSOAIZ,LL,7765,3755,4010,1401,1488
W02000012,Gwynedd 003,Middle Super Output Areas and Intermediate Zones,MSOAIZ,LL,8351,4114,4237,1741,1776
W02000013,Gwynedd 004,Middle Super Output Areas and Intermediate Zones,MSOAIZ,LL,6590,3266,3324,1360,1333
W02000014,Gwynedd 005,Middle Super Output Areas and Intermediate Zones,MSOAIZ,LL,6936,3411,3525,1417,1409
W02000015,Gwynedd 006,Middle Super Output Areas and Intermediate Zones,MSOAIZ,LL,8083,3912,4171,1489,1603
W02000016,Gwynedd 007,Middle Super Output Areas and Intermediate Zones,MSOAIZ,LL,6364,3129,3235,1190,1227
W02000017,Gwynedd 008,Middle Super Output Areas and Intermediate Zones,MSOAIZ,LL,7671,3735,3936,1412,1407
W02000018,Gwynedd 009,Middle Super Output Areas and Intermediate Zones,MSOAIZ,LL,6479,3192,3287,1166,1185
W02000019,Gwynedd 010,Middle Super Output Areas and Intermediate Zones,MSOAIZ,LL,7037,3462,3575,1193,1161
W02000020,Gwynedd 011,Middle Super Output Areas and Intermediate Zones,MSOAIZ,LL,6870,3323,3547,1208,1207
W02000021,Gwynedd 012,Middle Super Output Areas and Intermediate Zones,MSOAIZ,LL,7953,3948,4005,1491,1419
W02000022,Gwynedd 013,Middle Super Output Areas and Intermediate Zones,MSOAIZ,LL,6168,3030,3138,985,970
W02000023,Gwynedd 014,Middle Super Output Areas and Intermediate Zones,MSOAIZ,LL,5922,2957,2965,967,957
W02000024,Gwynedd 015,Middle Super Output Areas and Intermediate Zones,MSOAIZ,SY,5707,2849,2858,1087,1066
W02000025,Gwynedd 016,Middle Super Output Areas and Intermediate Zones,MSOAIZ,LL,6654,3278,3376,1154,1156
W02000026,Gwynedd 017,Middle Super Output Areas and Intermediate Zones,MSOAIZ,SY,7514,3652,3862,1154,1139
W02000027,Conwy 001,Middle Super Output Areas and Intermediate Zones,MSOAIZ,LL,8850,4297,4553,1668,1609
W02000028,Conwy 002,Middle Super Output Areas and Intermediate Zones,MSOAIZ,LL,6968,3233,3735,1104,1260
W02000029,Conwy 003,Middle Super Output Areas and Intermediate Zones,MSOAIZ,LL,6358,3040,3318,969,1066
W02000030,Conwy 004,Middle Super Output Areas and Intermediate Zones,MSOAIZ,LL,6118,2781,3337,890,941
W02000031,Conwy 005,Middle Super Output Areas and Intermediate Zones,MSOAIZ,LL,8460,4058,4402,1340,1520
W02000032,Conwy 006,Middle Super Output Areas and Intermediate Zones,MSOAIZ,LL,7815,3730,4085,1226,1325
W02000033,Conwy 007,Middle Super Output Areas and Intermediate Zones,MSOAIZ,LL,6698,3379,3319,1365,1243
W02000034,Conwy 008,Middle Super Output Areas and Intermediate Zones,MSOAIZ,LL,7830,3830,4000,1392,1470
W02000035,Conwy 009,Middle Super Output Areas and Intermediate Zones,MSOAIZ,LL,8851,4337,4514,1595,1728
W02000036,Conwy 010,Middle Super Output Areas and Intermediate Zones,MSOAIZ,LL,10577,5024,5553,1587,1687
W02000037,Conwy 011,Middle Super Output Areas and Intermediate Zones,MSOAIZ,LL,6962,3384,3578,1255,1337
W02000038,Conwy 012,Middle Super Output Areas and Intermediate Zones,MSOAIZ,LL,6072,2939,3133,1040,1166
W02000039,Conwy 013,Middle Super Output Areas and Intermediate Zones,MSOAIZ,LL,7990,3900,4090,1506,1514
W02000040,Conwy 014,Middle Super Output Areas and Intermediate Zones,MSOAIZ,LL,6881,3467,3414,1330,1303
W02000041,Conwy 015,Middle Super Output Areas and Intermediate Zones,MSOAIZ,LL,8798,4350,4448,1661,1629
W02000042,Denbighshire 001,Middle Super Output Areas and Intermediate Zones,MSOAIZ,LL,5716,2746,2970,918,987
W02000043,Denbighshire 002,Middle Super Output Areas and Intermediate Zones,MSOAIZ,LL,5358,2556,2802,901,992
W02000044,Denbighshire 003,Middle Super Output Areas and Intermediate Zones,MSOAIZ,LL,5197,2470,2727,822,868
W02000045,Denbighshire 004,Middle Super Output Areas and Intermediate Zones,MSOAIZ,LL,8603,4407,4196,1551,1467
W02000047,Denbighshire 006,Middle Super Output Areas and Intermediate Zones,MSOAIZ,LL,5383,2591,2792,885,1093
W02000049,Denbighshire 008,Middle Super Output Areas and Intermediate Zones,MSOAIZ,LL,6496,3180,3316,1147,1280
W02000050,Denbighshire 009,Middle Super Output Areas and Intermediate Zones,MSOAIZ,LL,6402,3094,3308,1132,1264
W02000051,Denbighshire 010,Middle Super Output Areas and Intermediate Zones,MSOAIZ,LL,5325,2574,2751,950,961
W02000052,Denbighshire 011,Middle Super Output Areas and Intermediate Zones,MSOAIZ,LL,5287,2664,2623,1032,1018
W02000053,Denbighshire 012,Middle Super Output Areas and Intermediate Zones,MSOAIZ,LL,6417,3161,3256,1215,1244
W02000054,Denbighshire 013,Middle Super Output Areas and Intermediate Zones,MSOAIZ,LL,6033,3036,2997,1102,1109
W02000055,Denbighshire 014,Middle Super Output Areas and Intermediate Zones,MSOAIZ,LL,5461,2661,2800,969,1011
W02000056,Denbighshire 015,Middle Super Output Areas and Intermediate Zones,MSOAIZ,LL,5227,2627,2600,972,967
W02000057,Denbighshire 016,Middle Super Output Areas and Intermediate Zones,MSOAIZ,LL,6212,3115,3097,1130,1093
W02000058,Flintshire 001,Middle Super Output Areas and Intermediate Zones,MSOAIZ,LL,5173,2535,2638,864,964
W02000059,Flintshire 002,Middle Super Output Areas and Intermediate Zones,MSOAIZ,LL,6565,3299,3266,1263,1251
W02000060,Flintshire 003,Middle Super Output Areas and Intermediate Zones,MSOAIZ,CH,10652,5238,5414,2088,2111
W02000061,Flintshire 004,Middle Super Output Areas and Intermediate Zones,MSOAIZ,CH,6584,3226,3358,1226,1245
W02000062,Flintshire 005,Middle Super Output Areas and Intermediate Zones,MSOAIZ,CH,6369,3141,3228,1283,1325
W02000063,Flintshire 006,Middle Super Output Areas and Intermediate Zones,MSOAIZ,CH,8381,4175,4206,1527,1579
W02000064,Flintshire 007,Middle Super Output Areas and Intermediate Zones,MSOAIZ,CH,6104,3025,3079,1202,1213
W02000065,Flintshire 008,Middle Super Output Areas and Intermediate Zones,MSOAIZ,CH,7501,3680,3821,1570,1596
W02000066,Flintshire 009,Middle Super Output Areas and Intermediate Zones,MSOAIZ,CH,9659,4804,4855,1985,1929
W02000067,Flintshire 010,Middle Super Output Areas and Intermediate Zones,MSOAIZ,CH,6330,3150,3180,1235,1282
W02000068,Flintshire 011,Middle Super Output Areas and Intermediate Zones,MSOAIZ,CH,5605,2858,2747,1175,1099
W02000069,Flintshire 012,Middle Super Output Areas and Intermediate Zones,MSOAIZ,CH,6062,2959,3103,1127,1208
W02000070,Flintshire 013,Middle Super Output Areas and Intermediate Zones,MSOAIZ,CH,10560,5165,5395,2085,2201
W02000071,Flintshire 014,Middle Super Output Areas and Intermediate Zones,MSOAIZ,CH,7386,3604,3782,1368,1454
W02000072,Flintshire 015,Middle Super Output Areas and Intermediate Zones,MSOAIZ,CH,11106,5532,5574,2387,2406
W02000073,Flintshire 016,Middle Super Output Areas and Intermediate Zones,MSOAIZ,CH,10058,4880,5178,1814,1919
W02000074,Flintshire 017,Middle Super Output Areas and Intermediate Zones,MSOAIZ,CH,9336,4576,4760,1835,1874
W02000075,Flintshire 018,Middle Super Output Areas and Intermediate Zones,MSOAIZ,CH,5571,2741,2830,1093,1152
W02000076,Flintshire 019,Middle Super Output Areas and Intermediate Zones,MSOAIZ,CH,7430,3665,3765,1341,1383
W02000077,Flintshire 020,Middle Super Output Areas and Intermediate Zones,MSOAIZ,LL,6074,2994,3080,1136,1156
W02000080,Wrexham 003,Middle Super Output Areas and Intermediate Zones,MSOAIZ,LL,7918,3903,4015,1603,1696
W02000081,Wrexham 004,Middle Super Output Areas and Intermediate Zones,MSOAIZ,LL,5904,2911,2993,1217,1255
W02000082,Wrexham 005,Middle Super Output Areas and Intermediate Zones,MSOAIZ,LL,7454,3663,3791,1567,1631
W02000083,Wrexham 006,Middle Super Output Areas and Intermediate Zones,MSOAIZ,LL,8683,4324,4359,1889,1838
W02000084,Wrexham 007,Middle Super Output Areas and Intermediate Zones,MSOAIZ,LL,5109,2508,2601,921,938
W02000085,Wrexham 008,Middle Super Output Areas and Intermediate Zones,MSOAIZ,LL,9162,4548,4614,1773,1659
W02000086,Wrexham 009,Middle Super Output Areas and Intermediate Zones,MSOAIZ,LL,5115,2449,2666,961,968
W02000087,Wrexham 010,Middle Super Output Areas and Intermediate Zones,MSOAIZ,LL,7401,3644,3757,1289,1479
W02000088,Wrexham 011,Middle Super Output Areas and Intermediate Zones,MSOAIZ,LL,8296,4351,3945,2084,1702
W02000089,Wrexham 012,Middle Super Output Areas and Intermediate Zones,MSOAIZ,LL,8372,4288,4084,1969,1789
W02000090,Wrexham 013,Middle Super Output Areas and Intermediate Zones,MSOAIZ,LL,5861,2935,2926,1123,1179
W02000091,Wrexham 014,Middle Super Output Areas and Intermediate Zones,MSOAIZ,LL,6163,3097,3066,1266,1287
W02000092,Wrexham 015,Middle Super Output Areas and Intermediate Zones,MSOAIZ,LL,7046,3453,3593,1410,1380
W02000093,Wrexham 016,Middle Super Output Areas and Intermediate Zones,MSOAIZ,LL,6645,3309,3336,1367,1407
W02000094,Wrexham 017,Middle Super Output Areas and Intermediate Zones,MSOAIZ,LL,9110,4539,4571,1711,1752
W02000095,Wrexham 018,Middle Super Output Areas and Intermediate Zones,MSOAIZ,SY,6494,3221,3273,1178,1240
W02000096,Wrexham 019,Middle Super Output Areas and Intermediate Zones,MSOAIZ,SY,6647,3270,3377,1247,1308
W02000097,Powys 001,Middle Super Output Areas and Intermediate Zones,MSOAIZ,SY,9114,4593,4521,1609,1576
W02000098,Powys 002,Middle Super Output Areas and Intermediate Zones,MSOAIZ,SY,6299,3107,3192,1133,1183
W02000099,Powys 003,Middle Super Output Areas and Intermediate Zones,MSOAIZ,SY,6664,3273,3391,1271,1240
W02000100,Powys 004,Middle Super Output Areas and Intermediate Zones,MSOAIZ,SY,6206,3084,3122,1146,1110
W02000101,Powys 005,Middle Super Output Areas and Intermediate Zones,MSOAIZ,SY,5485,2716,2769,924,963
W02000102,Powys 006,Middle Super Output Areas and Intermediate Zones,MSOAIZ,SY,6306,3182,3124,1120,1146
W02000103,Powys 007,Middle Super Output Areas and Intermediate Zones,MSOAIZ,SY,5720,2858,2862,1022,988
W02000104,Powys 008,Middle Super Output Areas and Intermediate Zones,MSOAIZ,SY,6180,3062,3118,1188,1147
W02000105,Powys 009,Middle Super Output Areas and Intermediate Zones,MSOAIZ,SY,5177,2498,2679,951,1032
W02000106,Powys 010,Middle Super Output Areas and Intermediate Zones,MSOAIZ,SY,6628,3337,3291,1146,1137
W02000107,Powys 011,Middle Super Output Areas and Intermediate Zones,MSOAIZ,LD,9945,4958,4987,1615,1639
W02000108,Powys 012,Middle Super Output Areas and Intermediate Zones,MSOAIZ,SY,7062,3468,3594,1083,1133
W02000109,Powys 013,Middle Super Output Areas and Intermediate Zones,MSOAIZ,LD,5309,2587,2722,921,929
W02000110,Powys 014,Middle Super Output Areas and Intermediate Zones,MSOAIZ,SA,7035,3484,3551,1204,1252
W02000111,Powys 015,Middle Super Output Areas and Intermediate Zones,MSOAIZ,NP,8430,4156,4274,1469,1496
W02000113,Powys 017,Middle Super Output Areas and Intermediate Zones,MSOAIZ,LD,8250,3966,4284,1426,1558
W02000114,Powys 018,Middle Super Output Areas and Intermediate Zones,MSOAIZ,NP,6942,3400,3542,1104,1170
W02000116,Ceredigion 001,Middle Super Output Areas and Intermediate Zones,MSOAIZ,SY,7660,3794,3866,1409,1504
W02000117,Ceredigion 002,Middle Super Output Areas and Intermediate Zones,MSOAIZ,SY,9998,5266,4732,1249,890
W02000118,Ceredigion 003,Middle Super Output Areas and Intermediate Zones,MSOAIZ,SY,7761,3882,3879,1233,1213
W02000120,Ceredigion 005,Middle Super Output Areas and Intermediate Zones,MSOAIZ,SY,7344,3619,3725,1218,1261
W02000122,Ceredigion 007,Middle Super Output Areas and Intermediate Zones,MSOAIZ,SA,6722,3347,3375,1101,1112
W02000123,Ceredigion 008,Middle Super Output Areas and Intermediate Zones,MSOAIZ,SY,8345,4161,4184,1388,1346
W02000124,Ceredigion 009,Middle Super Output Areas and Intermediate Zones,MSOAIZ,SA,8866,4316,4550,1448,1499
W02000125,Ceredigion 010,Middle Super Output Areas and Intermediate Zones,MSOAIZ,SA,7504,3664,3840,1187,1288
W02000126,Pembrokeshire 001,Middle Super Output Areas and Intermediate Zones,MSOAIZ,SA,8190,4098,4092,1386,1435
W02000127,Pembrokeshire 002,Middle Super Output Areas and Intermediate Zones,MSOAIZ,SA,9751,4722,5029,1562,1635
W02000128,Pembrokeshire 003,Middle Super Output Areas and Intermediate Zones,MSOAIZ,SA,7534,3846,3688,1349,1300
W02000129,Pembrokeshire 004,Middle Super Output Areas and Intermediate Zones,MSOAIZ,SA,6741,3291,3450,1184,1230
W02000130,Pembrokeshire 005,Middle Super Output Areas and Intermediate Zones,MSOAIZ,SA,6952,3374,3578,1413,1409
W02000131,Pembrokeshire 006,Middle Super Output Areas and Intermediate Zones,MSOAIZ,SA,6958,3291,3667,1296,1348
W02000132,Pembrokeshire 007,Middle Super Output Areas and Intermediate Zones,MSOAIZ,SA,6438,3093,3345,1076,1176
W02000133,Pembrokeshire 008,Middle Super Output Areas and Intermediate Zones,MSOAIZ,SA,8023,3894,4129,1331,1401
W02000134,Pembrokeshire 009,Middle Super Output Areas and Intermediate Zones,MSOAIZ,SA,8531,4114,4417,1458,1641
W02000135,Pembrokeshire 010,Middle Super Output Areas and Intermediate Zones,MSOAIZ,SA,6923,3402,3521,1280,1278
W02000136,Pembrokeshire 011,Middle Super Output Areas and Intermediate Zones,MSOAIZ,SA,8540,4219,4321,1322,1390
W02000137,Pembrokeshire 012,Middle Super Output Areas and Intermediate Zones,MSOAIZ,SA,6984,3400,3584,1219,1335
W02000138,Pembrokeshire 013,Middle Super Output Areas and Intermediate Zones,MSOAIZ,SA,9753,4841,4912,1749,1816
W02000139,Pembrokeshire 014,Middle Super Output Areas and Intermediate Zones,MSOAIZ,SA,7694,3746,3948,1237,1345
W02000140,Pembrokeshire 015,Middle Super Output Areas and Intermediate Zones,MSOAIZ,SA,7021,3438,3583,1232,1313
W02000141,Pembrokeshire 016,Middle Super Output Areas and Intermediate Zones,MSOAIZ,SA,6406,3054,3352,1053,1118
W02000142,Carmarthenshire 001,Middle Super Output Areas and Intermediate Zones,MSOAIZ,SA,5658,2812,2846,974,994
W02000143,Carmarthenshire 002,Middle Super Output Areas and Intermediate Zones,MSOAIZ,SA,5820,2898,2922,946,978
W02000144,Carmarthenshire 003,Middle Super Output Areas and Intermediate Zones,MSOAIZ,SA,7713,3822,3891,1250,1356
W02000145,Carmarthenshire 004,Middle Super Output Areas and Intermediate Zones,MSOAIZ,SA,7148,3513,3635,1231,1259
W02000146,Carmarthenshire 005,Middle Super Output Areas and Intermediate Zones,MSOAIZ,SA,6606,3271,3335,1140,1218
W02000147,Carmarthenshire 006,Middle Super Output Areas and Intermediate Zones,MSOAIZ,SA,8261,3879,4382,1440,1532
W02000148,Carmarthenshire 007,Middle Super Output Areas and Intermediate Zones,MSOAIZ,SA,5142,2493,2649,933,1039
W02000149,Carmarthenshire 008,Middle Super Output Areas and Intermediate Zones,MSOAIZ,SA,6181,2982,3199,1080,1037
W02000151,Carmarthenshire 010,Middle Super Output Areas and Intermediate Zones,MSOAIZ,SA,7407,3623,3784,1348,1391
W02000152,Carmarthenshire 011,Middle Super Output Areas and Intermediate Zones,MSOAIZ,SA,8105,3934,4171,1376,1547
W02000153,Carmarthenshire 012,Middle Super Output Areas and Intermediate Zones,MSOAIZ,SA,7739,3846,3893,1298,1396
W02000154,Carmarthenshire 013,Middle Super Output Areas and Intermediate Zones,MSOAIZ,SA,7586,3707,3879,1361,1448
W02000156,Carmarthenshire 015,Middle Super Output Areas and Intermediate Zones,MSOAIZ,SA,8159,4044,4115,1570,1660
W02000157,Carmarthenshire 016,Middle Super Output Areas and Intermediate Zones,MSOAIZ,SA,8989,4373,4616,1597,1757
W02000158,Carmarthenshire 017,Middle Super Output Areas and Intermediate Zones,MSOAIZ,SA,5664,2821,2843,1096,1166
W02000159,Carmarthenshire 018,Middle Super Output Areas and Intermediate Zones,MSOAIZ,SA,6064,2916,3148,1041,1095
W02000160,Carmarthenshire 019,Middle Super Output Areas and Intermediate Zones,MSOAIZ,SA,7500,3694,3806,1337,1466
W02000161,Carmarthenshire 020,Middle Super Output Areas and Intermediate Zones,MSOAIZ,SA,5651,2688,2963,957,1108
W02000162,Carmarthenshire 021,Middle Super Output Areas and Intermediate Zones,MSOAIZ,SA,8547,4164,4383,1417,1537
W02000163,Carmarthenshire 022,Middle Super Output Areas and Intermediate Zones,MSOAIZ,SA,5457,2618,2839,963,1046
W02000164,Carmarthenshire 023,Middle Super Output Areas and Intermediate Zones,MSOAIZ,SA,6948,3390,3558,1261,1299
W02000165,Carmarthenshire 024,Middle Super Output Areas and Intermediate Zones,MSOAIZ,SA,6761,3309,3452,1279,1330
W02000166,Carmarthenshire 025,Middle Super Output Areas and Intermediate Zones,MSOAIZ,SA,8713,4234,4479,1683,1798
W02000167,Carmarthenshire 026,Middle Super Output Areas and Intermediate Zones,MSOAIZ,SA,9747,4804,4943,1987,1968
W02000168,Swansea 001,Middle Super Output Areas and Intermediate Zones,MSOAIZ,SA,6281,3052,3229,1225,1292
W02000169,Swansea 002,Middle Super Output Areas and Intermediate Zones,MSOAIZ,SA,9353,4543,4810,1823,1863
W02000170,Swansea 003,Middle Super Output Areas and Intermediate Zones,MSOAIZ,SA,9111,4431,4680,1717,1848
W02000171,Swansea 004,Middle Super Output Areas and Intermediate Zones,MSOAIZ,SA,7907,3847,4060,1665,1824
W02000172,Swansea 005,Middle Super Output Areas and Intermediate Zones,MSOAIZ,SA,9824,4832,4992,2008,2040
W02000173,Swansea 006,Middle Super Output Areas and Intermediate Zones,MSOAIZ,SA,7392,3620,3772,1640,1719
W02000174,Swansea 007,Middle Super Output Areas and Intermediate Zones,MSOAIZ,SA,9134,4449,4685,1698,1812
W02000175,Swansea 008,Middle Super Output Areas and Intermediate Zones,MSOAIZ,SA,7817,3869,3948,1701,1700
W02000176,Swansea 009,Middle Super Output Areas and Intermediate Zones,MSOAIZ,SA,8872,4300,4572,1606,1697
W02000177,Swansea 010,Middle Super Output Areas and Intermediate Zones,MSOAIZ,SA,7041,3428,3613,1468,1553
W02000178,Swansea 011,Middle Super Output Areas and Intermediate Zones,MSOAIZ,SA,8866,4250,4616,1771,1861
W02000179,Swansea 012,Middle Super Output Areas and Intermediate Zones,MSOAIZ,SA,6778,3271,3507,1296,1372
W02000180,Swansea 013,Middle Super Output Areas and Intermediate Zones,MSOAIZ,SA,8086,3900,4186,1605,1664
W02000181,Swansea 014,Middle Super Output Areas and Intermediate Zones,MSOAIZ,SA,6857,3293,3564,1342,1395
W02000182,Swansea 015,Middle Super Output Areas and Intermediate Zones,MSOAIZ,SA,7972,3901,4071,1627,1688
W02000183,Swansea 016,Middle Super Output Areas and Intermediate Zones,MSOAIZ,SA,9241,4670,4571,2144,1963
W02000184,Swansea 017,Middle Super Output Areas and Intermediate Zones,MSOAIZ,SA,6963,3374,3589,1446,1423
W02000185,Swansea 018,Middle Super Output Areas and Intermediate Zones,MSOAIZ,SA,5218,2513,2705,900,960
W02000186,Swansea 019,Middle Super Output Areas and Intermediate Zones,MSOAIZ,SA,8696,4085,4611,1583,1872
W02000187,Swansea 020,Middle Super Output Areas and Intermediate Zones,MSOAIZ,SA,5714,2802,2912,983,1053
W02000188,Swansea 021,Middle Super Output Areas and Intermediate Zones,MSOAIZ,SA,7187,3617,3570,1598,1464
W02000189,Swansea 022,Middle Super Output Areas and Intermediate Zones,MSOAIZ,SA,7955,3875,4080,1523,1455
W02000190,Swansea 023,Middle Super Output Areas and Intermediate Zones,MSOAIZ,SA,5702,2820,2882,798,858
W02000191,Swansea 024,Middle Super Output Areas and Intermediate Zones,MSOAIZ,SA,9962,5223,4739,1861,1544
W02000192,Swansea 025,Middle Super Output Areas and Intermediate Zones,MSOAIZ,SA,9006,5329,3677,2522,1376
W02000193,Swansea 026,Middle Super Output Areas and Intermediate Zones,MSOAIZ,SA,9507,5157,4350,1601,1022
W02000194,Swansea 027,Middle Super Output Areas and Intermediate Zones,MSOAIZ,SA,6346,3060,3286,907,889
W02000195,Swansea 028,Middle Super Output Areas and Intermediate Zones,MSOAIZ,SA,5927,2814,3113,902,984
W02000196,Swansea 029,Middle Super Output Areas and Intermediate Zones,MSOAIZ,SA,6448,3059,3389,1057,1149
W02000197,Swansea 030,Middle Super Output Areas and Intermediate Zones,MSOAIZ,SA,6384,3156,3228,993,1056
W02000198,Swansea 031,Middle Super Output Areas and Intermediate Zones,MSOAIZ,SA,7476,3547,3929,1292,1349
W02000200,Neath Port Talbot 002,Middle Super Output Areas and Intermediate Zones,MSOAIZ,SA,5227,2578,2649,1015,992
W02000201,Neath Port Talbot 003,Middle Super Output Areas and Intermediate Zones,MSOAIZ,SA,5419,2672,2747,994,1026
W02000202,Neath Port Talbot 004,Middle Super Output Areas and Intermediate Zones,MSOAIZ,SA,11601,5700,5901,2262,2339
W02000203,Neath Port Talbot 005,Middle Super Output Areas and Intermediate Zones,MSOAIZ,SA,6774,3326,3448,1334,1362
W02000204,Neath Port Talbot 006,Middle Super Output Areas and Intermediate Zones,MSOAIZ,SA,6952,3373,3579,1278,1362
W02000205,Neath Port Talbot 007,Middle Super Output Areas and Intermediate Zones,MSOAIZ,SA,5961,2903,3058,1115,1182
W02000206,Neath Port Talbot 008,Middle Super Output Areas and Intermediate Zones,MSOAIZ,SA,6785,3347,3438,1356,1240
W02000207,Neath Port Talbot 009,Middle Super Output Areas and Intermediate Zones,MSOAIZ,SA,5200,2511,2689,1005,1038
W02000208,Neath Port Talbot 010,Middle Super Output Areas and Intermediate Zones,MSOAIZ,SA,9053,4404,4649,1887,1854
W02000209,Neath Port Talbot 011,Middle Super Output Areas and Intermediate Zones,MSOAIZ,SA,5283,2626,2657,985,971
W02000210,Neath Port Talbot 012,Middle Super Output Areas and Intermediate Zones,MSOAIZ,SA,6493,3196,3297,1274,1403
W02000211,Neath Port Talbot 013,Middle Super Output Areas and Intermediate Zones,MSOAIZ,SA,7951,3882,4069,1605,1663
W02000212,Neath Port Talbot 014,Middle Super Output Areas and Intermediate Zones,MSOAIZ,SA,7690,3763,3927,1519,1582
W02000213,Neath Port Talbot 015,Middle Super Output Areas and Intermediate Zones,MSOAIZ,SA,6819,3305,3514,1280,1307
W02000214,Neath Port Talbot 016,Middle Super Output Areas and Intermediate Zones,MSOAIZ,SA,9808,4674,5134,1786,1931
W02000215,Neath Port Talbot 017,Middle Super Output Areas and Intermediate Zones,MSOAIZ,SA,9264,4551,4713,1947,1865
W02000216,Neath Port Talbot 018,Middle Super Output Areas and Intermediate Zones,MSOAIZ,SA,7073,3539,3534,1512,1440
W02000217,Neath Port Talbot 019,Middle Super Output Areas and Intermediate Zones,MSOAIZ,SA,6384,3117,3267,1324,1393
W02000218,Bridgend 001,Middle Super Output Areas and Intermediate Zones,MSOAIZ,CF,6995,3439,3556,1362,1385
W02000219,Bridgend 002,Middle Super Output Areas and Intermediate Zones,MSOAIZ,CF,7415,3618,3797,1473,1531
W02000220,Bridgend 003,Middle Super Output Areas and Intermediate Zones,MSOAIZ,CF,7954,3872,4082,1628,1613
W02000221,Bridgend 004,Middle Super Output Areas and Intermediate Zones,MSOAIZ,CF,7784,3869,3915,1609,1578
W02000222,Bridgend 005,Middle Super Output Areas and Intermediate Zones,MSOAIZ,CF,6202,3068,3134,1164,1178
W02000223,Bridgend 006,Middle Super Output Areas and Intermediate Zones,MSOAIZ,CF,5406,2654,2752,1156,1211
W02000224,Bridgend 007,Middle Super Output Areas and Intermediate Zones,MSOAIZ,CF,6014,2959,3055,1233,1289
W02000225,Bridgend 008,Middle Super Output Areas and Intermediate Zones,MSOAIZ,CF,8886,4378,4508,1795,1852
W02000226,Bridgend 009,Middle Super Output Areas and Intermediate Zones,MSOAIZ,CF,10054,5050,5004,2014,2019
W02000227,Bridgend 010,Middle Super Output Areas and Intermediate Zones,MSOAIZ,CF,7059,3412,3647,1346,1461
W02000228,Bridgend 011,Middle Super Output Areas and Intermediate Zones,MSOAIZ,CF,6961,4066,2895,1864,1113
W02000229,Bridgend 012,Middle Super Output Areas and Intermediate Zones,MSOAIZ,CF,6135,2991,3144,1176,1240
W02000230,Bridgend 013,Middle Super Output Areas and Intermediate Zones,MSOAIZ,CF,5453,2655,2798,1045,1058
W02000231,Bridgend 014,Middle Super Output Areas and Intermediate Zones,MSOAIZ,CF,8169,4083,4086,1794,1607
W02000232,Bridgend 015,Middle Super Output Areas and Intermediate Zones,MSOAIZ,CF,6005,2924,3081,1304,1349
W02000233,Bridgend 016,Middle Super Output Areas and Intermediate Zones,MSOAIZ,CF,6226,3043,3183,1312,1446
W02000234,Bridgend 017,Middle Super Output Areas and Intermediate Zones,MSOAIZ,CF,10455,5078,5377,2259,2451
W02000235,Bridgend 018,Middle Super Output Areas and Intermediate Zones,MSOAIZ,CF,9009,4261,4748,1433,1502
W02000236,Bridgend 019,Middle Super Output Areas and Intermediate Zones,MSOAIZ,CF,6996,3369,3627,1261,1251
W02000237,The Vale of Glamorgan 001,Middle Super Output Areas and Intermediate Zones,MSOAIZ,CF,5281,2613,2668,909,984
W02000238,The Vale of Glamorgan 002,Middle Super Output Areas and Intermediate Zones,MSOAIZ,CF,6180,3004,3176,1001,1007
W02000239,The Vale of Glamorgan 003,Middle Super Output Areas and Intermediate Zones,MSOAIZ,CF,6679,3272,3407,1178,1264
W02000240,The Vale of Glamorgan 004,Middle Super Output Areas and Intermediate Zones,MSOAIZ,CF,8714,4161,4553,1644,1820
W02000241,The Vale of Glamorgan 005,Middle Super Output Areas and Intermediate Zones,MSOAIZ,CF,9858,4868,4990,2196,2004
W02000242,The Vale of Glamorgan 006,Middle Super Output Areas and Intermediate Zones,MSOAIZ,CF,7799,3722,4077,1289,1390
W02000243,The Vale of Glamorgan 007,Middle Super Output Areas and Intermediate Zones,MSOAIZ,CF,9153,4284,4869,1568,1874
W02000244,The Vale of Glamorgan 008,Middle Super Output Areas and Intermediate Zones,MSOAIZ,CF,10031,4799,5232,1758,1940
W02000245,The Vale of Glamorgan 009,Middle Super Output Areas and Intermediate Zones,MSOAIZ,CF,8543,4211,4332,1910,1934
W02000246,The Vale of Glamorgan 010,Middle Super Output Areas and Intermediate Zones,MSOAIZ,CF,5477,2623,2854,952,1039
W02000247,The Vale of Glamorgan 011,Middle Super Output Areas and Intermediate Zones,MSOAIZ,CF,8936,4265,4671,1527,1657
W02000248,The Vale of Glamorgan 012,Middle Super Output Areas and Intermediate Zones,MSOAIZ,CF,10843,5304,5539,2333,2382
W02000249,The Vale of Glamorgan 013,Middle Super Output Areas and Intermediate Zones,MSOAIZ,CF,9010,4309,4701,1809,1915
W02000250,The Vale of Glamorgan 014,Middle Super Output Areas and Intermediate Zones,MSOAIZ,CF,11356,5983,5373,2388,2294
W02000251,The Vale of Glamorgan 015,Middle Super Output Areas and Intermediate Zones,MSOAIZ,CF,8476,4104,4372,1762,1725
W02000252,Rhondda Cynon Taf 001,Middle Super Output Areas and Intermediate Zones,MSOAIZ,SA,8947,4344,4603,1633,1722
W02000253,Rhondda Cynon Taf 002,Middle Super Output Areas and Intermediate Zones,MSOAIZ,CF,6279,3039,3240,1145,1269
W02000254,Rhondda Cynon Taf 003,Middle Super Output Areas and Intermediate Zones,MSOAIZ,CF,7728,3740,3988,1497,1514
W02000255,Rhondda Cynon Taf 004,Middle Super Output Areas and Intermediate Zones,MSOAIZ,CF,6202,2997,3205,1144,1244
W02000256,Rhondda Cynon Taf 005,Middle Super Output Areas and Intermediate Zones,MSOAIZ,CF,9865,4845,5020,1868,1898
W02000257,Rhondda Cynon Taf 006,Middle Super Output Areas and Intermediate Zones,MSOAIZ,CF,7374,3510,3864,1382,1438
W02000258,Rhondda Cynon Taf 007,Middle Super Output Areas and Intermediate Zones,MSOAIZ,CF,5727,2801,2926,1052,1063
W02000259,Rhondda Cynon Taf 008,Middle Super Output Areas and Intermediate Zones,MSOAIZ,CF,5789,2809,2980,1075,1174
W02000260,Rhondda Cynon Taf 009,Middle Super Output Areas and Intermediate Zones,MSOAIZ,CF,5878,2877,3001,1080,1074
W02000261,Rhondda Cynon Taf 010,Middle Super Output Areas and Intermediate Zones,MSOAIZ,CF,7694,3752,3942,1403,1491
W02000262,Rhondda Cynon Taf 011,Middle Super Output Areas and Intermediate Zones,MSOAIZ,CF,5232,2529,2703,1049,1016
W02000263,Rhondda Cynon Taf 012,Middle Super Output Areas and Intermediate Zones,MSOAIZ,CF,6390,3146,3244,1251,1299
W02000264,Rhondda Cynon Taf 013,Middle Super Output Areas and Intermediate Zones,MSOAIZ,CF,6006,2942,3064,1163,1194
W02000265,Rhondda Cynon Taf 014,Middle Super Output Areas and Intermediate Zones,MSOAIZ,CF,9192,4478,4714,1747,1782
W02000266,Rhondda Cynon Taf 015,Middle Super Output Areas and Intermediate Zones,MSOAIZ,CF,7523,3671,3852,1450,1584
W02000267,Rhondda Cynon Taf 016,Middle Super Output Areas and Intermediate Zones,MSOAIZ,CF,6549,3256,3293,1307,1228
W02000268,Rhondda Cynon Taf 017,Middle Super Output Areas and Intermediate Zones,MSOAIZ,CF,9156,4507,4649,1790,1805
W02000269,Rhondda Cynon Taf 018,Middle Super Output Areas and Intermediate Zones,MSOAIZ,CF,8503,4199,4304,1664,1638
W02000270,Rhondda Cynon Taf 019,Middle Super Output Areas and Intermediate Zones,MSOAIZ,CF,6609,3205,3404,1330,1397
W02000271,Rhondda Cynon Taf 020,Middle Super Output Areas and Intermediate Zones,MSOAIZ,CF,5639,2747,2892,1079,1122
W02000272,Rhondda Cynon Taf 021,Middle Super Output Areas and Intermediate Zones,MSOAIZ,CF,9983,4879,5104,1993,2028
W02000273,Rhondda Cynon Taf 022,Middle Super Output Areas and Intermediate Zones,MSOAIZ,CF,9915,5114,4801,1737,1511
W02000274,Rhondda Cynon Taf 023,Middle Super Output Areas and Intermediate Zones,MSOAIZ,CF,9810,4792,5018,1930,2121
W02000275,Rhondda Cynon Taf 024,Middle Super Output Areas and Intermediate Zones,MSOAIZ,CF,5927,2870,3057,1126,1188
W02000276,Rhondda Cynon Taf 025,Middle Super Output Areas and Intermediate Zones,MSOAIZ,CF,5766,2790,2976,969,974
W02000277,Rhondda Cynon Taf 026,Middle Super Output Areas and Intermediate Zones,MSOAIZ,CF,7000,3424,3576,1393,1471
W02000278,Rhondda Cynon Taf 027,Middle Super Output Areas and Intermediate Zones,MSOAIZ,CF,9402,4614,4788,2023,2181
W02000279,Rhondda Cynon Taf 028,Middle Super Output Areas and Intermediate Zones,MSOAIZ,CF,7703,3756,3947,1562,1689
W02000280,Rhondda Cynon Taf 029,Middle Super Output Areas and Intermediate Zones,MSOAIZ,CF,8012,3934,4078,1748,1859
W02000281,Rhondda Cynon Taf 030,Middle Super Output Areas and Intermediate Zones,MSOAIZ,CF,7610,3728,3882,1533,1566
W02000282,Rhondda Cynon Taf 031,Middle Super Output Areas and Intermediate Zones,MSOAIZ,CF,11000,5340,5660,2338,2495
W02000284,Merthyr Tydfil 002,Middle Super Output Areas and Intermediate Zones,MSOAIZ,CF,9748,4805,4943,1991,2056
W02000285,Merthyr Tydfil 003,Middle Super Output Areas and Intermediate Zones,MSOAIZ,CF,8363,4083,4280,1670,1729
W02000286,Merthyr Tydfil 004,Middle Super Output Areas and Intermediate Zones,MSOAIZ,CF,6574,3241,3333,1295,1284
W02000287,Merthyr Tydfil 005,Middle Super Output Areas and Intermediate Zones,MSOAIZ,CF,8141,4039,4102,1696,1721
W02000288,Merthyr Tydfil 006,Middle Super Output Areas and Intermediate Zones,MSOAIZ,CF,8340,4094,4246,1607,1633
W02000289,Merthyr Tydfil 007,Middle Super Output Areas and Intermediate Zones,MSOAIZ,CF,8241,4063,4178,1656,1733
W02000290,Caerphilly 001,Middle Super Output Areas and Intermediate Zones,MSOAIZ,NP,8845,4314,4531,1766,1820
W02000291,Caerphilly 002,Middle Super Output Areas and Intermediate Zones,MSOAIZ,NP,7573,3746,3827,1496,1470
W02000292,Caerphilly 003,Middle Super Output Areas and Intermediate Zones,MSOAIZ,NP,5704,2817,2887,1117,1120
W02000293,Caerphilly 004,Middle Super Output Areas and Intermediate Zones,MSOAIZ,CF,6196,3064,3132,1216,1223
W02000294,Caerphilly 005,Middle Super Output Areas and Intermediate Zones,MSOAIZ,NP,5715,2823,2892,1089,1125
W02000295,Caerphilly 006,Middle Super Output Areas and Intermediate Zones,MSOAIZ,NP,9429,4673,4756,1838,1919
W02000296,Caerphilly 007,Middle Super Output Areas and Intermediate Zones,MSOAIZ,NP,7742,3766,3976,1445,1526
W02000297,Caerphilly 008,Middle Super Output Areas and Intermediate Zones,MSOAIZ,NP,7817,3830,3987,1550,1649
W02000298,Caerphilly 009,Middle Super Output Areas and Intermediate Zones,MSOAIZ,NP,7319,3557,3762,1455,1545
W02000299,Caerphilly 010,Middle Super Output Areas and Intermediate Zones,MSOAIZ,NP,6509,3201,3308,1223,1265
W02000300,Caerphilly 011,Middle Super Output Areas and Intermediate Zones,MSOAIZ,NP,8552,4230,4322,1608,1647
W02000301,Caerphilly 012,Middle Super Output Areas and Intermediate Zones,MSOAIZ,NP,7790,3818,3972,1565,1601
W02000302,Caerphilly 013,Middle Super Output Areas and Intermediate Zones,MSOAIZ,CF,9690,4712,4978,1906,1952
W02000303,Caerphilly 014,Middle Super Output Areas and Intermediate Zones,MSOAIZ,NP,6998,3476,3522,1449,1467
W02000304,Caerphilly 015,Middle Super Output Areas and Intermediate Zones,MSOAIZ,NP,5567,2731,2836,1130,1124
W02000305,Caerphilly 016,Middle Super Output Areas and Intermediate Zones,MSOAIZ,NP,6464,3167,3297,1317,1362
W02000306,Caerphilly 017,Middle Super Output Areas and Intermediate Zones,MSOAIZ,NP,5229,2521,2708,1062,1039
W02000307,Caerphilly 018,Middle Super Output Areas and Intermediate Zones,MSOAIZ,CF,6799,3377,3422,1410,1426
W02000308,Caerphilly 019,Middle Super Output Areas and Intermediate Zones,MSOAIZ,CF,9292,4577,4715,1830,1985
W02000309,Caerphilly 020,Middle Super Output Areas and Intermediate Zones,MSOAIZ,NP,6859,3343,3516,1314,1335
W02000310,Caerphilly 021,Middle Super Output Areas and Intermediate Zones,MSOAIZ,NP,5455,2696,2759,1065,1105
W02000311,Caerphilly 022,Middle Super Output Areas and Intermediate Zones,MSOAIZ,NP,9505,4558,4947,1838,1927
W02000312,Caerphilly 023,Middle Super Output Areas and Intermediate Zones,MSOAIZ,CF,7500,3663,3837,1371,1487
W02000313,Caerphilly 024,Middle Super Output Areas and Intermediate Zones,MSOAIZ,CF,10257,5041,5216,2270,2273
W02000314,Blaenau Gwent 001,Middle Super Output Areas and Intermediate Zones,MSOAIZ,NP,7100,3483,3617,1359,1416
W02000315,Blaenau Gwent 002,Middle Super Output Areas and Intermediate Zones,MSOAIZ,NP,5530,2741,2789,1100,1084
W02000316,Blaenau Gwent 003,Middle Super Output Areas and Intermediate Zones,MSOAIZ,NP,7125,3469,3656,1360,1398
W02000317,Blaenau Gwent 004,Middle Super Output Areas and Intermediate Zones,MSOAIZ,NP,7671,3689,3982,1449,1529
W02000318,Blaenau Gwent 005,Middle Super Output Areas and Intermediate Zones,MSOAIZ,NP,9443,4677,4766,1884,1933
W02000319,Blaenau Gwent 006,Middle Super Output Areas and Intermediate Zones,MSOAIZ,NP,7978,3848,4130,1575,1603
W02000320,Blaenau Gwent 007,Middle Super Output Areas and Intermediate Zones,MSOAIZ,NP,8569,4263,4306,1813,1784
W02000321,Blaenau Gwent 008,Middle Super Output Areas and Intermediate Zones,MSOAIZ,NP,9119,4485,4634,1762,1800
W02000322,Blaenau Gwent 009,Middle Super Output Areas and Intermediate Zones,MSOAIZ,NP,7279,3670,3609,1471,1397
W02000323,Torfaen 001,Middle Super Output Areas and Intermediate Zones,MSOAIZ,NP,6055,2978,3077,1181,1155
W02000324,Torfaen 002,Middle Super Output Areas and Intermediate Zones,MSOAIZ,NP,7064,3425,3639,1340,1426
W02000325,Torfaen 003,Middle Super Output Areas and Intermediate Zones,MSOAIZ,NP,7210,3545,3665,1421,1403
W02000326,Torfaen 004,Middle Super Output Areas and Intermediate Zones,MSOAIZ,NP,9008,4406,4602,1771,1807
W02000327,Torfaen 005,Middle Super Output Areas and Intermediate Zones,MSOAIZ,NP,5986,2918,3068,1061,1114
W02000328,Torfaen 006,Middle Super Output Areas and Intermediate Zones,MSOAIZ,NP,7217,3570,3647,1436,1464
W02000329,Torfaen 007,Middle Super Output Areas and Intermediate Zones,MSOAIZ,NP,7505,3704,3801,1527,1499
W02000330,Torfaen 008,Middle Super Output Areas and Intermediate Zones,MSOAIZ,NP,7259,3448,3811,1265,1335
W02000331,Torfaen 009,Middle Super Output Areas and Intermediate Zones,MSOAIZ,NP,6767,3222,3545,1213,1446
W02000332,Torfaen 010,Middle Super Output Areas and Intermediate Zones,MSOAIZ,NP,6822,3303,3519,1315,1226
W02000333,Torfaen 011,Middle Super Output Areas and Intermediate Zones,MSOAIZ,NP,6558,3168,3390,1232,1373
W02000334,Torfaen 012,Middle Super Output Areas and Intermediate Zones,MSOAIZ,NP,6791,3382,3409,1384,1446
W02000335,Torfaen 013,Middle Super Output Areas and Intermediate Zones,MSOAIZ,NP,6833,3313,3520,1220,1266
W02000336,Monmouthshire 001,Middle Super Output Areas and Intermediate Zones,MSOAIZ,NP,8148,3893,4255,1383,1487
W02000337,Monmouthshire 002,Middle Super Output Areas and Intermediate Zones,MSOAIZ,NP,7506,3633,3873,1376,1421
W02000338,Monmouthshire 003,Middle Super Output Areas and Intermediate Zones,MSOAIZ,NP,7665,3735,3930,1251,1355
W02000339,Monmouthshire 004,Middle Super Output Areas and Intermediate Zones,MSOAIZ,NP,10508,5100,5408,1734,1924
W02000340,Monmouthshire 005,Middle Super Output Areas and Intermediate Zones,MSOAIZ,NP,7220,3574,3646,1270,1272
W02000341,Monmouthshire 006,Middle Super Output Areas and Intermediate Zones,MSOAIZ,NP,8387,4309,4078,1644,1452
W02000342,Monmouthshire 007,Middle Super Output Areas and Intermediate Zones,MSOAIZ,NP,9673,4761,4912,1714,1847
W02000343,Monmouthshire 008,Middle Super Output Areas and Intermediate Zones,MSOAIZ,NP,8534,4127,4407,1770,1812
W02000344,Monmouthshire 009,Middle Super Output Areas and Intermediate Zones,MSOAIZ,NP,7565,3824,3741,1381,1445
W02000345,Monmouthshire 010,Middle Super Output Areas and Intermediate Zones,MSOAIZ,NP,8164,4024,4140,1514,1513
W02000346,Monmouthshire 011,Middle Super Output Areas and Intermediate Zones,MSOAIZ,NP,7953,3942,4011,1659,1746
W02000347,Newport 001,Middle Super Output Areas and Intermediate Zones,MSOAIZ,NP,8061,3914,4147,1438,1537
W02000348,Newport 002,Middle Super Output Areas and Intermediate Zones,MSOAIZ,NP,7997,3850,4147,1438,1514
W02000349,Newport 003,Middle Super Output Areas and Intermediate Zones,MSOAIZ,NP,7606,3644,3962,1437,1523
W02000350,Newport 004,Middle Super Output Areas and Intermediate Zones,MSOAIZ,NP,7386,3630,3756,1375,1512
W02000351,Newport 005,Middle Super Output Areas and Intermediate Zones,MSOAIZ,NP,6072,2980,3092,1199,1202
W02000352,Newport 006,Middle Super Output Areas and Intermediate Zones,MSOAIZ,NP,6598,3203,3395,1423,1494
W02000353,Newport 007,Middle Super Output Areas and Intermediate Zones,MSOAIZ,NP,7066,3514,3552,1447,1479
W02000354,Newport 008,Middle Super Output Areas and Intermediate Zones,MSOAIZ,NP,5982,2827,3155,1056,1116
W02000355,Newport 009,Middle Super Output Areas and Intermediate Zones,MSOAIZ,NP,8434,4159,4275,1580,1667
W02000356,Newport 010,Middle Super Output Areas and Intermediate Zones,MSOAIZ,NP,5389,2593,2796,922,1033
W02000357,Newport 011,Middle Super Output Areas and Intermediate Zones,MSOAIZ,NP,7899,3977,3922,1714,1655
W02000358,Newport 012,Middle Super Output Areas and Intermediate Zones,MSOAIZ,NP,5951,2911,3040,1143,1111
W02000359,Newport 013,Middle Super Output Areas and Intermediate Zones,MSOAIZ,NP,9855,4986,4869,2364,2177
W02000360,Newport 014,Middle Super Output Areas and Intermediate Zones,MSOAIZ,NP,6141,3204,2937,1607,1262
W02000361,Newport 015,Middle Super Output Areas and Intermediate Zones,MSOAIZ,NP,10686,5121,5565,1792,2060
W02000362,Newport 016,Middle Super Output Areas and Intermediate Zones,MSOAIZ,NP,5986,2894,3092,1125,1203
W02000363,Newport 017,Middle Super Output Areas and Intermediate Zones,MSOAIZ,NP,5657,2715,2942,1020,1056
W02000364,Newport 018,Middle Super Output Areas and Intermediate Zones,MSOAIZ,NP,7318,3691,3627,1433,1342
W02000365,Newport 019,Middle Super Output Areas and Intermediate Zones,MSOAIZ,NP,7485,3519,3966,1384,1670
W02000366,Newport 020,Middle Super Output Areas and Intermediate Zones,MSOAIZ,NP,8167,4048,4119,1821,1920
W02000367,Cardiff 001,Middle Super Output Areas and Intermediate Zones,MSOAIZ,CF,6068,2925,3143,1022,1141
W02000368,Cardiff 002,Middle Super Output Areas and Intermediate Zones,MSOAIZ,CF,5946,2845,3101,1288,1463
W02000369,Cardiff 003,Middle Super Output Areas and Intermediate Zones,MSOAIZ,CF,7968,3838,4130,1921,2121
W02000370,Cardiff 004,Middle Super Output Areas and Intermediate Zones,MSOAIZ,CF,6509,3030,3479,1044,1135
W02000371,Cardiff 005,Middle Super Output Areas and Intermediate Zones,MSOAIZ,CF,9110,4391,4719,1842,1950
W02000372,Cardiff 006,Middle Super Output Areas and Intermediate Zones,MSOAIZ,CF,7613,3740,3873,1525,1664
W02000373,Cardiff 007,Middle Super Output Areas and Intermediate Zones,MSOAIZ,CF,6541,3063,3478,1159,1425
W02000374,Cardiff 008,Middle Super Output Areas and Intermediate Zones,MSOAIZ,CF,5683,2705,2978,938,1041
W02000375,Cardiff 009,Middle Super Output Areas and Intermediate Zones,MSOAIZ,CF,7062,3338,3724,1408,1634
W02000376,Cardiff 010,Middle Super Output Areas and Intermediate Zones,MSOAIZ,CF,6780,3309,3471,1396,1423
W02000377,Cardiff 011,Middle Super Output Areas and Intermediate Zones,MSOAIZ,CF,7125,3380,3745,1524,1784
W02000378,Cardiff 012,Middle Super Output Areas and Intermediate Zones,MSOAIZ,CF,7384,3595,3789,1417,1485
W02000379,Cardiff 013,Middle Super Output Areas and Intermediate Zones,MSOAIZ,CF,6270,2827,3443,1066,1466
W02000380,Cardiff 014,Middle Super Output Areas and Intermediate Zones,MSOAIZ,CF,7108,3431,3677,1308,1470
W02000381,Cardiff 015,Middle Super Output Areas and Intermediate Zones,MSOAIZ,CF,6271,3054,3217,1222,1269
W02000382,Cardiff 016,Middle Super Output Areas and Intermediate Zones,MSOAIZ,CF,5738,2689,3049,1003,1179
W02000383,Cardiff 017,Middle Super Output Areas and Intermediate Zones,MSOAIZ,CF,7219,3480,3739,1370,1543
W02000384,Cardiff 018,Middle Super Output Areas and Intermediate Zones,MSOAIZ,CF,5753,2864,2889,1216,1179
W02000385,Cardiff 019,Middle Super Output Areas and Intermediate Zones,MSOAIZ,CF,6818,3332,3486,1097,1138
W02000386,Cardiff 020,Middle Super Output Areas and Intermediate Zones,MSOAIZ,CF,7748,3705,4043,1427,1487
W02000387,Cardiff 021,Middle Super Output Areas and Intermediate Zones,MSOAIZ,CF,5962,2852,3110,1161,1257
W02000388,Cardiff 022,Middle Super Output Areas and Intermediate Zones,MSOAIZ,CF,5888,2799,3089,1102,1196
W02000389,Cardiff 023,Middle Super Output Areas and Intermediate Zones,MSOAIZ,CF,8344,4001,4343,1612,1862
W02000390,Cardiff 024,Middle Super Output Areas and Intermediate Zones,MSOAIZ,CF,6335,2945,3390,960,1052
W02000391,Cardiff 025,Middle Super Output Areas and Intermediate Zones,MSOAIZ,CF,8790,4058,4732,1486,1297
W02000392,Cardiff 026,Middle Super Output Areas and Intermediate Zones,MSOAIZ,CF,8997,4309,4688,1748,1818
W02000393,Cardiff 027,Middle Super Output Areas and Intermediate Zones,MSOAIZ,CF,6342,3059,3283,1327,1377
W02000394,Cardiff 028,Middle Super Output Areas and Intermediate Zones,MSOAIZ,CF,8922,4416,4506,1311,970
W02000395,Cardiff 029,Middle Super Output Areas and Intermediate Zones,MSOAIZ,CF,6322,3084,3238,1520,1478
W02000396,Cardiff 030,Middle Super Output Areas and Intermediate Zones,MSOAIZ,CF,8079,4147,3932,1828,1462
W02000397,Cardiff 031,Middle Super Output Areas and Intermediate Zones,MSOAIZ,CF,6639,3147,3492,1230,1446
W02000398,Cardiff 032,Middle Super Output Areas and Intermediate Zones,MSOAIZ,CF,11199,5814,5385,1522,914
W02000399,Cardiff 033,Middle Super Output Areas and Intermediate Zones,MSOAIZ,CF,10087,5571,4516,2499,1816
W02000400,Cardiff 034,Middle Super Output Areas and Intermediate Zones,MSOAIZ,CF,6531,3265,3266,1925,1758
W02000401,Cardiff 035,Middle Super Output Areas and Intermediate Zones,MSOAIZ,CF,5947,2893,3054,1364,1443
W02000402,Cardiff 036,Middle Super Output Areas and Intermediate Zones,MSOAIZ,CF,10371,5592,4779,2771,2016
W02000403,Cardiff 037,Middle Super Output Areas and Intermediate Zones,MSOAIZ,CF,7213,3489,3724,1591,1805
W02000404,Cardiff 038,Middle Super Output Areas and Intermediate Zones,MSOAIZ,CF,6048,2972,3076,1447,1497
W02000405,Cardiff 039,Middle Super Output Areas and Intermediate Zones,MSOAIZ,CF,7507,3484,4023,1261,1583
W02000406,Cardiff 040,Middle Super Output Areas and Intermediate Zones,MSOAIZ,CF,8357,4114,4243,2090,2007
W02000407,Cardiff 041,Middle Super Output Areas and Intermediate Zones,MSOAIZ,CF,6406,2977,3429,1102,1347
W02000408,Cardiff 042,Middle Super Output Areas and Intermediate Zones,MSOAIZ,CF,7240,3950,3290,1959,1508
W02000409,Cardiff 043,Middle Super Output Areas and Intermediate Zones,MSOAIZ,CF,5886,2778,3108,1019,1211
W02000410,Cardiff 044,Middle Super Output Areas and Intermediate Zones,MSOAIZ,CF,8423,4367,4056,1917,1717
W02000411,Cardiff 045,Middle Super Output Areas and Intermediate Zones,MSOAIZ,CF,6454,3106,3348,1269,1443
W02000412,Cardiff 046,Middle Super Output Areas and Intermediate Zones,MSOAIZ,CF,6816,3409,3407,1587,1530
W02000414,Powys 020,Middle Super Output Areas and Intermediate Zones,MSOAIZ,SA,6014,2981,3033,1084,1110
W02000415,Merthyr Tydfil 008,Middle Super Output Areas and Intermediate Zones,MSOAIZ,CF,9395,4466,4929,1692,1945
W02000416,Powys 021,Middle Super Output Areas and Intermediate Zones,MSOAIZ,SA,10210,4973,5237,1773,1889
W02000417,Neath Port Talbot 020,Middle Super Output Areas and Intermediate Zones,MSOAIZ,SA,10075,4983,5092,2023,1999
W02000418,Carmarthenshire 027,Middle Super Output Areas and Intermediate Zones,MSOAIZ,SA,12211,6002,6209,2137,2292
W02000419,Denbighshire 017,Middle Super Output Areas and Intermediate Zones,MSOAIZ,LL,10617,5105,5512,1828,2034
W02000420,Wrexham 020,Middle Super Output Areas and Intermediate Zones,MSOAIZ,LL,13464,6639,6825,2507,2596
W02000421,Ceredigion 011,Middle Super Output Areas and Intermediate Zones,MSOAIZ,SY,11722,5744,5978,2013,2117
W02000422,Cardiff 048,Middle Super Output Areas and Intermediate Zones,MSOAIZ,CF,6043,3342,2701,2399,1714
W02000423,Cardiff 049,Middle Super Output Areas and Intermediate Zones,MSOAIZ,CF,8228,4412,3816,2478,1903
S02001236,Culter,Middle Super Output Areas and Intermediate Zones,MSOAIZ,AB,4845,2363,2482,1127,1215
S02001237,Cults; Bieldside and Milltimber West,Middle Super Output Areas and Intermediate Zones,MSOAIZ,AB,4007,1964,2043,839,897
S02001238,Cults; Bieldside and Milltimber East,Middle Super Output Areas and Intermediate Zones,MSOAIZ,AB,6112,2975,3137,1306,1416
S02001239,Garthdee,Middle Super Output Areas and Intermediate Zones,MSOAIZ,AB,5229,2504,2725,1425,1482
S02001240,Braeside; Mannofield; Broomhill and Seafield East,Middle Super Output Areas and Intermediate Zones,MSOAIZ,AB,4419,2197,2222,1359,1252
S02001241,Braeside; Mannofield; Broomhill and Seafield South,Middle Super Output Areas and Intermediate Zones,MSOAIZ,AB,3831,1795,2036,840,884
S02001242,Braeside; Mannofield; Broomhill and Seafield North,Middle Super Output Areas and Intermediate Zones,MSOAIZ,AB,4564,2199,2365,1110,1020
S02001243,Hazlehead,Middle Super Output Areas and Intermediate Zones,MSOAIZ,AB,4946,2391,2555,1076,1126
S02001244,Summerhill,Middle Super Output Areas and Intermediate Zones,MSOAIZ,AB,3911,1860,2051,942,992
S02001245,Midstocket,Middle Super Output Areas and Intermediate Zones,MSOAIZ,AB,4572,2238,2334,1185,1129
S02001246,Rosemount,Middle Super Output Areas and Intermediate Zones,MSOAIZ,AB,5843,2923,2920,2203,2153
S02001247,West End North,Middle Super Output Areas and Intermediate Zones,MSOAIZ,AB,3518,1747,1771,917,910
S02001248,West End South,Middle Super Output Areas and Intermediate Zones,MSOAIZ,AB,6102,3192,2910,2179,1934
S02001249,City Centre West,Middle Super Output Areas and Intermediate Zones,MSOAIZ,AB,4025,2143,1882,1663,1460
S02001250,City Centre East,Middle Super Output Areas and Intermediate Zones,MSOAIZ,AB,2509,1401,1108,1186,941
S02001251,Ferryhill North,Middle Super Output Areas and Intermediate Zones,MSOAIZ,AB,4901,2585,2316,2021,1700
S02001252,Ferryhill South,Middle Super Output Areas and Intermediate Zones,MSOAIZ,AB,4745,2354,2391,1454,1305
S02001253,Kincorth; Leggart and Nigg North,Middle Super Output Areas and Intermediate Zones,MSOAIZ,AB,4094,1903,2191,1002,1026
S02001254,Kincorth; Leggart and Nigg South,Middle Super Output Areas and Intermediate Zones,MSOAIZ,AB,4024,1923,2101,992,1037
S02001255,Cove South,Middle Super Output Areas and Intermediate Zones,MSOAIZ,AB,4069,2030,2039,1173,1216
S02001256,Cove North,Middle Super Output Areas and Intermediate Zones,MSOAIZ,AB,3683,1778,1905,1007,1035
S02001257,Torry West,Middle Super Output Areas and Intermediate Zones,MSOAIZ,AB,5686,2950,2736,1988,1678
S02001258,Torry East,Middle Super Output Areas and Intermediate Zones,MSOAIZ,AB,4606,2215,2391,1199,1308
S02001259,Hanover South,Middle Super Output Areas and Intermediate Zones,MSOAIZ,AB,3255,1706,1549,1357,1098
S02001260,Hanover North,Middle Super Output Areas and Intermediate Zones,MSOAIZ,AB,4108,2094,2014,1810,1726
S02001261,George Street,Middle Super Output Areas and Intermediate Zones,MSOAIZ,AB,7144,3702,3442,3008,2788
S02001262,Ashgrove,Middle Super Output Areas and Intermediate Zones,MSOAIZ,AB,3705,1877,1828,1339,1276
S02001263,Froghall; Powis and Sunnybank,Middle Super Output Areas and Intermediate Zones,MSOAIZ,AB,5432,2809,2623,2167,2044
S02001264,Seaton,Middle Super Output Areas and Intermediate Zones,MSOAIZ,AB,4674,2315,2359,1620,1691
S02001265,Old Aberdeen,Middle Super Output Areas and Intermediate Zones,MSOAIZ,AB,5021,2367,2654,1786,2071
S02001266,Tillydrone,Middle Super Output Areas and Intermediate Zones,MSOAIZ,AB,4835,2469,2366,1451,1397
S02001267,Woodside,Middle Super Output Areas and Intermediate Zones,MSOAIZ,AB,3989,2025,1964,1261,1183
S02001268,Hilton,Middle Super Output Areas and Intermediate Zones,MSOAIZ,AB,5944,2897,3047,1706,1640
S02001269,Stockethill,Middle Super Output Areas and Intermediate Zones,MSOAIZ,AB,5344,2505,2839,1263,1357
S02001270,Mastrick,Middle Super Output Areas and Intermediate Zones,MSOAIZ,AB,4812,2266,2546,1130,1267
S02001271,Sheddocksley,Middle Super Output Areas and Intermediate Zones,MSOAIZ,AB,4917,2320,2597,1106,1180
S02001272,Cummings Park,Middle Super Output Areas and Intermediate Zones,MSOAIZ,AB,3532,1686,1846,837,876
S02001273,Northfield,Middle Super Output Areas and Intermediate Zones,MSOAIZ,AB,5507,2639,2868,1324,1472
S02001274,Heathryfold and Middlefield,Middle Super Output Areas and Intermediate Zones,MSOAIZ,AB,5272,2582,2690,1323,1479
S02001275,Kingswells,Middle Super Output Areas and Intermediate Zones,MSOAIZ,AB,5304,2566,2738,1352,1458
S02001276,Bucksburn South,Middle Super Output Areas and Intermediate Zones,MSOAIZ,AB,3299,1675,1624,923,842
S02001277,Bucksburn North,Middle Super Output Areas and Intermediate Zones,MSOAIZ,AB,4540,2195,2345,1070,1070
S02001278,Dyce,Middle Super Output Areas and Intermediate Zones,MSOAIZ,AB,5402,2629,2773,1211,1198
S02001279,Danestone,Middle Super Output Areas and Intermediate Zones,MSOAIZ,AB,4055,1983,2072,1096,1125
S02001280,Oldmachar West,Middle Super Output Areas and Intermediate Zones,MSOAIZ,AB,4343,2110,2233,1187,1256
S02001281,Oldmachar East,Middle Super Output Areas and Intermediate Zones,MSOAIZ,AB,4902,2498,2404,1188,1219
S02001282,Balgownie and Donmouth West,Middle Super Output Areas and Intermediate Zones,MSOAIZ,AB,3588,1737,1851,811,824
S02001283,Balgownie and Donmouth East,Middle Super Output Areas and Intermediate Zones,MSOAIZ,AB,2715,1358,1357,657,646
S02001284,Denmore,Middle Super Output Areas and Intermediate Zones,MSOAIZ,AB,2913,1482,1431,780,758
S02001285,East Cairngorms,Middle Super Output Areas and Intermediate Zones,MSOAIZ,AB,3114,1542,1572,653,631
S02001286,Aboyne and South Deeside,Middle Super Output Areas and Intermediate Zones,MSOAIZ,AB,4894,2383,2511,1049,1088
S02001287,Mearns and Laurencekirk,Middle Super Output Areas and Intermediate Zones,MSOAIZ,DD,4188,2054,2134,969,1031
S02001288,Mearns South and Benholm,Middle Super Output Areas and Intermediate Zones,MSOAIZ,DD,3972,2022,1950,922,944
S02001289,Mearns North and Inverbervie,Middle Super Output Areas and Intermediate Zones,MSOAIZ,DD,5365,2680,2685,1341,1326
S02001290,Fetteresso; Netherley and Catter,Middle Super Output Areas and Intermediate Zones,MSOAIZ,AB,3343,1677,1666,832,855
S02001291,Stonehaven South,Middle Super Output Areas and Intermediate Zones,MSOAIZ,AB,5544,2678,2866,1340,1380
S02001292,Stonehaven North,Middle Super Output Areas and Intermediate Zones,MSOAIZ,AB,5887,2885,3002,1420,1423
S02001293,Newtonhill,Middle Super Output Areas and Intermediate Zones,MSOAIZ,AB,2982,1466,1516,723,757
S02001294,Portlethen,Middle Super Output Areas and Intermediate Zones,MSOAIZ,AB,4526,2259,2267,1256,1257
S02001295,Banchory-Devenick and Findon,Middle Super Output Areas and Intermediate Zones,MSOAIZ,AB,4306,2124,2182,1144,1189
S02001296,Dunecht; Durris and Drumoak,Middle Super Output Areas and Intermediate Zones,MSOAIZ,AB,4812,2384,2428,1106,1144
S02001297,Banchory East,Middle Super Output Areas and Intermediate Zones,MSOAIZ,AB,4049,1964,2085,969,977
S02001298,Banchory West,Middle Super Output Areas and Intermediate Zones,MSOAIZ,AB,3097,1543,1554,675,652
S02001299,Crathes and Torphins,Middle Super Output Areas and Intermediate Zones,MSOAIZ,AB,4041,2002,2039,838,881
S02001300,Cromar and Kildrummy,Middle Super Output Areas and Intermediate Zones,MSOAIZ,AB,4140,2082,2058,939,901
S02001301,Howe of Alford,Middle Super Output Areas and Intermediate Zones,MSOAIZ,AB,5571,2773,2798,1252,1274
S02001302,Kemnay,Middle Super Output Areas and Intermediate Zones,MSOAIZ,AB,3599,1749,1850,808,870
S02001303,Inverurie North,Middle Super Output Areas and Intermediate Zones,MSOAIZ,AB,5501,2726,2775,1409,1405
S02001304,Inverurie South,Middle Super Output Areas and Intermediate Zones,MSOAIZ,AB,5376,2555,2821,1264,1308
S02001305,Durno-Chapel of Garioch,Middle Super Output Areas and Intermediate Zones,MSOAIZ,AB,4843,2492,2351,1328,1278
S02001306,Kintore,Middle Super Output Areas and Intermediate Zones,MSOAIZ,AB,5723,2820,2903,1414,1466
S02001307,Blackburn,Middle Super Output Areas and Intermediate Zones,MSOAIZ,AB,3271,1668,1603,905,914
S02001308,Westhill North and South,Middle Super Output Areas and Intermediate Zones,MSOAIZ,AB,3931,1940,1991,962,1006
S02001309,Westhill Central,Middle Super Output Areas and Intermediate Zones,MSOAIZ,AB,4163,1998,2165,974,1038
S02001310,Garlogie and Elrick,Middle Super Output Areas and Intermediate Zones,MSOAIZ,AB,3772,1829,1943,991,1064
S02001311,Newmachar and Fintray,Middle Super Output Areas and Intermediate Zones,MSOAIZ,AB,4205,2051,2154,1096,1152
S02001312,Balmedie and Potterton,Middle Super Output Areas and Intermediate Zones,MSOAIZ,AB,5259,2681,2578,1366,1369
S02001313,Ellon East,Middle Super Output Areas and Intermediate Zones,MSOAIZ,AB,5849,2874,2975,1467,1450
S02001314,Ellon West,Middle Super Output Areas and Intermediate Zones,MSOAIZ,AB,4419,2115,2304,1047,1106
S02001315,Ythanside,Middle Super Output Areas and Intermediate Zones,MSOAIZ,AB,4307,2216,2091,1122,1078
S02001316,Ythsie,Middle Super Output Areas and Intermediate Zones,MSOAIZ,AB,5693,2855,2838,1442,1408
S02001317,Barrahill,Middle Super Output Areas and Intermediate Zones,MSOAIZ,AB,4896,2437,2459,1228,1280
S02001318,Fyvie-Rothie,Middle Super Output Areas and Intermediate Zones,MSOAIZ,AB,3800,1927,1873,958,953
S02001319,Insch; Oyne and Ythanwells,Middle Super Output Areas and Intermediate Zones,MSOAIZ,AB,4623,2312,2311,1128,1122
S02001320,Clashindarroch,Middle Super Output Areas and Intermediate Zones,MSOAIZ,AB,4502,2320,2182,1077,1056
S02001321,Huntly,Middle Super Output Areas and Intermediate Zones,MSOAIZ,AB,4438,2108,2330,966,977
S02001322,Auchterless and Monquhitter,Middle Super Output Areas and Intermediate Zones,MSOAIZ,AB,2806,1427,1379,717,664
S02001323,Turriff,Middle Super Output Areas and Intermediate Zones,MSOAIZ,AB,4841,2303,2538,1093,1101
S02001324,Portsoy; Fordyce and Cornhill,Middle Super Output Areas and Intermediate Zones,MSOAIZ,AB,3293,1623,1670,676,701
S02001325,Aberchirder and Whitehills,Middle Super Output Areas and Intermediate Zones,MSOAIZ,AB,3829,1925,1904,830,819
S02001326,Banff,Middle Super Output Areas and Intermediate Zones,MSOAIZ,AB,4082,1965,2117,910,925
S02001327,Macduff,Middle Super Output Areas and Intermediate Zones,MSOAIZ,AB,4009,1984,2025,989,977
S02001328,Gardenstown and King Edward,Middle Super Output Areas and Intermediate Zones,MSOAIZ,AB,3209,1603,1606,715,710
S02001329,New Pitsligo,Middle Super Output Areas and Intermediate Zones,MSOAIZ,AB,3073,1568,1505,749,733
S02001330,Deer and Mormond,Middle Super Output Areas and Intermediate Zones,MSOAIZ,AB,4592,2317,2275,1133,1078
S02001331,Mintlaw,Middle Super Output Areas and Intermediate Zones,MSOAIZ,AB,2721,1306,1415,579,606
S02001332,Auchnagatt,Middle Super Output Areas and Intermediate Zones,MSOAIZ,AB,2892,1458,1434,705,706
S02001333,Cruden,Middle Super Output Areas and Intermediate Zones,MSOAIZ,AB,4687,2342,2345,1149,1159
S02001334,Peterhead Links,Middle Super Output Areas and Intermediate Zones,MSOAIZ,AB,4526,2278,2248,1194,1121
S02001335,Peterhead Bay,Middle Super Output Areas and Intermediate Zones,MSOAIZ,AB,2620,1267,1353,614,607
S02001336,Peterhead Harbour,Middle Super Output Areas and Intermediate Zones,MSOAIZ,AB,6432,3222,3210,1750,1724
S02001337,Peterhead Ugieside,Middle Super Output Areas and Intermediate Zones,MSOAIZ,AB,4412,2172,2240,1097,1104
S02001338,Longside and Rattray,Middle Super Output Areas and Intermediate Zones,MSOAIZ,AB,5864,2944,2920,1460,1447
S02001339,Rosehearty and Strathbeg,Middle Super Output Areas and Intermediate Zones,MSOAIZ,AB,5984,2938,3046,1379,1398
S02001340,Fraserburgh Smiddyhill,Middle Super Output Areas and Intermediate Zones,MSOAIZ,AB,4144,2079,2065,1005,931
S02001341,Fraserburgh Lochpots,Middle Super Output Areas and Intermediate Zones,MSOAIZ,AB,2577,1246,1331,688,720
S02001342,Fraserburgh Central-Academy,Middle Super Output Areas and Intermediate Zones,MSOAIZ,AB,2708,1295,1413,663,633
S02001343,Fraserburgh Harbour and Broadsea,Middle Super Output Areas and Intermediate Zones,MSOAIZ,AB,3671,1816,1855,961,970
S02001344,South Angus,Middle Super Output Areas and Intermediate Zones,MSOAIZ,DD,5551,2704,2847,1201,1315
S02001345,Monikie,Middle Super Output Areas and Intermediate Zones,MSOAIZ,DD,5864,2913,2951,1419,1429
S02001346,Monifieth West,Middle Super Output Areas and Intermediate Zones,MSOAIZ,DD,2900,1410,1490,571,594
S02001347,Monifieth East,Middle Super Output Areas and Intermediate Zones,MSOAIZ,DD,4819,2250,2569,919,936
S02001348,Carnoustie West,Middle Super Output Areas and Intermediate Zones,MSOAIZ,DD,5199,2475,2724,1170,1332
S02001349,Carnoustie East,Middle Super Output Areas and Intermediate Zones,MSOAIZ,DD,5524,2595,2929,1040,1145
S02001350,Arbroath Landward,Middle Super Output Areas and Intermediate Zones,MSOAIZ,DD,2321,1212,1109,610,516
S02001351,Arbroath Kirkton,Middle Super Output Areas and Intermediate Zones,MSOAIZ,DD,5823,2838,2985,1338,1411
S02001352,Arbroath Keptie,Middle Super Output Areas and Intermediate Zones,MSOAIZ,DD,3694,1738,1956,757,829
S02001353,Arbroath Harbour,Middle Super Output Areas and Intermediate Zones,MSOAIZ,DD,4707,2232,2475,1153,1182
S02001354,Arbroath Cliffburn,Middle Super Output Areas and Intermediate Zones,MSOAIZ,DD,4801,2258,2543,1090,1191
S02001355,Arbroath Warddykes,Middle Super Output Areas and Intermediate Zones,MSOAIZ,DD,4938,2384,2554,1165,1270
S02001356,Lunan,Middle Super Output Areas and Intermediate Zones,MSOAIZ,DD,2961,1464,1497,671,697
S02001357,Montrose South,Middle Super Output Areas and Intermediate Zones,MSOAIZ,DD,5702,2732,2970,1405,1408
S02001358,Montrose North,Middle Super Output Areas and Intermediate Zones,MSOAIZ,DD,4820,2367,2453,1116,1153
S02001359,Hillside,Middle Super Output Areas and Intermediate Zones,MSOAIZ,DD,3535,1748,1787,803,828
S02001360,Friockheim,Middle Super Output Areas and Intermediate Zones,MSOAIZ,DD,3509,1771,1738,822,807
S02001361,Brechin East,Middle Super Output Areas and Intermediate Zones,MSOAIZ,DD,3595,1743,1852,844,896
S02001362,Brechin West,Middle Super Output Areas and Intermediate Zones,MSOAIZ,DD,3886,1865,2021,862,874
S02001363,Letham and Glamis,Middle Super Output Areas and Intermediate Zones,MSOAIZ,DD,5334,2639,2695,1194,1166
S02001364,Forfar East,Middle Super Output Areas and Intermediate Zones,MSOAIZ,DD,4150,2007,2143,894,922
S02001365,Forfar Central,Middle Super Output Areas and Intermediate Zones,MSOAIZ,DD,4755,2260,2495,1142,1185
S02001366,Forfar West,Middle Super Output Areas and Intermediate Zones,MSOAIZ,DD,5050,2410,2640,1124,1178
S02001367,Kirriemuir Landward,Middle Super Output Areas and Intermediate Zones,MSOAIZ,PH,2780,1403,1377,639,641
S02001368,Kirriemuir,Middle Super Output Areas and Intermediate Zones,MSOAIZ,DD,6085,2913,3172,1344,1366
S02001369,Angus Glens,Middle Super Output Areas and Intermediate Zones,MSOAIZ,PH,3675,1875,1800,874,765
S02001370,Mull; Iona; Coll and Tiree,Middle Super Output Areas and Intermediate Zones,MSOAIZ,PA,3844,1800,2044,762,876
S02001371,Oban South,Middle Super Output Areas and Intermediate Zones,MSOAIZ,PA,5830,2827,3003,1406,1489
S02001372,Oban North,Middle Super Output Areas and Intermediate Zones,MSOAIZ,PA,2799,1384,1415,761,710
S02001373,Benderloch Trail,Middle Super Output Areas and Intermediate Zones,MSOAIZ,PA,5260,2557,2703,1085,1128
S02001374,Loch Awe,Middle Super Output Areas and Intermediate Zones,MSOAIZ,PA,2259,1125,1134,459,478
S02001375,Mid Argyll,Middle Super Output Areas and Intermediate Zones,MSOAIZ,PA,3146,1559,1587,672,671
S02001376,Greater Lochgilphead,Middle Super Output Areas and Intermediate Zones,MSOAIZ,PA,3825,1877,1948,878,883
S02001377,Knapdale,Middle Super Output Areas and Intermediate Zones,MSOAIZ,PA,2521,1245,1276,550,528
S02001378,Whisky Isles,Middle Super Output Areas and Intermediate Zones,MSOAIZ,PA,3556,1724,1832,703,784
S02001379,Kintyre Trail,Middle Super Output Areas and Intermediate Zones,MSOAIZ,PA,2971,1482,1489,614,574
S02001380,Campbeltown,Middle Super Output Areas and Intermediate Zones,MSOAIZ,PA,4932,2362,2570,1025,1047
S02001381,Bute,Middle Super Output Areas and Intermediate Zones,MSOAIZ,PA,2687,1278,1409,465,472
S02001382,Rothesay Town,Middle Super Output Areas and Intermediate Zones,MSOAIZ,PA,3811,1805,2006,785,829
S02001383,Cowal South,Middle Super Output Areas and Intermediate Zones,MSOAIZ,PA,2584,1268,1316,470,443
S02001384,Cowal North,Middle Super Output Areas and Intermediate Zones,MSOAIZ,PA,3376,1652,1724,661,681
S02001385,Hunter's Quay,Middle Super Output Areas and Intermediate Zones,MSOAIZ,PA,5249,2465,2784,949,1064
S02001386,Dunoon,Middle Super Output Areas and Intermediate Zones,MSOAIZ,PA,4711,2281,2430,1062,1074
S02001387,Garelochhead,Middle Super Output Areas and Intermediate Zones,MSOAIZ,G,5636,3179,2457,1911,1134
S02001388,Helensburgh West and Rhu,Middle Super Output Areas and Intermediate Zones,MSOAIZ,G,4342,2088,2254,875,929
S02001389,Helensburgh North,Middle Super Output Areas and Intermediate Zones,MSOAIZ,G,4487,2141,2346,936,1019
S02001390,Helensburgh Centre,Middle Super Output Areas and Intermediate Zones,MSOAIZ,G,3153,1515,1638,747,693
S02001391,Helensburgh East,Middle Super Output Areas and Intermediate Zones,MSOAIZ,G,4155,2017,2138,987,1062
S02001392,Lomond Shore,Middle Super Output Areas and Intermediate Zones,MSOAIZ,G,3032,1509,1523,669,677
S02001393,Tullibody South,Middle Super Output Areas and Intermediate Zones,MSOAIZ,FK,4396,2120,2276,1072,1167
S02001394,Tullibody North and Glenochil,Middle Super Output Areas and Intermediate Zones,MSOAIZ,FK,5410,2917,2493,1820,1326
S02001395,Menstrie,Middle Super Output Areas and Intermediate Zones,MSOAIZ,FK,2804,1356,1448,664,685
S02001396,Alva,Middle Super Output Areas and Intermediate Zones,MSOAIZ,FK,4773,2279,2494,1133,1193
S02001397,Fishcross; Devon Village and Coalsnaughton,Middle Super Output Areas and Intermediate Zones,MSOAIZ,FK,2112,997,1115,494,516
S02001398,Tillicoultry,Middle Super Output Areas and Intermediate Zones,MSOAIZ,FK,4835,2390,2445,1107,1153
S02001399,Dollar and Muckhart,Middle Super Output Areas and Intermediate Zones,MSOAIZ,KY,3520,1681,1839,673,711
S02001400,Clackmannan; Kennet and Forestmill,Middle Super Output Areas and Intermediate Zones,MSOAIZ,FK,4408,2134,2274,1052,1092
S02001401,Sauchie,Middle Super Output Areas and Intermediate Zones,MSOAIZ,FK,5220,2483,2737,1224,1344
S02001402,Alloa South and East,Middle Super Output Areas and Intermediate Zones,MSOAIZ,FK,4910,2388,2522,1310,1364
S02001403,Alloa North,Middle Super Output Areas and Intermediate Zones,MSOAIZ,FK,5598,2695,2903,1329,1451
S02001404,Alloa West,Middle Super Output Areas and Intermediate Zones,MSOAIZ,FK,3456,1669,1787,875,891
S02001405,Stranraer West,Middle Super Output Areas and Intermediate Zones,MSOAIZ,DG,3670,1743,1927,743,867
S02001406,Stranraer East,Middle Super Output Areas and Intermediate Zones,MSOAIZ,DG,2791,1333,1458,638,659
S02001407,Stranraer South,Middle Super Output Areas and Intermediate Zones,MSOAIZ,DG,3606,1710,1896,813,891
S02001408,Rhins North,Middle Super Output Areas and Intermediate Zones,MSOAIZ,DG,3825,1887,1938,767,779
S02001409,Rhins South,Middle Super Output Areas and Intermediate Zones,MSOAIZ,DG,2127,1050,1077,429,454
S02001410,Machars North,Middle Super Output Areas and Intermediate Zones,MSOAIZ,DG,2676,1327,1349,568,575
S02001411,Machars South,Middle Super Output Areas and Intermediate Zones,MSOAIZ,DG,5127,2532,2595,987,982
S02001412,Newton Stewart,Middle Super Output Areas and Intermediate Zones,MSOAIZ,DG,5507,2681,2826,1149,1183
S02001413,Gatehouse,Middle Super Output Areas and Intermediate Zones,MSOAIZ,DG,3465,1660,1805,659,713
S02001414,Kirkcudbright,Middle Super Output Areas and Intermediate Zones,MSOAIZ,DG,5302,2606,2696,1071,1098
S02001415,Castle Douglas,Middle Super Output Areas and Intermediate Zones,MSOAIZ,DG,4933,2332,2601,979,1108
S02001416,Dalbeattie,Middle Super Output Areas and Intermediate Zones,MSOAIZ,DG,4227,2011,2216,869,899
S02001417,Dalbeattie Rural,Middle Super Output Areas and Intermediate Zones,MSOAIZ,DG,2431,1193,1238,438,443
S02001418,Glenkens,Middle Super Output Areas and Intermediate Zones,MSOAIZ,DG,3664,1789,1875,689,747
S02001419,Upper Nithsdale,Middle Super Output Areas and Intermediate Zones,MSOAIZ,ML,4810,2334,2476,1001,1096
S02001420,Thornhill,Middle Super Output Areas and Intermediate Zones,MSOAIZ,ML,4154,2010,2144,809,866
S02001421,Mid Nithsdale,Middle Super Output Areas and Intermediate Zones,MSOAIZ,DG,4525,2264,2261,999,995
S02001422,Shawhead,Middle Super Output Areas and Intermediate Zones,MSOAIZ,DG,3083,1459,1624,702,750
S02001423,Lochside and Lincluden,Middle Super Output Areas and Intermediate Zones,MSOAIZ,DG,5991,2873,3118,1391,1531
S02001424,Summerville,Middle Super Output Areas and Intermediate Zones,MSOAIZ,DG,4923,2386,2537,1204,1193
S02001425,Troqueer,Middle Super Output Areas and Intermediate Zones,MSOAIZ,DG,3531,1670,1861,819,870
S02001426,New Abbey,Middle Super Output Areas and Intermediate Zones,MSOAIZ,DG,3545,1693,1852,734,789
S02001427,Kingholm,Middle Super Output Areas and Intermediate Zones,MSOAIZ,DG,3246,1598,1648,714,779
S02001428,Calside,Middle Super Output Areas and Intermediate Zones,MSOAIZ,DG,2950,1439,1511,724,766
S02001429,Georgetown,Middle Super Output Areas and Intermediate Zones,MSOAIZ,DG,2888,1417,1471,656,682
S02001430,Dumfries Central,Middle Super Output Areas and Intermediate Zones,MSOAIZ,DG,3393,1617,1776,871,908
S02001431,Nunholm,Middle Super Output Areas and Intermediate Zones,MSOAIZ,DG,3436,1638,1798,820,850
S02001432,Locharbriggs,Middle Super Output Areas and Intermediate Zones,MSOAIZ,DG,3022,1459,1563,637,710
S02001433,Heathhall,Middle Super Output Areas and Intermediate Zones,MSOAIZ,DG,3009,1456,1553,742,775
S02001434,Collin,Middle Super Output Areas and Intermediate Zones,MSOAIZ,DG,2776,1351,1425,626,672
S02001435,Lochmaben,Middle Super Output Areas and Intermediate Zones,MSOAIZ,DG,3143,1579,1564,660,691
S02001436,Lockerbie,Middle Super Output Areas and Intermediate Zones,MSOAIZ,DG,5011,2425,2586,1073,1087
S02001437,Moffat,Middle Super Output Areas and Intermediate Zones,MSOAIZ,DG,3962,1918,2044,779,806
S02001438,Langholm and Eskdale,Middle Super Output Areas and Intermediate Zones,MSOAIZ,DG,3914,1966,1948,828,822
S02001439,Annandale East,Middle Super Output Areas and Intermediate Zones,MSOAIZ,DG,3970,1922,2048,828,888
S02001440,Annandale West,Middle Super Output Areas and Intermediate Zones,MSOAIZ,DG,2613,1288,1325,563,589
S02001441,Annan West,Middle Super Output Areas and Intermediate Zones,MSOAIZ,DG,3262,1552,1710,735,767
S02001442,Annan East,Middle Super Output Areas and Intermediate Zones,MSOAIZ,DG,5658,2739,2919,1293,1378
S02001443,Eastriggs,Middle Super Output Areas and Intermediate Zones,MSOAIZ,DG,2998,1466,1532,637,650
S02001444,Gretna,Middle Super Output Areas and Intermediate Zones,MSOAIZ,DG,4160,2032,2128,901,934
S02001445,Westend,Middle Super Output Areas and Intermediate Zones,MSOAIZ,DD,5863,2842,3021,1641,1748
S02001446,Perth Road,Middle Super Output Areas and Intermediate Zones,MSOAIZ,DD,7417,3430,3987,2935,3394
S02001447,Logie and Blackness,Middle Super Output Areas and Intermediate Zones,MSOAIZ,DD,5602,2843,2759,1966,1781
S02001448,City Centre,Middle Super Output Areas and Intermediate Zones,MSOAIZ,DD,4781,2516,2265,2034,1736
S02001449,Docks and Wellgate,Middle Super Output Areas and Intermediate Zones,MSOAIZ,DD,5126,2653,2473,1984,1707
S02001450,Hilltown,Middle Super Output Areas and Intermediate Zones,MSOAIZ,DD,4852,2514,2338,1506,1309
S02001451,The Glens,Middle Super Output Areas and Intermediate Zones,MSOAIZ,DD,4648,2333,2315,1287,1224
S02001452,Stobswell,Middle Super Output Areas and Intermediate Zones,MSOAIZ,DD,5524,2806,2718,1983,1841
S02001453,Baxter Park,Middle Super Output Areas and Intermediate Zones,MSOAIZ,DD,3224,1590,1634,783,789
S02001454,Craigie and  Craigiebank,Middle Super Output Areas and Intermediate Zones,MSOAIZ,DD,4337,1932,2405,866,947
S02001455,Douglas West,Middle Super Output Areas and Intermediate Zones,MSOAIZ,DD,4453,2107,2346,1054,1213
S02001456,West Ferry,Middle Super Output Areas and Intermediate Zones,MSOAIZ,DD,3061,1413,1648,523,569
S02001457,Douglas East,Middle Super Output Areas and Intermediate Zones,MSOAIZ,DD,2925,1318,1607,591,728
S02001458,Broughty Ferry West,Middle Super Output Areas and Intermediate Zones,MSOAIZ,DD,4988,2279,2709,986,1075
S02001459,Broughty Ferry East,Middle Super Output Areas and Intermediate Zones,MSOAIZ,DD,3782,1810,1972,764,791
S02001460,Barnhill,Middle Super Output Areas and Intermediate Zones,MSOAIZ,DD,4350,2014,2336,835,942
S02001461,West Pitkerro,Middle Super Output Areas and Intermediate Zones,MSOAIZ,DD,6456,3180,3276,1787,1833
S02001462,Whitfield,Middle Super Output Areas and Intermediate Zones,MSOAIZ,DD,6261,2952,3309,1388,1726
S02001463,Fintry,Middle Super Output Areas and Intermediate Zones,MSOAIZ,DD,6047,2854,3193,1362,1610
S02001464,Linlathen and Midcraigie,Middle Super Output Areas and Intermediate Zones,MSOAIZ,DD,5344,2507,2837,1225,1475
S02001465,Caird Park,Middle Super Output Areas and Intermediate Zones,MSOAIZ,DD,3357,1634,1723,772,852
S02001466,Kirkton,Middle Super Output Areas and Intermediate Zones,MSOAIZ,DD,4001,1860,2141,862,1049
S02001467,Downfield,Middle Super Output Areas and Intermediate Zones,MSOAIZ,DD,4940,2347,2593,1117,1184
S02001468,Fairmuir,Middle Super Output Areas and Intermediate Zones,MSOAIZ,DD,3617,1717,1900,824,922
S02001469,Law,Middle Super Output Areas and Intermediate Zones,MSOAIZ,DD,4793,2256,2537,1065,1053
S02001470,Balgay,Middle Super Output Areas and Intermediate Zones,MSOAIZ,DD,3582,1647,1935,790,863
S02001471,Menzieshill,Middle Super Output Areas and Intermediate Zones,MSOAIZ,DD,4585,2177,2408,1229,1320
S02001472,Charleston,Middle Super Output Areas and Intermediate Zones,MSOAIZ,DD,4317,1996,2321,944,1199
S02001473,Lochee,Middle Super Output Areas and Intermediate Zones,MSOAIZ,DD,5504,2626,2878,1250,1336
S02001474,Ardler and St Marys,Middle Super Output Areas and Intermediate Zones,MSOAIZ,DD,5917,2775,3142,1333,1591
S02001475,Western Edge,Middle Super Output Areas and Intermediate Zones,MSOAIZ,DD,3614,1778,1836,918,986
S02001476,Doon Valley South,Middle Super Output Areas and Intermediate Zones,MSOAIZ,KA,3322,1613,1709,750,843
S02001477,Doon Valley North,Middle Super Output Areas and Intermediate Zones,MSOAIZ,KA,4123,1995,2128,930,1018
S02001478,Mauchline Rural,Middle Super Output Areas and Intermediate Zones,MSOAIZ,KA,5154,2556,2598,1294,1362
S02001479,Drongan,Middle Super Output Areas and Intermediate Zones,MSOAIZ,KA,3205,1515,1690,719,838
S02001480,Mauchline,Middle Super Output Areas and Intermediate Zones,MSOAIZ,KA,4099,1974,2125,960,982
S02001481,Cumnock Rural,Middle Super Output Areas and Intermediate Zones,MSOAIZ,KA,4871,2438,2433,1159,1129
S02001482,New Cumnock,Middle Super Output Areas and Intermediate Zones,MSOAIZ,KA,2860,1371,1489,590,687
S02001483,Cumnock South and Craigens,Middle Super Output Areas and Intermediate Zones,MSOAIZ,KA,5072,2426,2646,1236,1297
S02001484,Cumnock North,Middle Super Output Areas and Intermediate Zones,MSOAIZ,KA,3967,1972,1995,958,905
S02001485,Auchinleck,Middle Super Output Areas and Intermediate Zones,MSOAIZ,KA,3819,1849,1970,905,959
S02001486,Northern and Irvine Valley Rural,Middle Super Output Areas and Intermediate Zones,MSOAIZ,KA,5063,2483,2580,1167,1234
S02001487,Stewarton East,Middle Super Output Areas and Intermediate Zones,MSOAIZ,KA,4238,2006,2232,971,1064
S02001488,Stewarton West,Middle Super Output Areas and Intermediate Zones,MSOAIZ,KA,2695,1256,1439,610,719
S02001489,Darvel,Middle Super Output Areas and Intermediate Zones,MSOAIZ,KA,3770,1858,1912,858,894
S02001490,Newmilns,Middle Super Output Areas and Intermediate Zones,MSOAIZ,KA,3053,1528,1525,719,733
S02001491,Galston,Middle Super Output Areas and Intermediate Zones,MSOAIZ,KA,4670,2198,2472,1080,1199
S02001492,Earlston and Hurlford Rural,Middle Super Output Areas and Intermediate Zones,MSOAIZ,KA,6058,3134,2924,1757,1452
S02001493,Shortlees,Middle Super Output Areas and Intermediate Zones,MSOAIZ,KA,4583,2124,2459,983,1235
S02001494,Bellfield and Kirkstyle,Middle Super Output Areas and Intermediate Zones,MSOAIZ,KA,4338,2028,2310,1021,1091
S02001495,Kilmarnock South Central and Caprington,Middle Super Output Areas and Intermediate Zones,MSOAIZ,KA,2981,1435,1546,712,747
S02001496,Piersland,Middle Super Output Areas and Intermediate Zones,MSOAIZ,KA,3282,1590,1692,857,836
S02001497,New Farm Loch South,Middle Super Output Areas and Intermediate Zones,MSOAIZ,KA,3039,1438,1601,663,715
S02001498,Dean and New Farm Loch North,Middle Super Output Areas and Intermediate Zones,MSOAIZ,KA,3802,1819,1983,890,980
S02001499,Southcraig and Beansburn,Middle Super Output Areas and Intermediate Zones,MSOAIZ,KA,5832,2881,2951,1474,1565
S02001500,Altonhill North and Onthank,Middle Super Output Areas and Intermediate Zones,MSOAIZ,KA,4547,2118,2429,1109,1292
S02001501,Altonhill South; Longpark and Hillhead,Middle Super Output Areas and Intermediate Zones,MSOAIZ,KA,4523,2187,2336,1226,1331
S02001502,Bonnyton and Town Centre,Middle Super Output Areas and Intermediate Zones,MSOAIZ,KA,3648,1754,1894,961,940
S02001503,Grange; Howard and Gargieston,Middle Super Output Areas and Intermediate Zones,MSOAIZ,KA,5584,2692,2892,1319,1395
S02001504,Crosshouse; Gatehead and Kilmaurs Rural,Middle Super Output Areas and Intermediate Zones,MSOAIZ,KA,3736,1834,1902,907,903
S02001505,Kilmaurs,Middle Super Output Areas and Intermediate Zones,MSOAIZ,KA,2833,1317,1516,636,712
S02001506,West Clober and Mains Estate,Middle Super Output Areas and Intermediate Zones,MSOAIZ,G,2896,1443,1453,716,735
S02001507,East Clober and Mains Estate,Middle Super Output Areas and Intermediate Zones,MSOAIZ,G,3487,1636,1851,777,868
S02001508,Barloch,Middle Super Output Areas and Intermediate Zones,MSOAIZ,G,3228,1545,1683,596,646
S02001509,Keystone and Dougalston,Middle Super Output Areas and Intermediate Zones,MSOAIZ,G,3954,1848,2106,753,779
S02001510,Kilmardinny East,Middle Super Output Areas and Intermediate Zones,MSOAIZ,G,2941,1415,1526,602,625
S02001511,Kilmardinny West,Middle Super Output Areas and Intermediate Zones,MSOAIZ,G,3518,1730,1788,736,714
S02001512,North Castlehill and Thorn,Middle Super Output Areas and Intermediate Zones,MSOAIZ,G,4149,1953,2196,877,998
S02001513,South Castlehill and Thorn,Middle Super Output Areas and Intermediate Zones,MSOAIZ,G,4196,2067,2129,909,953
S02001514,Westerton West,Middle Super Output Areas and Intermediate Zones,MSOAIZ,G,2724,1317,1407,602,667
S02001515,Westerton East,Middle Super Output Areas and Intermediate Zones,MSOAIZ,G,3612,1718,1894,775,848
S02001516,Kessington West,Middle Super Output Areas and Intermediate Zones,MSOAIZ,G,3252,1554,1698,592,619
S02001517,Kessington East,Middle Super Output Areas and Intermediate Zones,MSOAIZ,G,2845,1372,1473,623,655
S02001518,Torrance and Balmore,Middle Super Output Areas and Intermediate Zones,MSOAIZ,G,2917,1428,1489,649,720
S02001519,Bishopbriggs North and Kenmure,Middle Super Output Areas and Intermediate Zones,MSOAIZ,G,5299,2550,2749,1134,1177
S02001520,Bishopbriggs West and Cadder,Middle Super Output Areas and Intermediate Zones,MSOAIZ,G,5860,2822,3038,1258,1349
S02001521,Auchinairn,Middle Super Output Areas and Intermediate Zones,MSOAIZ,G,5059,2361,2698,1234,1361
S02001522,Woodhill East,Middle Super Output Areas and Intermediate Zones,MSOAIZ,G,2476,1198,1278,611,681
S02001523,Woodhill West,Middle Super Output Areas and Intermediate Zones,MSOAIZ,G,4176,2034,2142,973,986
S02001524,Lenzie North,Middle Super Output Areas and Intermediate Zones,MSOAIZ,G,5336,2580,2756,1081,1215
S02001525,Lenzie South,Middle Super Output Areas and Intermediate Zones,MSOAIZ,G,3432,1674,1758,752,785
S02001526,Kirkintilloch South,Middle Super Output Areas and Intermediate Zones,MSOAIZ,G,3227,1616,1611,834,829
S02001527,Kirkintilloch West,Middle Super Output Areas and Intermediate Zones,MSOAIZ,G,4202,2028,2174,1053,1051
S02001528,Hillhead,Middle Super Output Areas and Intermediate Zones,MSOAIZ,G,4035,1935,2100,953,1106
S02001529,Rosebank and Waterside,Middle Super Output Areas and Intermediate Zones,MSOAIZ,G,3169,1520,1649,736,818
S02001530,Twechar and Harestanes East,Middle Super Output Areas and Intermediate Zones,MSOAIZ,G,2842,1421,1421,722,706
S02001531,Harestanes,Middle Super Output Areas and Intermediate Zones,MSOAIZ,G,3409,1616,1793,776,887
S02001532,Milton of Campsie,Middle Super Output Areas and Intermediate Zones,MSOAIZ,G,4055,1910,2145,904,994
S02001533,Lennoxtown,Middle Super Output Areas and Intermediate Zones,MSOAIZ,G,4730,2292,2438,1185,1276
S02001534,IZ01,Middle Super Output Areas and Intermediate Zones,MSOAIZ,EH,5839,2684,3155,1448,1926
S02001535,IZ02,Middle Super Output Areas and Intermediate Zones,MSOAIZ,EH,4560,2145,2415,1073,1249
S02001536,IZ03,Middle Super Output Areas and Intermediate Zones,MSOAIZ,EH,3079,1494,1585,724,763
S02001537,IZ04,Middle Super Output Areas and Intermediate Zones,MSOAIZ,EH,4844,2252,2592,1237,1368
S02001538,IZ05,Middle Super Output Areas and Intermediate Zones,MSOAIZ,EH,4454,2036,2418,975,1189
S02001539,IZ06,Middle Super Output Areas and Intermediate Zones,MSOAIZ,EH,2222,1044,1178,554,611
S02001540,IZ07,Middle Super Output Areas and Intermediate Zones,MSOAIZ,EH,4957,2387,2570,1259,1368
S02001541,IZ08,Middle Super Output Areas and Intermediate Zones,MSOAIZ,EH,4183,2022,2161,1033,1092
S02001542,IZ09,Middle Super Output Areas and Intermediate Zones,MSOAIZ,EH,5967,2897,3070,1418,1494
S02001543,IZ10,Middle Super Output Areas and Intermediate Zones,MSOAIZ,EH,6314,3074,3240,1555,1617
S02001544,IZ11,Middle Super Output Areas and Intermediate Zones,MSOAIZ,EH,5658,2765,2893,1483,1550
S02001545,IZ12,Middle Super Output Areas and Intermediate Zones,MSOAIZ,EH,2925,1440,1485,656,666
S02001546,IZ13,Middle Super Output Areas and Intermediate Zones,MSOAIZ,EH,5465,2691,2774,1133,1153
S02001547,IZ14,Middle Super Output Areas and Intermediate Zones,MSOAIZ,TD,5633,2788,2845,1246,1307
S02001548,IZ15,Middle Super Output Areas and Intermediate Zones,MSOAIZ,EH,4088,1972,2116,902,932
S02001549,IZ16,Middle Super Output Areas and Intermediate Zones,MSOAIZ,EH,4777,2316,2461,1184,1152
S02001550,IZ17,Middle Super Output Areas and Intermediate Zones,MSOAIZ,EH,4166,2000,2166,837,867
S02001551,IZ18,Middle Super Output Areas and Intermediate Zones,MSOAIZ,EH,3234,1512,1722,596,573
S02001552,IZ19,Middle Super Output Areas and Intermediate Zones,MSOAIZ,EH,3687,1792,1895,743,806
S02001553,IZ20,Middle Super Output Areas and Intermediate Zones,MSOAIZ,TD,4894,2368,2526,1079,1103
S02001554,IZ21,Middle Super Output Areas and Intermediate Zones,MSOAIZ,EH,4146,1966,2180,904,936
S02001555,IZ22,Middle Super Output Areas and Intermediate Zones,MSOAIZ,TD,4625,2228,2397,1100,1153
S02001556,West Neilston and Uplawmoor,Middle Super Output Areas and Intermediate Zones,MSOAIZ,G,6414,3113,3301,1498,1559
S02001557,Cross Stobbs,Middle Super Output Areas and Intermediate Zones,MSOAIZ,G,3642,1764,1878,886,867
S02001558,Dunterlie; East Arthurlie and Dovecothall,Middle Super Output Areas and Intermediate Zones,MSOAIZ,G,6000,2817,3183,1507,1700
S02001559,West Arthurlie and North Neilston,Middle Super Output Areas and Intermediate Zones,MSOAIZ,G,3946,1855,2091,909,976
S02001560,Auchenback,Middle Super Output Areas and Intermediate Zones,MSOAIZ,G,4061,1918,2143,951,1112
S02001561,Crookfur and Fruin,Middle Super Output Areas and Intermediate Zones,MSOAIZ,G,5729,2702,3027,1237,1368
S02001562,Mearns Village; Westacres and Greenfarm,Middle Super Output Areas and Intermediate Zones,MSOAIZ,G,6250,2970,3280,1516,1685
S02001563,Whitecraigs and Broom,Middle Super Output Areas and Intermediate Zones,MSOAIZ,G,3659,1782,1877,718,793
S02001564,Mearnskirk and South Kirkhill,Middle Super Output Areas and Intermediate Zones,MSOAIZ,G,6034,2834,3200,1197,1272
S02001565,Eaglesham and Waterfoot,Middle Super Output Areas and Intermediate Zones,MSOAIZ,G,4647,2207,2440,986,1097
S02001566,North Kirkhill,Middle Super Output Areas and Intermediate Zones,MSOAIZ,G,3130,1486,1644,694,777
S02001567,Busby,Middle Super Output Areas and Intermediate Zones,MSOAIZ,G,3531,1619,1912,783,891
S02001568,Clarkston and Sheddens,Middle Super Output Areas and Intermediate Zones,MSOAIZ,G,6198,3041,3157,1425,1455
S02001569,Williamwood,Middle Super Output Areas and Intermediate Zones,MSOAIZ,G,2958,1489,1469,692,686
S02001570,Stamperland,Middle Super Output Areas and Intermediate Zones,MSOAIZ,G,3691,1784,1907,882,956
S02001571,Netherlee,Middle Super Output Areas and Intermediate Zones,MSOAIZ,G,4640,2182,2458,911,957
S02001572,Merrylee and Braidbar,Middle Super Output Areas and Intermediate Zones,MSOAIZ,G,4876,2284,2592,995,1082
S02001573,Lower Whitecraigs and South Giffnock,Middle Super Output Areas and Intermediate Zones,MSOAIZ,G,3440,1655,1785,690,712
S02001574,North Giffnock and North Thornliebank,Middle Super Output Areas and Intermediate Zones,MSOAIZ,G,3629,1667,1962,759,828
S02001575,South Thornliebank and Woodfarm,Middle Super Output Areas and Intermediate Zones,MSOAIZ,G,4099,1996,2103,989,1068
S02001576,Balerno and Bonnington Village,Middle Super Output Areas and Intermediate Zones,MSOAIZ,EH,5796,2838,2958,1187,1244
S02001577,Currie West,Middle Super Output Areas and Intermediate Zones,MSOAIZ,EH,4782,2570,2212,1731,1290
S02001578,Currie East,Middle Super Output Areas and Intermediate Zones,MSOAIZ,EH,3050,1499,1551,618,627
S02001579,Baberton and Juniper Green,Middle Super Output Areas and Intermediate Zones,MSOAIZ,EH,3954,1886,2068,840,898
S02001580,Bonaly and The Pentlands,Middle Super Output Areas and Intermediate Zones,MSOAIZ,EH,4295,2101,2194,890,947
S02001581,Colinton and Kingsknowe,Middle Super Output Areas and Intermediate Zones,MSOAIZ,EH,4112,2113,1999,876,824
S02001582,Clovenstone and Wester Hailes,Middle Super Output Areas and Intermediate Zones,MSOAIZ,EH,3223,1554,1669,883,960
S02001583,The Calders,Middle Super Output Areas and Intermediate Zones,MSOAIZ,EH,4534,2290,2244,1283,1227
S02001584,Murrayburn and Wester Hailes North,Middle Super Output Areas and Intermediate Zones,MSOAIZ,EH,3694,1917,1777,1105,1008
S02001585,Parkhead and Sighthill,Middle Super Output Areas and Intermediate Zones,MSOAIZ,EH,3121,1487,1634,755,844
S02001586,Broomhouse and Bankhead,Middle Super Output Areas and Intermediate Zones,MSOAIZ,EH,3555,1746,1809,941,940
S02001587,Stenhouse and Saughton Mains,Middle Super Output Areas and Intermediate Zones,MSOAIZ,EH,5770,2690,3080,1510,1576
S02001588,Longstone and Saughton,Middle Super Output Areas and Intermediate Zones,MSOAIZ,EH,4596,2562,2034,1529,1003
S02001589,Slateford and Chesser,Middle Super Output Areas and Intermediate Zones,MSOAIZ,EH,4817,2333,2484,1512,1461
S02001590,Gorgie West,Middle Super Output Areas and Intermediate Zones,MSOAIZ,EH,4272,2186,2086,1680,1569
S02001591,Gorgie East,Middle Super Output Areas and Intermediate Zones,MSOAIZ,EH,3563,1923,1640,1616,1326
S02001592,Shandon,Middle Super Output Areas and Intermediate Zones,MSOAIZ,EH,5042,2395,2647,1718,1784
S02001593,Craiglockhart,Middle Super Output Areas and Intermediate Zones,MSOAIZ,EH,4843,2291,2552,1051,1125
S02001594,Morningside and Craighouse,Middle Super Output Areas and Intermediate Zones,MSOAIZ,EH,4347,2048,2299,1206,1248
S02001595,Greenbank and The Braids,Middle Super Output Areas and Intermediate Zones,MSOAIZ,EH,4291,2076,2215,885,964
S02001596,Colinton Mains and Firrhill,Middle Super Output Areas and Intermediate Zones,MSOAIZ,EH,3938,1809,2129,955,1086
S02001597,Oxgangs,Middle Super Output Areas and Intermediate Zones,MSOAIZ,EH,2639,1185,1454,620,687
S02001598,Comiston and Swanston,Middle Super Output Areas and Intermediate Zones,MSOAIZ,EH,5463,2626,2837,1175,1249
S02001599,Fairmilehead,Middle Super Output Areas and Intermediate Zones,MSOAIZ,EH,4925,2464,2461,1064,1145
S02001600,Gilmerton South and the Murrays,Middle Super Output Areas and Intermediate Zones,MSOAIZ,EH,2797,1341,1456,723,828
S02001601,Mortonhall and Anwickhill,Middle Super Output Areas and Intermediate Zones,MSOAIZ,EH,2658,1279,1379,612,624
S02001602,Gracemount; Southhouse and Burdiehouse,Middle Super Output Areas and Intermediate Zones,MSOAIZ,EH,5272,2453,2819,1179,1382
S02001603,Hyvots and Gilmerton,Middle Super Output Areas and Intermediate Zones,MSOAIZ,EH,3593,1670,1923,817,934
S02001604,Fernieside and Moredun South,Middle Super Output Areas and Intermediate Zones,MSOAIZ,EH,4120,1958,2162,990,1082
S02001605,Moredun and Craigour,Middle Super Output Areas and Intermediate Zones,MSOAIZ,EH,3168,1563,1605,803,809
S02001606,Liberton East,Middle Super Output Areas and Intermediate Zones,MSOAIZ,EH,3274,1592,1682,795,865
S02001607,Liberton West and Braid Hills,Middle Super Output Areas and Intermediate Zones,MSOAIZ,EH,3004,1364,1640,567,597
S02001608,The Inch,Middle Super Output Areas and Intermediate Zones,MSOAIZ,EH,4895,2361,2534,1227,1233
S02001609,Blackford; West Mains and Mayfield Road,Middle Super Output Areas and Intermediate Zones,MSOAIZ,EH,6240,3009,3231,1619,1538
S02001610,Prestonfield,Middle Super Output Areas and Intermediate Zones,MSOAIZ,EH,3474,1680,1794,949,937
S02001611,Newington and Dalkeith Road,Middle Super Output Areas and Intermediate Zones,MSOAIZ,EH,6070,2851,3219,2279,2520
S02001612,The Grange,Middle Super Output Areas and Intermediate Zones,MSOAIZ,EH,5608,2648,2960,1389,1442
S02001613,Marchmont East and Sciennes,Middle Super Output Areas and Intermediate Zones,MSOAIZ,EH,5277,2455,2822,1922,2215
S02001614,Marchmont West,Middle Super Output Areas and Intermediate Zones,MSOAIZ,EH,5144,2405,2739,1892,2188
S02001615,Morningside,Middle Super Output Areas and Intermediate Zones,MSOAIZ,EH,5575,2694,2881,1501,1462
S02001616,Merchiston and Greenhill,Middle Super Output Areas and Intermediate Zones,MSOAIZ,EH,5018,2395,2623,1418,1436
S02001617,Bruntsfield,Middle Super Output Areas and Intermediate Zones,MSOAIZ,EH,5758,2812,2946,2092,2136
S02001618,Polwarth,Middle Super Output Areas and Intermediate Zones,MSOAIZ,EH,4468,2290,2178,1868,1729
S02001619,Dalry and Fountainbridge,Middle Super Output Areas and Intermediate Zones,MSOAIZ,EH,6462,3570,2892,3013,2360
S02001620,Tollcross,Middle Super Output Areas and Intermediate Zones,MSOAIZ,EH,6233,3223,3010,2702,2531
S02001621,Meadows and Southside,Middle Super Output Areas and Intermediate Zones,MSOAIZ,EH,6556,3099,3457,2649,2943
S02001622,Old Town; Princes Street and Leith Street,Middle Super Output Areas and Intermediate Zones,MSOAIZ,EH,5651,2843,2808,2415,2410
S02001623,Canongate; Southside and Dumbiedykes,Middle Super Output Areas and Intermediate Zones,MSOAIZ,EH,5915,2895,3020,2191,2320
S02001624,Abbeyhill,Middle Super Output Areas and Intermediate Zones,MSOAIZ,EH,2507,1256,1251,914,867
S02001625,Meadowbank and Abbeyhill North,Middle Super Output Areas and Intermediate Zones,MSOAIZ,EH,4072,1996,2076,1460,1503
S02001626,Willowbrae and Duddingston Village,Middle Super Output Areas and Intermediate Zones,MSOAIZ,EH,5407,2637,2770,1440,1504
S02001627,Craigmillar,Middle Super Output Areas and Intermediate Zones,MSOAIZ,EH,3161,1519,1642,885,953
S02001628,Niddrie,Middle Super Output Areas and Intermediate Zones,MSOAIZ,EH,4330,2095,2235,1067,1208
S02001629,Bingham; Magdalene and The Christians,Middle Super Output Areas and Intermediate Zones,MSOAIZ,EH,3654,1712,1942,824,875
S02001630,Jewel; Brunstane and Newcraighall,Middle Super Output Areas and Intermediate Zones,MSOAIZ,EH,3270,1569,1701,852,934
S02001631,Joppa,Middle Super Output Areas and Intermediate Zones,MSOAIZ,EH,5136,2420,2716,1093,1214
S02001632,Portobello,Middle Super Output Areas and Intermediate Zones,MSOAIZ,EH,3926,1870,2056,1021,1149
S02001633,Duddingston and Portobello South,Middle Super Output Areas and Intermediate Zones,MSOAIZ,EH,3881,1826,2055,786,836
S02001634,Mountcastle,Middle Super Output Areas and Intermediate Zones,MSOAIZ,EH,2549,1229,1320,538,558
S02001635,Northfield and Piershill,Middle Super Output Areas and Intermediate Zones,MSOAIZ,EH,3512,1682,1830,919,964
S02001636,Craigentinny,Middle Super Output Areas and Intermediate Zones,MSOAIZ,EH,2855,1349,1506,578,611
S02001637,Restalrig (Loganlea) and Craigentinny West,Middle Super Output Areas and Intermediate Zones,MSOAIZ,EH,3476,1672,1804,966,1022
S02001638,Restalrig and Lochend,Middle Super Output Areas and Intermediate Zones,MSOAIZ,EH,4420,2134,2286,1182,1258
S02001639,Leith (Hermitage and Prospect Bank),Middle Super Output Areas and Intermediate Zones,MSOAIZ,EH,4698,2192,2506,1213,1341
S02001640,Western Harbour and Leith Docks,Middle Super Output Areas and Intermediate Zones,MSOAIZ,EH,2837,1459,1378,1056,951
S02001641,North Leith and Newhaven,Middle Super Output Areas and Intermediate Zones,MSOAIZ,EH,5065,2660,2405,1704,1510
S02001642,The Shore and Constitution Street,Middle Super Output Areas and Intermediate Zones,MSOAIZ,EH,4929,2529,2400,1981,1905
S02001643,Great Junction Street,Middle Super Output Areas and Intermediate Zones,MSOAIZ,EH,5025,2542,2483,1842,1685
S02001644,South Leith,Middle Super Output Areas and Intermediate Zones,MSOAIZ,EH,5260,2658,2602,1824,1779
S02001645,Easter Road and Hawkhill Avenue,Middle Super Output Areas and Intermediate Zones,MSOAIZ,EH,3423,1806,1617,1452,1266
S02001646,Leith (Albert Street),Middle Super Output Areas and Intermediate Zones,MSOAIZ,EH,3185,1622,1563,1244,1134
S02001647,Hillside and Calton Hill,Middle Super Output Areas and Intermediate Zones,MSOAIZ,EH,5164,2538,2626,1965,1992
S02001648,Pilrig,Middle Super Output Areas and Intermediate Zones,MSOAIZ,EH,3243,1683,1560,1178,1070
S02001649,Bonnington,Middle Super Output Areas and Intermediate Zones,MSOAIZ,EH,3414,1667,1747,1097,1165
S02001650,Trinity East and The Dudleys,Middle Super Output Areas and Intermediate Zones,MSOAIZ,EH,3701,1751,1950,911,968
S02001651,Trinity,Middle Super Output Areas and Intermediate Zones,MSOAIZ,EH,4461,2113,2348,1033,1118
S02001652,Inverleith; Goldenacre and Warriston,Middle Super Output Areas and Intermediate Zones,MSOAIZ,EH,3687,1743,1944,936,910
S02001653,Broughton North and Powderhall,Middle Super Output Areas and Intermediate Zones,MSOAIZ,EH,3726,1905,1821,1381,1272
S02001654,Broughton South,Middle Super Output Areas and Intermediate Zones,MSOAIZ,EH,4210,1993,2217,1516,1648
S02001655,New Town East and Gayfield,Middle Super Output Areas and Intermediate Zones,MSOAIZ,EH,3031,1524,1507,1165,1141
S02001656,New Town West,Middle Super Output Areas and Intermediate Zones,MSOAIZ,EH,3569,1758,1811,1132,1146
S02001657,Canonmills and New Town North,Middle Super Output Areas and Intermediate Zones,MSOAIZ,EH,3212,1605,1607,1212,1214
S02001658,Stockbridge,Middle Super Output Areas and Intermediate Zones,MSOAIZ,EH,5686,2730,2956,1812,1923
S02001659,Comely Bank,Middle Super Output Areas and Intermediate Zones,MSOAIZ,EH,3614,1731,1883,998,1042
S02001660,Deans Village,Middle Super Output Areas and Intermediate Zones,MSOAIZ,EH,6021,3124,2897,2125,1827
S02001661,Balgreen and Roseburn,Middle Super Output Areas and Intermediate Zones,MSOAIZ,EH,4305,2035,2270,1080,1139
S02001662,Murrayfield and Ravelston,Middle Super Output Areas and Intermediate Zones,MSOAIZ,EH,4215,1967,2248,806,838
S02001663,Craigleith; Orchard Brae and Crewe Toll,Middle Super Output Areas and Intermediate Zones,MSOAIZ,EH,4227,2012,2215,987,1049
S02001664,Blackhall,Middle Super Output Areas and Intermediate Zones,MSOAIZ,EH,5674,2675,2999,1140,1249
S02001665,Drylaw,Middle Super Output Areas and Intermediate Zones,MSOAIZ,EH,4618,2183,2435,1115,1215
S02001666,West Pilton,Middle Super Output Areas and Intermediate Zones,MSOAIZ,EH,4623,2249,2374,1236,1309
S02001667,Boswall and Pilton,Middle Super Output Areas and Intermediate Zones,MSOAIZ,EH,5104,2465,2639,1365,1461
S02001668,Granton South and Wardieburn,Middle Super Output Areas and Intermediate Zones,MSOAIZ,EH,2912,1420,1492,759,787
S02001669,Granton and Royston Mains,Middle Super Output Areas and Intermediate Zones,MSOAIZ,EH,3364,1608,1756,992,1009
S02001670,Granton West and Salvesen,Middle Super Output Areas and Intermediate Zones,MSOAIZ,EH,3788,1826,1962,1046,1210
S02001671,Muirhouse,Middle Super Output Areas and Intermediate Zones,MSOAIZ,EH,4814,2375,2439,1323,1416
S02001672,Siverknowes and Davidson's Mains,Middle Super Output Areas and Intermediate Zones,MSOAIZ,EH,4288,2064,2224,910,908
S02001673,Cramond,Middle Super Output Areas and Intermediate Zones,MSOAIZ,EH,2492,1174,1318,481,537
S02001674,Barnton; Cammo and Cramond South,Middle Super Output Areas and Intermediate Zones,MSOAIZ,EH,3770,1840,1930,705,735
S02001675,Clermiston and Drumbrae,Middle Super Output Areas and Intermediate Zones,MSOAIZ,EH,5971,2789,3182,1430,1565
S02001676,East Craigs North,Middle Super Output Areas and Intermediate Zones,MSOAIZ,EH,4106,1962,2144,995,1079
S02001677,East Craigs South,Middle Super Output Areas and Intermediate Zones,MSOAIZ,EH,4887,2421,2466,1107,1153
S02001678,Corstorphine North,Middle Super Output Areas and Intermediate Zones,MSOAIZ,EH,3130,1504,1626,667,706
S02001679,Corstorphine,Middle Super Output Areas and Intermediate Zones,MSOAIZ,EH,5372,2519,2853,1173,1221
S02001680,Carrick Knowe,Middle Super Output Areas and Intermediate Zones,MSOAIZ,EH,2762,1292,1470,675,811
S02001681,Corstorphine South,Middle Super Output Areas and Intermediate Zones,MSOAIZ,EH,4146,1987,2159,1029,1104
S02001682,South Gyle,Middle Super Output Areas and Intermediate Zones,MSOAIZ,EH,4767,2331,2436,1352,1310
S02001683,Ratho; Ingliston and Gogar,Middle Super Output Areas and Intermediate Zones,MSOAIZ,EH,3264,1569,1695,778,834
S02001684,Dalmeny; Kirkliston and Newbridge,Middle Super Output Areas and Intermediate Zones,MSOAIZ,EH,5092,2493,2599,1191,1250
S02001685,Queensferry East,Middle Super Output Areas and Intermediate Zones,MSOAIZ,EH,4754,2304,2450,1113,1182
S02001686,Queensferry West,Middle Super Output Areas and Intermediate Zones,MSOAIZ,EH,4012,1962,2050,1039,1147
S02001687,Barra and South Uist,Middle Super Output Areas and Intermediate Zones,MSOAIZ,PA,3161,1586,1575,682,669
S02001688,Benbecula and North Uist,Middle Super Output Areas and Intermediate Zones,MSOAIZ,PA,2949,1489,1460,691,656
S02001689,Harris,Middle Super Output Areas and Intermediate Zones,MSOAIZ,PA,1916,958,958,402,332
S02001690,South Lewis,Middle Super Output Areas and Intermediate Zones,MSOAIZ,PA,2583,1280,1303,544,506
S02001691,Northwest Lewis,Middle Super Output Areas and Intermediate Zones,MSOAIZ,PA,4066,2058,2008,904,814
S02001692,Broadbay,Middle Super Output Areas and Intermediate Zones,MSOAIZ,PA,3606,1825,1781,852,822
S02001693,Stornoway West,Middle Super Output Areas and Intermediate Zones,MSOAIZ,PA,3276,1600,1676,822,784
S02001694,Stornoway East,Middle Super Output Areas and Intermediate Zones,MSOAIZ,PA,2997,1347,1650,643,687
S02001695,Point,Middle Super Output Areas and Intermediate Zones,MSOAIZ,PA,3130,1525,1605,718,694
S02001696,Dunipace,Middle Super Output Areas and Intermediate Zones,MSOAIZ,FK,3266,1604,1662,795,815
S02001697,Fankerton; Stoneywood and Denny Town,Middle Super Output Areas and Intermediate Zones,MSOAIZ,FK,4163,2065,2098,1082,1100
S02001698,Denny - Nethermains,Middle Super Output Areas and Intermediate Zones,MSOAIZ,FK,4152,2006,2146,938,1040
S02001699,Head of Muir and Dennyloanhead,Middle Super Output Areas and Intermediate Zones,MSOAIZ,FK,3016,1474,1542,775,831
S02001700,Banknock; Haggs and Longcroft,Middle Super Output Areas and Intermediate Zones,MSOAIZ,G,3868,1866,2002,925,1006
S02001701,Bonnybridge,Middle Super Output Areas and Intermediate Zones,MSOAIZ,FK,4931,2401,2530,1228,1222
S02001702,High Bonnybridge and Greenhill,Middle Super Output Areas and Intermediate Zones,MSOAIZ,FK,3415,1673,1742,873,923
S02001703,Larbert - North Broomage and Inches,Middle Super Output Areas and Intermediate Zones,MSOAIZ,FK,5355,2628,2727,1438,1478
S02001704,Larbert - South Broomage and Village,Middle Super Output Areas and Intermediate Zones,MSOAIZ,FK,3913,1921,1992,943,950
S02001705,Stenhousemuir West,Middle Super Output Areas and Intermediate Zones,MSOAIZ,FK,3290,1565,1725,780,809
S02001706,Stenhousemuir East,Middle Super Output Areas and Intermediate Zones,MSOAIZ,FK,3537,1670,1867,859,931
S02001707,Stenhousemuir - Antonshill,Middle Super Output Areas and Intermediate Zones,MSOAIZ,FK,3399,1638,1761,820,846
S02001708,Carron,Middle Super Output Areas and Intermediate Zones,MSOAIZ,FK,2759,1366,1393,733,712
S02001709,Carronshore,Middle Super Output Areas and Intermediate Zones,MSOAIZ,FK,2771,1379,1392,738,763
S02001710,Carse and Grangemouth Old Town,Middle Super Output Areas and Intermediate Zones,MSOAIZ,FK,3608,1746,1862,851,942
S02001711,Falkirk - Bainsford and Langlees,Middle Super Output Areas and Intermediate Zones,MSOAIZ,FK,3653,1761,1892,939,990
S02001712,Falkirk - Merchiston and New Carron Village,Middle Super Output Areas and Intermediate Zones,MSOAIZ,FK,4268,2088,2180,1230,1213
S02001713,Falkirk - Grahamston,Middle Super Output Areas and Intermediate Zones,MSOAIZ,FK,3391,1721,1670,1056,911
S02001714,Falkirk - Middlefield,Middle Super Output Areas and Intermediate Zones,MSOAIZ,FK,4761,2327,2434,1241,1246
S02001715,Falkirk - Town Centre and Callendar Park,Middle Super Output Areas and Intermediate Zones,MSOAIZ,FK,3575,1720,1855,776,660
S02001716,Falkirk - Bantaskin,Middle Super Output Areas and Intermediate Zones,MSOAIZ,FK,3483,1653,1830,810,807
S02001717,Falkirk - Camelon East,Middle Super Output Areas and Intermediate Zones,MSOAIZ,FK,3029,1473,1556,778,803
S02001718,Falkirk - Camelon West,Middle Super Output Areas and Intermediate Zones,MSOAIZ,FK,2857,1408,1449,736,759
S02001719,Falkirk - Tamfourhill,Middle Super Output Areas and Intermediate Zones,MSOAIZ,FK,2736,1340,1396,618,617
S02001720,Falkirk - Lochgreen and Lionthorn,Middle Super Output Areas and Intermediate Zones,MSOAIZ,FK,3751,1856,1895,960,977
S02001721,Hallglen and Glen Village,Middle Super Output Areas and Intermediate Zones,MSOAIZ,FK,3227,1552,1675,778,880
S02001722,Shieldhill,Middle Super Output Areas and Intermediate Zones,MSOAIZ,FK,2594,1276,1318,698,700
S02001723,Braes Villages,Middle Super Output Areas and Intermediate Zones,MSOAIZ,FK,4753,2310,2443,1114,1208
S02001724,Reddingmuirhead and Overton,Middle Super Output Areas and Intermediate Zones,MSOAIZ,FK,2973,1717,1256,1111,708
S02001725,Brightons and Wallacestone,Middle Super Output Areas and Intermediate Zones,MSOAIZ,FK,4115,2036,2079,1041,1027
S02001726,Maddiston and Rumford,Middle Super Output Areas and Intermediate Zones,MSOAIZ,FK,4455,2139,2316,1062,1189
S02001727,Polmont,Middle Super Output Areas and Intermediate Zones,MSOAIZ,FK,4128,2018,2110,970,985
S02001728,Redding,Middle Super Output Areas and Intermediate Zones,MSOAIZ,FK,3361,1589,1772,794,844
S02001729,Laurieston and Westquarter,Middle Super Output Areas and Intermediate Zones,MSOAIZ,FK,3256,1568,1688,767,827
S02001730,Grangemouth - Newlands,Middle Super Output Areas and Intermediate Zones,MSOAIZ,FK,4920,2317,2603,1128,1244
S02001731,Grangemouth - Town Centre,Middle Super Output Areas and Intermediate Zones,MSOAIZ,FK,3298,1552,1746,828,830
S02001732,Grangemouth - Kersiebank,Middle Super Output Areas and Intermediate Zones,MSOAIZ,FK,4443,2185,2258,1135,1139
S02001733,Grangemouth - Bowhouse,Middle Super Output Areas and Intermediate Zones,MSOAIZ,FK,3901,1877,2024,981,1021
S02001734,Bo'ness - Douglas,Middle Super Output Areas and Intermediate Zones,MSOAIZ,FK,4470,2213,2257,1048,1108
S02001735,Bo'ness - Newtown,Middle Super Output Areas and Intermediate Zones,MSOAIZ,EH,3167,1533,1634,749,802
S02001736,Bo'ness - Kinneil,Middle Super Output Areas and Intermediate Zones,MSOAIZ,EH,3093,1521,1572,775,755
S02001737,Blackness; Bo'ness - Carriden and Grahamsdyke,Middle Super Output Areas and Intermediate Zones,MSOAIZ,EH,4889,2398,2491,1246,1277
S02001738,Kincardine,Middle Super Output Areas and Intermediate Zones,MSOAIZ,FK,3001,1465,1536,656,721
S02001739,Oakley Comrie and Blairhall,Middle Super Output Areas and Intermediate Zones,MSOAIZ,KY,4078,2016,2062,996,1047
S02001740,Saline and Gowkhall,Middle Super Output Areas and Intermediate Zones,MSOAIZ,KY,3178,1599,1579,717,692
S02001741,Valleyfield Culross and Torryburn,Middle Super Output Areas and Intermediate Zones,MSOAIZ,KY,3604,1761,1843,852,896
S02001742,Cairneyhill and Crombie,Middle Super Output Areas and Intermediate Zones,MSOAIZ,KY,2909,1437,1472,698,761
S02001743,Crossford Charlestown and Limekilns,Middle Super Output Areas and Intermediate Zones,MSOAIZ,KY,4079,1987,2092,794,824
S02001744,Dunfermline Milesmark and Wellwood,Middle Super Output Areas and Intermediate Zones,MSOAIZ,KY,3683,1824,1859,947,965
S02001745,Dunfermline Baldridgeburn,Middle Super Output Areas and Intermediate Zones,MSOAIZ,KY,3434,1670,1764,950,939
S02001746,Dunfermline Headwell,Middle Super Output Areas and Intermediate Zones,MSOAIZ,KY,4426,2131,2295,1141,1201
S02001747,Dunfermline Central,Middle Super Output Areas and Intermediate Zones,MSOAIZ,KY,3197,1566,1631,935,859
S02001748,Dunfermline Brucefield,Middle Super Output Areas and Intermediate Zones,MSOAIZ,KY,3241,1561,1680,829,845
S02001749,Dunfermline Garvock Hill,Middle Super Output Areas and Intermediate Zones,MSOAIZ,KY,3125,1525,1600,693,707
S02001750,Dunfermline Bellyeoman and Townhill,Middle Super Output Areas and Intermediate Zones,MSOAIZ,KY,5372,2508,2864,1130,1239
S02001751,Dunfermline Duloch North and Lynebank,Middle Super Output Areas and Intermediate Zones,MSOAIZ,KY,3123,1545,1578,895,926
S02001752,Dunfermline Touch and Woodmill,Middle Super Output Areas and Intermediate Zones,MSOAIZ,KY,2804,1395,1409,726,712
S02001753,Dunfermline Abbeyview North,Middle Super Output Areas and Intermediate Zones,MSOAIZ,KY,3500,1718,1782,842,929
S02001754,Dunfermline Abbeyview South,Middle Super Output Areas and Intermediate Zones,MSOAIZ,KY,2888,1365,1523,692,762
S02001755,Dunfermline Duloch South,Middle Super Output Areas and Intermediate Zones,MSOAIZ,KY,3899,1987,1912,1170,1137
S02001756,Dunfermline Masterton,Middle Super Output Areas and Intermediate Zones,MSOAIZ,KY,2125,1086,1039,636,648
S02001757,Dunfermline Pitcorthie East,Middle Super Output Areas and Intermediate Zones,MSOAIZ,KY,3813,1889,1924,969,973
S02001758,Dunfermline Pitcorthie West,Middle Super Output Areas and Intermediate Zones,MSOAIZ,KY,2618,1287,1331,633,631
S02001759,Rosyth North,Middle Super Output Areas and Intermediate Zones,MSOAIZ,KY,3018,1474,1544,750,751
S02001760,Rosyth East,Middle Super Output Areas and Intermediate Zones,MSOAIZ,KY,3171,1542,1629,763,817
S02001761,Rosyth Central,Middle Super Output Areas and Intermediate Zones,MSOAIZ,KY,3547,1731,1816,887,892
S02001762,Rosyth South,Middle Super Output Areas and Intermediate Zones,MSOAIZ,KY,3844,1965,1879,1226,1104
S02001763,North Queensferry and Inverkeithing West,Middle Super Output Areas and Intermediate Zones,MSOAIZ,KY,3307,1650,1657,860,831
S02001764,Inverkeithing East,Middle Super Output Areas and Intermediate Zones,MSOAIZ,KY,3111,1494,1617,766,795
S02001765,Dalgety Bay West and Hillend,Middle Super Output Areas and Intermediate Zones,MSOAIZ,KY,2739,1354,1385,747,760
S02001766,Dalgety Bay Central,Middle Super Output Areas and Intermediate Zones,MSOAIZ,KY,4452,2205,2247,986,976
S02001767,Dalgety Bay East,Middle Super Output Areas and Intermediate Zones,MSOAIZ,KY,2683,1327,1356,581,567
S02001768,Crossgates and Halbeath,Middle Super Output Areas and Intermediate Zones,MSOAIZ,KY,3171,1556,1615,781,811
S02001769,Hill of Beath and Kingseat,Middle Super Output Areas and Intermediate Zones,MSOAIZ,KY,3265,1577,1688,782,847
S02001770,Cowdenbeath South,Middle Super Output Areas and Intermediate Zones,MSOAIZ,KY,3107,1479,1628,701,759
S02001771,Cowdenbeath North,Middle Super Output Areas and Intermediate Zones,MSOAIZ,KY,4396,2164,2232,1096,1066
S02001772,Kelty West,Middle Super Output Areas and Intermediate Zones,MSOAIZ,KY,2738,1296,1442,638,710
S02001773,Kelty East,Middle Super Output Areas and Intermediate Zones,MSOAIZ,KY,3646,1777,1869,905,916
S02001774,Lochore and Crosshill,Middle Super Output Areas and Intermediate Zones,MSOAIZ,KY,2779,1333,1446,602,667
S02001775,Ballingry,Middle Super Output Areas and Intermediate Zones,MSOAIZ,KY,2960,1429,1531,712,771
S02001776,Cardenden,Middle Super Output Areas and Intermediate Zones,MSOAIZ,KY,5931,2811,3120,1331,1479
S02001777,Lochgelly East,Middle Super Output Areas and Intermediate Zones,MSOAIZ,KY,4354,2099,2255,1041,1105
S02001778,Lochgelly West and Lumphinnans,Middle Super Output Areas and Intermediate Zones,MSOAIZ,KY,3147,1533,1614,773,812
S02001779,Aberdour and Auchtertool,Middle Super Output Areas and Intermediate Zones,MSOAIZ,KY,3052,1511,1541,672,655
S02001780,Burntisland West,Middle Super Output Areas and Intermediate Zones,MSOAIZ,KY,3693,1803,1890,889,915
S02001781,Burntisland East,Middle Super Output Areas and Intermediate Zones,MSOAIZ,KY,2690,1280,1410,571,618
S02001782,Kinghorn,Middle Super Output Areas and Intermediate Zones,MSOAIZ,KY,2826,1328,1498,588,653
S02001783,Kirkcaldy Linktown & Seafield,Middle Super Output Areas and Intermediate Zones,MSOAIZ,KY,4470,2203,2267,1190,1135
S02001784,Kirkcaldy Central,Middle Super Output Areas and Intermediate Zones,MSOAIZ,KY,3244,1582,1662,859,799
S02001785,Kirkcaldy Bennochy East,Middle Super Output Areas and Intermediate Zones,MSOAIZ,KY,3064,1483,1581,866,824
S02001786,Kirkcaldy Bennochy West,Middle Super Output Areas and Intermediate Zones,MSOAIZ,KY,2930,1383,1547,655,664
S02001787,Kirkcaldy Raith,Middle Super Output Areas and Intermediate Zones,MSOAIZ,KY,2665,1318,1347,607,644
S02001788,Kirkcaldy Newliston and Redcraigs,Middle Super Output Areas and Intermediate Zones,MSOAIZ,KY,3199,1544,1655,685,762
S02001789,Kirkcaldy Templehall West,Middle Super Output Areas and Intermediate Zones,MSOAIZ,KY,3007,1397,1610,667,775
S02001790,Kirkcaldy Templehall East,Middle Super Output Areas and Intermediate Zones,MSOAIZ,KY,5027,2429,2598,1230,1338
S02001791,Kirkcaldy Dunnikier,Middle Super Output Areas and Intermediate Zones,MSOAIZ,KY,3349,1629,1720,715,764
S02001792,Kirkcaldy Chapel,Middle Super Output Areas and Intermediate Zones,MSOAIZ,KY,4863,2327,2536,1192,1288
S02001793,Kirkcaldy Hayfield and Smeaton,Middle Super Output Areas and Intermediate Zones,MSOAIZ,KY,3721,1782,1939,835,977
S02001794,Kirkcaldy Pathhead,Middle Super Output Areas and Intermediate Zones,MSOAIZ,KY,2963,1432,1531,741,697
S02001795,Kirkcaldy Gallatown and Sinclairtown,Middle Super Output Areas and Intermediate Zones,MSOAIZ,KY,3854,1861,1993,914,960
S02001796,Dysart,Middle Super Output Areas and Intermediate Zones,MSOAIZ,KY,3564,1717,1847,878,859
S02001797,Wemyss,Middle Super Output Areas and Intermediate Zones,MSOAIZ,KY,2891,1376,1515,667,733
S02001798,Thornton and Kinglassie,Middle Super Output Areas and Intermediate Zones,MSOAIZ,KY,3994,1963,2031,967,1048
S02001799,Leslie and Newcastle,Middle Super Output Areas and Intermediate Zones,MSOAIZ,KY,4184,2005,2179,975,997
S02001800,Glenrothes Macedonia and Tanshall,Middle Super Output Areas and Intermediate Zones,MSOAIZ,KY,4256,2016,2240,1041,1154
S02001801,Glenrothes South Parks,Middle Super Output Areas and Intermediate Zones,MSOAIZ,KY,2217,1052,1165,468,502
S02001802,Glenrothes Caskieberran and Rimbleton,Middle Super Output Areas and Intermediate Zones,MSOAIZ,KY,4651,2212,2439,1081,1146
S02001803,Glenrothes Auchmuty,Middle Super Output Areas and Intermediate Zones,MSOAIZ,KY,3489,1669,1820,843,879
S02001804,Glenrothes Stenton and Finglassie,Middle Super Output Areas and Intermediate Zones,MSOAIZ,KY,3536,1734,1802,880,928
S02001805,Glenrothes Pitteuchar,Middle Super Output Areas and Intermediate Zones,MSOAIZ,KY,5055,2499,2556,1205,1238
S02001806,Glenrothes Woodside,Middle Super Output Areas and Intermediate Zones,MSOAIZ,KY,2731,1319,1412,607,611
S02001807,Glenrothes Balgeddie and Town Park,Middle Super Output Areas and Intermediate Zones,MSOAIZ,KY,3706,1837,1869,867,889
S02001808,Glenrothes Collydean,Middle Super Output Areas and Intermediate Zones,MSOAIZ,KY,2322,1105,1217,574,673
S02001809,Glenrothes Cadham and Pitcoudie,Middle Super Output Areas and Intermediate Zones,MSOAIZ,KY,2198,1062,1136,533,577
S02001810,Glenrothes Balfarg Pitcairn and Coul,Middle Super Output Areas and Intermediate Zones,MSOAIZ,KY,2952,1451,1501,740,777
S02001811,Markinch and Star,Middle Super Output Areas and Intermediate Zones,MSOAIZ,KY,4034,1942,2092,958,975
S02001812,Windygates and Coaltown,Middle Super Output Areas and Intermediate Zones,MSOAIZ,KY,3419,1700,1719,832,839
S02001813,Buckhaven; Denbeath and Muiredge,Middle Super Output Areas and Intermediate Zones,MSOAIZ,KY,4979,2388,2591,1099,1214
S02001814,Methil Methilhill,Middle Super Output Areas and Intermediate Zones,MSOAIZ,KY,4705,2197,2508,1016,1191
S02001815,Methil West,Middle Super Output Areas and Intermediate Zones,MSOAIZ,KY,2523,1251,1272,599,591
S02001816,Methil East,Middle Super Output Areas and Intermediate Zones,MSOAIZ,KY,3263,1582,1681,802,842
S02001817,Leven East,Middle Super Output Areas and Intermediate Zones,MSOAIZ,KY,3083,1457,1626,698,730
S02001818,Leven West,Middle Super Output Areas and Intermediate Zones,MSOAIZ,KY,3239,1545,1694,781,828
S02001819,Leven North,Middle Super Output Areas and Intermediate Zones,MSOAIZ,KY,2682,1289,1393,582,623
S02001820,Largo,Middle Super Output Areas and Intermediate Zones,MSOAIZ,KY,2818,1300,1518,542,547
S02001821,Kennoway and Bonnybank,Middle Super Output Areas and Intermediate Zones,MSOAIZ,KY,5472,2675,2797,1255,1326
S02001822,Kettle and Ladybank,Middle Super Output Areas and Intermediate Zones,MSOAIZ,KY,4187,2076,2111,941,951
S02001823,Falkland and Freuchie,Middle Super Output Areas and Intermediate Zones,MSOAIZ,KY,2494,1199,1295,570,605
S02001824,Auchtermuchty and Gateside,Middle Super Output Areas and Intermediate Zones,MSOAIZ,PH,4207,2066,2141,925,926
S02001825,Newburgh,Middle Super Output Areas and Intermediate Zones,MSOAIZ,KY,2899,1432,1467,657,655
S02001826,Cupar West and Springfield,Middle Super Output Areas and Intermediate Zones,MSOAIZ,KY,3899,1924,1975,906,898
S02001827,Cupar Central,Middle Super Output Areas and Intermediate Zones,MSOAIZ,KY,3355,1613,1742,840,902
S02001828,Cupar East,Middle Super Output Areas and Intermediate Zones,MSOAIZ,KY,4015,1914,2101,828,844
S02001829,Dairsie Ceres and Dunino,Middle Super Output Areas and Intermediate Zones,MSOAIZ,KY,2850,1358,1492,598,640
S02001830,Elie Colinsburgh and Largoward,Middle Super Output Areas and Intermediate Zones,MSOAIZ,KY,2196,1091,1105,425,414
S02001831,St Monans and Pittenweem,Middle Super Output Areas and Intermediate Zones,MSOAIZ,KY,2843,1377,1466,611,623
S02001832,Anstruther,Middle Super Output Areas and Intermediate Zones,MSOAIZ,KY,3831,1868,1963,860,820
S02001833,Crail and Boarhills,Middle Super Output Areas and Intermediate Zones,MSOAIZ,KY,2450,1170,1280,473,482
S02001834,St Andrews South East,Middle Super Output Areas and Intermediate Zones,MSOAIZ,KY,4008,1865,2143,1043,1198
S02001835,St Andrews Central,Middle Super Output Areas and Intermediate Zones,MSOAIZ,KY,5188,2313,2875,1813,2299
S02001836,St Andrews South West,Middle Super Output Areas and Intermediate Zones,MSOAIZ,KY,4169,2002,2167,967,1011
S02001837,St Andrews North and Strathkinness,Middle Super Output Areas and Intermediate Zones,MSOAIZ,KY,5279,2410,2869,1687,2002
S02001838,Leuchars and Guardbridge,Middle Super Output Areas and Intermediate Zones,MSOAIZ,KY,3453,1843,1610,1144,921
S02001839,Balmullo and Gauldry,Middle Super Output Areas and Intermediate Zones,MSOAIZ,KY,3774,1844,1930,772,836
S02001840,Tayport,Middle Super Output Areas and Intermediate Zones,MSOAIZ,DD,3815,1812,2003,875,950
S02001841,Newport and Wormit,Middle Super Output Areas and Intermediate Zones,MSOAIZ,DD,4243,2013,2230,834,925
S02001842,Darnley East,Middle Super Output Areas and Intermediate Zones,MSOAIZ,G,5033,2323,2710,1255,1511
S02001843,Darnley North,Middle Super Output Areas and Intermediate Zones,MSOAIZ,G,2813,1308,1505,719,784
S02001844,Darnley West,Middle Super Output Areas and Intermediate Zones,MSOAIZ,G,4741,2268,2473,1296,1436
S02001845,Nitshill,Middle Super Output Areas and Intermediate Zones,MSOAIZ,G,5836,2692,3144,1359,1660
S02001846,Crookston South,Middle Super Output Areas and Intermediate Zones,MSOAIZ,G,3387,1578,1809,767,932
S02001847,Crookston North,Middle Super Output Areas and Intermediate Zones,MSOAIZ,G,3022,1374,1648,692,787
S02001848,Pollok South and West,Middle Super Output Areas and Intermediate Zones,MSOAIZ,G,5467,2641,2826,1466,1611
S02001849,Pollok North and East,Middle Super Output Areas and Intermediate Zones,MSOAIZ,G,6145,2870,3275,1512,1727
S02001850,Cardonald South and East,Middle Super Output Areas and Intermediate Zones,MSOAIZ,G,3512,1646,1866,889,936
S02001851,Cardonald North,Middle Super Output Areas and Intermediate Zones,MSOAIZ,G,4271,1965,2306,971,1068
S02001852,Cardonald West and Central,Middle Super Output Areas and Intermediate Zones,MSOAIZ,G,5315,2468,2847,1189,1305
S02001853,Penilee,Middle Super Output Areas and Intermediate Zones,MSOAIZ,G,5309,2404,2905,1210,1430
S02001854,Hillington,Middle Super Output Areas and Intermediate Zones,MSOAIZ,G,3519,1567,1952,879,997
S02001855,Drumoyne and Shieldhall,Middle Super Output Areas and Intermediate Zones,MSOAIZ,G,6268,2890,3378,1523,1810
S02001856,Govan and Linthouse,Middle Super Output Areas and Intermediate Zones,MSOAIZ,G,4899,2489,2410,1455,1477
S02001857,Craigton,Middle Super Output Areas and Intermediate Zones,MSOAIZ,G,3303,1529,1774,796,826
S02001858,Mosspark,Middle Super Output Areas and Intermediate Zones,MSOAIZ,G,5240,2362,2878,1172,1389
S02001859,Ibrox,Middle Super Output Areas and Intermediate Zones,MSOAIZ,G,3061,1467,1594,825,822
S02001860,Ibrox East and Cessnock,Middle Super Output Areas and Intermediate Zones,MSOAIZ,G,2948,1547,1401,1029,913
S02001861,Kinning Park and Festival Park,Middle Super Output Areas and Intermediate Zones,MSOAIZ,G,3742,1977,1765,1417,1100
S02001862,Kingston West and Dumbreck,Middle Super Output Areas and Intermediate Zones,MSOAIZ,G,3669,1883,1786,1041,912
S02001863,Pollokshields West,Middle Super Output Areas and Intermediate Zones,MSOAIZ,G,4744,2356,2388,1296,1284
S02001864,Pollokshields East,Middle Super Output Areas and Intermediate Zones,MSOAIZ,G,4968,2611,2357,1679,1487
S02001865,Govanhill West,Middle Super Output Areas and Intermediate Zones,MSOAIZ,G,5429,2959,2470,1924,1509
S02001866,Govanhill East and Aikenhead,Middle Super Output Areas and Intermediate Zones,MSOAIZ,G,4081,2073,2008,1209,1096
S02001867,Battlefield,Middle Super Output Areas and Intermediate Zones,MSOAIZ,G,4990,2410,2580,1584,1649
S02001868,Strathbungo,Middle Super Output Areas and Intermediate Zones,MSOAIZ,G,5617,3007,2610,2071,1765
S02001869,Maxwell Park,Middle Super Output Areas and Intermediate Zones,MSOAIZ,G,5929,2852,3077,1448,1520
S02001870,Shawlands West,Middle Super Output Areas and Intermediate Zones,MSOAIZ,G,3573,1743,1830,1260,1292
S02001871,Shawlands East,Middle Super Output Areas and Intermediate Zones,MSOAIZ,G,3293,1620,1673,1157,1149
S02001872,Langside,Middle Super Output Areas and Intermediate Zones,MSOAIZ,G,4086,2005,2081,1372,1347
S02001873,Pollokshaws,Middle Super Output Areas and Intermediate Zones,MSOAIZ,G,4487,2212,2275,1226,1131
S02001874,Carnwadric West,Middle Super Output Areas and Intermediate Zones,MSOAIZ,G,4634,2294,2340,1231,1272
S02001875,Carnwadric East,Middle Super Output Areas and Intermediate Zones,MSOAIZ,G,3144,1468,1676,749,812
S02001876,Newlands,Middle Super Output Areas and Intermediate Zones,MSOAIZ,G,5387,2664,2723,1296,1327
S02001877,Merrylee and Millbrae,Middle Super Output Areas and Intermediate Zones,MSOAIZ,G,3435,1647,1788,807,851
S02001878,Muirend and Old Cathcart,Middle Super Output Areas and Intermediate Zones,MSOAIZ,G,4951,2357,2594,1249,1255
S02001879,Carmunnock North,Middle Super Output Areas and Intermediate Zones,MSOAIZ,G,2903,1417,1486,675,680
S02001880,Carmunnock South,Middle Super Output Areas and Intermediate Zones,MSOAIZ,G,3744,1720,2024,867,1008
S02001881,Glenwood South,Middle Super Output Areas and Intermediate Zones,MSOAIZ,G,5159,2336,2823,1187,1451
S02001882,Glenwood North,Middle Super Output Areas and Intermediate Zones,MSOAIZ,G,4319,1990,2329,1085,1322
S02001883,Castlemilk,Middle Super Output Areas and Intermediate Zones,MSOAIZ,G,4905,2225,2680,1148,1351
S02001884,Kingspark South,Middle Super Output Areas and Intermediate Zones,MSOAIZ,G,4157,1957,2200,1050,1223
S02001885,Kingspark North,Middle Super Output Areas and Intermediate Zones,MSOAIZ,G,4368,2081,2287,1044,1211
S02001886,Cathcart,Middle Super Output Areas and Intermediate Zones,MSOAIZ,G,4798,2354,2444,1512,1493
S02001887,Mount Florida,Middle Super Output Areas and Intermediate Zones,MSOAIZ,G,4172,2033,2139,1269,1302
S02001888,Toryglen and Oatlands,Middle Super Output Areas and Intermediate Zones,MSOAIZ,G,5646,2675,2971,1379,1549
S02001889,Gorbals and Hutchesontown,Middle Super Output Areas and Intermediate Zones,MSOAIZ,G,5824,2892,2932,1738,1655
S02001890,Laurieston and Tradeston,Middle Super Output Areas and Intermediate Zones,MSOAIZ,G,5001,2998,2003,2375,1395
S02001891,Calton and Gallowgate,Middle Super Output Areas and Intermediate Zones,MSOAIZ,G,3987,2135,1852,1570,1225
S02001892,Bridgeton,Middle Super Output Areas and Intermediate Zones,MSOAIZ,G,3552,1744,1808,1135,1122
S02001893,Dalmarnock,Middle Super Output Areas and Intermediate Zones,MSOAIZ,G,2529,1199,1330,606,694
S02001894,Parkhead West and Barrowfield,Middle Super Output Areas and Intermediate Zones,MSOAIZ,G,5709,2833,2876,1553,1566
S02001895,Parkhead East and Braidfauld North,Middle Super Output Areas and Intermediate Zones,MSOAIZ,G,3166,1529,1637,901,972
S02001896,Braidfauld,Middle Super Output Areas and Intermediate Zones,MSOAIZ,G,5637,2668,2969,1444,1624
S02001897,Shettleston South,Middle Super Output Areas and Intermediate Zones,MSOAIZ,G,3887,1879,2008,974,1037
S02001898,Carmyle and Mount Vernon South,Middle Super Output Areas and Intermediate Zones,MSOAIZ,G,2701,1295,1406,578,623
S02001899,Mount Vernon North and Sandyhills,Middle Super Output Areas and Intermediate Zones,MSOAIZ,G,3766,1854,1912,893,903
S02001900,Baillieston West,Middle Super Output Areas and Intermediate Zones,MSOAIZ,G,3842,1842,2000,888,926
S02001901,Baillieston East,Middle Super Output Areas and Intermediate Zones,MSOAIZ,G,5313,2543,2770,1377,1498
S02001902,Garrowhill West,Middle Super Output Areas and Intermediate Zones,MSOAIZ,G,4296,2043,2253,1002,1093
S02001903,Garrowhill East and Swinton,Middle Super Output Areas and Intermediate Zones,MSOAIZ,G,4298,2030,2268,1117,1258
S02001904,Easterhouse East,Middle Super Output Areas and Intermediate Zones,MSOAIZ,G,3183,1471,1712,821,932
S02001905,Central Easterhouse,Middle Super Output Areas and Intermediate Zones,MSOAIZ,G,2740,1262,1478,620,794
S02001906,Garthamlock; Auchinlea and Gartloch,Middle Super Output Areas and Intermediate Zones,MSOAIZ,G,3633,1708,1925,984,1142
S02001907,North Barlanark and Easterhouse South,Middle Super Output Areas and Intermediate Zones,MSOAIZ,G,3405,1583,1822,812,1007
S02001908,Barlanark,Middle Super Output Areas and Intermediate Zones,MSOAIZ,G,4904,2228,2676,1185,1505
S02001909,Greenfield,Middle Super Output Areas and Intermediate Zones,MSOAIZ,G,5228,2410,2818,1161,1259
S02001910,Shettleston North,Middle Super Output Areas and Intermediate Zones,MSOAIZ,G,4492,2170,2322,1164,1156
S02001911,Tollcross,Middle Super Output Areas and Intermediate Zones,MSOAIZ,G,3554,1690,1864,955,1022
S02001912,Old Shettleston and Parkhead North,Middle Super Output Areas and Intermediate Zones,MSOAIZ,G,3573,1612,1961,847,971
S02001913,Carntyne,Middle Super Output Areas and Intermediate Zones,MSOAIZ,G,3419,1512,1907,668,749
S02001914,Cranhill; Lightburn and Queenslie South,Middle Super Output Areas and Intermediate Zones,MSOAIZ,G,6265,2858,3407,1395,1686
S02001915,Craigend and Ruchazie,Middle Super Output Areas and Intermediate Zones,MSOAIZ,G,5100,2375,2725,1149,1386
S02001916,Riddrie and Hogganfield,Middle Super Output Areas and Intermediate Zones,MSOAIZ,G,5861,3120,2741,1924,1249
S02001917,Blackhill and Barmulloch East,Middle Super Output Areas and Intermediate Zones,MSOAIZ,G,4421,2008,2413,1017,1257
S02001918,Robroyston and Millerston,Middle Super Output Areas and Intermediate Zones,MSOAIZ,G,6125,2940,3185,1749,1880
S02001919,Balornock,Middle Super Output Areas and Intermediate Zones,MSOAIZ,G,3585,1670,1915,843,936
S02001920,Barmulloch,Middle Super Output Areas and Intermediate Zones,MSOAIZ,G,2637,1221,1416,576,742
S02001921,Petershill,Middle Super Output Areas and Intermediate Zones,MSOAIZ,G,4307,2014,2293,1123,1328
S02001922,Springburn,Middle Super Output Areas and Intermediate Zones,MSOAIZ,G,4716,2139,2577,1077,1245
S02001923,Springburn East and Cowlairs,Middle Super Output Areas and Intermediate Zones,MSOAIZ,G,4273,2016,2257,1090,1248
S02001924,Cowlairs and Port Dundas,Middle Super Output Areas and Intermediate Zones,MSOAIZ,G,3609,1807,1802,1111,1061
S02001925,Sighthill,Middle Super Output Areas and Intermediate Zones,MSOAIZ,G,2320,1172,1148,688,691
S02001926,Roystonhill; Blochairn; and Provanmill,Middle Super Output Areas and Intermediate Zones,MSOAIZ,G,5773,2828,2945,1601,1642
S02001927,Dennistoun North,Middle Super Output Areas and Intermediate Zones,MSOAIZ,G,4030,1985,2045,1505,1383
S02001928,Alexandra Parade,Middle Super Output Areas and Intermediate Zones,MSOAIZ,G,2500,1184,1316,745,753
S02001929,Carntyne West and Haghill,Middle Super Output Areas and Intermediate Zones,MSOAIZ,G,5068,2454,2614,1516,1592
S02001930,Dennistoun,Middle Super Output Areas and Intermediate Zones,MSOAIZ,G,4195,2132,2063,1596,1474
S02001931,Gallowgate North and Bellgrove,Middle Super Output Areas and Intermediate Zones,MSOAIZ,G,4926,2471,2455,1850,1800
S02001932,City Centre East,Middle Super Output Areas and Intermediate Zones,MSOAIZ,G,9139,4722,4417,3915,3604
S02001933,City Centre West,Middle Super Output Areas and Intermediate Zones,MSOAIZ,G,4453,2289,2164,1737,1602
S02001934,City Centre South,Middle Super Output Areas and Intermediate Zones,MSOAIZ,G,2832,1686,1146,1445,969
S02001935,Anderston,Middle Super Output Areas and Intermediate Zones,MSOAIZ,G,4420,2368,2052,1813,1472
S02001936,Finnieston and Kelvinhaugh,Middle Super Output Areas and Intermediate Zones,MSOAIZ,G,6985,3451,3534,2908,2992
S02001937,Woodlands,Middle Super Output Areas and Intermediate Zones,MSOAIZ,G,6449,3278,3171,2613,2565
S02001938,Woodside,Middle Super Output Areas and Intermediate Zones,MSOAIZ,G,3416,1739,1677,1116,962
S02001939,Firhill,Middle Super Output Areas and Intermediate Zones,MSOAIZ,G,5667,2814,2853,1988,1989
S02001940,Keppochhill,Middle Super Output Areas and Intermediate Zones,MSOAIZ,G,4616,2306,2310,1324,1338
S02001941,Ruchill,Middle Super Output Areas and Intermediate Zones,MSOAIZ,G,6987,3299,3688,2469,2696
S02001942,Possil Park,Middle Super Output Areas and Intermediate Zones,MSOAIZ,G,5812,2656,3156,1270,1488
S02001943,Milton West,Middle Super Output Areas and Intermediate Zones,MSOAIZ,G,4190,1899,2291,923,1165
S02001944,Milton East,Middle Super Output Areas and Intermediate Zones,MSOAIZ,G,3554,1627,1927,781,944
S02001945,Summerston Central and West,Middle Super Output Areas and Intermediate Zones,MSOAIZ,G,4093,1950,2143,1059,1208
S02001946,Summerston North,Middle Super Output Areas and Intermediate Zones,MSOAIZ,G,4031,1788,2243,898,1134
S02001947,Maryhill East,Middle Super Output Areas and Intermediate Zones,MSOAIZ,G,3295,1527,1768,802,940
S02001948,Maryhill West,Middle Super Output Areas and Intermediate Zones,MSOAIZ,G,2742,1281,1461,761,842
S02001949,Wyndford,Middle Super Output Areas and Intermediate Zones,MSOAIZ,G,3619,1896,1723,1111,904
S02001950,Kelvindale,Middle Super Output Areas and Intermediate Zones,MSOAIZ,G,6079,2899,3180,1692,1850
S02001951,North Kelvin,Middle Super Output Areas and Intermediate Zones,MSOAIZ,G,3795,1869,1926,1289,1353
S02001952,Kelvingrove and University,Middle Super Output Areas and Intermediate Zones,MSOAIZ,G,5946,2718,3228,2122,2585
S02001953,Hillhead,Middle Super Output Areas and Intermediate Zones,MSOAIZ,G,5715,2787,2928,2126,2210
S02001954,Glasgow Harbour and Partick South,Middle Super Output Areas and Intermediate Zones,MSOAIZ,G,4602,2338,2264,1856,1748
S02001955,Partick,Middle Super Output Areas and Intermediate Zones,MSOAIZ,G,3845,1890,1955,1277,1281
S02001956,Partickhill and Hyndland,Middle Super Output Areas and Intermediate Zones,MSOAIZ,G,5517,2614,2903,1793,1928
S02001957,Dowanhill,Middle Super Output Areas and Intermediate Zones,MSOAIZ,G,4338,2072,2266,1361,1492
S02001958,Kelvinside and Jordanhill,Middle Super Output Areas and Intermediate Zones,MSOAIZ,G,5577,2759,2818,1379,1389
S02001959,Broomhill,Middle Super Output Areas and Intermediate Zones,MSOAIZ,G,4348,2039,2309,1142,1269
S02001960,Victoria Park,Middle Super Output Areas and Intermediate Zones,MSOAIZ,G,2694,1257,1437,620,665
S02001961,Whiteinch,Middle Super Output Areas and Intermediate Zones,MSOAIZ,G,3405,1649,1756,1015,1077
S02001962,Scotstoun North and East,Middle Super Output Areas and Intermediate Zones,MSOAIZ,G,4321,2160,2161,1107,1103
S02001963,Scotstoun South and West,Middle Super Output Areas and Intermediate Zones,MSOAIZ,G,3718,1835,1883,1075,1092
S02001964,Yoker South,Middle Super Output Areas and Intermediate Zones,MSOAIZ,G,4571,2091,2480,1269,1578
S02001965,Yoker North,Middle Super Output Areas and Intermediate Zones,MSOAIZ,G,3030,1393,1637,657,712
S02001966,Knightswood West,Middle Super Output Areas and Intermediate Zones,MSOAIZ,G,2666,1277,1389,650,683
S02001967,Knightswood East,Middle Super Output Areas and Intermediate Zones,MSOAIZ,G,3977,1904,2073,997,983
S02001968,Knightswood Park West,Middle Super Output Areas and Intermediate Zones,MSOAIZ,G,3459,1625,1834,810,813
S02001969,Knightswood Park East,Middle Super Output Areas and Intermediate Zones,MSOAIZ,G,3692,1823,1869,991,911
S02001970,Anniesland East,Middle Super Output Areas and Intermediate Zones,MSOAIZ,G,4217,1982,2235,1141,1318
S02001971,Anniesland West,Middle Super Output Areas and Intermediate Zones,MSOAIZ,G,5995,2701,3294,1642,1863
S02001972,Blairdardie East,Middle Super Output Areas and Intermediate Zones,MSOAIZ,G,5683,2660,3023,1403,1465
S02001973,Blairdardie West,Middle Super Output Areas and Intermediate Zones,MSOAIZ,G,2926,1412,1514,674,724
S02001974,Drumchapel South,Middle Super Output Areas and Intermediate Zones,MSOAIZ,G,2623,1202,1421,582,741
S02001975,Drumchapel North,Middle Super Output Areas and Intermediate Zones,MSOAIZ,G,3686,1627,2059,852,1133
S02001976,Drumry East,Middle Super Output Areas and Intermediate Zones,MSOAIZ,G,3287,1520,1767,767,965
S02001977,Drumry West,Middle Super Output Areas and Intermediate Zones,MSOAIZ,G,3464,1559,1905,812,1047
S02001978,Lochaber West,Middle Super Output Areas and Intermediate Zones,MSOAIZ,PH,4667,2261,2406,1020,1064
S02001979,Fort William North,Middle Super Output Areas and Intermediate Zones,MSOAIZ,PH,4576,2172,2404,1024,1079
S02001980,Fort William South,Middle Super Output Areas and Intermediate Zones,MSOAIZ,PH,5861,2874,2987,1436,1488
S02001981,Lochaber East and North,Middle Super Output Areas and Intermediate Zones,MSOAIZ,PH,4883,2398,2485,1065,1057
S02001982,Badenoch and Strathspey South,Middle Super Output Areas and Intermediate Zones,MSOAIZ,PH,3842,1875,1967,805,861
S02001983,Badenoch and Strathspey Central,Middle Super Output Areas and Intermediate Zones,MSOAIZ,PH,5050,2497,2553,1239,1316
S02001984,Badenoch and Strathspey North,Middle Super Output Areas and Intermediate Zones,MSOAIZ,PH,4696,2279,2417,1004,985
S02001985,Nairn Rural,Middle Super Output Areas and Intermediate Zones,MSOAIZ,PH,4251,2148,2103,961,938
S02001986,Nairn East,Middle Super Output Areas and Intermediate Zones,MSOAIZ,IV,4184,1995,2189,923,1001
S02001987,Nairn West,Middle Super Output Areas and Intermediate Zones,MSOAIZ,IV,4582,2153,2429,934,951
S02001988,Inverness East Rural,Middle Super Output Areas and Intermediate Zones,MSOAIZ,IV,5080,2589,2491,1266,1193
S02001989,Inverness Culloden and Balloch,Middle Super Output Areas and Intermediate Zones,MSOAIZ,IV,4192,2077,2115,996,1065
S02001990,Inverness Smithton,Middle Super Output Areas and Intermediate Zones,MSOAIZ,IV,3248,1590,1658,887,928
S02001991,Inverness Westhill,Middle Super Output Areas and Intermediate Zones,MSOAIZ,IV,5884,2799,3085,1462,1631
S02001992,Inverness Inshes,Middle Super Output Areas and Intermediate Zones,MSOAIZ,IV,4327,2079,2248,1147,1258
S02001993,Inverness Slackbuie,Middle Super Output Areas and Intermediate Zones,MSOAIZ,IV,2519,1246,1273,716,773
S02001994,Inverness Lochardil and Holm Mains,Middle Super Output Areas and Intermediate Zones,MSOAIZ,IV,4942,2413,2529,1128,1133
S02001995,Inverness Drummond,Middle Super Output Areas and Intermediate Zones,MSOAIZ,IV,3595,1692,1903,857,884
S02001996,Inverness Hilton,Middle Super Output Areas and Intermediate Zones,MSOAIZ,IV,3770,1831,1939,949,979
S02001997,Inverness Drakies,Middle Super Output Areas and Intermediate Zones,MSOAIZ,IV,2516,1195,1321,601,654
S02001998,Inverness Central; Raigmore and Longman,Middle Super Output Areas and Intermediate Zones,MSOAIZ,IV,4378,2206,2172,1331,1290
S02001999,Inverness Crown and Haugh,Middle Super Output Areas and Intermediate Zones,MSOAIZ,PA,4524,2209,2315,1124,991
S02002000,Inverness Ballifeary and Dalneigh,Middle Super Output Areas and Intermediate Zones,MSOAIZ,IV,4663,2210,2453,1105,1182
S02002001,Inverness Muirtown,Middle Super Output Areas and Intermediate Zones,MSOAIZ,IV,4146,2044,2102,1113,1107
S02002002,Inverness Merkinch,Middle Super Output Areas and Intermediate Zones,MSOAIZ,IV,3406,1650,1756,855,966
S02002003,Inverness Scorguie,Middle Super Output Areas and Intermediate Zones,MSOAIZ,IV,3143,1538,1605,774,775
S02002004,Inverness Kinmylies and South West,Middle Super Output Areas and Intermediate Zones,MSOAIZ,IV,3255,1592,1663,826,894
S02002005,Inverness West Rural,Middle Super Output Areas and Intermediate Zones,MSOAIZ,IV,6307,3127,3180,1352,1420
S02002006,Loch Ness,Middle Super Output Areas and Intermediate Zones,MSOAIZ,PH,4524,2219,2305,979,1002
S02002007,Lochlash,Middle Super Output Areas and Intermediate Zones,MSOAIZ,IV,2709,1354,1355,589,593
S02002008,Skye South,Middle Super Output Areas and Intermediate Zones,MSOAIZ,PH,3410,1706,1704,741,748
S02002009,Skye North East,Middle Super Output Areas and Intermediate Zones,MSOAIZ,IV,3445,1636,1809,752,805
S02002010,Skye North West,Middle Super Output Areas and Intermediate Zones,MSOAIZ,IV,3322,1658,1664,672,684
S02002011,Ross and Cromarty South West,Middle Super Output Areas and Intermediate Zones,MSOAIZ,IV,3008,1513,1495,582,573
S02002012,Ross and Cromarty North West,Middle Super Output Areas and Intermediate Zones,MSOAIZ,IV,3226,1604,1622,704,691
S02002013,Ross and Cromarty Central,Middle Super Output Areas and Intermediate Zones,MSOAIZ,IV,3649,1812,1837,792,821
S02002014,Ross and Cromarty East,Middle Super Output Areas and Intermediate Zones,MSOAIZ,IV,3278,1646,1632,744,748
S02002015,Muir of Ord,Middle Super Output Areas and Intermediate Zones,MSOAIZ,IV,3305,1651,1654,776,793
S02002016,Conon,Middle Super Output Areas and Intermediate Zones,MSOAIZ,IV,3524,1689,1835,797,846
S02002017,Dingwall,Middle Super Output Areas and Intermediate Zones,MSOAIZ,IV,5429,2582,2847,1234,1339
S02002018,Black Isle South,Middle Super Output Areas and Intermediate Zones,MSOAIZ,IV,6314,2983,3331,1234,1385
S02002019,Black Isle North,Middle Super Output Areas and Intermediate Zones,MSOAIZ,IV,3640,1801,1839,770,818
S02002020,Alness,Middle Super Output Areas and Intermediate Zones,MSOAIZ,IV,5957,2881,3076,1330,1446
S02002021,Invergordon,Middle Super Output Areas and Intermediate Zones,MSOAIZ,IV,4309,2115,2194,937,1010
S02002022,Seaboard,Middle Super Output Areas and Intermediate Zones,MSOAIZ,IV,4459,2178,2281,943,995
S02002023,Tain,Middle Super Output Areas and Intermediate Zones,MSOAIZ,IV,3807,1804,2003,807,904
S02002024,Sutherland South,Middle Super Output Areas and Intermediate Zones,MSOAIZ,IV,6068,2968,3100,1197,1205
S02002025,Sutherland East,Middle Super Output Areas and Intermediate Zones,MSOAIZ,KW,4290,2041,2249,835,893
S02002026,Caithness South,Middle Super Output Areas and Intermediate Zones,MSOAIZ,KW,2911,1444,1467,628,667
S02002027,Wick South,Middle Super Output Areas and Intermediate Zones,MSOAIZ,KW,3667,1776,1891,880,901
S02002028,Wick North,Middle Super Output Areas and Intermediate Zones,MSOAIZ,KW,3287,1631,1656,786,788
S02002029,Caithness North East,Middle Super Output Areas and Intermediate Zones,MSOAIZ,KW,3773,1937,1836,833,796
S02002030,Caithness North West,Middle Super Output Areas and Intermediate Zones,MSOAIZ,KW,5086,2559,2527,1202,1141
S02002031,Thurso East,Middle Super Output Areas and Intermediate Zones,MSOAIZ,KW,2900,1384,1516,698,692
S02002032,Thurso West,Middle Super Output Areas and Intermediate Zones,MSOAIZ,KW,4862,2372,2490,1140,1167
S02002033,Sutherland North and West,Middle Super Output Areas and Intermediate Zones,MSOAIZ,KW,3486,1788,1698,799,702
S02002034,Kilmacolm Central,Middle Super Output Areas and Intermediate Zones,MSOAIZ,PA,2553,1188,1365,497,544
S02002035,Kilmacolm; Quarriers; Greenock Upper East/Central,Middle Super Output Areas and Intermediate Zones,MSOAIZ,PA,3204,1551,1653,677,740
S02002036,Inverkip and Wemyss Bay,Middle Super Output Areas and Intermediate Zones,MSOAIZ,PA,5766,2838,2928,1438,1559
S02002037,West Braeside; East Inverkip and West Gourock,Middle Super Output Areas and Intermediate Zones,MSOAIZ,PA,3193,1579,1614,778,799
S02002038,Gourock Upper and West Central and Upper Larkfield,Middle Super Output Areas and Intermediate Zones,MSOAIZ,PA,4267,2045,2222,1047,1020
S02002039,Gourock Central; Upper East and IRH,Middle Super Output Areas and Intermediate Zones,MSOAIZ,PA,4243,2031,2212,1042,1047
S02002040,Braeside; Branchton; Lower Larkfield and Ravenscraig,Middle Super Output Areas and Intermediate Zones,MSOAIZ,PA,6389,2995,3394,1456,1751
S02002041,Lower Bow and Larkfield; Fancy Farm; Mallard Bowl,Middle Super Output Areas and Intermediate Zones,MSOAIZ,PA,5024,2380,2644,1205,1354
S02002042,Gourock East; Greenock West and Lyle Road,Middle Super Output Areas and Intermediate Zones,MSOAIZ,PA,5084,2382,2702,1028,1060
S02002043,Greenock West and Central,Middle Super Output Areas and Intermediate Zones,MSOAIZ,PA,5921,2763,3158,1500,1570
S02002044,Bow Farm; Barrs Cottage; Cowdenknowes and Overton,Middle Super Output Areas and Intermediate Zones,MSOAIZ,PA,4616,2277,2339,1261,1147
S02002045,Greenock Upper Central,Middle Super Output Areas and Intermediate Zones,MSOAIZ,PA,4242,2042,2200,1146,1121
S02002046,Greenock Town Centre and East Central,Middle Super Output Areas and Intermediate Zones,MSOAIZ,PA,5150,2478,2672,1228,1258
S02002047,Greenock East,Middle Super Output Areas and Intermediate Zones,MSOAIZ,PA,6225,2952,3273,1613,1800
S02002048,Port Glasgow Upper; West and Central,Middle Super Output Areas and Intermediate Zones,MSOAIZ,PA,5603,2695,2908,1444,1399
S02002049,Port Glasgow Mid; East and Central,Middle Super Output Areas and Intermediate Zones,MSOAIZ,PA,4900,2370,2530,1157,1215
S02002050,Port Glasgow Upper East,Middle Super Output Areas and Intermediate Zones,MSOAIZ,PA,5105,2433,2672,1118,1284
S02002051,Rural South Midlothian,Middle Super Output Areas and Intermediate Zones,MSOAIZ,EH,2649,1288,1361,667,662
S02002052,Penicuik Southeast,Middle Super Output Areas and Intermediate Zones,MSOAIZ,EH,3914,1882,2032,884,908
S02002053,Penicuik Southwest,Middle Super Output Areas and Intermediate Zones,MSOAIZ,EH,3959,1921,2038,872,927
S02002054,Penicuik East,Middle Super Output Areas and Intermediate Zones,MSOAIZ,EH,2569,1223,1346,594,630
S02002055,Penicuik North,Middle Super Output Areas and Intermediate Zones,MSOAIZ,EH,3568,1709,1859,834,870
S02002056,Pentland,Middle Super Output Areas and Intermediate Zones,MSOAIZ,EH,2323,1194,1129,629,588
S02002057,Roslin and Bilston,Middle Super Output Areas and Intermediate Zones,MSOAIZ,EH,3310,1601,1709,750,789
S02002058,Straiton,Middle Super Output Areas and Intermediate Zones,MSOAIZ,EH,2519,1223,1296,566,605
S02002059,Loanhead,Middle Super Output Areas and Intermediate Zones,MSOAIZ,EH,3668,1739,1929,806,843
S02002060,Bonnyrigg South,Middle Super Output Areas and Intermediate Zones,MSOAIZ,EH,4862,2329,2533,1135,1229
S02002061,Bonnyrigg North,Middle Super Output Areas and Intermediate Zones,MSOAIZ,EH,5692,2657,3035,1204,1325
S02002062,Newbattle and Dalhousie,Middle Super Output Areas and Intermediate Zones,MSOAIZ,EH,5913,2881,3032,1561,1657
S02002063,Eskbank,Middle Super Output Areas and Intermediate Zones,MSOAIZ,EH,4581,2173,2408,946,998
S02002064,Shawfair,Middle Super Output Areas and Intermediate Zones,MSOAIZ,EH,3513,1688,1825,793,854
S02002065,Thornybank,Middle Super Output Areas and Intermediate Zones,MSOAIZ,EH,3637,1754,1883,845,936
S02002066,Dalkeith,Middle Super Output Areas and Intermediate Zones,MSOAIZ,EH,2861,1345,1516,708,751
S02002067,Pathhead and Rural East Midlothian,Middle Super Output Areas and Intermediate Zones,MSOAIZ,EH,5287,2609,2678,1301,1385
S02002068,Easthouses,Middle Super Output Areas and Intermediate Zones,MSOAIZ,EH,3057,1463,1594,720,819
S02002069,Mayfield,Middle Super Output Areas and Intermediate Zones,MSOAIZ,EH,4725,2299,2426,1202,1281
S02002070,Newtongrange,Middle Super Output Areas and Intermediate Zones,MSOAIZ,EH,4126,2005,2121,997,1067
S02002071,North Gorebridge,Middle Super Output Areas and Intermediate Zones,MSOAIZ,EH,2630,1258,1372,635,675
S02002072,Gorebridge and Middleton,Middle Super Output Areas and Intermediate Zones,MSOAIZ,EH,3824,1830,1994,864,1015
S02002073,South Speyside and the Cabrach,Middle Super Output Areas and Intermediate Zones,MSOAIZ,AB,4328,2172,2156,931,950
S02002074,North Speyside,Middle Super Output Areas and Intermediate Zones,MSOAIZ,IV,3792,1847,1945,819,805
S02002075,Rural Keith and Strathisla,Middle Super Output Areas and Intermediate Zones,MSOAIZ,AB,3119,1571,1548,718,736
S02002076,Keith and Fife Keith,Middle Super Output Areas and Intermediate Zones,MSOAIZ,AB,4734,2299,2435,1066,1035
S02002077,Cullen; Portknockie; Findochty; Drybridge and Berryhillock,Middle Super Output Areas and Intermediate Zones,MSOAIZ,AB,5406,2661,2745,1182,1177
S02002078,Buckie Central East,Middle Super Output Areas and Intermediate Zones,MSOAIZ,AB,3543,1694,1849,816,842
S02002079,Buckie West and Mains of Buckie,Middle Super Output Areas and Intermediate Zones,MSOAIZ,AB,4534,2190,2344,1092,1015
S02002080,Mosstodloch; Portgordon and seaward,Middle Super Output Areas and Intermediate Zones,MSOAIZ,IV,3675,1811,1864,789,820
S02002081,Fochabers; Aultmore; Clochan and Ordiquish,Middle Super Output Areas and Intermediate Zones,MSOAIZ,IV,2355,1135,1220,480,511
S02002082,Heldon West; Fogwatt to Inchberry,Middle Super Output Areas and Intermediate Zones,MSOAIZ,IV,3030,1506,1524,725,736
S02002083,Lhanbryde; Urquhart; Pitgavney and seaward,Middle Super Output Areas and Intermediate Zones,MSOAIZ,IV,3324,1637,1687,799,815
S02002084,Elgin Cathedral to Ashgrove and Pinefield,Middle Super Output Areas and Intermediate Zones,MSOAIZ,IV,4333,2059,2274,1062,1110
S02002085,New Elgin East,Middle Super Output Areas and Intermediate Zones,MSOAIZ,IV,3871,1867,2004,997,1068
S02002086,New Elgin West,Middle Super Output Areas and Intermediate Zones,MSOAIZ,IV,4079,1976,2103,983,1055
S02002087,Elgin Central West,Middle Super Output Areas and Intermediate Zones,MSOAIZ,IV,3235,1581,1654,656,658
S02002088,Elgin Bishopmill East and Ladyhill,Middle Super Output Areas and Intermediate Zones,MSOAIZ,IV,3441,1647,1794,885,908
S02002089,Elgin Bishopmill West and Newfield,Middle Super Output Areas and Intermediate Zones,MSOAIZ,IV,3376,1646,1730,843,856
S02002090,Lossiemouth East and Seatown,Middle Super Output Areas and Intermediate Zones,MSOAIZ,IV,3474,1725,1749,913,813
S02002091,Lossiemouth West,Middle Super Output Areas and Intermediate Zones,MSOAIZ,IV,4231,2282,1949,1450,1069
S02002092,Burghead; Roseisle and Laich,Middle Super Output Areas and Intermediate Zones,MSOAIZ,IV,5418,2748,2670,1213,1207
S02002093,Findhorn; Kinloss and Pluscarden Valley,Middle Super Output Areas and Intermediate Zones,MSOAIZ,IV,3410,1763,1647,977,849
S02002094,Forres Central East and seaward,Middle Super Output Areas and Intermediate Zones,MSOAIZ,IV,3721,1843,1878,841,769
S02002095,Forres South West and Mannachie,Middle Super Output Areas and Intermediate Zones,MSOAIZ,IV,5422,2587,2835,1201,1268
S02002096,Rafford; Dallas; Dyke to Dava,Middle Super Output Areas and Intermediate Zones,MSOAIZ,IV,3444,1694,1750,794,836
S02002097,Arran,Middle Super Output Areas and Intermediate Zones,MSOAIZ,KA,4660,2232,2428,850,858
S02002098,Springside and Rural,Middle Super Output Areas and Intermediate Zones,MSOAIZ,KA,2626,1271,1355,595,629
S02002099,Irvine Tarryholme,Middle Super Output Areas and Intermediate Zones,MSOAIZ,KA,2984,1460,1524,675,697
S02002100,Dreghorn,Middle Super Output Areas and Intermediate Zones,MSOAIZ,KA,3619,1736,1883,830,888
S02002101,Irvine Broomlands,Middle Super Output Areas and Intermediate Zones,MSOAIZ,KA,2908,1401,1507,690,819
S02002102,Irvine Bourtreehill,Middle Super Output Areas and Intermediate Zones,MSOAIZ,KA,2398,1117,1281,502,626
S02002103,Irvine Girdle Toll and Staneca,Middle Super Output Areas and Intermediate Zones,MSOAIZ,KA,4312,2041,2271,997,1144
S02002104,Irvine Perceton and Lawthorn,Middle Super Output Areas and Intermediate Zones,MSOAIZ,KA,5182,2542,2640,1366,1443
S02002105,Irvine Castlepark North,Middle Super Output Areas and Intermediate Zones,MSOAIZ,KA,3627,1650,1977,765,939
S02002106,Irvine Castlepark South,Middle Super Output Areas and Intermediate Zones,MSOAIZ,KA,3170,1498,1672,747,861
S02002107,Irvine East,Middle Super Output Areas and Intermediate Zones,MSOAIZ,KA,3086,1467,1619,702,789
S02002108,Irvine Central,Middle Super Output Areas and Intermediate Zones,MSOAIZ,KA,3177,1498,1679,702,747
S02002109,Irvine Fullarton,Middle Super Output Areas and Intermediate Zones,MSOAIZ,KA,3034,1441,1593,775,780
S02002110,Stevenston Ardeer,Middle Super Output Areas and Intermediate Zones,MSOAIZ,KA,2349,1129,1220,535,630
S02002111,Saltcoats Central,Middle Super Output Areas and Intermediate Zones,MSOAIZ,KA,3863,1937,1926,988,899
S02002112,Ardrossan Central,Middle Super Output Areas and Intermediate Zones,MSOAIZ,KA,3170,1509,1661,761,840
S02002113,Ardrossan North West,Middle Super Output Areas and Intermediate Zones,MSOAIZ,KA,3130,1466,1664,691,754
S02002114,Ardrossan North East,Middle Super Output Areas and Intermediate Zones,MSOAIZ,KA,4589,2114,2475,1049,1307
S02002115,Saltcoats North West,Middle Super Output Areas and Intermediate Zones,MSOAIZ,KA,3742,1820,1922,845,895
S02002116,Saltcoats North East,Middle Super Output Areas and Intermediate Zones,MSOAIZ,KA,5159,2383,2776,1174,1403
S02002117,Stevenston North West,Middle Super Output Areas and Intermediate Zones,MSOAIZ,KA,2975,1446,1529,657,672
S02002118,Stevenston Hayocks,Middle Super Output Areas and Intermediate Zones,MSOAIZ,KA,4206,1988,2218,997,1130
S02002119,Kilwinning Whitehirst Park and Woodside,Middle Super Output Areas and Intermediate Zones,MSOAIZ,KA,5304,2615,2689,1384,1443
S02002120,Kilwinning Pennyburn,Middle Super Output Areas and Intermediate Zones,MSOAIZ,KA,3013,1366,1647,664,823
S02002121,Kilwinning West and Blacklands,Middle Super Output Areas and Intermediate Zones,MSOAIZ,KA,4348,2042,2306,995,1084
S02002122,Kilwinning Central and North,Middle Super Output Areas and Intermediate Zones,MSOAIZ,KA,3846,1792,2054,843,930
S02002123,Dalry East and Rural,Middle Super Output Areas and Intermediate Zones,MSOAIZ,KA,2999,1416,1583,661,696
S02002124,Dalry West,Middle Super Output Areas and Intermediate Zones,MSOAIZ,KA,3152,1492,1660,750,819
S02002125,Fairlie and Rural,Middle Super Output Areas and Intermediate Zones,MSOAIZ,KA,2328,1149,1179,466,469
S02002126,West Kilbride and Seamill,Middle Super Output Areas and Intermediate Zones,MSOAIZ,KA,4783,2266,2517,940,1029
S02002127,Largs South,Middle Super Output Areas and Intermediate Zones,MSOAIZ,KA,3776,1705,2071,662,710
S02002128,Largs Central and Cumbrae,Middle Super Output Areas and Intermediate Zones,MSOAIZ,KA,4894,2354,2540,1039,1101
S02002129,Largs North,Middle Super Output Areas and Intermediate Zones,MSOAIZ,KA,4046,1911,2135,667,716
S02002130,Skelmorlie and Rural,Middle Super Output Areas and Intermediate Zones,MSOAIZ,PA,2942,1465,1477,592,602
S02002131,Kilbirnie North,Middle Super Output Areas and Intermediate Zones,MSOAIZ,KA,3359,1605,1754,806,869
S02002132,Kilbirnie South and Longbar,Middle Super Output Areas and Intermediate Zones,MSOAIZ,KA,4224,2022,2202,1017,1045
S02002133,Beith West,Middle Super Output Areas and Intermediate Zones,MSOAIZ,KA,3209,1521,1688,787,837
S02002134,Beith East and Rural,Middle Super Output Areas and Intermediate Zones,MSOAIZ,KA,3957,1937,2020,930,931
S02002135,Overtown,Middle Super Output Areas and Intermediate Zones,MSOAIZ,ML,3984,2030,1954,1103,1040
S02002136,Netherton and Kirkhill,Middle Super Output Areas and Intermediate Zones,MSOAIZ,ML,3537,1682,1855,798,862
S02002137,Muirhouse,Middle Super Output Areas and Intermediate Zones,MSOAIZ,ML,4057,2023,2034,1205,1137
S02002138,Muirhouse and Knowetop,Middle Super Output Areas and Intermediate Zones,MSOAIZ,ML,6064,2944,3120,1561,1574
S02002139,Craigneuk Wishaw,Middle Super Output Areas and Intermediate Zones,MSOAIZ,ML,4390,2126,2264,1084,1147
S02002140,Pather,Middle Super Output Areas and Intermediate Zones,MSOAIZ,ML,3984,1936,2048,1059,1135
S02002141,Wishaw South,Middle Super Output Areas and Intermediate Zones,MSOAIZ,ML,5080,2405,2675,1197,1289
S02002142,Wishaw North,Middle Super Output Areas and Intermediate Zones,MSOAIZ,ML,6110,2843,3267,1424,1531
S02002143,Coltness,Middle Super Output Areas and Intermediate Zones,MSOAIZ,ML,3832,1813,2019,894,964
S02002144,Wishaw East,Middle Super Output Areas and Intermediate Zones,MSOAIZ,ML,2885,1451,1434,744,734
S02002145,Newmains,Middle Super Output Areas and Intermediate Zones,MSOAIZ,ML,5745,2780,2965,1385,1476
S02002146,Allanton - Newmains Rural,Middle Super Output Areas and Intermediate Zones,MSOAIZ,ML,3399,1970,1429,1257,738
S02002147,Shotts,Middle Super Output Areas and Intermediate Zones,MSOAIZ,ML,4481,2136,2345,1084,1160
S02002148,Stane,Middle Super Output Areas and Intermediate Zones,MSOAIZ,ML,2920,1443,1477,784,822
S02002149,Harthill and Salsburgh,Middle Super Output Areas and Intermediate Zones,MSOAIZ,ML,5392,2620,2772,1294,1362
S02002150,Cleland,Middle Super Output Areas and Intermediate Zones,MSOAIZ,ML,3756,1824,1932,960,980
S02002151,Newarthill,Middle Super Output Areas and Intermediate Zones,MSOAIZ,ML,3223,1570,1653,807,817
S02002152,Carfin North,Middle Super Output Areas and Intermediate Zones,MSOAIZ,ML,3898,1874,2024,1040,1126
S02002153,Clydesdale and New Stevenston,Middle Super Output Areas and Intermediate Zones,MSOAIZ,ML,3045,1482,1563,823,858
S02002154,Carfin and Cleekhimin,Middle Super Output Areas and Intermediate Zones,MSOAIZ,ML,5122,2547,2575,1409,1440
S02002155,Motherwell South,Middle Super Output Areas and Intermediate Zones,MSOAIZ,ML,3818,1843,1975,922,809
S02002156,Ladywell,Middle Super Output Areas and Intermediate Zones,MSOAIZ,ML,4211,2068,2143,983,1011
S02002157,Motherwell West,Middle Super Output Areas and Intermediate Zones,MSOAIZ,ML,4068,1906,2162,967,1040
S02002158,Motherwell North,Middle Super Output Areas and Intermediate Zones,MSOAIZ,ML,3153,1517,1636,775,883
S02002159,Forgewood,Middle Super Output Areas and Intermediate Zones,MSOAIZ,ML,5037,2403,2634,1296,1370
S02002160,Holytown,Middle Super Output Areas and Intermediate Zones,MSOAIZ,ML,5254,2569,2685,1407,1429
S02002161,Milnwood,Middle Super Output Areas and Intermediate Zones,MSOAIZ,ML,5031,2452,2579,1329,1369
S02002162,Orbiston,Middle Super Output Areas and Intermediate Zones,MSOAIZ,ML,5314,2560,2754,1331,1416
S02002163,Bellshill South,Middle Super Output Areas and Intermediate Zones,MSOAIZ,ML,4866,2371,2495,1269,1283
S02002164,Hattonrigg,Middle Super Output Areas and Intermediate Zones,MSOAIZ,ML,2697,1278,1419,613,648
S02002165,Bellshill Central,Middle Super Output Areas and Intermediate Zones,MSOAIZ,ML,3550,1697,1853,870,960
S02002166,Fallside,Middle Super Output Areas and Intermediate Zones,MSOAIZ,ML,4900,2358,2542,1241,1310
S02002167,Viewpark,Middle Super Output Areas and Intermediate Zones,MSOAIZ,ML,5711,2720,2991,1382,1483
S02002168,Birkenshaw,Middle Super Output Areas and Intermediate Zones,MSOAIZ,G,4868,2369,2499,1166,1295
S02002169,Kirkwood and Bargeddie,Middle Super Output Areas and Intermediate Zones,MSOAIZ,ML,6328,3004,3324,1608,1718
S02002170,Kirkshaws,Middle Super Output Areas and Intermediate Zones,MSOAIZ,ML,6056,2861,3195,1414,1724
S02002171,Dundyvan,Middle Super Output Areas and Intermediate Zones,MSOAIZ,ML,6230,2913,3317,1554,1608
S02002172,Drumpellier and Langloan,Middle Super Output Areas and Intermediate Zones,MSOAIZ,ML,2636,1248,1388,658,732
S02002173,Coatbridge West,Middle Super Output Areas and Intermediate Zones,MSOAIZ,ML,4052,1930,2122,1022,1076
S02002174,Townhead,Middle Super Output Areas and Intermediate Zones,MSOAIZ,ML,4818,2303,2515,1178,1253
S02002175,Sunnyside and Cliftonville,Middle Super Output Areas and Intermediate Zones,MSOAIZ,ML,4064,1947,2117,1066,1107
S02002176,Cliftonville,Middle Super Output Areas and Intermediate Zones,MSOAIZ,ML,3193,1647,1546,905,831
S02002177,Shawhead and Whifflet,Middle Super Output Areas and Intermediate Zones,MSOAIZ,ML,2939,1414,1525,690,688
S02002178,Greenend and Carnbroe,Middle Super Output Areas and Intermediate Zones,MSOAIZ,ML,5640,2741,2899,1567,1673
S02002179,Calderbank and Brownsburn,Middle Super Output Areas and Intermediate Zones,MSOAIZ,ML,2538,1216,1322,569,649
S02002180,Chapelhall West,Middle Super Output Areas and Intermediate Zones,MSOAIZ,ML,2544,1209,1335,616,688
S02002181,Chapelhall East,Middle Super Output Areas and Intermediate Zones,MSOAIZ,ML,3952,1891,2061,1067,1129
S02002182,Craigneuk Airdrie,Middle Super Output Areas and Intermediate Zones,MSOAIZ,ML,3797,1880,1917,986,1036
S02002183,Petersburn,Middle Super Output Areas and Intermediate Zones,MSOAIZ,ML,4005,1899,2106,950,1078
S02002184,Gartlea,Middle Super Output Areas and Intermediate Zones,MSOAIZ,ML,3153,1464,1689,723,832
S02002185,Cairnhill,Middle Super Output Areas and Intermediate Zones,MSOAIZ,ML,4684,2215,2469,1134,1159
S02002186,Coatdyke and Whinhall,Middle Super Output Areas and Intermediate Zones,MSOAIZ,ML,5485,2644,2841,1370,1485
S02002187,Thrashbush,Middle Super Output Areas and Intermediate Zones,MSOAIZ,ML,5495,2689,2806,1383,1450
S02002188,Airdrie North,Middle Super Output Areas and Intermediate Zones,MSOAIZ,ML,5547,2645,2902,1397,1485
S02002189,Drumgelloch,Middle Super Output Areas and Intermediate Zones,MSOAIZ,ML,4134,1965,2169,965,1028
S02002190,Caldercruix and Plains,Middle Super Output Areas and Intermediate Zones,MSOAIZ,ML,5714,2771,2943,1402,1462
S02002191,Glenmavis and Greengairs,Middle Super Output Areas and Intermediate Zones,MSOAIZ,ML,4602,2285,2317,1237,1189
S02002192,Gartcosh and Marnock,Middle Super Output Areas and Intermediate Zones,MSOAIZ,ML,5621,2774,2847,1489,1553
S02002193,Cardowan and Millerston,Middle Super Output Areas and Intermediate Zones,MSOAIZ,G,4410,2140,2270,1125,1205
S02002194,Stepps,Middle Super Output Areas and Intermediate Zones,MSOAIZ,G,2380,1156,1224,552,571
S02002195,Chryston and Muirhead,Middle Super Output Areas and Intermediate Zones,MSOAIZ,G,4166,1957,2209,966,1085
S02002196,Moodiesburn West,Middle Super Output Areas and Intermediate Zones,MSOAIZ,G,3665,1715,1950,856,999
S02002197,Moodiesburn East,Middle Super Output Areas and Intermediate Zones,MSOAIZ,G,3626,1771,1855,964,1036
S02002198,Westfield,Middle Super Output Areas and Intermediate Zones,MSOAIZ,G,6234,3027,3207,1614,1659
S02002199,Condorrat,Middle Super Output Areas and Intermediate Zones,MSOAIZ,G,4985,2441,2544,1116,1175
S02002200,Greenfaulds,Middle Super Output Areas and Intermediate Zones,MSOAIZ,G,4039,1988,2051,961,990
S02002201,Seafar,Middle Super Output Areas and Intermediate Zones,MSOAIZ,G,3497,1667,1830,860,892
S02002202,Cumbernauld Central,Middle Super Output Areas and Intermediate Zones,MSOAIZ,G,4738,2261,2477,1184,1219
S02002203,Kildrum,Middle Super Output Areas and Intermediate Zones,MSOAIZ,G,4310,2078,2232,1104,1124
S02002204,Abronhill South,Middle Super Output Areas and Intermediate Zones,MSOAIZ,G,4120,2018,2102,1023,1047
S02002205,Abronhill North,Middle Super Output Areas and Intermediate Zones,MSOAIZ,G,4410,2140,2270,1122,1201
S02002206,Village and Castlecary,Middle Super Output Areas and Intermediate Zones,MSOAIZ,G,3546,1742,1804,886,847
S02002207,Carrickstone,Middle Super Output Areas and Intermediate Zones,MSOAIZ,G,5126,2517,2609,1358,1426
S02002208,Balloch West,Middle Super Output Areas and Intermediate Zones,MSOAIZ,G,3595,1758,1837,917,939
S02002209,Balloch East,Middle Super Output Areas and Intermediate Zones,MSOAIZ,G,2924,1388,1536,673,729
S02002210,Kilsyth East and Croy,Middle Super Output Areas and Intermediate Zones,MSOAIZ,G,6120,2970,3150,1450,1516
S02002211,Kilsyth Bogside,Middle Super Output Areas and Intermediate Zones,MSOAIZ,G,3308,1607,1701,800,856
S02002212,Balmalloch,Middle Super Output Areas and Intermediate Zones,MSOAIZ,G,3919,1876,2043,885,970
S02002213,Stromness; Sandwick and Stenness,Middle Super Output Areas and Intermediate Zones,MSOAIZ,KW,3146,1530,1616,693,712
S02002214,West Mainland,Middle Super Output Areas and Intermediate Zones,MSOAIZ,KW,4009,2018,1991,923,891
S02002215,East Mainland,Middle Super Output Areas and Intermediate Zones,MSOAIZ,KW,3663,1827,1836,871,879
S02002216,West Kirkwall,Middle Super Output Areas and Intermediate Zones,MSOAIZ,KW,3851,1854,1997,956,960
S02002217,East Kirkwall,Middle Super Output Areas and Intermediate Zones,MSOAIZ,KW,2500,1210,1290,604,642
S02002218,Isles,Middle Super Output Areas and Intermediate Zones,MSOAIZ,KW,4180,2127,2053,862,830
S02002219,Powmill; Cleish and Scotlandwell,Middle Super Output Areas and Intermediate Zones,MSOAIZ,KY,3630,1799,1831,776,801
S02002220,Kinross,Middle Super Output Areas and Intermediate Zones,MSOAIZ,KY,4698,2239,2459,1025,1093
S02002221,Milnathort and Crook of Devon,Middle Super Output Areas and Intermediate Zones,MSOAIZ,KY,3500,1666,1834,709,784
S02002222,Muthill; Greenloaning and Gleneagles,Middle Super Output Areas and Intermediate Zones,MSOAIZ,PH,3562,1723,1839,789,840
S02002223,Auchterarder,Middle Super Output Areas and Intermediate Zones,MSOAIZ,PH,4069,1954,2115,855,893
S02002224,Comrie; Gilmerton and St Fillans,Middle Super Output Areas and Intermediate Zones,MSOAIZ,PH,3788,1847,1941,734,726
S02002225,Crieff North,Middle Super Output Areas and Intermediate Zones,MSOAIZ,PH,3234,1547,1687,582,619
S02002226,Crieff South,Middle Super Output Areas and Intermediate Zones,MSOAIZ,PH,4134,2026,2108,961,996
S02002227,Aberuthven and Almondbank,Middle Super Output Areas and Intermediate Zones,MSOAIZ,PH,4144,2025,2119,899,1002
S02002228,Glenfarg; Dunning and Rhynd,Middle Super Output Areas and Intermediate Zones,MSOAIZ,PH,3982,2019,1963,801,852
S02002229,Bridge of Earn and Abernethy,Middle Super Output Areas and Intermediate Zones,MSOAIZ,PH,4933,2306,2627,1027,1161
S02002230,Moncrieffe and Friarton,Middle Super Output Areas and Intermediate Zones,MSOAIZ,PH,4366,2359,2007,1396,914
S02002231,Viewlands; Craigie and Wellshill,Middle Super Output Areas and Intermediate Zones,MSOAIZ,PH,5780,2729,3051,1395,1461
S02002232,Burghmuir and Oakbank,Middle Super Output Areas and Intermediate Zones,MSOAIZ,PH,4277,2038,2239,852,909
S02002233,Western Edge,Middle Super Output Areas and Intermediate Zones,MSOAIZ,PH,4205,1990,2215,1034,1103
S02002234,Letham,Middle Super Output Areas and Intermediate Zones,MSOAIZ,PH,5808,2690,3118,1351,1552
S02002235,Hillyland; Tulloch and Inveralmond,Middle Super Output Areas and Intermediate Zones,MSOAIZ,PH,5810,2817,2993,1520,1611
S02002236,North Muirton and Old Scone,Middle Super Output Areas and Intermediate Zones,MSOAIZ,PH,3303,1524,1779,742,841
S02002237,Muirton,Middle Super Output Areas and Intermediate Zones,MSOAIZ,PH,3001,1509,1492,894,851
S02002238,North Inch,Middle Super Output Areas and Intermediate Zones,MSOAIZ,PH,2256,1164,1092,749,629
S02002239,Central and South Inch,Middle Super Output Areas and Intermediate Zones,MSOAIZ,PH,4584,2377,2207,1683,1344
S02002240,Gannochy and Walnut Grove,Middle Super Output Areas and Intermediate Zones,MSOAIZ,PH,3724,1780,1944,713,722
S02002241,Scone,Middle Super Output Areas and Intermediate Zones,MSOAIZ,PH,4998,2336,2662,931,1005
S02002242,Guildtown; Balbeggie and St Madoes,Middle Super Output Areas and Intermediate Zones,MSOAIZ,PH,3894,1949,1945,941,909
S02002243,Errol and Inchture,Middle Super Output Areas and Intermediate Zones,MSOAIZ,PH,3729,1837,1892,865,948
S02002244,Invergowrie; Longforgan and Abernyte,Middle Super Output Areas and Intermediate Zones,MSOAIZ,PH,3790,1881,1909,915,847
S02002245,Coupar Angus and Meigle,Middle Super Output Areas and Intermediate Zones,MSOAIZ,PH,5145,2580,2565,1164,1144
S02002246,Alyth,Middle Super Output Areas and Intermediate Zones,MSOAIZ,PH,3054,1465,1589,664,693
S02002247,Blair Atholl; Strathardle and Glenshee,Middle Super Output Areas and Intermediate Zones,MSOAIZ,PH,4034,2034,2000,876,841
S02002248,Blairgowrie East (Rattray),Middle Super Output Areas and Intermediate Zones,MSOAIZ,PH,3010,1447,1563,642,729
S02002249,Blairgowrie West,Middle Super Output Areas and Intermediate Zones,MSOAIZ,PH,5533,2595,2938,1064,1115
S02002250,Stanley and Murthly,Middle Super Output Areas and Intermediate Zones,MSOAIZ,PH,4516,2245,2271,1018,1076
S02002251,Luncarty and Dunkeld,Middle Super Output Areas and Intermediate Zones,MSOAIZ,PH,5639,2797,2842,1201,1187
S02002252,Pitlochry,Middle Super Output Areas and Intermediate Zones,MSOAIZ,PH,3716,1749,1967,786,811
S02002253,Rannoch and Aberfeldy,Middle Super Output Areas and Intermediate Zones,MSOAIZ,PH,4806,2400,2406,1072,1029
S02002254,Lochwinnoch,Middle Super Output Areas and Intermediate Zones,MSOAIZ,PA,2769,1352,1417,648,695
S02002255,Renfrewshire Rural South and Howwood,Middle Super Output Areas and Intermediate Zones,MSOAIZ,PA,3768,1789,1979,880,984
S02002256,Renfrewshire Rural North and Langbank,Middle Super Output Areas and Intermediate Zones,MSOAIZ,PA,3722,1902,1820,812,855
S02002257,Kilbarchan,Middle Super Output Areas and Intermediate Zones,MSOAIZ,PA,3394,1665,1729,783,783
S02002258,Johnstone South West,Middle Super Output Areas and Intermediate Zones,MSOAIZ,PA,5411,2592,2819,1257,1394
S02002259,Johnstone North West,Middle Super Output Areas and Intermediate Zones,MSOAIZ,PA,3573,1726,1847,903,901
S02002260,Johnstone North East,Middle Super Output Areas and Intermediate Zones,MSOAIZ,PA,3877,1799,2078,911,1030
S02002261,Johnstone South East,Middle Super Output Areas and Intermediate Zones,MSOAIZ,PA,4260,2052,2208,1031,1097
S02002262,Elderslie and Phoenix,Middle Super Output Areas and Intermediate Zones,MSOAIZ,PA,5060,2424,2636,1162,1259
S02002263,Paisley Ferguslie,Middle Super Output Areas and Intermediate Zones,MSOAIZ,PA,4227,1929,2298,1057,1333
S02002264,Paisley North West,Middle Super Output Areas and Intermediate Zones,MSOAIZ,PA,3579,1800,1779,1114,1022
S02002265,Paisley West,Middle Super Output Areas and Intermediate Zones,MSOAIZ,PA,5615,2584,3031,1429,1630
S02002266,Paisley Foxbar,Middle Super Output Areas and Intermediate Zones,MSOAIZ,PA,4998,2363,2635,1247,1298
S02002267,Paisley South West,Middle Super Output Areas and Intermediate Zones,MSOAIZ,PA,4850,2351,2499,1122,1176
S02002268,Paisley Glenburn West,Middle Super Output Areas and Intermediate Zones,MSOAIZ,PA,4184,1972,2212,953,1071
S02002269,Paisley Glenburn East,Middle Super Output Areas and Intermediate Zones,MSOAIZ,PA,3470,1608,1862,819,948
S02002270,Paisley South,Middle Super Output Areas and Intermediate Zones,MSOAIZ,PA,3843,1855,1988,965,1021
S02002271,Paisley South East,Middle Super Output Areas and Intermediate Zones,MSOAIZ,PA,5791,2661,3130,1391,1476
S02002272,Paisley Dykebar,Middle Super Output Areas and Intermediate Zones,MSOAIZ,PA,3476,1690,1786,813,908
S02002273,Paisley East,Middle Super Output Areas and Intermediate Zones,MSOAIZ,PA,4111,1932,2179,1034,1131
S02002274,Paisley Central,Middle Super Output Areas and Intermediate Zones,MSOAIZ,PA,6584,3381,3203,2262,1971
S02002275,Paisley North East,Middle Super Output Areas and Intermediate Zones,MSOAIZ,PA,5930,2883,3047,1615,1521
S02002276,Paisley Ralston,Middle Super Output Areas and Intermediate Zones,MSOAIZ,PA,4904,2376,2528,1034,1077
S02002277,Paisley Gallowhill and Hillington,Middle Super Output Areas and Intermediate Zones,MSOAIZ,PA,5625,2599,3026,1313,1504
S02002278,Paisley North,Middle Super Output Areas and Intermediate Zones,MSOAIZ,PA,4603,2342,2261,1407,1333
S02002279,Renfrew West,Middle Super Output Areas and Intermediate Zones,MSOAIZ,PA,6750,3124,3626,1692,1960
S02002280,Renfrew South,Middle Super Output Areas and Intermediate Zones,MSOAIZ,PA,5128,2388,2740,1072,1132
S02002281,Renfrew East,Middle Super Output Areas and Intermediate Zones,MSOAIZ,PA,5626,2692,2934,1331,1388
S02002282,Renfrew North,Middle Super Output Areas and Intermediate Zones,MSOAIZ,PA,4350,2198,2152,1327,1256
S02002283,Erskine East and Inchinnan,Middle Super Output Areas and Intermediate Zones,MSOAIZ,PA,5893,2877,3016,1501,1584
S02002284,Erskine Central,Middle Super Output Areas and Intermediate Zones,MSOAIZ,PA,5176,2451,2725,1134,1259
S02002285,Erskine West,Middle Super Output Areas and Intermediate Zones,MSOAIZ,PA,5820,2830,2990,1435,1438
S02002286,Bishopton,Middle Super Output Areas and Intermediate Zones,MSOAIZ,PA,4708,2349,2359,1114,1072
S02002287,Linwood South,Middle Super Output Areas and Intermediate Zones,MSOAIZ,PA,3939,1820,2119,903,992
S02002288,Linwood North,Middle Super Output Areas and Intermediate Zones,MSOAIZ,PA,4652,2233,2419,1118,1205
S02002289,Houston South,Middle Super Output Areas and Intermediate Zones,MSOAIZ,PA,3294,1609,1685,815,886
S02002290,Houston North,Middle Super Output Areas and Intermediate Zones,MSOAIZ,PA,3102,1523,1579,689,758
S02002291,Bridge of Weir,Middle Super Output Areas and Intermediate Zones,MSOAIZ,PA,4846,2388,2458,1041,1100
S02002292,Tweeddale West Area,Middle Super Output Areas and Intermediate Zones,MSOAIZ,ML,5615,2761,2854,1207,1310
S02002293,Peebles North,Middle Super Output Areas and Intermediate Zones,MSOAIZ,EH,4331,2048,2283,975,1015
S02002294,Peebles South,Middle Super Output Areas and Intermediate Zones,MSOAIZ,EH,4045,1942,2103,775,866
S02002295,Tweeddale East Area,Middle Super Output Areas and Intermediate Zones,MSOAIZ,TD,5411,2668,2743,1196,1261
S02002296,Earlston Stow and Clovernfords Area,Middle Super Output Areas and Intermediate Zones,MSOAIZ,TD,4844,2383,2461,1077,1116
S02002297,Galashiels North,Middle Super Output Areas and Intermediate Zones,MSOAIZ,TD,3730,1828,1902,1016,1056
S02002298,Galashiels West,Middle Super Output Areas and Intermediate Zones,MSOAIZ,TD,3130,1512,1618,828,861
S02002299,Galashiels South,Middle Super Output Areas and Intermediate Zones,MSOAIZ,TD,3309,1522,1787,671,829
S02002300,Langlee,Middle Super Output Areas and Intermediate Zones,MSOAIZ,TD,2798,1369,1429,704,744
S02002301,Melrose and Tweedbank Area,Middle Super Output Areas and Intermediate Zones,MSOAIZ,TD,5266,2473,2793,1072,1245
S02002302,Lauder and Area,Middle Super Output Areas and Intermediate Zones,MSOAIZ,TD,2909,1433,1476,656,701
S02002303,Berwickshire Central,Middle Super Output Areas and Intermediate Zones,MSOAIZ,TD,4067,2051,2016,928,885
S02002304,Duns,Middle Super Output Areas and Intermediate Zones,MSOAIZ,TD,2753,1357,1396,618,586
S02002305,Berwickshire East,Middle Super Output Areas and Intermediate Zones,MSOAIZ,TD,3758,1848,1910,810,800
S02002306,Eyemouth,Middle Super Output Areas and Intermediate Zones,MSOAIZ,TD,3546,1691,1855,759,795
S02002307,Chirnside and Area,Middle Super Output Areas and Intermediate Zones,MSOAIZ,TD,4079,2004,2075,903,901
S02002308,Coldstream and Area,Middle Super Output Areas and Intermediate Zones,MSOAIZ,TD,2752,1320,1432,521,538
S02002309,Cheviot East,Middle Super Output Areas and Intermediate Zones,MSOAIZ,TD,4578,2222,2356,910,963
S02002310,Kelso North,Middle Super Output Areas and Intermediate Zones,MSOAIZ,TD,3308,1539,1769,690,736
S02002311,Kelso South,Middle Super Output Areas and Intermediate Zones,MSOAIZ,TD,2331,1075,1256,453,511
S02002312,Cheviot West,Middle Super Output Areas and Intermediate Zones,MSOAIZ,TD,2855,1407,1448,599,634
S02002313,St Boswells and Newtown Area,Middle Super Output Areas and Intermediate Zones,MSOAIZ,TD,3604,1749,1855,768,799
S02002314,Jedburgh,Middle Super Output Areas and Intermediate Zones,MSOAIZ,TD,4030,1895,2135,891,931
S02002315,Denholm and Hermitage,Middle Super Output Areas and Intermediate Zones,MSOAIZ,TD,3923,1934,1989,801,804
S02002316,Burnfoot,Middle Super Output Areas and Intermediate Zones,MSOAIZ,TD,3068,1451,1617,677,764
S02002317,Hawick Central,Middle Super Output Areas and Intermediate Zones,MSOAIZ,TD,4333,2147,2186,1030,995
S02002318,Hawick West End,Middle Super Output Areas and Intermediate Zones,MSOAIZ,TD,3372,1627,1745,731,745
S02002319,Hawick North,Middle Super Output Areas and Intermediate Zones,MSOAIZ,TD,3580,1716,1864,832,856
S02002320,Ettrick Yarrow and Liliesleaf Area,Middle Super Output Areas and Intermediate Zones,MSOAIZ,TD,2761,1374,1387,596,598
S02002321,Selkirk,Middle Super Output Areas and Intermediate Zones,MSOAIZ,TD,5784,2814,2970,1268,1293
S02002322,Shetland South,Middle Super Output Areas and Intermediate Zones,MSOAIZ,ZE,3291,1672,1619,785,770
S02002323,Lerwick South,Middle Super Output Areas and Intermediate Zones,MSOAIZ,ZE,3475,1747,1728,817,844
S02002324,Lerwick North,Middle Super Output Areas and Intermediate Zones,MSOAIZ,ZE,4965,2532,2433,1347,1180
S02002325,Central Shetland,Middle Super Output Areas and Intermediate Zones,MSOAIZ,ZE,3195,1617,1578,834,798
S02002326,East and West Mainland,Middle Super Output Areas and Intermediate Zones,MSOAIZ,ZE,2789,1395,1394,658,625
S02002327,North Mainland,Middle Super Output Areas and Intermediate Zones,MSOAIZ,ZE,2658,1389,1269,676,642
S02002328,North and East Isles,Middle Super Output Areas and Intermediate Zones,MSOAIZ,ZE,2794,1409,1385,614,550
S02002329,Carrick South,Middle Super Output Areas and Intermediate Zones,MSOAIZ,KA,5501,2750,2751,1139,1178
S02002330,Girvan Glendoune,Middle Super Output Areas and Intermediate Zones,MSOAIZ,KA,3405,1588,1817,698,819
S02002331,Girvan Ailsa,Middle Super Output Areas and Intermediate Zones,MSOAIZ,KA,3246,1529,1717,634,680
S02002332,Maybole,Middle Super Output Areas and Intermediate Zones,MSOAIZ,KA,4846,2310,2536,1115,1212
S02002333,Carrick North,Middle Super Output Areas and Intermediate Zones,MSOAIZ,KA,4001,1976,2025,902,926
S02002334,Coylton,Middle Super Output Areas and Intermediate Zones,MSOAIZ,KA,3709,1802,1907,874,956
S02002335,Alloway and Doonfoot,Middle Super Output Areas and Intermediate Zones,MSOAIZ,KA,6075,2893,3182,997,1069
S02002336,Castlehill and Kincaidston,Middle Super Output Areas and Intermediate Zones,MSOAIZ,KA,4487,2119,2368,1014,1144
S02002337,Belmont,Middle Super Output Areas and Intermediate Zones,MSOAIZ,KA,5553,2572,2981,1064,1190
S02002338,Holmston and Forehill,Middle Super Output Areas and Intermediate Zones,MSOAIZ,KA,5041,2405,2636,1079,1178
S02002339,Ayr South Harbour and Town Centre,Middle Super Output Areas and Intermediate Zones,MSOAIZ,KA,5359,2510,2849,1240,1171
S02002340,Ayr North Harbour; Wallacetown and Newton South,Middle Super Output Areas and Intermediate Zones,MSOAIZ,KA,4757,2342,2415,1324,1308
S02002341,Craigie,Middle Super Output Areas and Intermediate Zones,MSOAIZ,KA,2627,1282,1345,580,603
S02002342,Dalmilling,Middle Super Output Areas and Intermediate Zones,MSOAIZ,KA,2884,1320,1564,628,747
S02002343,Lochside; Braehead and Whitletts,Middle Super Output Areas and Intermediate Zones,MSOAIZ,KA,4211,1968,2243,951,1187
S02002344,Newton North,Middle Super Output Areas and Intermediate Zones,MSOAIZ,KA,4247,1984,2263,998,1067
S02002345,Heathfield,Middle Super Output Areas and Intermediate Zones,MSOAIZ,KA,4353,2060,2293,1050,1211
S02002346,Prestwick West,Middle Super Output Areas and Intermediate Zones,MSOAIZ,KA,4145,1988,2157,907,867
S02002347,Prestwick East,Middle Super Output Areas and Intermediate Zones,MSOAIZ,KA,5417,2519,2898,1115,1173
S02002348,Prestwick Airport and Monkton,Middle Super Output Areas and Intermediate Zones,MSOAIZ,KA,2710,1286,1424,646,633
S02002349,Annbank; Mossblown and Tarbolton - the Coalfields,Middle Super Output Areas and Intermediate Zones,MSOAIZ,KA,5962,2887,3075,1395,1525
S02002350,Dundonald; Loans and Symington,Middle Super Output Areas and Intermediate Zones,MSOAIZ,KA,5341,2546,2795,1120,1256
S02002351,Muirhead,Middle Super Output Areas and Intermediate Zones,MSOAIZ,KA,5472,2644,2828,1232,1344
S02002352,Barassie,Middle Super Output Areas and Intermediate Zones,MSOAIZ,KA,4046,1916,2130,879,931
S02002353,Troon,Middle Super Output Areas and Intermediate Zones,MSOAIZ,KA,5404,2536,2868,1057,1124
S02002354,Clydesdale South,Middle Super Output Areas and Intermediate Zones,MSOAIZ,ML,2623,1335,1288,642,616
S02002355,Biggar; Symington; Thankerton and Dolphinton,Middle Super Output Areas and Intermediate Zones,MSOAIZ,ML,5552,2647,2905,1162,1270
S02002356,Carstairs; Carstairs Junction and Carnwath,Middle Super Output Areas and Intermediate Zones,MSOAIZ,ML,4872,2454,2418,1345,1184
S02002357,Forth; Braehead and Auchengray,Middle Super Output Areas and Intermediate Zones,MSOAIZ,ML,3756,1843,1913,868,922
S02002358,Law,Middle Super Output Areas and Intermediate Zones,MSOAIZ,ML,3737,1823,1914,938,969
S02002359,Carluke West,Middle Super Output Areas and Intermediate Zones,MSOAIZ,ML,2910,1448,1462,713,716
S02002360,Carluke North,Middle Super Output Areas and Intermediate Zones,MSOAIZ,ML,2417,1130,1287,539,580
S02002361,Carluke East,Middle Super Output Areas and Intermediate Zones,MSOAIZ,ML,4103,1968,2135,1044,1115
S02002362,Carluke South,Middle Super Output Areas and Intermediate Zones,MSOAIZ,ML,3260,1572,1688,758,799
S02002363,Crossford; Braidwood and Yieldshields,Middle Super Output Areas and Intermediate Zones,MSOAIZ,ML,2576,1247,1329,569,616
S02002364,Lanark North West,Middle Super Output Areas and Intermediate Zones,MSOAIZ,ML,2602,1252,1350,553,559
S02002365,Lanark North East,Middle Super Output Areas and Intermediate Zones,MSOAIZ,ML,2366,1110,1256,583,585
S02002366,Lanark South,Middle Super Output Areas and Intermediate Zones,MSOAIZ,ML,3779,1809,1970,892,903
S02002367,Hazelbank and Kirkfieldbank,Middle Super Output Areas and Intermediate Zones,MSOAIZ,ML,3788,1892,1896,887,893
S02002368,Douglas; Coalburn and Rigside,Middle Super Output Areas and Intermediate Zones,MSOAIZ,ML,4613,2203,2410,1031,1070
S02002369,Lesmahagow,Middle Super Output Areas and Intermediate Zones,MSOAIZ,ML,3780,1748,2032,833,931
S02002370,Kirkmuirhill and Blackwood,Middle Super Output Areas and Intermediate Zones,MSOAIZ,ML,4242,2068,2174,1081,1106
S02002371,Ashgill and Netherburn,Middle Super Output Areas and Intermediate Zones,MSOAIZ,ML,2784,1348,1436,671,701
S02002372,Merryton and Meadowhill,Middle Super Output Areas and Intermediate Zones,MSOAIZ,ML,3367,1548,1819,796,891
S02002373,Larkhall Central; Raploch; Millheugh and Burnhead,Middle Super Output Areas and Intermediate Zones,MSOAIZ,ML,3823,1809,2014,892,946
S02002374,Hareleeshill,Middle Super Output Areas and Intermediate Zones,MSOAIZ,ML,4126,1927,2199,901,1037
S02002375,Strutherhill,Middle Super Output Areas and Intermediate Zones,MSOAIZ,ML,3583,1705,1878,837,944
S02002376,Stonehouse,Middle Super Output Areas and Intermediate Zones,MSOAIZ,ML,5713,2755,2958,1329,1425
S02002377,Strathaven South,Middle Super Output Areas and Intermediate Zones,MSOAIZ,ML,4649,2257,2392,1058,1083
S02002378,Strathaven North,Middle Super Output Areas and Intermediate Zones,MSOAIZ,ML,2901,1419,1482,630,705
S02002379,Chapelton; Glengavel and Sandford,Middle Super Output Areas and Intermediate Zones,MSOAIZ,ML,2948,1550,1398,812,648
S02002380,Glassford; Quarter and Allanton,Middle Super Output Areas and Intermediate Zones,MSOAIZ,ML,3018,1423,1595,684,764
S02002381,Eddlewood,Middle Super Output Areas and Intermediate Zones,MSOAIZ,ML,3743,1826,1917,957,1025
S02002382,Low Waters,Middle Super Output Areas and Intermediate Zones,MSOAIZ,ML,2751,1328,1423,658,664
S02002383,Silvertonhill,Middle Super Output Areas and Intermediate Zones,MSOAIZ,ML,2878,1379,1499,627,617
S02002384,Hamilton Centre and Low Parks,Middle Super Output Areas and Intermediate Zones,MSOAIZ,ML,4060,1984,2076,1061,983
S02002385,Laighstonehall,Middle Super Output Areas and Intermediate Zones,MSOAIZ,ML,3683,1794,1889,948,933
S02002386,Fairhill,Middle Super Output Areas and Intermediate Zones,MSOAIZ,ML,2163,985,1178,484,562
S02002387,Woodhead and Meikle Earnock,Middle Super Output Areas and Intermediate Zones,MSOAIZ,ML,2868,1359,1509,668,763
S02002388,Little Earnock,Middle Super Output Areas and Intermediate Zones,MSOAIZ,ML,6305,3061,3244,1756,1820
S02002389,Earnock,Middle Super Output Areas and Intermediate Zones,MSOAIZ,ML,3976,1942,2034,1014,1060
S02002390,Hillhouse,Middle Super Output Areas and Intermediate Zones,MSOAIZ,ML,4141,2006,2135,1045,1083
S02002391,High Blantyre,Middle Super Output Areas and Intermediate Zones,MSOAIZ,G,3955,1843,2112,879,1007
S02002392,Blantyre South and Wheatlands,Middle Super Output Areas and Intermediate Zones,MSOAIZ,G,4358,2071,2287,1043,1142
S02002393,Low Blantyre and Bardykes,Middle Super Output Areas and Intermediate Zones,MSOAIZ,G,3388,1660,1728,806,867
S02002394,Blantytre North and Coatshill,Middle Super Output Areas and Intermediate Zones,MSOAIZ,G,3082,1456,1626,727,784
S02002395,Burnbank North,Middle Super Output Areas and Intermediate Zones,MSOAIZ,ML,4896,2301,2595,1305,1437
S02002396,Burnbank Central and Udston,Middle Super Output Areas and Intermediate Zones,MSOAIZ,ML,4687,2280,2407,1254,1319
S02002397,Burnbank South and Chantinghall,Middle Super Output Areas and Intermediate Zones,MSOAIZ,ML,3641,1741,1900,861,906
S02002398,Whitehill,Middle Super Output Areas and Intermediate Zones,MSOAIZ,ML,3886,1934,1952,1067,1051
S02002399,Bothwell South,Middle Super Output Areas and Intermediate Zones,MSOAIZ,G,3430,1649,1781,768,788
S02002400,Bothwell North,Middle Super Output Areas and Intermediate Zones,MSOAIZ,G,3085,1425,1660,727,804
S02002401,Uddingston and Gardenside,Middle Super Output Areas and Intermediate Zones,MSOAIZ,G,5482,2607,2875,1308,1350
S02002402,Halfway; Hallside and Drumsagard,Middle Super Output Areas and Intermediate Zones,MSOAIZ,G,5459,2661,2798,1496,1621
S02002403,Westburn and Newton,Middle Super Output Areas and Intermediate Zones,MSOAIZ,G,6002,2955,3047,1658,1776
S02002404,Vicarland and Cairns,Middle Super Output Areas and Intermediate Zones,MSOAIZ,G,4132,1953,2179,917,1017
S02002405,Whitlawburn and Greenlees,Middle Super Output Areas and Intermediate Zones,MSOAIZ,G,4881,2400,2481,1333,1400
S02002406,Cambuslang Central,Middle Super Output Areas and Intermediate Zones,MSOAIZ,G,3834,1846,1988,856,920
S02002407,Burgh; Eastfield and Silverbank,Middle Super Output Areas and Intermediate Zones,MSOAIZ,G,5876,2801,3075,1437,1530
S02002408,Farme Cross and Gallowflat North,Middle Super Output Areas and Intermediate Zones,MSOAIZ,G,3236,1519,1717,856,820
S02002409,Shawfield and Clincarthill,Middle Super Output Areas and Intermediate Zones,MSOAIZ,G,3738,1774,1964,959,954
S02002410,Burnhill and Bankhead North,Middle Super Output Areas and Intermediate Zones,MSOAIZ,G,3348,1590,1758,793,843
S02002411,Bankhead South,Middle Super Output Areas and Intermediate Zones,MSOAIZ,G,3257,1563,1694,790,883
S02002412,Spittal,Middle Super Output Areas and Intermediate Zones,MSOAIZ,G,2878,1313,1565,662,729
S02002413,High Crosshill,Middle Super Output Areas and Intermediate Zones,MSOAIZ,G,3412,1574,1838,772,836
S02002414,Burnside and Springhall,Middle Super Output Areas and Intermediate Zones,MSOAIZ,G,4540,2148,2392,988,1075
S02002415,Fernhill and Cathkin,Middle Super Output Areas and Intermediate Zones,MSOAIZ,G,3993,1837,2156,921,1069
S02002416,Nerston and EK Landward Area,Middle Super Output Areas and Intermediate Zones,MSOAIZ,G,4611,2269,2342,1155,1174
S02002417,Calderwood East,Middle Super Output Areas and Intermediate Zones,MSOAIZ,G,3686,1749,1937,959,1050
S02002418,Calderwood Central,Middle Super Output Areas and Intermediate Zones,MSOAIZ,G,3946,1870,2076,977,957
S02002419,Calderwood West and Nerston,Middle Super Output Areas and Intermediate Zones,MSOAIZ,G,4191,2018,2173,1057,1048
S02002420,St Leonards North,Middle Super Output Areas and Intermediate Zones,MSOAIZ,G,4608,2248,2360,1104,1108
S02002421,St Leonards South,Middle Super Output Areas and Intermediate Zones,MSOAIZ,G,4716,2323,2393,1192,1179
S02002422,East Mains,Middle Super Output Areas and Intermediate Zones,MSOAIZ,G,3061,1459,1602,757,714
S02002423,West Mains,Middle Super Output Areas and Intermediate Zones,MSOAIZ,G,3013,1450,1563,703,737
S02002424,Stewartfield East,Middle Super Output Areas and Intermediate Zones,MSOAIZ,G,2829,1388,1441,692,714
S02002425,Stewartfield West,Middle Super Output Areas and Intermediate Zones,MSOAIZ,G,4127,1985,2142,1003,1099
S02002426,Thorntonhall; Jackton and Gardenhall,Middle Super Output Areas and Intermediate Zones,MSOAIZ,G,3767,1885,1882,995,1001
S02002427,Hairmyres and Westwood West,Middle Super Output Areas and Intermediate Zones,MSOAIZ,G,3738,1849,1889,949,913
S02002428,Mossneuk and Newlandsmuir,Middle Super Output Areas and Intermediate Zones,MSOAIZ,G,2846,1366,1480,714,814
S02002429,Crosshouse and Lindsayfield,Middle Super Output Areas and Intermediate Zones,MSOAIZ,G,4793,2285,2508,1201,1246
S02002430,Whitehills West,Middle Super Output Areas and Intermediate Zones,MSOAIZ,G,4021,1915,2106,939,1022
S02002431,Greenhills,Middle Super Output Areas and Intermediate Zones,MSOAIZ,G,3336,1607,1729,798,837
S02002432,Westwood South,Middle Super Output Areas and Intermediate Zones,MSOAIZ,G,4392,2096,2296,1113,1183
S02002433,Westwood East,Middle Super Output Areas and Intermediate Zones,MSOAIZ,G,3324,1553,1771,811,832
S02002434,The Murray,Middle Super Output Areas and Intermediate Zones,MSOAIZ,G,3784,1733,2051,909,960
S02002435,Birniehill; Kelvin and Whitehills East,Middle Super Output Areas and Intermediate Zones,MSOAIZ,G,4109,1955,2154,1075,1166
S02002436,Blane Valley,Middle Super Output Areas and Intermediate Zones,MSOAIZ,G,5281,2528,2753,1007,1109
S02002437,Balfron and Drymen,Middle Super Output Areas and Intermediate Zones,MSOAIZ,G,4060,1915,2145,812,950
S02002438,Kippen and Fintry,Middle Super Output Areas and Intermediate Zones,MSOAIZ,G,3169,1528,1641,642,712
S02002439,Cambusbarron,Middle Super Output Areas and Intermediate Zones,MSOAIZ,FK,3642,1748,1894,806,892
S02002440,Plean and Rural SE,Middle Super Output Areas and Intermediate Zones,MSOAIZ,FK,3029,1464,1565,714,794
S02002441,Cowie,Middle Super Output Areas and Intermediate Zones,MSOAIZ,FK,2649,1289,1360,681,723
S02002442,Fallin,Middle Super Output Areas and Intermediate Zones,MSOAIZ,FK,2832,1341,1491,699,812
S02002443,Bannockburn,Middle Super Output Areas and Intermediate Zones,MSOAIZ,FK,3494,1662,1832,875,876
S02002444,Hillpark,Middle Super Output Areas and Intermediate Zones,MSOAIZ,FK,3550,1710,1840,880,957
S02002445,Broomridge,Middle Super Output Areas and Intermediate Zones,MSOAIZ,FK,5541,2681,2860,1408,1504
S02002446,Borestone,Middle Super Output Areas and Intermediate Zones,MSOAIZ,FK,3751,1781,1970,906,1027
S02002447,King's Park and Torbrex,Middle Super Output Areas and Intermediate Zones,MSOAIZ,FK,3784,1803,1981,737,759
S02002448,Braehead,Middle Super Output Areas and Intermediate Zones,MSOAIZ,FK,2458,1196,1262,657,631
S02002449,City Centre,Middle Super Output Areas and Intermediate Zones,MSOAIZ,FK,3938,1904,2034,1506,1635
S02002450,Raploch,Middle Super Output Areas and Intermediate Zones,MSOAIZ,FK,2895,1359,1536,710,810
S02002451,Cornton,Middle Super Output Areas and Intermediate Zones,MSOAIZ,FK,3397,1496,1901,855,1185
S02002452,Causewayhead,Middle Super Output Areas and Intermediate Zones,MSOAIZ,FK,2344,1149,1195,552,574
S02002453,Bridge of Allan and University,Middle Super Output Areas and Intermediate Zones,MSOAIZ,FK,7147,3354,3793,1979,2255
S02002454,Forth,Middle Super Output Areas and Intermediate Zones,MSOAIZ,FK,2650,1307,1343,843,809
S02002455,Dunblane East,Middle Super Output Areas and Intermediate Zones,MSOAIZ,FK,5089,2450,2639,990,1106
S02002456,Dunblane West,Middle Super Output Areas and Intermediate Zones,MSOAIZ,FK,4344,2064,2280,888,981
S02002457,Carse of Stirling,Middle Super Output Areas and Intermediate Zones,MSOAIZ,FK,4218,2140,2078,955,915
S02002458,Callander and Trossachs,Middle Super Output Areas and Intermediate Zones,MSOAIZ,FK,3666,1746,1920,777,811
S02002459,Highland,Middle Super Output Areas and Intermediate Zones,MSOAIZ,G,3319,1625,1694,781,811
S02002460,IZ01,Middle Super Output Areas and Intermediate Zones,MSOAIZ,G,4485,2111,2374,1064,1225
S02002461,IZ02,Middle Super Output Areas and Intermediate Zones,MSOAIZ,G,4641,2142,2499,1182,1387
S02002462,IZ03,Middle Super Output Areas and Intermediate Zones,MSOAIZ,G,5682,2700,2982,1301,1446
S02002463,IZ04,Middle Super Output Areas and Intermediate Zones,MSOAIZ,G,4416,2049,2367,1004,1036
S02002464,IZ05,Middle Super Output Areas and Intermediate Zones,MSOAIZ,G,3722,1735,1987,854,948
S02002465,IZ06,Middle Super Output Areas and Intermediate Zones,MSOAIZ,G,5535,2539,2996,1303,1574
S02002466,IZ07,Middle Super Output Areas and Intermediate Zones,MSOAIZ,G,4567,2196,2371,1068,1120
S02002467,IZ08,Middle Super Output Areas and Intermediate Zones,MSOAIZ,G,5575,2759,2816,1362,1355
S02002468,IZ09,Middle Super Output Areas and Intermediate Zones,MSOAIZ,G,5281,2545,2736,1316,1405
S02002469,IZ10,Middle Super Output Areas and Intermediate Zones,MSOAIZ,G,4237,2061,2176,1041,1081
S02002470,IZ11,Middle Super Output Areas and Intermediate Zones,MSOAIZ,G,5188,2458,2730,1300,1450
S02002471,IZ12,Middle Super Output Areas and Intermediate Zones,MSOAIZ,G,6221,2990,3231,1650,1637
S02002472,IZ13,Middle Super Output Areas and Intermediate Zones,MSOAIZ,G,5715,2723,2992,1375,1479
S02002473,IZ14,Middle Super Output Areas and Intermediate Zones,MSOAIZ,G,5117,2474,2643,1289,1375
S02002474,IZ15,Middle Super Output Areas and Intermediate Zones,MSOAIZ,G,5798,2784,3014,1406,1599
S02002475,IZ16,Middle Super Output Areas and Intermediate Zones,MSOAIZ,G,3966,1879,2087,977,1045
S02002476,IZ17,Middle Super Output Areas and Intermediate Zones,MSOAIZ,G,6145,2939,3206,1462,1542
S02002477,IZ18,Middle Super Output Areas and Intermediate Zones,MSOAIZ,G,4429,2099,2330,1092,1153
S02002478,Fauldhouse,Middle Super Output Areas and Intermediate Zones,MSOAIZ,EH,4843,2356,2487,1190,1260
S02002479,Breich Valley,Middle Super Output Areas and Intermediate Zones,MSOAIZ,ML,5021,2752,2269,1599,1108
S02002480,West Calder and Polbeth,Middle Super Output Areas and Intermediate Zones,MSOAIZ,EH,5505,2652,2853,1249,1385
S02002481,Bellsquarry; Adambrae and Kirkton,Middle Super Output Areas and Intermediate Zones,MSOAIZ,EH,4686,2281,2405,1209,1295
S02002482,Bankton and Murieston,Middle Super Output Areas and Intermediate Zones,MSOAIZ,EH,5273,2654,2619,1379,1356
S02002483,Dedridge East,Middle Super Output Areas and Intermediate Zones,MSOAIZ,EH,5525,2631,2894,1390,1493
S02002484,Mid Calder and Kirknewton,Middle Super Output Areas and Intermediate Zones,MSOAIZ,EH,5815,2829,2986,1487,1604
S02002485,East Calder,Middle Super Output Areas and Intermediate Zones,MSOAIZ,EH,4999,2422,2577,1262,1303
S02002486,Pumpherston and Uphall Station,Middle Super Output Areas and Intermediate Zones,MSOAIZ,EH,2671,1304,1367,648,710
S02002487,Craigshill,Middle Super Output Areas and Intermediate Zones,MSOAIZ,EH,5738,2838,2900,1563,1549
S02002488,Howden,Middle Super Output Areas and Intermediate Zones,MSOAIZ,EH,4493,2142,2351,1139,1186
S02002489,Livingston Village and Eliburn South,Middle Super Output Areas and Intermediate Zones,MSOAIZ,EH,5201,2575,2626,1365,1388
S02002490,Ladywell,Middle Super Output Areas and Intermediate Zones,MSOAIZ,EH,4939,2354,2585,1223,1389
S02002491,Knightsridge,Middle Super Output Areas and Intermediate Zones,MSOAIZ,EH,5673,2800,2873,1583,1628
S02002492,Knightsridge and Deans North,Middle Super Output Areas and Intermediate Zones,MSOAIZ,EH,3825,1922,1903,993,976
S02002493,Deans,Middle Super Output Areas and Intermediate Zones,MSOAIZ,EH,2881,1417,1464,728,709
S02002494,Carmondean and Eliburn North,Middle Super Output Areas and Intermediate Zones,MSOAIZ,EH,5848,2843,3005,1618,1686
S02002495,Seafield,Middle Super Output Areas and Intermediate Zones,MSOAIZ,EH,2134,1049,1085,496,548
S02002496,Blackburn,Middle Super Output Areas and Intermediate Zones,MSOAIZ,EH,4743,2226,2517,1110,1221
S02002497,Blaeberry Hill and East Whitburn,Middle Super Output Areas and Intermediate Zones,MSOAIZ,EH,6107,2951,3156,1480,1550
S02002498,Whitburn Central,Middle Super Output Areas and Intermediate Zones,MSOAIZ,EH,4918,2336,2582,1128,1215
S02002499,Whitburn; Croftmalloch and Greenrigg,Middle Super Output Areas and Intermediate Zones,MSOAIZ,ML,2994,1468,1526,745,720
S02002500,Armadale,Middle Super Output Areas and Intermediate Zones,MSOAIZ,EH,5794,2790,3004,1338,1386
S02002501,Armadale South,Middle Super Output Areas and Intermediate Zones,MSOAIZ,EH,6135,3022,3113,1693,1741
S02002502,Bathgate; Wester Inch and Inchcross,Middle Super Output Areas and Intermediate Zones,MSOAIZ,EH,3983,1959,2024,1260,1308
S02002503,Bathgate and Boghall,Middle Super Output Areas and Intermediate Zones,MSOAIZ,EH,4221,2016,2205,1061,1155
S02002504,Bathgate East,Middle Super Output Areas and Intermediate Zones,MSOAIZ,EH,6330,3091,3239,1650,1666
S02002505,Bathgate West,Middle Super Output Areas and Intermediate Zones,MSOAIZ,EH,6062,2963,3099,1560,1637
S02002506,Blackridge; Westfield and Torphichen,Middle Super Output Areas and Intermediate Zones,MSOAIZ,FK,3531,1713,1818,852,906
S02002507,Linlithgow South,Middle Super Output Areas and Intermediate Zones,MSOAIZ,EH,5996,2970,3026,1368,1440
S02002508,Linlithgow Bridge,Middle Super Output Areas and Intermediate Zones,MSOAIZ,EH,4423,2118,2305,1054,1091
S02002509,Linlithgow North,Middle Super Output Areas and Intermediate Zones,MSOAIZ,EH,3676,1816,1860,873,905
S02002510,Winchburgh; Bridgend and Philpstoun,Middle Super Output Areas and Intermediate Zones,MSOAIZ,EH,4477,2210,2267,1108,1122
S02002511,Broxburn Kirkhill,Middle Super Output Areas and Intermediate Zones,MSOAIZ,EH,4204,2063,2141,1100,1159
S02002512,Uphall; Dechmont and Ecclesmachan,Middle Super Output Areas and Intermediate Zones,MSOAIZ,EH,5873,2799,3074,1351,1470
S02002513,Broxburn South,Middle Super Output Areas and Intermediate Zones,MSOAIZ,EH,3813,1893,1920,998,1023
S02002514,Broxburn East,Middle Super Output Areas and Intermediate Zones,MSOAIZ,EH,2768,1331,1437,693,696