GEO_CODE,GEO_LABEL,GEO_TYPE,GEO_TYP2,Postcode_Area,Total\ Tenure - Unit : Persons,Total\ Tenure - Unit : Households,Owned - Unit : Persons,Owned - Unit : Households,Owned\ Owned outright - Unit : Persons,Owned\ Owned outright - Unit : Households,Owned\ Owned with a mortgage or loan - Unit : Persons,Owned\ Owned with a mortgage or loan - Unit : Households,Shared ownership (part owned and part rented) - Unit : Persons,Shared ownership (part owned and part rented) - Unit : Households,Social rented - Unit : Persons,Social rented - Unit : Households,Social rented\ Rented from council (Local Authority) - Unit : Persons,Social rented\ Rented from council (Local Authority) - Unit : Households,Social rented\ Other social rented - Unit : Persons,Social rented\ Other social rented - Unit : Households,Social rented\ Other - Unit : Households,Rented\ Rented from council (Local Authority) - Unit : Households,Rented\ Other social rented - Unit : Households,Rented\ Private landlord or letting agency - Unit : Households,Private rented - Unit : Persons,Private rented - Unit : Households,Private rented\ Private landlord or letting agency - Unit : Persons,Private rented\ Private landlord or letting agency - Unit : Households,Private rented\ Employer of a household member - Unit : Persons,Private rented\ Employer of a household member - Unit : Households,Private rented\ Relative or friend of household member - Unit : Persons,Private rented\ Relative or friend of household member - Unit : Households,Private rented\ Other - Unit : Persons,Private rented\ Other - Unit : Households,Private rented\ Other than private landlord or letting agency - Unit : Households,Living rent-free - Unit : Persons,Living rent-free - Unit : Households
E02000001,City of London 001,Middle Super Output Areas and Intermediate Zones,MSOAIZ,WC,7187,4385,3023,1855,1666,1093,1357,762,27,13,1344,725,773,458,571,267,267,,,,2465,1573,2263,1451,28,16,100,61,74,45,122,328,219
E02000002,Barking and Dagenham 001,Middle Super Output Areas and Intermediate Zones,MSOAIZ,RM,6724,2713,3074,1259,1075,596,1999,663,42,18,2793,1133,2099,894,694,239,239,,,,743,269,718,255,0,0,25,14,0,0,14,72,34
E02000003,Barking and Dagenham 002,Middle Super Output Areas and Intermediate Zones,MSOAIZ,RM,10033,3834,6537,2501,2035,1028,4502,1473,91,34,1097,446,846,359,251,87,87,,,,2247,830,2127,788,2,1,96,35,22,6,42,61,23
E02000004,Barking and Dagenham 003,Middle Super Output Areas and Intermediate Zones,MSOAIZ,RM,5937,2318,4317,1687,1425,718,2892,969,54,16,884,371,636,268,248,103,103,,,,652,228,620,213,0,0,26,12,6,3,15,30,16
E02000005,Barking and Dagenham 004,Middle Super Output Areas and Intermediate Zones,MSOAIZ,RM,8562,3183,4958,1857,1365,711,3593,1146,52,18,1985,793,1683,702,302,91,91,,,,1505,482,1439,456,0,0,50,20,16,6,26,62,33
E02000007,Barking and Dagenham 006,Middle Super Output Areas and Intermediate Zones,MSOAIZ,RM,8672,3441,3657,1379,1065,558,2592,821,75,32,3840,1663,3579,1570,261,93,93,,,,1033,333,950,305,13,3,42,18,28,7,28,67,34
E02000008,Barking and Dagenham 007,Middle Super Output Areas and Intermediate Zones,MSOAIZ,RM,11564,4591,5587,2099,1272,708,4315,1391,145,49,3948,1762,3444,1579,504,183,183,,,,1803,641,1677,589,2,1,95,39,29,12,52,81,40
E02000009,Barking and Dagenham 008,Middle Super Output Areas and Intermediate Zones,MSOAIZ,RM,8376,3212,3832,1475,943,488,2889,987,225,79,2477,982,1939,797,538,185,185,,,,1728,619,1652,589,7,1,60,22,9,7,30,114,57
E02000010,Barking and Dagenham 009,Middle Super Output Areas and Intermediate Zones,MSOAIZ,RM,8615,3292,4086,1491,836,463,3250,1028,146,62,2847,1195,2429,1039,418,156,156,,,,1484,517,1389,478,2,1,76,32,17,6,39,52,27
E02000011,Barking and Dagenham 010,Middle Super Output Areas and Intermediate Zones,MSOAIZ,RM,6086,2289,4070,1521,1367,672,2703,849,31,12,742,289,475,203,267,86,86,,,,1198,440,1141,416,8,3,46,18,3,3,24,45,27
E02000012,Barking and Dagenham 011,Middle Super Output Areas and Intermediate Zones,MSOAIZ,IG,9879,3258,7243,2254,2021,935,5222,1319,38,12,876,475,697,374,179,101,101,,,,1625,476,1556,455,4,1,49,15,16,5,21,97,41
E02000013,Barking and Dagenham 012,Middle Super Output Areas and Intermediate Zones,MSOAIZ,RM,8396,3125,3908,1439,887,479,3021,960,86,37,2977,1181,2700,1093,277,88,88,,,,1354,435,1254,402,6,2,84,28,10,3,33,71,33
E02000014,Barking and Dagenham 013,Middle Super Output Areas and Intermediate Zones,MSOAIZ,RM,9319,3531,4169,1548,1109,557,3060,991,34,16,3452,1413,2951,1211,501,202,202,,,,1604,527,1543,501,7,4,30,13,24,9,26,60,27
E02000015,Barking and Dagenham 014,Middle Super Output Areas and Intermediate Zones,MSOAIZ,RM,7549,3170,2486,980,704,369,1782,611,112,60,3596,1604,2650,1261,946,343,343,,,,1316,505,1250,483,4,2,44,14,18,6,22,39,21
E02000016,Barking and Dagenham 015,Middle Super Output Areas and Intermediate Zones,MSOAIZ,IG,7670,2934,1766,663,325,160,1441,503,84,40,2617,1038,1777,690,840,348,348,,,,3149,1172,2958,1105,12,5,102,29,77,33,67,54,21
E02000017,Barking and Dagenham 016,Middle Super Output Areas and Intermediate Zones,MSOAIZ,IG,8468,2729,4922,1552,1639,641,3283,911,60,21,621,267,456,206,165,61,61,,,,2789,860,2591,795,0,0,176,56,22,9,65,76,29
E02000018,Barking and Dagenham 017,Middle Super Output Areas and Intermediate Zones,MSOAIZ,RM,8884,3326,3528,1291,805,403,2723,888,136,44,3432,1405,2782,1163,650,242,242,,,,1745,565,1638,530,0,0,81,25,26,10,35,43,21
E02000019,Barking and Dagenham 018,Middle Super Output Areas and Intermediate Zones,MSOAIZ,RM,8234,3010,3844,1393,803,404,3041,989,168,68,2663,1045,2113,844,550,201,201,,,,1484,472,1428,453,3,1,49,16,4,2,19,75,32
E02000020,Barking and Dagenham 019,Middle Super Output Areas and Intermediate Zones,MSOAIZ,IG,9274,3460,4121,1482,1024,521,3097,961,147,53,2976,1260,2499,1050,477,210,210,,,,1955,633,1802,577,6,4,128,45,19,7,56,75,32
E02000021,Barking and Dagenham 020,Middle Super Output Areas and Intermediate Zones,MSOAIZ,RM,7798,2949,4251,1592,1160,582,3091,1010,85,44,1292,565,890,372,402,193,193,,,,2098,717,2013,687,9,3,53,18,23,9,30,72,31
E02000022,Barking and Dagenham 021,Middle Super Output Areas and Intermediate Zones,MSOAIZ,IG,8684,3261,1258,482,258,129,1000,353,300,121,5461,2061,5182,1929,279,132,132,,,,1563,563,1453,520,1,1,70,26,39,16,43,102,34
E02000023,Barking and Dagenham 022,Middle Super Output Areas and Intermediate Zones,MSOAIZ,RM,6482,2431,2037,717,409,203,1628,514,77,31,3126,1271,2868,1182,258,89,89,,,,1208,396,1146,371,0,0,58,23,4,2,25,34,16
E02000024,Barnet 001,Middle Super Output Areas and Intermediate Zones,MSOAIZ,EN,9969,4110,7691,3041,3045,1507,4646,1534,84,43,427,214,197,87,230,127,127,,,,1663,753,1589,712,14,5,44,29,16,7,41,104,59
E02000025,Barnet 002,Middle Super Output Areas and Intermediate Zones,MSOAIZ,EN,7929,3622,5142,2272,1912,1050,3230,1222,61,33,1007,512,606,276,401,236,236,,,,1642,763,1589,736,5,3,35,18,13,6,27,77,42
E02000026,Barnet 003,Middle Super Output Areas and Intermediate Zones,MSOAIZ,N,6276,2496,4711,1898,1940,951,2771,947,57,24,361,133,211,79,150,54,54,,,,1048,404,971,374,0,0,44,17,33,13,30,99,37
E02000027,Barnet 004,Middle Super Output Areas and Intermediate Zones,MSOAIZ,EN,9499,3705,5016,1951,1748,879,3268,1072,194,82,3143,1259,2390,920,753,339,339,,,,1044,369,978,340,15,5,34,18,17,6,29,102,44
E02000028,Barnet 005,Middle Super Output Areas and Intermediate Zones,MSOAIZ,N,6107,2473,4429,1773,1823,878,2606,895,32,14,201,89,101,38,100,51,51,,,,1389,574,1331,546,1,1,50,24,7,3,28,56,23
E02000029,Barnet 006,Middle Super Output Areas and Intermediate Zones,MSOAIZ,N,8507,3513,5548,2233,1881,961,3667,1272,33,14,764,336,456,188,308,148,148,,,,2067,890,1992,848,9,4,60,34,6,4,42,95,40
E02000030,Barnet 007,Middle Super Output Areas and Intermediate Zones,MSOAIZ,WD,9013,3410,7025,2649,3178,1450,3847,1199,29,10,926,385,813,328,113,57,57,,,,909,303,863,287,6,3,25,9,15,4,16,124,63
E02000031,Barnet 008,Middle Super Output Areas and Intermediate Zones,MSOAIZ,N,7150,2817,4781,1899,2230,1078,2551,821,29,21,537,231,193,94,344,137,137,,,,1726,633,1523,572,95,26,42,13,66,22,61,77,33
E02000032,Barnet 009,Middle Super Output Areas and Intermediate Zones,MSOAIZ,N,7825,2742,6665,2353,2595,1163,4070,1190,14,4,156,81,38,17,118,64,64,,,,944,280,906,263,4,3,30,11,4,3,17,46,24
E02000033,Barnet 010,Middle Super Output Areas and Intermediate Zones,MSOAIZ,N,8438,3317,5504,2216,2033,1023,3471,1193,175,85,1268,466,527,200,741,266,266,,,,1419,520,1338,487,8,3,57,26,16,4,33,72,30
E02000034,Barnet 011,Middle Super Output Areas and Intermediate Zones,MSOAIZ,N,8450,3403,5529,2189,2111,1019,3418,1170,30,14,779,334,448,192,331,142,142,,,,2009,811,1924,774,13,4,49,23,23,10,37,103,55
E02000035,Barnet 012,Middle Super Output Areas and Intermediate Zones,MSOAIZ,N,7783,3381,4410,1880,1887,949,2523,931,46,29,905,437,369,199,536,238,238,,,,2331,991,2239,944,21,12,41,22,30,13,47,91,44
E02000036,Barnet 013,Middle Super Output Areas and Intermediate Zones,MSOAIZ,NW,10689,3942,7049,2571,2335,1097,4714,1474,116,52,1250,498,703,251,547,247,247,,,,2154,770,2040,722,6,4,93,39,15,5,48,120,51
E02000037,Barnet 014,Middle Super Output Areas and Intermediate Zones,MSOAIZ,HA,9741,3397,6367,2220,2464,1088,3903,1132,76,32,1761,686,1172,442,589,244,244,,,,1405,411,1371,396,0,0,28,12,6,3,15,132,48
E02000038,Barnet 015,Middle Super Output Areas and Intermediate Zones,MSOAIZ,N,10285,4049,6598,2570,2250,1066,4348,1504,30,14,903,391,520,221,383,170,170,,,,2509,989,2392,937,19,4,92,46,6,2,52,245,85
E02000039,Barnet 016,Middle Super Output Areas and Intermediate Zones,MSOAIZ,NW,6675,2485,4993,1811,1924,849,3069,962,12,4,209,101,148,77,61,24,24,,,,1403,542,1343,515,12,4,35,17,13,6,27,58,27
E02000040,Barnet 017,Middle Super Output Areas and Intermediate Zones,MSOAIZ,NW,7094,2649,3732,1494,1567,766,2165,728,36,15,1897,660,701,272,1196,388,388,,,,1126,388,999,336,56,23,36,19,35,10,52,303,92
E02000041,Barnet 018,Middle Super Output Areas and Intermediate Zones,MSOAIZ,HA,8762,3120,5184,1886,1971,909,3213,977,20,8,896,343,635,238,261,105,105,,,,2550,831,2466,798,15,6,49,21,20,6,33,112,52
E02000042,Barnet 019,Middle Super Output Areas and Intermediate Zones,MSOAIZ,N,10458,4421,5643,2346,2307,1103,3336,1243,30,17,743,384,500,259,243,125,125,,,,3855,1575,3719,1516,26,11,88,37,22,11,59,187,99
E02000043,Barnet 020,Middle Super Output Areas and Intermediate Zones,MSOAIZ,N,7616,2693,5363,1912,2315,984,3048,928,23,11,146,65,90,43,56,22,22,,,,2024,679,1989,668,3,1,21,7,11,3,11,60,26
E02000044,Barnet 021,Middle Super Output Areas and Intermediate Zones,MSOAIZ,NW,8071,2862,3763,1347,1146,512,2617,835,133,60,2500,882,1740,647,760,235,235,,,,1606,542,1535,517,4,2,56,18,11,5,25,69,31
E02000045,Barnet 022,Middle Super Output Areas and Intermediate Zones,MSOAIZ,N,10226,4168,4962,2093,1613,793,3349,1300,101,45,2317,893,1589,627,728,266,266,,,,2556,1037,2422,980,15,4,93,45,26,8,57,290,100
E02000046,Barnet 023,Middle Super Output Areas and Intermediate Zones,MSOAIZ,N,7000,2860,3613,1438,1559,721,2054,717,12,7,306,131,59,25,247,106,106,,,,2999,1249,2885,1200,8,5,56,25,50,19,49,70,35
E02000047,Barnet 024,Middle Super Output Areas and Intermediate Zones,MSOAIZ,NW,11207,4036,4481,1645,1307,596,3174,1049,146,58,3191,1257,2530,1007,661,250,250,,,,3229,1018,3079,967,37,15,67,24,46,12,51,160,58
E02000048,Barnet 025,Middle Super Output Areas and Intermediate Zones,MSOAIZ,NW,9817,3784,6668,2595,2545,1209,4123,1386,34,11,490,200,149,67,341,133,133,,,,2518,933,2408,881,11,5,98,46,1,1,52,107,45
E02000049,Barnet 026,Middle Super Output Areas and Intermediate Zones,MSOAIZ,NW,8503,3028,1621,587,432,202,1189,385,256,103,5189,1886,3182,1181,2007,705,705,,,,1300,404,1220,370,1,1,44,15,35,18,34,137,48
E02000050,Barnet 027,Middle Super Output Areas and Intermediate Zones,MSOAIZ,N,10052,3853,5136,1950,2006,874,3130,1076,155,61,2300,955,745,294,1555,661,661,,,,2333,842,2245,804,4,2,68,29,16,7,38,128,45
E02000051,Barnet 028,Middle Super Output Areas and Intermediate Zones,MSOAIZ,N,8569,3537,5067,2077,2465,1197,2602,880,15,8,572,218,452,173,120,45,45,,,,2694,1132,2586,1080,22,6,51,31,35,15,52,221,102
E02000052,Barnet 029,Middle Super Output Areas and Intermediate Zones,MSOAIZ,N,9698,4163,4986,2151,1939,988,3047,1163,30,16,1466,682,1075,469,391,213,213,,,,3091,1258,3006,1216,3,2,62,32,20,8,42,125,56
E02000053,Barnet 030,Middle Super Output Areas and Intermediate Zones,MSOAIZ,NW,8250,3244,3569,1399,1412,615,2157,784,198,94,1259,502,438,195,821,307,307,,,,3113,1206,2960,1151,18,8,81,33,54,14,55,111,43
E02000054,Barnet 031,Middle Super Output Areas and Intermediate Zones,MSOAIZ,NW,7175,2774,3859,1498,1476,678,2383,820,68,33,438,189,80,35,358,154,154,,,,2741,1027,2621,983,28,8,75,30,17,6,44,69,27
E02000055,Barnet 032,Middle Super Output Areas and Intermediate Zones,MSOAIZ,NW,10893,4179,5036,1914,2254,1033,2782,881,48,19,1295,601,914,415,381,186,186,,,,4296,1553,4106,1476,13,6,119,48,58,23,77,218,92
E02000056,Barnet 033,Middle Super Output Areas and Intermediate Zones,MSOAIZ,NW,9042,3390,6441,2370,3273,1380,3168,990,10,5,344,183,100,45,244,138,138,,,,2046,743,1936,696,21,8,61,27,28,12,47,201,89
E02000057,Barnet 034,Middle Super Output Areas and Intermediate Zones,MSOAIZ,NW,7437,2460,4066,1351,1723,717,2343,634,15,7,389,149,219,88,170,61,61,,,,2815,902,2714,867,11,3,79,30,11,2,35,152,51
E02000058,Barnet 035,Middle Super Output Areas and Intermediate Zones,MSOAIZ,NW,10177,3961,6302,2462,3059,1418,3243,1044,34,15,342,222,146,83,196,139,139,,,,3371,1207,3222,1162,11,6,111,31,27,8,45,128,55
E02000059,Barnet 036,Middle Super Output Areas and Intermediate Zones,MSOAIZ,NW,10442,3990,4771,1813,2079,884,2692,929,54,29,2175,942,1700,759,475,183,183,,,,3328,1151,3226,1109,21,5,57,26,24,11,42,114,55
E02000060,Barnet 037,Middle Super Output Areas and Intermediate Zones,MSOAIZ,NW,10693,3400,5467,1675,2402,932,3065,743,41,17,406,250,70,23,336,227,227,,,,4571,1390,4384,1334,12,6,120,31,55,19,56,208,68
E02000061,Barnet 038,Middle Super Output Areas and Intermediate Zones,MSOAIZ,NW,7875,3172,4189,1609,2304,992,1885,617,47,16,179,97,70,45,109,52,52,,,,3308,1372,3164,1312,30,10,89,39,25,11,60,152,78
E02000062,Barnet 039,Middle Super Output Areas and Intermediate Zones,MSOAIZ,NW,6302,2357,2250,855,828,360,1422,495,59,28,1846,710,1178,457,668,253,253,,,,2061,729,1985,700,5,4,52,19,19,6,29,86,35
E02000063,Barnet 040,Middle Super Output Areas and Intermediate Zones,MSOAIZ,NW,6886,2503,3391,1339,1517,690,1874,649,27,15,517,158,282,87,235,71,71,,,,2832,940,2736,905,10,3,51,24,35,8,35,119,51
E02000064,Barnet 041,Middle Super Output Areas and Intermediate Zones,MSOAIZ,NW,6016,2450,2398,1018,1153,544,1245,474,40,18,1460,622,1216,521,244,101,101,,,,2001,743,1867,694,27,9,74,28,33,12,49,117,49
E02000065,Bexley 001,Middle Super Output Areas and Intermediate Zones,MSOAIZ,SE,7652,2728,4015,1394,644,296,3371,1098,43,19,1535,622,182,81,1353,541,541,,,,1977,666,1864,632,0,0,90,27,23,7,34,82,27
E02000066,Bexley 002,Middle Super Output Areas and Intermediate Zones,MSOAIZ,SE,9599,3795,3609,1360,1064,506,2545,854,15,9,4402,1907,347,166,4055,1741,1741,,,,1495,482,1363,437,4,1,120,40,8,4,45,78,37
E02000067,Bexley 003,Middle Super Output Areas and Intermediate Zones,MSOAIZ,DA,8737,3580,4980,2069,1400,727,3580,1342,49,19,1717,699,264,94,1453,605,605,,,,1915,754,1774,699,2,1,95,38,44,16,55,76,39
E02000068,Bexley 004,Middle Super Output Areas and Intermediate Zones,MSOAIZ,DA,7388,3041,3513,1433,906,474,2607,959,267,141,1758,728,198,81,1560,647,647,,,,1771,700,1684,663,7,2,59,23,21,12,37,79,39
E02000069,Bexley 005,Middle Super Output Areas and Intermediate Zones,MSOAIZ,DA,6144,2495,4355,1766,1631,824,2724,942,37,16,729,315,79,34,650,281,281,,,,976,380,920,356,8,2,46,21,2,1,24,47,18
E02000070,Bexley 006,Middle Super Output Areas and Intermediate Zones,MSOAIZ,SE,7875,3177,6442,2591,2550,1331,3892,1260,93,40,570,244,87,37,483,207,207,,,,734,281,677,255,3,2,50,22,4,2,26,36,21
E02000071,Bexley 007,Middle Super Output Areas and Intermediate Zones,MSOAIZ,DA,7300,2782,5628,2138,1809,912,3819,1226,46,18,792,316,106,46,686,270,270,,,,749,278,690,254,0,0,52,21,7,3,24,85,32
E02000072,Bexley 008,Middle Super Output Areas and Intermediate Zones,MSOAIZ,DA,11726,4722,4953,1928,1075,575,3878,1353,49,22,5019,2087,864,375,4155,1712,1712,,,,1614,636,1527,597,0,0,57,26,30,13,39,91,49
E02000073,Bexley 009,Middle Super Output Areas and Intermediate Zones,MSOAIZ,DA,10724,3968,9579,3542,3392,1683,6187,1859,46,19,386,163,50,24,336,139,139,,,,672,224,609,198,0,0,58,23,5,3,26,41,20
E02000074,Bexley 010,Middle Super Output Areas and Intermediate Zones,MSOAIZ,DA,7573,3185,4104,1652,1191,630,2913,1022,205,91,2582,1149,283,125,2299,1024,1024,,,,640,267,583,241,6,1,44,20,7,5,26,42,26
E02000075,Bexley 011,Middle Super Output Areas and Intermediate Zones,MSOAIZ,DA,7920,3172,7026,2796,2915,1468,4111,1328,20,8,378,176,54,25,324,151,151,,,,460,171,432,159,0,0,27,11,1,1,12,36,21
E02000077,Bexley 013,Middle Super Output Areas and Intermediate Zones,MSOAIZ,DA,7760,2870,6455,2320,2102,979,4353,1341,42,15,551,276,88,37,463,239,239,,,,670,235,608,212,0,0,61,22,1,1,23,42,24
E02000078,Bexley 014,Middle Super Output Areas and Intermediate Zones,MSOAIZ,DA,7665,3036,6722,2632,2279,1155,4443,1477,54,18,277,128,75,28,202,100,100,,,,572,241,513,212,0,0,55,27,4,2,29,40,17
E02000079,Bexley 015,Middle Super Output Areas and Intermediate Zones,MSOAIZ,DA,7713,3267,6128,2558,2346,1240,3782,1318,25,14,243,132,55,17,188,115,115,,,,1255,526,1140,480,3,2,109,42,3,2,46,62,37
E02000080,Bexley 016,Middle Super Output Areas and Intermediate Zones,MSOAIZ,DA,9430,3702,7693,2999,2772,1423,4921,1576,90,32,505,231,63,25,442,206,206,,,,1059,410,993,380,7,3,47,23,12,4,30,83,30
E02000081,Bexley 017,Middle Super Output Areas and Intermediate Zones,MSOAIZ,DA,7486,3106,5778,2375,2212,1162,3566,1213,17,6,1023,438,103,49,920,389,389,,,,610,258,553,230,10,4,40,20,7,4,28,58,29
E02000082,Bexley 018,Middle Super Output Areas and Intermediate Zones,MSOAIZ,SE,8876,3356,7997,3014,2698,1328,5299,1686,71,23,45,17,4,2,41,15,15,,,,719,273,645,243,4,1,70,29,0,0,30,44,29
E02000083,Bexley 019,Middle Super Output Areas and Intermediate Zones,MSOAIZ,DA,9750,3985,6920,2808,1968,1081,4952,1727,46,17,1778,715,373,147,1405,568,568,,,,945,416,868,379,2,1,66,31,9,5,37,61,29
E02000084,Bexley 020,Middle Super Output Areas and Intermediate Zones,MSOAIZ,DA,10635,4209,9281,3625,3374,1696,5907,1929,54,28,399,175,22,11,377,164,164,,,,854,353,785,319,6,3,61,30,2,1,34,47,28
E02000085,Bexley 021,Middle Super Output Areas and Intermediate Zones,MSOAIZ,DA,7893,3084,6744,2621,2227,1113,4517,1508,39,16,324,135,39,17,285,118,118,,,,756,295,698,274,2,1,46,17,10,3,21,30,17
E02000086,Bexley 022,Middle Super Output Areas and Intermediate Zones,MSOAIZ,DA,7323,2789,6580,2506,2256,1104,4324,1402,37,13,76,23,10,3,66,20,20,,,,609,232,562,213,2,1,39,16,6,2,19,21,15
E02000087,Bexley 023,Middle Super Output Areas and Intermediate Zones,MSOAIZ,DA,7559,3142,6533,2666,2792,1436,3741,1230,8,4,248,127,33,11,215,116,116,,,,719,318,671,295,3,2,39,17,6,4,23,51,27
E02000088,Bexley 024,Middle Super Output Areas and Intermediate Zones,MSOAIZ,DA,7737,2984,6867,2650,2492,1249,4375,1401,17,7,210,99,30,12,180,87,87,,,,599,208,544,185,5,1,42,19,8,3,23,44,20
E02000089,Bexley 025,Middle Super Output Areas and Intermediate Zones,MSOAIZ,SE,7635,2899,6774,2553,2418,1200,4356,1353,24,11,332,148,17,7,315,141,141,,,,464,168,423,153,0,0,40,14,1,1,15,41,19
E02000090,Bexley 026,Middle Super Output Areas and Intermediate Zones,MSOAIZ,DA,8469,3962,6004,2809,2464,1397,3540,1412,124,56,648,356,58,32,590,324,324,,,,1633,707,1520,654,16,8,91,42,6,3,53,60,34
E02000091,Bexley 027,Middle Super Output Areas and Intermediate Zones,MSOAIZ,DA,9542,4279,6995,2964,3019,1595,3976,1369,30,16,1256,694,71,29,1185,665,665,,,,1219,575,1140,538,6,4,67,31,6,2,37,42,30
E02000092,Bexley 028,Middle Super Output Areas and Intermediate Zones,MSOAIZ,DA,6407,2722,3588,1499,1274,656,2314,843,113,57,2039,889,289,119,1750,770,770,,,,603,245,565,229,3,2,35,14,0,0,16,64,32
E02000093,Brent 001,Middle Super Output Areas and Intermediate Zones,MSOAIZ,NW,10776,3408,6654,2176,2960,1108,3694,1068,149,59,1096,402,122,64,974,338,338,,,,2745,718,2673,689,4,1,60,21,8,7,29,132,53
E02000094,Brent 002,Middle Super Output Areas and Intermediate Zones,MSOAIZ,NW,8640,2738,4893,1599,1963,750,2930,849,119,46,1125,396,222,88,903,308,308,,,,2391,655,2323,632,0,0,45,14,23,9,23,112,42
E02000095,Brent 003,Middle Super Output Areas and Intermediate Zones,MSOAIZ,NW,9783,3117,5633,1868,2725,1025,2908,843,67,29,1057,398,492,215,565,183,183,,,,2903,780,2759,739,25,7,83,24,36,10,41,123,42
E02000096,Brent 004,Middle Super Output Areas and Intermediate Zones,MSOAIZ,HA,7535,2518,5620,1898,2498,1027,3122,871,13,5,206,109,82,45,124,64,64,,,,1614,469,1539,443,27,8,30,13,18,5,26,82,37
E02000097,Brent 005,Middle Super Output Areas and Intermediate Zones,MSOAIZ,NW,8958,2926,5390,1845,2151,877,3239,968,39,12,832,317,475,200,357,117,117,,,,2594,714,2501,681,6,2,67,24,20,7,33,103,38
E02000098,Brent 006,Middle Super Output Areas and Intermediate Zones,MSOAIZ,NW,7917,2652,4126,1425,1609,696,2517,729,74,34,1220,482,494,213,726,269,269,,,,2410,674,2302,640,5,3,69,21,34,10,34,87,37
E02000099,Brent 007,Middle Super Output Areas and Intermediate Zones,MSOAIZ,HA,8651,2782,4102,1442,1651,701,2451,741,126,53,1195,377,262,91,933,286,286,,,,3086,865,2967,826,21,7,66,22,32,10,39,142,45
E02000100,Brent 008,Middle Super Output Areas and Intermediate Zones,MSOAIZ,HA,7718,2696,5395,1768,2330,899,3065,869,49,26,755,441,92,36,663,405,405,,,,1463,434,1390,399,10,4,28,10,35,21,35,56,27
E02000101,Brent 009,Middle Super Output Areas and Intermediate Zones,MSOAIZ,NW,9162,3312,3458,1240,1370,569,2088,671,210,85,2528,1047,747,329,1781,718,718,,,,2804,882,2729,854,0,0,34,16,41,12,28,162,58
E02000102,Brent 010,Middle Super Output Areas and Intermediate Zones,MSOAIZ,NW,7783,2496,3427,1142,1669,604,1758,538,107,49,1864,590,352,129,1512,461,461,,,,2340,698,2249,670,17,8,43,13,31,7,28,45,17
E02000103,Brent 011,Middle Super Output Areas and Intermediate Zones,MSOAIZ,NW,8705,2994,3887,1418,1648,706,2239,712,116,54,2134,772,879,379,1255,393,393,,,,2423,710,2322,678,6,3,61,21,34,8,32,145,40
E02000104,Brent 012,Middle Super Output Areas and Intermediate Zones,MSOAIZ,HA,6665,2213,3671,1286,1570,684,2101,602,103,47,621,254,240,104,381,150,150,,,,2200,596,2115,568,3,1,50,20,32,7,28,70,30
E02000105,Brent 013,Middle Super Output Areas and Intermediate Zones,MSOAIZ,HA,9160,2997,4316,1479,1450,613,2866,866,74,26,1107,424,388,178,719,246,246,,,,3524,1017,3367,974,10,2,116,31,31,10,43,139,51
E02000106,Brent 014,Middle Super Output Areas and Intermediate Zones,MSOAIZ,NW,10208,3449,4145,1450,1777,700,2368,750,105,40,1797,642,568,233,1229,409,409,,,,4010,1270,3844,1222,27,7,116,33,23,8,48,151,47
E02000107,Brent 015,Middle Super Output Areas and Intermediate Zones,MSOAIZ,NW,10625,4107,3887,1475,1841,699,2046,776,46,21,1501,630,417,174,1084,456,456,,,,5087,1941,4940,1883,10,4,104,42,33,12,58,104,40
E02000108,Brent 016,Middle Super Output Areas and Intermediate Zones,MSOAIZ,HA,6565,2147,3529,1176,1332,534,2197,642,59,20,852,337,368,152,484,185,185,,,,2057,585,1965,559,9,3,69,19,14,4,26,68,29
E02000109,Brent 017,Middle Super Output Areas and Intermediate Zones,MSOAIZ,HA,9693,3264,4513,1536,2088,791,2425,745,273,129,1234,487,371,161,863,326,326,,,,3558,1072,3413,1025,27,5,92,31,26,11,47,115,40
E02000110,Brent 018,Middle Super Output Areas and Intermediate Zones,MSOAIZ,NW,8083,2969,3682,1357,1775,686,1907,671,56,24,1417,593,456,188,961,405,405,,,,2862,972,2758,928,14,4,66,27,24,13,44,66,23
E02000111,Brent 019,Middle Super Output Areas and Intermediate Zones,MSOAIZ,NW,9696,2914,4714,1479,1896,711,2818,768,78,31,1048,389,416,164,632,225,225,,,,3739,971,3515,910,17,5,133,38,74,18,61,117,44
E02000112,Brent 020,Middle Super Output Areas and Intermediate Zones,MSOAIZ,NW,9326,2892,4703,1503,2167,776,2536,727,133,48,829,264,251,90,578,174,174,,,,3566,1036,3374,987,49,12,100,27,43,10,49,95,41
E02000113,Brent 021,Middle Super Output Areas and Intermediate Zones,MSOAIZ,NW,9655,3306,2058,736,729,292,1329,444,146,60,5719,1956,3723,1339,1996,617,617,,,,1529,494,1466,473,0,0,44,13,19,8,21,203,60
E02000114,Brent 022,Middle Super Output Areas and Intermediate Zones,MSOAIZ,NW,8997,3528,2831,1081,1255,466,1576,615,142,77,1719,727,486,191,1233,536,536,,,,4196,1586,4085,1544,14,5,68,23,29,14,42,109,57
E02000115,Brent 023,Middle Super Output Areas and Intermediate Zones,MSOAIZ,NW,8298,3911,2797,1249,1172,545,1625,704,56,29,1800,1031,1039,605,761,426,426,,,,3549,1549,3435,1499,5,2,77,34,32,14,50,96,53
E02000116,Brent 024,Middle Super Output Areas and Intermediate Zones,MSOAIZ,NW,8146,3072,1713,679,773,311,940,368,244,105,2429,1012,491,200,1938,812,812,,,,3614,1226,3508,1188,12,2,55,20,39,16,38,146,50
E02000117,Brent 025,Middle Super Output Areas and Intermediate Zones,MSOAIZ,NW,11944,4557,2571,1020,1016,429,1555,591,193,84,5697,2153,1093,400,4604,1753,1753,,,,3269,1214,3193,1175,0,0,43,24,33,15,39,214,86
E02000118,Brent 026,Middle Super Output Areas and Intermediate Zones,MSOAIZ,NW,9419,2849,4978,1484,1701,632,3277,852,97,39,1478,582,771,299,707,283,283,,,,2783,710,2552,659,13,2,173,37,45,12,51,83,34
E02000119,Brent 027,Middle Super Output Areas and Intermediate Zones,MSOAIZ,NW,7222,2597,868,335,318,135,550,200,231,97,4850,1722,1924,681,2926,1041,1041,,,,1125,397,1075,379,0,0,24,9,26,9,18,148,46
E02000120,Brent 028,Middle Super Output Areas and Intermediate Zones,MSOAIZ,NW,9204,4277,3177,1436,1200,558,1977,878,37,26,1939,1008,661,319,1278,689,689,,,,3974,1766,3828,1700,12,6,103,48,31,12,66,77,41
E02000121,Brent 029,Middle Super Output Areas and Intermediate Zones,MSOAIZ,UB,8932,2623,4610,1393,2000,700,2610,693,130,45,749,246,163,63,586,183,183,,,,3300,884,3028,823,23,4,143,31,106,26,61,143,55
E02000122,Brent 030,Middle Super Output Areas and Intermediate Zones,MSOAIZ,NW,8063,3047,4671,1659,2104,820,2567,839,23,8,1151,545,493,223,658,322,322,,,,2091,775,2012,739,16,6,45,23,18,7,36,127,60
E02000123,Brent 031,Middle Super Output Areas and Intermediate Zones,MSOAIZ,NW,14657,5884,3478,1415,1246,526,2232,889,195,90,4982,1997,1127,484,3855,1513,1513,,,,5828,2303,5645,2224,4,2,96,42,83,35,79,174,79
E02000124,Brent 032,Middle Super Output Areas and Intermediate Zones,MSOAIZ,W,10168,4334,4350,1776,1794,766,2556,1010,68,31,1861,898,945,464,916,434,434,,,,3760,1567,3626,1508,15,7,74,32,45,20,59,129,62
E02000125,Brent 033,Middle Super Output Areas and Intermediate Zones,MSOAIZ,NW,10803,4329,5401,2094,2333,933,3068,1161,89,45,2020,926,609,266,1411,660,660,,,,3179,1213,3061,1162,4,1,88,39,26,11,51,114,51
E02000126,Brent 034,Middle Super Output Areas and Intermediate Zones,MSOAIZ,W,7738,3381,868,405,266,147,602,258,129,62,5526,2437,4428,1919,1098,518,518,,,,1123,438,1047,404,8,3,37,13,31,18,34,92,39
E02000127,Bromley 001,Middle Super Output Areas and Intermediate Zones,MSOAIZ,SE,8435,3675,4393,1894,1408,767,2985,1127,77,40,2999,1314,350,174,2649,1140,1140,,,,881,381,824,360,12,3,34,15,11,3,21,85,46
E02000128,Bromley 002,Middle Super Output Areas and Intermediate Zones,MSOAIZ,SE,7230,3006,5517,2222,1763,927,3754,1295,34,10,750,376,60,36,690,340,340,,,,877,372,820,348,18,6,27,13,12,5,24,52,26
E02000130,Bromley 004,Middle Super Output Areas and Intermediate Zones,MSOAIZ,SE,7889,3464,4859,2040,1527,765,3332,1275,85,43,1345,660,84,41,1261,619,619,,,,1539,691,1460,651,9,4,43,23,27,13,40,61,30
E02000131,Bromley 005,Middle Super Output Areas and Intermediate Zones,MSOAIZ,SE,8894,4589,3312,1775,777,478,2535,1297,70,39,2511,1210,275,111,2236,1099,1099,,,,2935,1534,2839,1484,8,2,82,42,6,6,50,66,31
E02000132,Bromley 006,Middle Super Output Areas and Intermediate Zones,MSOAIZ,SE,8486,4668,4400,2481,1764,1150,2636,1331,105,53,1386,703,86,44,1300,659,659,,,,2479,1369,2390,1316,6,3,73,42,10,8,53,116,62
E02000133,Bromley 007,Middle Super Output Areas and Intermediate Zones,MSOAIZ,BR,9403,3961,8137,3360,3639,1789,4498,1571,49,21,247,98,4,1,243,97,97,,,,887,436,843,413,2,2,39,18,3,3,23,83,46
E02000134,Bromley 008,Middle Super Output Areas and Intermediate Zones,MSOAIZ,BR,10614,5106,6339,2932,2098,1151,4241,1781,35,22,1497,871,120,74,1377,797,797,,,,2627,1220,2492,1150,17,7,97,51,21,12,70,116,61
E02000135,Bromley 009,Middle Super Output Areas and Intermediate Zones,MSOAIZ,SE,9614,4402,2322,1115,608,336,1714,779,194,91,5101,2225,562,272,4539,1953,1953,,,,1943,940,1863,896,10,7,57,26,13,11,44,54,31
E02000136,Bromley 010,Middle Super Output Areas and Intermediate Zones,MSOAIZ,DA,5323,2207,3959,1600,1593,819,2366,781,30,10,936,427,105,53,831,374,374,,,,320,130,289,115,8,3,17,8,6,4,15,78,40
E02000137,Bromley 011,Middle Super Output Areas and Intermediate Zones,MSOAIZ,BR,7679,3637,5758,2645,2301,1272,3457,1373,30,16,485,269,52,26,433,243,243,,,,1370,684,1299,644,16,6,53,32,2,2,40,36,23
E02000138,Bromley 012,Middle Super Output Areas and Intermediate Zones,MSOAIZ,BR,7927,4057,5885,2931,2691,1587,3194,1344,13,9,230,143,11,4,219,139,139,,,,1710,911,1611,847,7,5,71,48,21,11,64,89,63
E02000139,Bromley 013,Middle Super Output Areas and Intermediate Zones,MSOAIZ,SE,7266,3202,5153,2147,1506,762,3647,1385,111,51,811,429,81,43,730,386,386,,,,1130,543,1086,519,3,1,37,19,4,4,24,61,32
E02000140,Bromley 014,Middle Super Output Areas and Intermediate Zones,MSOAIZ,DA,8041,3301,3789,1517,1193,645,2596,872,143,63,3535,1485,460,199,3075,1286,1286,,,,521,211,475,188,5,3,37,17,4,3,23,53,25
E02000141,Bromley 015,Middle Super Output Areas and Intermediate Zones,MSOAIZ,SE,6918,3055,4577,1973,1256,686,3321,1287,72,34,999,451,93,39,906,412,412,,,,1227,575,1147,539,9,3,69,31,2,2,36,43,22
E02000142,Bromley 016,Middle Super Output Areas and Intermediate Zones,MSOAIZ,BR,8075,3283,6348,2506,2271,1118,4077,1388,59,24,412,195,32,12,380,183,183,,,,1203,527,1131,487,8,3,56,32,8,5,40,53,31
E02000144,Bromley 018,Middle Super Output Areas and Intermediate Zones,MSOAIZ,BR,8663,3831,6119,2608,2251,1189,3868,1419,23,14,412,201,30,11,382,190,190,,,,2039,969,1967,929,9,3,56,33,7,4,40,70,39
E02000145,Bromley 019,Middle Super Output Areas and Intermediate Zones,MSOAIZ,DA,8076,3376,3933,1700,1180,651,2753,1049,130,78,3159,1228,493,213,2666,1015,1015,,,,800,338,680,288,26,10,81,33,13,7,50,54,32
E02000146,Bromley 020,Middle Super Output Areas and Intermediate Zones,MSOAIZ,BR,8170,3508,6261,2571,1931,1010,4330,1561,88,43,449,287,27,18,422,269,269,,,,1313,574,1238,543,8,2,60,27,7,2,31,59,33
E02000147,Bromley 021,Middle Super Output Areas and Intermediate Zones,MSOAIZ,BR,7951,3183,7043,2725,3016,1485,4027,1240,12,6,176,118,15,7,161,111,111,,,,681,312,645,292,0,0,24,15,12,5,20,39,22
E02000148,Bromley 022,Middle Super Output Areas and Intermediate Zones,MSOAIZ,BR,6554,2633,5620,2225,2354,1165,3266,1060,4,4,321,173,17,6,304,167,167,,,,551,205,505,188,10,3,28,11,8,3,17,58,26
E02000149,Bromley 023,Middle Super Output Areas and Intermediate Zones,MSOAIZ,BR,7706,3249,5147,2178,1737,941,3410,1237,77,38,1645,681,203,78,1442,603,603,,,,777,323,729,298,0,0,48,25,0,0,25,60,29
E02000150,Bromley 024,Middle Super Output Areas and Intermediate Zones,MSOAIZ,BR,8235,3109,6916,2536,2266,1098,4650,1438,30,8,566,287,50,26,516,261,261,,,,677,254,630,234,12,7,27,9,8,4,20,46,24
E02000151,Bromley 025,Middle Super Output Areas and Intermediate Zones,MSOAIZ,BR,7574,2994,6910,2738,2932,1462,3978,1276,6,4,119,49,3,2,116,47,47,,,,469,175,437,164,0,0,32,11,0,0,11,70,28
E02000152,Bromley 026,Middle Super Output Areas and Intermediate Zones,MSOAIZ,BR,6561,2623,4043,1605,1280,675,2763,930,51,25,2021,821,295,131,1726,690,690,,,,395,142,373,134,6,2,16,6,0,0,8,51,30
E02000153,Bromley 027,Middle Super Output Areas and Intermediate Zones,MSOAIZ,BR,7755,2860,7185,2648,2501,1243,4684,1405,10,4,232,98,25,9,207,89,89,,,,302,98,276,87,3,2,23,9,0,0,11,26,12
E02000154,Bromley 028,Middle Super Output Areas and Intermediate Zones,MSOAIZ,BR,7917,3293,6196,2503,2507,1261,3689,1242,68,32,633,297,68,35,565,262,262,,,,979,440,905,402,11,5,55,29,8,4,38,41,21
E02000155,Bromley 029,Middle Super Output Areas and Intermediate Zones,MSOAIZ,BR,6905,3057,5601,2512,2458,1362,3143,1150,97,38,652,262,77,35,575,227,227,,,,516,222,471,203,0,0,42,18,3,1,19,39,23
E02000156,Bromley 030,Middle Super Output Areas and Intermediate Zones,MSOAIZ,CR,12022,4756,10531,4058,4249,2127,6282,1931,54,21,376,242,18,10,358,232,232,,,,953,380,874,342,19,8,34,20,26,10,38,108,55
E02000157,Bromley 031,Middle Super Output Areas and Intermediate Zones,MSOAIZ,BR,7964,3300,7217,2990,3206,1705,4011,1285,16,7,128,64,11,6,117,58,58,,,,552,209,510,190,0,0,35,17,7,2,19,51,30
E02000158,Bromley 032,Middle Super Output Areas and Intermediate Zones,MSOAIZ,BR,7364,2952,5059,2115,2295,1198,2764,917,45,23,1863,662,251,89,1612,573,573,,,,364,137,334,123,0,0,26,12,4,2,14,33,15
E02000159,Bromley 033,Middle Super Output Areas and Intermediate Zones,MSOAIZ,BR,6812,2749,5938,2422,2624,1331,3314,1091,34,15,206,66,26,8,180,58,58,,,,588,222,569,212,0,0,8,5,11,5,10,46,24
E02000160,Bromley 034,Middle Super Output Areas and Intermediate Zones,MSOAIZ,BR,7725,2968,6800,2576,2581,1255,4219,1321,7,4,186,80,16,8,170,72,72,,,,676,279,604,251,26,9,42,17,4,2,28,56,29
E02000161,Bromley 035,Middle Super Output Areas and Intermediate Zones,MSOAIZ,BR,8378,3369,7542,3052,2943,1513,4599,1539,10,8,214,76,25,10,189,66,66,,,,561,212,514,192,5,4,34,14,8,2,20,51,21
E02000162,Bromley 036,Middle Super Output Areas and Intermediate Zones,MSOAIZ,TN,6647,2889,5030,2140,2212,1192,2818,948,14,8,1093,513,41,17,1052,496,496,,,,458,204,404,177,18,6,29,15,7,6,27,52,24
E02000163,Bromley 037,Middle Super Output Areas and Intermediate Zones,MSOAIZ,TN,7650,3072,6554,2597,2746,1334,3808,1263,60,26,451,203,43,26,408,177,177,,,,547,223,488,194,3,3,36,19,20,7,29,38,23
E02000165,Bromley 039,Middle Super Output Areas and Intermediate Zones,MSOAIZ,TN,7045,2691,6242,2364,1881,918,4361,1446,56,27,282,130,27,12,255,118,118,,,,431,151,406,139,5,2,17,9,3,1,12,34,19
E02000166,Camden 001,Middle Super Output Areas and Intermediate Zones,MSOAIZ,NW,7916,3537,3751,1595,1963,895,1788,700,66,29,2685,1272,2389,1118,296,154,154,,,,1271,571,1165,514,16,9,79,37,11,11,57,143,70
E02000167,Camden 002,Middle Super Output Areas and Intermediate Zones,MSOAIZ,NW,7869,3629,4564,2017,2871,1347,1693,670,17,8,534,304,420,238,114,66,66,,,,2605,1211,2479,1152,36,14,72,38,18,7,59,149,89
E02000168,Camden 003,Middle Super Output Areas and Intermediate Zones,MSOAIZ,NW,8040,3535,3671,1485,1810,744,1861,741,57,28,2321,1034,1353,577,968,457,457,,,,1877,943,1789,900,21,10,58,26,9,7,43,114,45
E02000169,Camden 004,Middle Super Output Areas and Intermediate Zones,MSOAIZ,NW,6981,2942,3910,1631,2292,1017,1618,614,9,5,530,219,403,170,127,49,49,,,,2380,1001,2324,973,9,3,31,18,16,7,28,152,86
E02000170,Camden 005,Middle Super Output Areas and Intermediate Zones,MSOAIZ,NW,8293,3685,3993,1643,1776,781,2217,862,46,24,909,416,551,234,358,182,182,,,,3268,1554,3153,1504,12,4,88,35,15,11,50,77,48
E02000171,Camden 006,Middle Super Output Areas and Intermediate Zones,MSOAIZ,NW,7789,3502,3586,1517,1745,772,1841,745,46,31,1967,906,1404,614,563,292,292,,,,2086,991,1984,938,12,7,68,34,22,12,53,104,57
E02000172,Camden 007,Middle Super Output Areas and Intermediate Zones,MSOAIZ,NW,9919,4186,2061,911,864,404,1197,507,138,64,5811,2465,4631,2019,1180,446,446,,,,1791,695,1711,658,11,4,64,28,5,5,37,118,51
E02000173,Camden 008,Middle Super Output Areas and Intermediate Zones,MSOAIZ,NW,7565,3569,3061,1411,1808,875,1253,536,29,12,1053,523,624,289,429,234,234,,,,3257,1539,3159,1480,26,18,43,22,29,19,59,165,84
E02000174,Camden 009,Middle Super Output Areas and Intermediate Zones,MSOAIZ,NW,8703,3822,2581,1175,1050,525,1531,650,35,21,3648,1581,2996,1295,652,286,286,,,,2336,990,2220,933,12,7,78,36,26,14,57,103,55
E02000175,Camden 010,Middle Super Output Areas and Intermediate Zones,MSOAIZ,NW,8846,4277,2890,1393,1275,649,1615,744,53,19,1972,870,900,444,1072,426,426,,,,3823,1937,3715,1888,6,2,86,43,16,4,49,108,58
E02000176,Camden 011,Middle Super Output Areas and Intermediate Zones,MSOAIZ,NW,6289,3261,3027,1493,1669,873,1358,620,18,9,470,286,205,114,265,172,172,,,,2676,1411,2589,1369,12,6,57,28,18,8,42,98,62
E02000177,Camden 012,Middle Super Output Areas and Intermediate Zones,MSOAIZ,NW,8863,3865,2052,1013,934,477,1118,536,61,22,4721,1898,4366,1736,355,162,162,,,,1954,894,1846,841,6,4,89,42,13,7,53,75,38
E02000178,Camden 013,Middle Super Output Areas and Intermediate Zones,MSOAIZ,NW,8823,4280,2244,1153,837,432,1407,721,39,25,3072,1401,2055,931,1017,470,470,,,,3405,1657,3307,1608,6,2,63,33,29,14,49,63,44
E02000179,Camden 014,Middle Super Output Areas and Intermediate Zones,MSOAIZ,NW,6305,2870,2267,1049,1184,612,1083,437,12,6,2183,916,1933,815,250,101,101,,,,1765,861,1687,821,29,14,37,20,12,6,40,78,38
E02000180,Camden 015,Middle Super Output Areas and Intermediate Zones,MSOAIZ,NW,7662,3394,2241,986,942,441,1299,545,26,16,2999,1298,2248,903,751,395,395,,,,2320,1054,2155,972,8,6,113,55,44,21,82,76,40
E02000181,Camden 016,Middle Super Output Areas and Intermediate Zones,MSOAIZ,NW,7703,3657,3221,1554,1474,742,1747,812,15,9,1254,562,776,320,478,242,242,,,,3140,1490,3019,1428,23,10,73,39,25,13,62,73,42
E02000182,Camden 017,Middle Super Output Areas and Intermediate Zones,MSOAIZ,NW,6638,2963,2456,1133,1378,699,1078,434,32,13,1380,543,1047,413,333,130,130,,,,2566,1158,2465,1111,38,11,45,24,18,12,47,204,116
E02000183,Camden 018,Middle Super Output Areas and Intermediate Zones,MSOAIZ,NW,7909,3881,3265,1515,1811,890,1454,625,31,20,2325,1130,1040,476,1285,654,654,,,,2172,1153,1997,1047,54,38,92,49,29,19,106,116,63
E02000184,Camden 019,Middle Super Output Areas and Intermediate Zones,MSOAIZ,NW,8726,3655,1516,740,633,313,883,427,245,124,4283,1674,3410,1350,873,324,324,,,,2613,1086,2462,1018,0,0,111,53,40,15,68,69,31
E02000185,Camden 020,Middle Super Output Areas and Intermediate Zones,MSOAIZ,W,8213,3938,1636,815,674,367,962,448,127,65,3855,1790,3055,1295,800,495,495,,,,2474,1208,2368,1149,9,6,64,32,33,21,59,121,60
E02000186,Camden 021,Middle Super Output Areas and Intermediate Zones,MSOAIZ,NW,6491,3099,1897,860,1051,497,846,363,53,25,1811,865,1146,519,665,346,346,,,,2577,1272,2400,1175,49,23,58,32,70,42,97,153,77
E02000187,Camden 022,Middle Super Output Areas and Intermediate Zones,MSOAIZ,NW,8064,3290,848,396,329,168,519,228,38,12,5716,2288,4114,1583,1602,705,705,,,,1355,541,1277,505,14,3,47,23,17,10,36,107,53
E02000188,Camden 023,Middle Super Output Areas and Intermediate Zones,MSOAIZ,NW,7939,3170,1012,435,435,217,577,218,41,19,4775,1957,3592,1382,1183,575,575,,,,2013,719,1903,672,2,1,86,35,22,11,47,98,40
E02000189,Camden 024,Middle Super Output Areas and Intermediate Zones,MSOAIZ,WC,5407,2253,589,285,277,145,312,140,24,12,3251,1259,1817,612,1434,647,647,,,,1406,636,1317,595,0,0,37,15,52,26,41,137,61
E02000190,Camden 025,Middle Super Output Areas and Intermediate Zones,MSOAIZ,WC,5914,3181,1103,664,583,395,520,269,14,6,2896,1391,2126,996,770,395,395,,,,1753,1038,1628,967,16,8,72,39,37,24,71,148,82
E02000191,Camden 026,Middle Super Output Areas and Intermediate Zones,MSOAIZ,WC,5545,2868,1267,715,727,432,540,283,25,12,1351,663,860,399,491,264,264,,,,2725,1387,2480,1261,56,29,105,52,84,45,126,177,91
E02000192,Camden 027,Middle Super Output Areas and Intermediate Zones,MSOAIZ,WC,7021,3375,1330,676,570,316,760,360,12,6,3781,1708,2579,1132,1202,576,576,,,,1782,918,1659,856,16,10,79,36,28,16,62,116,67
E02000193,Camden 028,Middle Super Output Areas and Intermediate Zones,MSOAIZ,WC,7010,3850,1928,1108,939,619,989,489,40,32,2059,1076,919,499,1140,577,577,,,,2779,1519,2494,1371,68,33,109,57,108,58,148,204,115
E02000194,Croydon 001,Middle Super Output Areas and Intermediate Zones,MSOAIZ,SE,8536,4099,4055,1940,1311,731,2744,1209,81,52,2126,1002,1221,553,905,449,449,,,,2191,1065,2083,1001,18,8,64,40,26,16,64,83,40
E02000195,Croydon 002,Middle Super Output Areas and Intermediate Zones,MSOAIZ,SW,9112,3446,6607,2468,2344,1102,4263,1366,119,51,619,264,323,146,296,118,118,,,,1652,619,1538,572,15,5,79,33,20,9,47,115,44
E02000196,Croydon 003,Middle Super Output Areas and Intermediate Zones,MSOAIZ,SW,7366,2553,4366,1496,1523,655,2843,841,69,44,1257,446,834,297,423,149,149,,,,1612,540,1525,508,5,3,75,26,7,3,32,62,27
E02000197,Croydon 004,Middle Super Output Areas and Intermediate Zones,MSOAIZ,SW,9072,3403,4778,1823,1591,767,3187,1056,122,48,1536,631,1141,442,395,189,189,,,,2514,859,2409,819,2,1,84,32,19,7,40,122,42
E02000198,Croydon 005,Middle Super Output Areas and Intermediate Zones,MSOAIZ,SE,8021,3338,3882,1651,1060,542,2822,1109,67,33,1766,718,812,320,954,398,398,,,,2229,892,2088,827,13,4,94,46,34,15,65,77,44
E02000199,Croydon 006,Middle Super Output Areas and Intermediate Zones,MSOAIZ,SE,8423,3172,5216,2056,1395,671,3821,1385,46,18,1061,351,242,90,819,261,261,,,,1995,700,1851,646,13,4,106,42,25,8,54,105,47
E02000200,Croydon 007,Middle Super Output Areas and Intermediate Zones,MSOAIZ,SE,8192,3811,4441,2036,1191,666,3250,1370,65,28,1069,473,272,141,797,332,332,,,,2523,1228,2414,1176,9,4,71,34,29,14,52,94,46
E02000201,Croydon 008,Middle Super Output Areas and Intermediate Zones,MSOAIZ,SE,8281,3814,3233,1437,794,426,2439,1011,51,26,2312,1124,1016,519,1296,605,605,,,,2593,1175,2498,1132,3,2,53,27,39,14,43,92,52
E02000202,Croydon 009,Middle Super Output Areas and Intermediate Zones,MSOAIZ,SW,8503,2981,5529,2014,1883,835,3646,1179,70,21,469,163,182,63,287,100,100,,,,2339,747,2187,704,0,0,131,38,21,5,43,96,36
E02000203,Croydon 010,Middle Super Output Areas and Intermediate Zones,MSOAIZ,SE,7494,3062,3571,1400,1093,498,2478,902,153,71,1419,687,663,378,756,309,309,,,,2298,880,2170,820,25,11,82,41,21,8,60,53,24
E02000204,Croydon 011,Middle Super Output Areas and Intermediate Zones,MSOAIZ,SW,9310,3146,5668,1974,2103,844,3565,1130,91,39,788,266,169,68,619,198,198,,,,2651,815,2522,770,4,2,116,38,9,5,45,112,52
E02000206,Croydon 013,Middle Super Output Areas and Intermediate Zones,MSOAIZ,SE,9399,4009,3908,1695,1003,505,2905,1190,114,61,2485,1049,1074,505,1411,544,544,,,,2745,1136,2647,1082,7,3,56,37,35,14,54,147,68
E02000207,Croydon 014,Middle Super Output Areas and Intermediate Zones,MSOAIZ,SE,8977,3592,4342,1721,1114,547,3228,1174,247,95,2593,1007,792,361,1801,646,646,,,,1726,731,1656,699,0,0,61,25,9,7,32,69,38
E02000208,Croydon 015,Middle Super Output Areas and Intermediate Zones,MSOAIZ,CR,9645,3821,3374,1322,804,372,2570,950,358,174,2783,1113,1005,456,1778,657,657,,,,2942,1135,2822,1090,9,3,48,20,63,22,45,188,77
E02000209,Croydon 016,Middle Super Output Areas and Intermediate Zones,MSOAIZ,CR,8411,2919,4584,1655,1168,539,3416,1116,66,22,1448,504,303,131,1145,373,373,,,,2242,711,2077,660,3,1,118,34,44,16,51,71,27
E02000210,Croydon 017,Middle Super Output Areas and Intermediate Zones,MSOAIZ,SE,8300,3371,5220,2212,1409,723,3811,1489,149,61,1020,377,366,144,654,233,233,,,,1839,690,1724,645,13,3,75,32,27,10,45,72,31
E02000211,Croydon 018,Middle Super Output Areas and Intermediate Zones,MSOAIZ,CR,8000,3279,6706,2780,2364,1264,4342,1516,17,6,516,200,53,18,463,182,182,,,,729,276,677,252,6,4,38,18,8,2,24,32,17
E02000212,Croydon 019,Middle Super Output Areas and Intermediate Zones,MSOAIZ,CR,8522,2977,3757,1358,996,467,2761,891,137,64,2062,740,1290,458,772,282,282,,,,2512,788,2373,745,0,0,106,32,33,11,43,54,27
E02000213,Croydon 020,Middle Super Output Areas and Intermediate Zones,MSOAIZ,CR,9495,4160,2674,1166,779,385,1895,781,122,72,2732,1201,1569,734,1163,467,467,,,,3823,1656,3673,1594,17,7,122,49,11,6,62,144,65
E02000214,Croydon 021,Middle Super Output Areas and Intermediate Zones,MSOAIZ,CR,6219,2321,4956,1854,1858,874,3098,980,87,40,375,129,70,28,305,101,101,,,,751,280,705,259,0,0,44,19,2,2,21,50,18
E02000215,Croydon 022,Middle Super Output Areas and Intermediate Zones,MSOAIZ,CR,10414,4991,4428,2125,1441,791,2987,1334,88,54,1437,800,608,413,829,387,387,,,,4330,1948,4157,1862,19,7,122,62,32,17,86,131,64
E02000216,Croydon 023,Middle Super Output Areas and Intermediate Zones,MSOAIZ,CR,6622,3028,3575,1673,1751,968,1824,705,6,4,629,350,56,23,573,327,327,,,,2345,964,2261,929,0,0,74,31,10,4,35,67,37
E02000217,Croydon 024,Middle Super Output Areas and Intermediate Zones,MSOAIZ,CR,9688,4273,4446,1936,1104,593,3342,1343,193,103,2085,953,955,445,1130,508,508,,,,2860,1235,2730,1167,11,10,82,39,37,19,68,104,46
E02000218,Croydon 025,Middle Super Output Areas and Intermediate Zones,MSOAIZ,CR,6640,2369,3685,1378,1346,649,2339,729,14,5,2468,826,2013,691,455,135,135,,,,402,139,359,122,10,4,27,11,6,2,17,71,21
E02000219,Croydon 026,Middle Super Output Areas and Intermediate Zones,MSOAIZ,CR,7650,2999,6768,2662,2827,1422,3941,1240,15,7,228,84,61,30,167,54,54,,,,548,204,496,182,13,5,20,11,19,6,22,91,42
E02000220,Croydon 027,Middle Super Output Areas and Intermediate Zones,MSOAIZ,CR,9509,4847,3133,1676,941,615,2192,1061,309,180,1516,756,539,262,977,494,494,,,,4427,2172,4189,2073,64,26,122,49,52,24,99,124,63
E02000221,Croydon 028,Middle Super Output Areas and Intermediate Zones,MSOAIZ,CR,9630,3866,4473,1874,1313,701,3160,1173,125,59,3373,1264,2180,857,1193,407,407,,,,1533,612,1437,570,23,11,64,28,9,3,42,126,57
E02000222,Croydon 029,Middle Super Output Areas and Intermediate Zones,MSOAIZ,CR,7806,3539,4816,2142,1725,863,3091,1279,113,56,758,343,125,61,633,282,282,,,,2064,968,1954,920,9,4,93,40,8,4,48,55,30
E02000223,Croydon 030,Middle Super Output Areas and Intermediate Zones,MSOAIZ,CR,8371,2875,2097,796,609,314,1488,482,25,6,5720,1914,4886,1679,834,235,235,,,,462,135,439,128,0,0,12,4,11,3,7,67,24
E02000224,Croydon 031,Middle Super Output Areas and Intermediate Zones,MSOAIZ,CR,7646,3309,4917,2047,1441,718,3476,1329,88,42,565,246,126,66,439,180,180,,,,2003,934,1901,891,4,4,88,33,10,6,43,73,40
E02000225,Croydon 032,Middle Super Output Areas and Intermediate Zones,MSOAIZ,CR,7534,2708,3906,1504,1276,630,2630,874,62,23,3027,1012,1971,705,1056,307,307,,,,496,152,464,139,0,0,26,11,6,2,13,43,17
E02000226,Croydon 033,Middle Super Output Areas and Intermediate Zones,MSOAIZ,CR,7350,2796,6593,2535,2570,1287,4023,1248,24,7,86,31,51,19,35,12,12,,,,598,201,552,185,19,7,24,7,3,2,16,49,22
E02000227,Croydon 034,Middle Super Output Areas and Intermediate Zones,MSOAIZ,CR,11411,4851,8343,3622,2770,1533,5573,2089,88,31,1456,510,877,335,579,175,175,,,,1465,656,1307,590,18,5,136,58,4,3,66,59,32
E02000228,Croydon 035,Middle Super Output Areas and Intermediate Zones,MSOAIZ,CR,7539,2924,6745,2587,2915,1410,3830,1177,10,2,185,76,102,52,83,24,24,,,,542,233,500,216,11,3,27,13,4,1,17,57,26
E02000229,Croydon 036,Middle Super Output Areas and Intermediate Zones,MSOAIZ,CR,6315,2413,2561,975,747,384,1814,591,62,22,2996,1181,2178,916,818,265,265,,,,652,211,606,195,14,4,22,9,10,3,16,44,24
E02000230,Croydon 037,Middle Super Output Areas and Intermediate Zones,MSOAIZ,CR,9745,4004,7070,2838,2540,1275,4530,1563,152,69,620,277,164,70,456,207,207,,,,1813,780,1729,742,5,2,68,32,11,4,38,90,40
E02000231,Croydon 038,Middle Super Output Areas and Intermediate Zones,MSOAIZ,CR,7441,2543,6587,2233,2532,1072,4055,1161,8,2,132,40,50,17,82,23,23,,,,671,251,612,228,8,2,32,14,19,7,23,43,17
E02000232,Croydon 039,Middle Super Output Areas and Intermediate Zones,MSOAIZ,CR,6178,2324,5060,1931,1861,953,3199,978,10,6,659,243,533,208,126,35,35,,,,418,128,395,121,13,4,10,3,0,0,7,31,16
E02000233,Croydon 040,Middle Super Output Areas and Intermediate Zones,MSOAIZ,CR,5977,2391,4418,1758,1300,654,3118,1104,32,10,812,333,501,210,311,123,123,,,,676,272,639,255,0,0,36,16,1,1,17,39,18
E02000234,Croydon 041,Middle Super Output Areas and Intermediate Zones,MSOAIZ,CR,7980,3161,5616,2175,1913,928,3703,1247,154,79,1004,408,369,153,635,255,255,,,,1144,468,1082,442,8,2,49,21,5,3,26,62,31
E02000235,Croydon 042,Middle Super Output Areas and Intermediate Zones,MSOAIZ,CR,6900,2694,5557,2154,1931,946,3626,1208,78,38,747,282,356,133,391,149,149,,,,482,203,450,187,3,2,24,12,5,2,16,36,17
E02000236,Croydon 043,Middle Super Output Areas and Intermediate Zones,MSOAIZ,CR,7631,2838,6639,2490,2163,1069,4476,1421,17,6,418,142,280,100,138,42,42,,,,540,188,503,172,5,2,32,14,0,0,16,17,12
E02000237,Croydon 044,Middle Super Output Areas and Intermediate Zones,MSOAIZ,CR,7455,3090,6154,2491,2357,1231,3797,1260,0,0,808,406,732,382,76,24,24,,,,435,162,374,134,22,8,31,17,8,3,28,58,31
E02000238,Ealing 001,Middle Super Output Areas and Intermediate Zones,MSOAIZ,UB,9381,3179,5589,1994,1648,753,3941,1241,108,43,1089,382,610,244,479,138,138,,,,2520,730,2428,700,5,1,73,25,14,4,30,75,30
E02000239,Ealing 002,Middle Super Output Areas and Intermediate Zones,MSOAIZ,UB,9000,2924,5900,2058,2333,1008,3567,1050,69,31,275,93,226,77,49,16,16,,,,2713,721,2587,683,23,7,74,24,29,7,38,43,21
E02000240,Ealing 003,Middle Super Output Areas and Intermediate Zones,MSOAIZ,UB,10265,3770,4731,1817,1391,711,3340,1106,208,89,3213,1218,2103,851,1110,367,367,,,,1983,597,1871,565,4,1,77,22,31,9,32,130,49
E02000241,Ealing 004,Middle Super Output Areas and Intermediate Zones,MSOAIZ,UB,6639,2366,4108,1576,1372,668,2736,908,49,16,484,155,188,56,296,99,99,,,,1905,585,1820,554,11,6,72,24,2,1,31,93,34
E02000242,Ealing 005,Middle Super Output Areas and Intermediate Zones,MSOAIZ,UB,6763,2151,4196,1371,1475,607,2721,764,38,14,326,102,217,70,109,32,32,,,,2150,641,2010,600,3,1,111,31,26,9,41,53,23
E02000243,Ealing 006,Middle Super Output Areas and Intermediate Zones,MSOAIZ,UB,8467,3068,4549,1674,1617,718,2932,956,73,31,1242,534,704,329,538,205,205,,,,2497,783,2402,748,13,3,77,30,5,2,35,106,46
E02000244,Ealing 007,Middle Super Output Areas and Intermediate Zones,MSOAIZ,UB,7172,2658,4294,1678,1596,759,2698,919,87,33,451,188,208,95,243,93,93,,,,2231,713,2085,670,25,6,108,34,13,3,43,109,46
E02000245,Ealing 008,Middle Super Output Areas and Intermediate Zones,MSOAIZ,UB,8144,3210,2888,1124,711,360,2177,764,171,82,3267,1308,2020,844,1247,464,464,,,,1722,650,1675,629,1,1,24,12,22,8,21,96,46
E02000246,Ealing 009,Middle Super Output Areas and Intermediate Zones,MSOAIZ,UB,8748,3071,4192,1465,1229,563,2963,902,79,22,2716,1015,2298,887,418,128,128,,,,1658,518,1595,493,3,1,43,18,17,6,25,103,51
E02000247,Ealing 010,Middle Super Output Areas and Intermediate Zones,MSOAIZ,UB,10090,3755,4586,1794,1372,653,3214,1141,268,124,2443,912,1338,554,1105,358,358,,,,2666,883,2536,840,3,1,95,34,32,8,43,127,42
E02000248,Ealing 011,Middle Super Output Areas and Intermediate Zones,MSOAIZ,W,7334,2902,3278,1387,1473,744,1805,643,181,86,274,104,105,38,169,66,66,,,,3498,1276,3398,1231,17,3,76,36,7,6,45,103,49
E02000249,Ealing 012,Middle Super Output Areas and Intermediate Zones,MSOAIZ,UB,7678,2739,3966,1470,1542,716,2424,754,180,82,1107,438,848,328,259,110,110,,,,2305,702,2213,671,11,3,64,23,17,5,31,120,47
E02000250,Ealing 013,Middle Super Output Areas and Intermediate Zones,MSOAIZ,W,6367,2541,4639,1844,1917,930,2722,914,41,32,196,104,127,77,69,27,27,,,,1448,541,1425,528,1,1,17,9,5,3,13,43,20
E02000251,Ealing 014,Middle Super Output Areas and Intermediate Zones,MSOAIZ,UB,7944,2442,5379,1713,1879,758,3500,955,72,23,389,123,151,49,238,74,74,,,,2036,551,1921,522,0,0,102,25,13,4,29,68,32
E02000252,Ealing 015,Middle Super Output Areas and Intermediate Zones,MSOAIZ,W,9647,3717,2909,1217,1251,582,1658,635,410,219,2209,888,516,205,1693,683,683,,,,3985,1331,3850,1288,12,4,72,22,51,17,43,134,62
E02000253,Ealing 016,Middle Super Output Areas and Intermediate Zones,MSOAIZ,W,9565,3744,4126,1583,1305,630,2821,953,83,31,3505,1541,3002,1348,503,193,193,,,,1705,522,1618,497,0,0,62,18,25,7,25,146,67
E02000254,Ealing 017,Middle Super Output Areas and Intermediate Zones,MSOAIZ,UB,8827,2487,6035,1713,2483,815,3552,898,39,10,641,207,478,154,163,53,53,,,,1995,517,1872,479,3,1,107,33,13,4,38,117,40
E02000255,Ealing 018,Middle Super Output Areas and Intermediate Zones,MSOAIZ,W,9329,3622,4991,2013,1954,941,3037,1072,55,21,2108,733,1339,455,769,278,278,,,,2072,810,2015,787,8,3,41,17,8,3,23,103,45
E02000256,Ealing 019,Middle Super Output Areas and Intermediate Zones,MSOAIZ,W,8651,3782,4297,1777,1951,907,2346,870,148,87,722,349,145,65,577,284,284,,,,3384,1519,3290,1476,26,7,44,25,24,11,43,100,50
E02000257,Ealing 020,Middle Super Output Areas and Intermediate Zones,MSOAIZ,W,13210,5873,5554,2453,2709,1305,2845,1148,53,29,1241,646,232,125,1009,521,521,,,,6180,2658,6042,2586,30,14,88,52,20,6,72,182,87
E02000258,Ealing 021,Middle Super Output Areas and Intermediate Zones,MSOAIZ,W,6659,2544,2973,1147,1201,523,1772,624,59,28,875,412,210,114,665,298,298,,,,2656,927,2474,872,10,3,63,21,109,31,55,96,30
E02000259,Ealing 022,Middle Super Output Areas and Intermediate Zones,MSOAIZ,W,6275,2283,3933,1462,1403,634,2530,828,51,15,584,202,215,77,369,125,125,,,,1658,584,1584,558,22,7,31,14,21,5,26,49,20
E02000260,Ealing 023,Middle Super Output Areas and Intermediate Zones,MSOAIZ,UB,8532,2468,4896,1404,2283,743,2613,661,79,25,1068,395,563,229,505,166,166,,,,2315,593,2097,547,9,2,126,30,83,14,46,174,51
E02000261,Ealing 024,Middle Super Output Areas and Intermediate Zones,MSOAIZ,W,10752,4110,3872,1559,1705,744,2167,815,451,249,2396,971,1408,533,988,438,438,,,,3873,1265,3742,1213,6,4,62,28,63,20,52,160,66
E02000262,Ealing 025,Middle Super Output Areas and Intermediate Zones,MSOAIZ,W,8755,3771,3373,1400,1153,517,2220,883,92,53,1921,944,816,365,1105,579,579,,,,3274,1326,3157,1282,2,1,80,33,35,10,44,95,48
E02000263,Ealing 026,Middle Super Output Areas and Intermediate Zones,MSOAIZ,UB,11575,3155,6819,1794,3094,945,3725,849,166,55,1354,477,393,144,961,333,333,,,,3044,756,2759,693,17,4,130,29,138,30,63,192,73
E02000264,Ealing 027,Middle Super Output Areas and Intermediate Zones,MSOAIZ,W,7979,3205,3926,1550,1753,781,2173,769,78,37,661,324,197,82,464,242,242,,,,3212,1251,3132,1214,8,5,54,22,18,10,37,102,43
E02000265,Ealing 028,Middle Super Output Areas and Intermediate Zones,MSOAIZ,W,10981,4747,4709,1944,1539,694,3170,1250,220,115,2545,1255,1334,618,1211,637,637,,,,3362,1356,3249,1305,17,6,79,33,17,12,51,145,77
E02000266,Ealing 029,Middle Super Output Areas and Intermediate Zones,MSOAIZ,W,11638,3711,3956,1232,1628,573,2328,659,367,153,5288,1728,3165,1072,2123,656,656,,,,1850,534,1724,494,14,4,78,26,34,10,40,177,64
E02000267,Ealing 030,Middle Super Output Areas and Intermediate Zones,MSOAIZ,W,6913,2847,3791,1593,1185,588,2606,1005,123,69,722,328,318,128,404,200,200,,,,2196,823,2112,785,3,3,43,20,38,15,38,81,34
E02000268,Ealing 031,Middle Super Output Areas and Intermediate Zones,MSOAIZ,W,9125,3824,4840,1981,1909,888,2931,1093,65,35,1411,643,1088,483,323,160,160,,,,2711,1108,2622,1071,14,6,51,24,24,7,37,98,57
E02000269,Ealing 032,Middle Super Output Areas and Intermediate Zones,MSOAIZ,W,8003,3245,5053,2061,1950,926,3103,1135,25,13,353,168,173,91,180,77,77,,,,2463,956,2354,918,16,5,82,27,11,6,38,109,47
E02000270,Ealing 033,Middle Super Output Areas and Intermediate Zones,MSOAIZ,W,8040,3331,1882,819,648,316,1234,503,195,84,3834,1633,2988,1256,846,377,377,,,,1896,703,1827,674,6,2,48,20,15,7,29,233,92
E02000271,Ealing 034,Middle Super Output Areas and Intermediate Zones,MSOAIZ,W,6757,2871,4354,1820,1771,871,2583,949,49,24,327,168,175,84,152,84,84,,,,1955,825,1916,802,4,2,29,16,6,5,23,72,34
E02000272,Ealing 035,Middle Super Output Areas and Intermediate Zones,MSOAIZ,W,6703,2579,4860,1909,2006,940,2854,969,40,18,384,144,305,105,79,39,39,,,,1373,486,1330,468,3,1,39,16,1,1,18,46,22
E02000274,Ealing 037,Middle Super Output Areas and Intermediate Zones,MSOAIZ,UB,12724,3557,6496,1837,2575,852,3921,985,171,59,1634,486,508,133,1126,353,353,,,,4174,1101,3890,1027,25,8,135,39,124,27,74,249,74
E02000275,Ealing 038,Middle Super Output Areas and Intermediate Zones,MSOAIZ,UB,6923,2131,3867,1089,1629,521,2238,568,50,17,1144,455,574,226,570,229,229,,,,1770,525,1666,489,28,6,37,16,39,14,36,92,45
E02000276,Ealing 039,Middle Super Output Areas and Intermediate Zones,MSOAIZ,W,6459,2634,3824,1532,1240,583,2584,949,17,9,507,283,301,168,206,115,115,,,,2065,780,1979,742,12,5,69,30,5,3,38,46,30
E02000277,Enfield 001,Middle Super Output Areas and Intermediate Zones,MSOAIZ,EN,7038,2651,4640,1777,1593,773,3047,1004,100,44,879,302,472,157,407,145,145,,,,1348,496,1281,465,10,4,51,26,6,1,31,71,32
E02000278,Enfield 002,Middle Super Output Areas and Intermediate Zones,MSOAIZ,EN,8771,3278,3821,1522,1312,677,2509,845,146,57,3014,1097,2102,796,912,301,301,,,,1667,555,1620,536,5,1,40,16,2,2,19,123,47
E02000279,Enfield 003,Middle Super Output Areas and Intermediate Zones,MSOAIZ,EN,11289,4356,5208,2046,1207,603,4001,1443,157,73,2890,1048,1211,446,1679,602,602,,,,2860,1128,2743,1087,1,1,76,28,40,12,41,174,61
E02000280,Enfield 004,Middle Super Output Areas and Intermediate Zones,MSOAIZ,EN,8464,3466,5594,2266,1979,1002,3615,1264,104,40,1534,688,1238,574,296,114,114,,,,1118,421,1036,388,15,7,58,23,9,3,33,114,51
E02000281,Enfield 005,Middle Super Output Areas and Intermediate Zones,MSOAIZ,EN,8705,3531,4865,1969,1389,730,3476,1239,62,26,1804,713,1190,487,614,226,226,,,,1872,771,1809,742,11,4,37,20,15,5,29,102,52
E02000282,Enfield 006,Middle Super Output Areas and Intermediate Zones,MSOAIZ,EN,9112,3491,3535,1357,962,477,2573,880,50,29,3087,1208,2427,966,660,242,242,,,,2322,840,2239,814,11,4,35,11,37,11,26,118,57
E02000283,Enfield 007,Middle Super Output Areas and Intermediate Zones,MSOAIZ,EN,8408,2843,4930,1784,1561,711,3369,1073,47,17,1635,496,1172,359,463,137,137,,,,1671,508,1604,481,0,0,56,21,11,6,27,125,38
E02000284,Enfield 008,Middle Super Output Areas and Intermediate Zones,MSOAIZ,EN,8152,3497,5501,2352,1920,1025,3581,1327,66,35,858,365,703,272,155,93,93,,,,1650,704,1545,658,13,7,71,33,21,6,46,77,41
E02000285,Enfield 009,Middle Super Output Areas and Intermediate Zones,MSOAIZ,EN,6568,2466,5703,2126,2239,1075,3464,1051,18,10,212,87,81,41,131,46,46,,,,575,215,539,200,10,4,9,5,17,6,15,60,28
E02000286,Enfield 010,Middle Super Output Areas and Intermediate Zones,MSOAIZ,EN,7940,3863,5643,2707,2458,1387,3185,1320,26,13,357,176,185,86,172,90,90,,,,1831,926,1674,853,75,28,56,31,26,14,73,83,41
E02000287,Enfield 011,Middle Super Output Areas and Intermediate Zones,MSOAIZ,N,6494,2540,5048,1886,2307,1054,2741,832,14,7,382,247,268,175,114,72,72,,,,948,361,921,343,5,4,10,5,12,9,18,102,39
E02000288,Enfield 012,Middle Super Output Areas and Intermediate Zones,MSOAIZ,N,10462,3784,5192,1902,1623,768,3569,1134,200,89,2196,806,1436,531,760,275,275,,,,2715,925,2628,893,16,5,52,19,19,8,32,159,62
E02000289,Enfield 013,Middle Super Output Areas and Intermediate Zones,MSOAIZ,N,6569,2421,5551,2061,2403,1119,3148,942,32,12,422,155,264,93,158,62,62,,,,520,169,486,155,1,1,27,9,6,4,14,44,24
E02000290,Enfield 014,Middle Super Output Areas and Intermediate Zones,MSOAIZ,EN,7242,2853,2563,956,786,364,1777,592,91,33,2666,1124,2096,894,570,230,230,,,,1844,705,1782,676,4,3,51,23,7,3,29,78,35
E02000291,Enfield 015,Middle Super Output Areas and Intermediate Zones,MSOAIZ,EN,8809,3998,4721,2208,1717,1003,3004,1205,34,14,1472,631,1210,484,262,147,147,,,,2507,1107,2434,1068,0,0,53,29,20,10,39,75,38
E02000292,Enfield 016,Middle Super Output Areas and Intermediate Zones,MSOAIZ,N,9495,3578,6655,2585,2135,1073,4520,1512,33,13,857,293,697,240,160,53,53,,,,1878,660,1827,636,0,0,41,21,10,3,24,72,27
E02000293,Enfield 017,Middle Super Output Areas and Intermediate Zones,MSOAIZ,N,6274,2470,5306,2069,2356,1143,2950,926,4,3,145,66,97,37,48,29,29,,,,755,300,707,281,8,2,35,14,5,3,19,64,32
E02000294,Enfield 018,Middle Super Output Areas and Intermediate Zones,MSOAIZ,N,8700,3009,4957,1825,1722,801,3235,1024,35,15,1518,517,1107,386,411,131,131,,,,2053,599,1957,567,1,1,70,24,25,7,32,137,53
E02000295,Enfield 019,Middle Super Output Areas and Intermediate Zones,MSOAIZ,N,8287,3347,5601,2279,2346,1138,3255,1141,107,53,801,313,289,128,512,185,185,,,,1708,671,1656,649,5,2,35,17,12,3,22,70,31
E02000296,Enfield 020,Middle Super Output Areas and Intermediate Zones,MSOAIZ,N,9406,3941,4600,2077,1996,1092,2604,985,51,24,1129,447,934,373,195,74,74,,,,3521,1337,3419,1282,18,7,74,42,10,6,55,105,56
E02000297,Enfield 021,Middle Super Output Areas and Intermediate Zones,MSOAIZ,N,9235,3482,7867,2971,3158,1499,4709,1472,12,7,215,74,160,54,55,20,20,,,,1078,398,1034,377,0,0,35,17,9,4,21,63,32
E02000298,Enfield 022,Middle Super Output Areas and Intermediate Zones,MSOAIZ,N,7909,3075,6328,2385,2594,1181,3734,1204,9,5,269,121,203,92,66,29,29,,,,1234,530,1190,507,9,6,32,15,3,2,23,69,34
E02000299,Enfield 023,Middle Super Output Areas and Intermediate Zones,MSOAIZ,N,9262,3438,4378,1727,1636,759,2742,968,184,75,1711,636,965,344,746,292,292,,,,2863,947,2761,901,7,3,60,24,35,19,46,126,53
E02000300,Enfield 024,Middle Super Output Areas and Intermediate Zones,MSOAIZ,N,8102,2998,4236,1635,1502,690,2734,945,45,14,1050,364,623,222,427,142,142,,,,2641,932,2549,899,0,0,58,22,34,11,33,130,53
E02000301,Enfield 025,Middle Super Output Areas and Intermediate Zones,MSOAIZ,N,10070,3923,3778,1496,1262,605,2516,891,126,53,3295,1319,1671,700,1624,619,619,,,,2688,989,2602,957,8,1,60,23,18,8,32,183,66
E02000302,Enfield 026,Middle Super Output Areas and Intermediate Zones,MSOAIZ,N,8276,3123,5751,2145,2214,1029,3537,1116,50,12,861,401,605,277,256,124,124,,,,1513,518,1474,497,6,3,25,14,8,4,21,101,47
E02000303,Enfield 027,Middle Super Output Areas and Intermediate Zones,MSOAIZ,N,8372,3120,3329,1202,913,437,2416,765,32,14,2651,1066,1803,722,848,344,344,,,,2183,779,2128,749,13,4,20,13,22,13,30,177,59
E02000304,Enfield 028,Middle Super Output Areas and Intermediate Zones,MSOAIZ,N,7997,2964,6296,2308,2629,1196,3667,1112,56,24,167,81,96,54,71,27,27,,,,1421,523,1375,502,4,2,36,17,6,2,21,57,28
E02000305,Enfield 029,Middle Super Output Areas and Intermediate Zones,MSOAIZ,N,8473,3481,5340,2157,1915,899,3425,1258,24,11,346,166,178,61,168,105,105,,,,2667,1096,2540,1043,19,7,76,33,32,13,53,96,51
E02000306,Enfield 030,Middle Super Output Areas and Intermediate Zones,MSOAIZ,N,9149,3594,2027,752,532,248,1495,504,298,130,4843,1979,2696,1036,2147,943,943,,,,1811,667,1743,640,0,0,50,17,18,10,27,170,66
E02000307,Enfield 031,Middle Super Output Areas and Intermediate Zones,MSOAIZ,N,9873,3368,6188,2241,2266,1010,3922,1231,31,14,938,291,700,208,238,83,83,,,,2571,766,2480,734,5,3,75,26,11,3,32,145,56
E02000308,Enfield 032,Middle Super Output Areas and Intermediate Zones,MSOAIZ,N,7661,2908,4039,1576,1770,805,2269,771,22,7,1328,546,1019,417,309,129,129,,,,2179,738,2074,696,11,2,62,22,32,18,42,93,41
E02000309,Enfield 033,Middle Super Output Areas and Intermediate Zones,MSOAIZ,N,10412,3785,4399,1695,1312,645,3087,1050,89,41,2365,847,1633,559,732,288,288,,,,3317,1118,3194,1071,16,6,56,26,51,15,47,242,84
E02000311,Enfield 035,Middle Super Output Areas and Intermediate Zones,MSOAIZ,N,9861,3656,5581,2138,2252,995,3329,1143,65,33,1584,596,669,244,915,352,352,,,,2516,846,2411,806,3,1,79,30,23,9,40,115,43
E02000312,Enfield 036,Middle Super Output Areas and Intermediate Zones,MSOAIZ,N,10404,4262,5588,2257,2348,1068,3240,1189,80,32,709,341,296,145,413,196,196,,,,3861,1556,3733,1494,7,3,71,37,50,22,62,166,76
E02000313,Greenwich 001,Middle Super Output Areas and Intermediate Zones,MSOAIZ,SE,6563,2575,1646,584,368,168,1278,416,73,39,3768,1621,222,111,3546,1510,1510,,,,1045,314,950,288,4,1,70,17,21,8,26,31,17
E02000314,Greenwich 002,Middle Super Output Areas and Intermediate Zones,MSOAIZ,SE,12265,4382,4708,1689,623,271,4085,1418,422,188,2759,1025,191,84,2568,941,941,,,,4310,1447,4145,1389,9,3,131,48,25,7,58,66,33
E02000315,Greenwich 003,Middle Super Output Areas and Intermediate Zones,MSOAIZ,SE,9039,3440,3348,1291,922,494,2426,797,46,20,4022,1604,3362,1385,660,219,219,,,,1529,487,1445,463,2,1,69,19,13,4,24,94,38
E02000316,Greenwich 004,Middle Super Output Areas and Intermediate Zones,MSOAIZ,SE,10698,4944,1878,913,387,202,1491,711,577,334,4613,2013,2875,1362,1738,651,651,,,,3520,1630,3361,1565,19,5,104,48,36,12,65,110,54
E02000317,Greenwich 005,Middle Super Output Areas and Intermediate Zones,MSOAIZ,SE,8293,3200,1654,634,482,220,1172,414,78,33,5239,2063,4116,1698,1123,365,365,,,,1198,424,1131,399,0,0,53,18,14,7,25,124,46
E02000318,Greenwich 006,Middle Super Output Areas and Intermediate Zones,MSOAIZ,SE,9842,3283,4112,1430,1163,493,2949,937,56,21,2019,843,1047,444,972,399,399,,,,3567,951,3397,904,9,1,116,36,45,10,47,88,38
E02000319,Greenwich 007,Middle Super Output Areas and Intermediate Zones,MSOAIZ,SE,10825,3866,3609,1370,1071,453,2538,917,202,106,3011,1210,1269,541,1742,669,669,,,,3909,1142,3730,1084,12,3,111,39,56,16,58,94,38
E02000320,Greenwich 008,Middle Super Output Areas and Intermediate Zones,MSOAIZ,SE,6603,2524,3615,1356,1044,497,2571,859,36,13,1599,717,1343,630,256,87,87,,,,1297,419,1225,396,4,1,60,20,8,2,23,56,19
E02000321,Greenwich 009,Middle Super Output Areas and Intermediate Zones,MSOAIZ,SE,7147,2877,1729,679,506,234,1223,445,109,45,3706,1581,3179,1395,527,186,186,,,,1489,522,1407,497,1,1,53,13,28,11,25,114,50
E02000323,Greenwich 011,Middle Super Output Areas and Intermediate Zones,MSOAIZ,SE,10631,4001,2610,961,825,340,1785,621,253,108,4937,1976,3758,1508,1179,468,468,,,,2738,912,2574,859,10,3,112,36,42,14,53,93,44
E02000324,Greenwich 012,Middle Super Output Areas and Intermediate Zones,MSOAIZ,SE,7181,2807,2441,909,694,320,1747,589,25,8,3608,1483,1893,822,1715,661,661,,,,1028,374,963,350,0,0,40,18,25,6,24,79,33
E02000326,Greenwich 014,Middle Super Output Areas and Intermediate Zones,MSOAIZ,SE,7063,2932,3435,1483,1071,547,2364,936,26,13,2205,878,634,281,1571,597,597,,,,1353,538,1255,498,10,4,73,30,15,6,40,44,20
E02000327,Greenwich 015,Middle Super Output Areas and Intermediate Zones,MSOAIZ,SE,6436,2357,1144,433,220,101,924,332,57,35,3305,1206,2794,1021,511,185,185,,,,1869,659,1024,403,469,137,66,24,310,95,256,61,24
E02000328,Greenwich 016,Middle Super Output Areas and Intermediate Zones,MSOAIZ,SE,6512,3070,3422,1437,1332,610,2090,827,125,68,1568,889,1041,601,527,288,288,,,,1369,656,1316,636,1,1,41,15,11,4,20,28,20
E02000329,Greenwich 017,Middle Super Output Areas and Intermediate Zones,MSOAIZ,SE,6169,2364,3756,1443,1095,538,2661,905,58,19,1272,545,688,307,584,238,238,,,,1031,330,971,308,0,0,51,18,9,4,22,52,27
E02000331,Greenwich 019,Middle Super Output Areas and Intermediate Zones,MSOAIZ,SE,7805,3236,3397,1401,899,464,2498,937,78,32,2644,1142,1822,853,822,289,289,,,,1614,630,1497,586,0,0,91,34,26,10,44,72,31
E02000332,Greenwich 020,Middle Super Output Areas and Intermediate Zones,MSOAIZ,SE,7239,2958,4811,1982,1650,827,3161,1155,49,21,1131,495,580,255,551,240,240,,,,1191,435,1133,414,7,3,38,13,13,5,21,57,25
E02000333,Greenwich 021,Middle Super Output Areas and Intermediate Zones,MSOAIZ,SE,6152,3005,3448,1598,1472,746,1976,852,12,7,877,469,614,313,263,156,156,,,,1732,890,1654,850,21,9,39,20,18,11,40,83,41
E02000334,Greenwich 022,Middle Super Output Areas and Intermediate Zones,MSOAIZ,SE,6463,2585,3876,1515,1206,586,2670,929,47,17,1699,725,1445,641,254,84,84,,,,777,297,728,279,0,0,34,14,15,4,18,64,31
E02000335,Greenwich 023,Middle Super Output Areas and Intermediate Zones,MSOAIZ,SE,6549,2637,5247,2043,1761,881,3486,1162,30,11,743,376,246,153,497,223,223,,,,505,193,449,169,3,1,28,13,25,10,24,24,14
E02000337,Greenwich 025,Middle Super Output Areas and Intermediate Zones,MSOAIZ,SE,7906,2998,3619,1390,952,463,2667,927,101,36,3362,1275,2733,1067,629,208,208,,,,766,265,705,246,4,1,55,16,2,2,19,58,32
E02000339,Greenwich 027,Middle Super Output Areas and Intermediate Zones,MSOAIZ,SE,5963,2502,4469,1716,1643,807,2826,909,1,1,888,499,463,290,425,209,209,,,,531,237,492,221,0,0,30,12,9,4,16,74,49
E02000340,Greenwich 028,Middle Super Output Areas and Intermediate Zones,MSOAIZ,SE,6086,2799,4191,1879,1742,975,2449,904,38,18,750,412,581,333,169,79,79,,,,1041,450,960,412,13,5,63,30,5,3,38,66,40
E02000341,Greenwich 029,Middle Super Output Areas and Intermediate Zones,MSOAIZ,SE,7683,3024,3002,1209,902,437,2100,772,23,9,3922,1546,3502,1408,420,138,138,,,,681,232,598,200,15,4,53,22,15,6,32,55,28
E02000342,Greenwich 030,Middle Super Output Areas and Intermediate Zones,MSOAIZ,SE,5379,2268,2828,1154,961,485,1867,669,123,58,1608,723,1135,538,473,185,185,,,,774,312,684,276,0,0,27,12,63,24,36,46,21
E02000343,Greenwich 031,Middle Super Output Areas and Intermediate Zones,MSOAIZ,SE,6658,2699,3836,1501,1318,658,2518,843,16,7,2132,935,1816,808,316,127,127,,,,618,228,570,212,11,2,32,11,5,3,16,56,28
E02000344,Greenwich 032,Middle Super Output Areas and Intermediate Zones,MSOAIZ,SE,6277,2476,4894,1885,1672,826,3222,1059,31,11,581,283,435,191,146,92,92,,,,743,280,677,258,0,0,65,21,1,1,22,28,17
E02000345,Hackney 001,Middle Super Output Areas and Intermediate Zones,MSOAIZ,N,8828,2693,2487,748,1176,387,1311,361,228,110,1836,636,637,272,1199,364,364,,,,4176,1162,3939,1117,0,0,221,40,16,5,45,101,37
E02000346,Hackney 002,Middle Super Output Areas and Intermediate Zones,MSOAIZ,N,6021,2563,651,290,219,116,432,174,112,45,3956,1722,3328,1436,628,286,286,,,,1222,475,1182,459,8,2,13,7,19,7,16,80,31
E02000347,Hackney 003,Middle Super Output Areas and Intermediate Zones,MSOAIZ,N,7884,2727,2118,744,910,326,1208,418,44,18,2346,1016,1318,579,1028,437,437,,,,3329,923,3142,873,0,0,167,37,20,13,50,47,26
E02000348,Hackney 004,Middle Super Output Areas and Intermediate Zones,MSOAIZ,N,8107,2804,1631,552,673,247,958,305,132,31,3292,1325,1267,563,2025,762,762,,,,2915,851,2802,816,9,2,91,27,13,6,35,137,45
E02000350,Hackney 006,Middle Super Output Areas and Intermediate Zones,MSOAIZ,N,9474,3605,3235,1173,1328,454,1907,719,165,77,2201,869,671,271,1530,598,598,,,,3773,1447,3568,1387,15,3,177,50,13,7,60,100,39
E02000351,Hackney 007,Middle Super Output Areas and Intermediate Zones,MSOAIZ,N,8441,3826,2396,1123,772,391,1624,732,156,83,2240,908,787,312,1453,596,596,,,,3540,1664,3405,1593,9,5,122,64,4,2,71,109,48
E02000352,Hackney 008,Middle Super Output Areas and Intermediate Zones,MSOAIZ,N,6833,2810,2191,887,679,304,1512,583,208,89,2646,1115,1197,549,1449,566,566,,,,1719,688,1619,650,4,1,64,25,32,12,38,69,31
E02000353,Hackney 009,Middle Super Output Areas and Intermediate Zones,MSOAIZ,N,7774,3192,3476,1323,1182,499,2294,824,28,13,1521,692,708,347,813,345,345,,,,2681,1135,2589,1097,11,6,71,26,10,6,38,68,29
E02000354,Hackney 010,Middle Super Output Areas and Intermediate Zones,MSOAIZ,N,9449,4056,2032,866,578,242,1454,624,210,114,4540,1910,2428,1106,2112,804,804,,,,2567,1125,2435,1061,19,10,85,41,28,13,64,100,41
E02000355,Hackney 011,Middle Super Output Areas and Intermediate Zones,MSOAIZ,E,8325,3240,3519,1241,1518,551,2001,690,101,49,1959,811,893,373,1066,438,438,,,,2663,1101,2523,1044,5,3,101,38,34,16,57,83,38
E02000356,Hackney 012,Middle Super Output Areas and Intermediate Zones,MSOAIZ,N,7288,3144,3125,1270,1000,451,2125,819,117,53,1859,861,1066,469,793,392,392,,,,2132,935,2020,889,7,2,75,30,30,14,46,55,25
E02000357,Hackney 013,Middle Super Output Areas and Intermediate Zones,MSOAIZ,E,6339,2507,882,353,230,109,652,244,19,10,4439,1791,2000,866,2439,925,925,,,,906,317,867,300,1,1,29,11,9,5,17,93,36
E02000358,Hackney 014,Middle Super Output Areas and Intermediate Zones,MSOAIZ,N,11047,4775,3139,1287,1029,432,2110,855,155,85,4199,1890,2445,1068,1754,822,822,,,,3437,1463,3305,1406,9,2,74,34,49,21,57,117,50
E02000359,Hackney 015,Middle Super Output Areas and Intermediate Zones,MSOAIZ,E,6569,2416,2523,968,862,376,1661,592,79,29,2235,799,1098,424,1137,375,375,,,,1629,582,1557,557,8,2,52,16,12,7,25,103,38
E02000360,Hackney 016,Middle Super Output Areas and Intermediate Zones,MSOAIZ,N,11292,4747,1666,725,439,196,1227,529,169,85,6933,2877,2055,812,4878,2065,2065,,,,2330,988,2206,937,2,1,77,29,45,21,51,194,72
E02000361,Hackney 017,Middle Super Output Areas and Intermediate Zones,MSOAIZ,E,7632,3467,1555,703,479,229,1076,474,90,48,3157,1373,1442,636,1715,737,737,,,,2774,1310,2692,1269,9,5,59,30,14,6,41,56,33
E02000362,Hackney 018,Middle Super Output Areas and Intermediate Zones,MSOAIZ,E,6266,2634,1330,600,369,181,961,419,307,165,2871,1183,1197,558,1674,625,625,,,,1673,655,1606,630,2,1,55,21,10,3,25,85,31
E02000363,Hackney 019,Middle Super Output Areas and Intermediate Zones,MSOAIZ,E,10845,4402,1580,636,388,190,1192,446,248,126,7283,2975,5211,2157,2072,818,818,,,,1608,610,1522,576,1,1,50,20,35,13,34,126,55
E02000364,Hackney 020,Middle Super Output Areas and Intermediate Zones,MSOAIZ,E,8848,3899,2878,1209,944,456,1934,753,152,75,3289,1518,1410,606,1879,912,912,,,,2427,1054,2288,994,2,1,121,51,16,8,60,102,43
E02000365,Hackney 021,Middle Super Output Areas and Intermediate Zones,MSOAIZ,N,12708,5740,3234,1478,1118,544,2116,934,226,100,4298,1919,1879,848,2419,1071,1071,,,,4784,2166,4631,2091,16,7,116,60,21,8,75,166,77
E02000366,Hackney 022,Middle Super Output Areas and Intermediate Zones,MSOAIZ,E,8396,3690,1981,830,614,283,1367,547,101,54,4756,2118,1664,731,3092,1387,1387,,,,1448,623,1340,580,0,0,68,24,40,19,43,110,65
E02000367,Hackney 023,Middle Super Output Areas and Intermediate Zones,MSOAIZ,E,9622,4163,2216,1028,590,283,1626,745,378,191,4007,1604,1481,610,2526,994,994,,,,2928,1297,2810,1237,10,6,94,47,14,7,60,93,43
E02000368,Hackney 024,Middle Super Output Areas and Intermediate Zones,MSOAIZ,E,9601,4028,1622,743,427,209,1195,534,60,28,5969,2502,4655,1946,1314,556,556,,,,1794,700,1684,656,4,3,79,27,27,14,44,156,55
E02000369,Hackney 025,Middle Super Output Areas and Intermediate Zones,MSOAIZ,N,11560,5100,1512,757,461,247,1051,510,576,317,6636,2712,4290,1762,2346,950,950,,,,2647,1238,2539,1191,4,1,72,34,32,12,47,189,76
E02000370,Hackney 026,Middle Super Output Areas and Intermediate Zones,MSOAIZ,N,8292,3768,1295,660,384,232,911,428,270,158,4785,2077,3823,1705,962,372,372,,,,1830,828,1724,774,7,3,70,37,29,14,54,112,45
E02000371,Hackney 027,Middle Super Output Areas and Intermediate Zones,MSOAIZ,N,11642,5672,1676,916,485,282,1191,634,173,98,4911,2250,4044,1767,867,483,483,,,,4725,2329,4522,2228,16,8,131,60,56,33,101,157,79
E02000372,Hammersmith and Fulham 001,Middle Super Output Areas and Intermediate Zones,MSOAIZ,W,8831,3674,1764,745,735,354,1029,391,294,159,4681,2054,1237,495,3444,1559,1559,,,,1972,673,1875,630,3,2,54,23,40,18,43,120,43
E02000373,Hammersmith and Fulham 002,Middle Super Output Areas and Intermediate Zones,MSOAIZ,WC,6658,2433,862,343,259,128,603,215,38,15,4548,1691,4058,1535,490,156,156,,,,1052,336,994,318,16,4,23,8,19,6,18,158,48
E02000374,Hammersmith and Fulham 003,Middle Super Output Areas and Intermediate Zones,MSOAIZ,W,6712,2590,2400,963,968,451,1432,512,114,52,2351,935,900,343,1451,592,592,,,,1746,599,1668,565,0,0,51,24,27,10,34,101,41
E02000375,Hammersmith and Fulham 004,Middle Super Output Areas and Intermediate Zones,MSOAIZ,W,6998,3230,1677,777,745,365,932,412,106,52,2893,1438,1525,853,1368,585,585,,,,2226,922,2131,886,27,5,63,26,5,5,36,96,41
E02000376,Hammersmith and Fulham 005,Middle Super Output Areas and Intermediate Zones,MSOAIZ,W,6890,3152,1603,771,661,320,942,451,105,58,2234,1053,803,378,1431,675,675,,,,2852,1221,2762,1185,3,1,57,26,30,9,36,96,49
E02000377,Hammersmith and Fulham 006,Middle Super Output Areas and Intermediate Zones,MSOAIZ,W,7933,3613,2520,1093,930,432,1590,661,150,90,2527,1262,968,485,1559,777,777,,,,2639,1126,2569,1091,9,4,51,24,10,7,35,97,42
E02000378,Hammersmith and Fulham 007,Middle Super Output Areas and Intermediate Zones,MSOAIZ,W,6514,3271,2196,1128,794,448,1402,680,24,17,1690,843,1046,490,644,353,353,,,,2544,1251,2436,1195,9,5,84,42,15,9,56,60,32
E02000379,Hammersmith and Fulham 008,Middle Super Output Areas and Intermediate Zones,MSOAIZ,W,7411,3190,3131,1333,1294,605,1837,728,177,97,1940,869,693,319,1247,550,550,,,,2085,864,1989,813,2,1,81,40,13,10,51,78,27
E02000380,Hammersmith and Fulham 009,Middle Super Output Areas and Intermediate Zones,MSOAIZ,W,5811,2559,2538,1098,1104,538,1434,560,28,9,1267,633,325,175,942,458,458,,,,1917,787,1830,750,15,5,61,28,11,4,37,61,32
E02000381,Hammersmith and Fulham 010,Middle Super Output Areas and Intermediate Zones,MSOAIZ,W,7682,3583,3052,1337,1477,672,1575,665,34,16,1812,891,679,311,1133,580,580,,,,2684,1294,2557,1227,17,9,99,52,11,6,67,100,45
E02000382,Hammersmith and Fulham 011,Middle Super Output Areas and Intermediate Zones,MSOAIZ,W,6146,2823,2357,1039,1126,540,1231,499,143,73,1572,701,561,270,1011,431,431,,,,1995,970,1876,912,23,11,69,34,27,13,58,79,40
E02000383,Hammersmith and Fulham 012,Middle Super Output Areas and Intermediate Zones,MSOAIZ,W,9300,4456,2965,1496,1379,719,1586,777,52,28,1846,911,843,428,1003,483,483,,,,4295,1942,4055,1837,24,11,124,60,92,34,105,142,79
E02000384,Hammersmith and Fulham 013,Middle Super Output Areas and Intermediate Zones,MSOAIZ,W,7120,3256,1506,709,714,346,792,363,62,37,3167,1515,1581,777,1586,738,738,,,,2269,930,2161,885,23,7,78,33,7,5,45,116,65
E02000385,Hammersmith and Fulham 014,Middle Super Output Areas and Intermediate Zones,MSOAIZ,W,6142,3094,1989,1089,745,440,1244,649,59,21,855,498,428,217,427,281,281,,,,3145,1440,2967,1350,16,8,132,62,30,20,90,94,46
E02000386,Hammersmith and Fulham 015,Middle Super Output Areas and Intermediate Zones,MSOAIZ,W,8117,3585,1570,784,543,292,1027,492,81,37,3844,1625,2917,1242,927,383,383,,,,2473,1058,2379,1007,19,8,55,27,20,16,51,149,81
E02000387,Hammersmith and Fulham 016,Middle Super Output Areas and Intermediate Zones,MSOAIZ,W,6240,2841,1561,747,556,309,1005,438,42,15,2503,1298,1451,690,1052,608,608,,,,2029,743,1890,680,23,11,92,35,24,17,63,105,38
E02000388,Hammersmith and Fulham 017,Middle Super Output Areas and Intermediate Zones,MSOAIZ,SW,8151,3805,2400,1138,1022,531,1378,607,111,56,2289,1172,754,441,1535,731,731,,,,3246,1385,3070,1310,18,5,124,54,34,16,75,105,54
E02000389,Hammersmith and Fulham 018,Middle Super Output Areas and Intermediate Zones,MSOAIZ,W,8248,3452,4168,1745,1742,824,2426,921,76,38,979,517,670,361,309,156,156,,,,2885,1081,2768,1029,4,1,83,39,30,12,52,140,71
E02000390,Hammersmith and Fulham 019,Middle Super Output Areas and Intermediate Zones,MSOAIZ,SW,6442,2823,2276,1072,1024,510,1252,562,39,16,1672,746,772,351,900,395,395,,,,2370,954,2262,906,4,3,80,36,24,9,48,85,35
E02000391,Hammersmith and Fulham 020,Middle Super Output Areas and Intermediate Zones,MSOAIZ,SW,7712,3419,3504,1493,1631,775,1873,718,37,19,1640,841,920,456,720,385,385,,,,2438,1012,2290,947,19,11,114,46,15,8,65,93,54
E02000392,Hammersmith and Fulham 021,Middle Super Output Areas and Intermediate Zones,MSOAIZ,SW,9537,4122,3459,1496,1483,690,1976,806,154,88,2384,1041,1789,793,595,248,248,,,,3404,1440,3231,1360,23,8,129,62,21,10,80,136,57
E02000393,Hammersmith and Fulham 022,Middle Super Output Areas and Intermediate Zones,MSOAIZ,SW,6025,2650,2964,1311,1228,592,1736,719,38,18,610,339,300,144,310,195,195,,,,2342,947,2262,910,0,0,76,35,4,2,37,71,35
E02000394,Hammersmith and Fulham 023,Middle Super Output Areas and Intermediate Zones,MSOAIZ,SW,7448,3551,2212,1159,954,532,1258,627,236,145,2767,1218,1043,498,1724,720,720,,,,2108,951,1968,880,11,5,116,59,13,7,71,125,78
E02000395,Hammersmith and Fulham 024,Middle Super Output Areas and Intermediate Zones,MSOAIZ,SW,5951,2719,3100,1425,1649,828,1451,597,53,27,493,279,244,147,249,132,132,,,,2171,921,2084,879,14,5,65,34,8,3,42,134,67
E02000396,Hammersmith and Fulham 025,Middle Super Output Areas and Intermediate Zones,MSOAIZ,SW,6633,2699,2682,1106,1161,536,1521,570,141,74,1892,763,1099,484,793,279,279,,,,1809,708,1712,663,5,2,83,40,9,3,45,109,48
E02000397,Haringey 001,Middle Super Output Areas and Intermediate Zones,MSOAIZ,N,7798,3376,2616,1166,873,454,1743,712,109,50,1894,849,1015,411,879,438,438,,,,3069,1262,2981,1221,5,2,61,30,22,9,41,110,49
E02000398,Haringey 002,Middle Super Output Areas and Intermediate Zones,MSOAIZ,N,6999,2713,1560,664,615,309,945,355,65,22,3265,1332,2357,1003,908,329,329,,,,1995,656,1944,631,6,3,32,15,13,7,25,114,39
E02000400,Haringey 004,Middle Super Output Areas and Intermediate Zones,MSOAIZ,N,7648,3061,3249,1300,1131,551,2118,749,175,87,2276,901,1289,527,987,374,374,,,,1870,737,1820,714,3,1,34,16,13,6,23,78,36
E02000401,Haringey 005,Middle Super Output Areas and Intermediate Zones,MSOAIZ,N,6734,2351,2117,780,573,263,1544,517,63,22,3332,1178,2652,935,680,243,243,,,,1125,337,1051,312,12,3,37,13,25,9,25,97,34
E02000402,Haringey 006,Middle Super Output Areas and Intermediate Zones,MSOAIZ,N,6697,2469,1625,652,441,207,1184,445,83,46,3274,1169,2389,867,885,302,302,,,,1568,551,1486,520,0,0,17,12,65,19,31,147,51
E02000403,Haringey 007,Middle Super Output Areas and Intermediate Zones,MSOAIZ,N,7194,2915,2652,1109,930,424,1722,685,33,15,1133,451,576,215,557,236,236,,,,3296,1305,3215,1274,9,3,41,20,31,8,31,80,35
E02000404,Haringey 008,Middle Super Output Areas and Intermediate Zones,MSOAIZ,N,7304,2640,2431,984,891,417,1540,567,113,55,2387,838,1811,645,576,193,193,,,,2257,716,2179,688,2,1,45,18,31,9,28,116,47
E02000405,Haringey 009,Middle Super Output Areas and Intermediate Zones,MSOAIZ,N,6541,2550,4634,1744,1685,722,2949,1022,16,7,513,208,338,134,175,74,74,,,,1340,573,1298,557,2,1,36,14,4,1,16,38,18
E02000406,Haringey 010,Middle Super Output Areas and Intermediate Zones,MSOAIZ,N,7025,2665,2058,869,769,339,1289,530,58,17,2706,1049,2528,979,178,70,70,,,,2083,686,2015,662,4,1,45,16,19,7,24,120,44
E02000407,Haringey 011,Middle Super Output Areas and Intermediate Zones,MSOAIZ,N,7239,2905,1925,817,657,309,1268,508,140,67,2432,1033,1077,430,1355,603,603,,,,2577,914,2472,877,2,2,85,24,18,11,37,165,74
E02000408,Haringey 012,Middle Super Output Areas and Intermediate Zones,MSOAIZ,N,7577,2689,1672,688,516,246,1156,442,111,47,3139,1198,2014,789,1125,409,409,,,,2487,703,2399,662,0,0,39,18,49,23,41,168,53
E02000409,Haringey 013,Middle Super Output Areas and Intermediate Zones,MSOAIZ,N,6470,2505,1633,651,643,295,990,356,32,11,3321,1331,2431,1006,890,325,325,,,,1344,459,1266,430,6,1,44,16,28,12,29,140,53
E02000410,Haringey 014,Middle Super Output Areas and Intermediate Zones,MSOAIZ,N,6636,2839,4069,1548,1493,630,2576,918,11,6,315,186,152,75,163,111,111,,,,2198,1082,2121,1041,17,12,53,25,7,4,41,43,17
E02000411,Haringey 015,Middle Super Output Areas and Intermediate Zones,MSOAIZ,N,7450,2695,2218,990,762,383,1456,607,63,29,2432,911,1572,622,860,289,289,,,,2595,713,2479,674,13,6,66,22,37,11,39,142,52
E02000412,Haringey 016,Middle Super Output Areas and Intermediate Zones,MSOAIZ,N,6760,2873,1626,692,693,322,933,370,258,134,2367,1065,1367,575,1000,490,490,,,,2393,934,2337,912,6,2,40,14,10,6,22,116,48
E02000413,Haringey 017,Middle Super Output Areas and Intermediate Zones,MSOAIZ,N,7408,2945,4453,1645,1706,748,2747,897,121,49,1013,428,707,329,306,99,99,,,,1751,794,1685,760,3,1,40,23,23,10,34,70,29
E02000414,Haringey 018,Middle Super Output Areas and Intermediate Zones,MSOAIZ,N,7156,2562,2840,1144,1015,479,1825,665,58,26,1422,510,685,218,737,292,292,,,,2734,844,2662,821,0,0,47,15,25,8,23,102,38
E02000415,Haringey 019,Middle Super Output Areas and Intermediate Zones,MSOAIZ,N,6811,2697,2622,1102,1188,537,1434,565,58,24,1331,543,725,278,606,265,265,,,,2672,982,2582,946,6,2,37,18,47,16,36,128,46
E02000416,Haringey 020,Middle Super Output Areas and Intermediate Zones,MSOAIZ,N,7482,3463,2486,1170,702,356,1784,814,150,78,2768,1202,1985,857,783,345,345,,,,1995,974,1939,946,6,2,41,22,9,4,28,83,39
E02000417,Haringey 021,Middle Super Output Areas and Intermediate Zones,MSOAIZ,N,6584,2852,3740,1500,1613,719,2127,781,19,7,543,234,288,132,255,102,102,,,,2210,1078,2105,1027,13,8,76,35,16,8,51,72,33
E02000418,Haringey 022,Middle Super Output Areas and Intermediate Zones,MSOAIZ,N,5509,2235,3996,1524,1472,658,2524,866,30,19,480,255,426,226,54,29,29,,,,949,416,908,395,3,2,27,13,11,6,21,54,21
E02000419,Haringey 023,Middle Super Output Areas and Intermediate Zones,MSOAIZ,N,8100,3323,2917,1214,1142,504,1775,710,31,16,1212,506,586,223,626,283,283,,,,3791,1527,3704,1493,19,5,31,15,37,14,34,149,60
E02000420,Haringey 024,Middle Super Output Areas and Intermediate Zones,MSOAIZ,N,7425,3050,2231,951,766,351,1465,600,46,21,2397,1059,1173,516,1224,543,543,,,,2610,969,2518,935,7,2,40,16,45,16,34,141,50
E02000421,Haringey 025,Middle Super Output Areas and Intermediate Zones,MSOAIZ,N,6958,2875,1369,638,436,222,933,416,229,122,2973,1266,1713,741,1260,525,525,,,,2269,810,2184,773,0,0,53,23,32,14,37,118,39
E02000422,Haringey 026,Middle Super Output Areas and Intermediate Zones,MSOAIZ,N,7783,2926,2253,966,834,388,1419,578,160,75,2481,916,1762,648,719,268,268,,,,2721,914,2637,883,25,7,49,21,10,3,31,168,55
E02000423,Haringey 027,Middle Super Output Areas and Intermediate Zones,MSOAIZ,N,6709,2516,2636,1083,1143,510,1493,573,44,13,970,370,702,242,268,128,128,,,,3002,1024,2911,988,15,4,32,16,44,16,36,57,26
E02000424,Haringey 028,Middle Super Output Areas and Intermediate Zones,MSOAIZ,N,7056,3088,3462,1438,1085,488,2377,950,71,36,1604,749,636,289,968,460,460,,,,1860,837,1802,805,0,0,41,22,17,10,32,59,28
E02000425,Haringey 029,Middle Super Output Areas and Intermediate Zones,MSOAIZ,N,7251,2116,2360,775,921,389,1439,386,135,60,1165,457,683,278,482,179,179,,,,3550,808,3369,767,3,1,143,28,35,12,41,41,16
E02000426,Haringey 030,Middle Super Output Areas and Intermediate Zones,MSOAIZ,N,6650,2882,3725,1517,1765,786,1960,731,21,12,891,462,655,315,236,147,147,,,,1866,826,1725,769,56,22,61,25,24,10,57,147,65
E02000427,Haringey 031,Middle Super Output Areas and Intermediate Zones,MSOAIZ,N,6828,2829,2540,1084,1010,432,1530,652,132,67,1022,379,487,171,535,208,208,,,,3070,1268,2979,1234,6,3,69,27,16,4,34,64,31
E02000428,Haringey 032,Middle Super Output Areas and Intermediate Zones,MSOAIZ,N,7014,2758,1710,748,604,287,1106,461,90,43,2988,1184,2218,930,770,254,254,,,,2083,728,2030,708,4,2,28,13,21,5,20,143,55
E02000429,Haringey 033,Middle Super Output Areas and Intermediate Zones,MSOAIZ,N,6803,3207,4063,1810,1624,828,2439,982,42,21,551,298,212,118,339,180,180,,,,2100,1054,2042,1020,8,2,47,29,3,3,34,47,24
E02000430,Haringey 034,Middle Super Output Areas and Intermediate Zones,MSOAIZ,N,7408,3462,3420,1524,1132,542,2288,982,85,45,875,412,332,142,543,270,270,,,,2968,1442,2892,1404,9,4,61,32,6,2,38,60,39
E02000431,Haringey 035,Middle Super Output Areas and Intermediate Zones,MSOAIZ,N,6531,3133,3247,1502,1435,691,1812,811,8,6,372,184,161,75,211,109,109,,,,2845,1407,2783,1374,7,2,50,28,5,3,33,59,34
E02000432,Haringey 036,Middle Super Output Areas and Intermediate Zones,MSOAIZ,N,6421,2879,2538,1121,792,357,1746,764,30,13,1650,728,1082,426,568,302,302,,,,2139,986,2074,956,1,1,62,27,2,2,30,64,31
E02000433,Harrow 001,Middle Super Output Areas and Intermediate Zones,MSOAIZ,WD,7558,3309,5104,2223,2648,1355,2456,868,119,53,663,364,257,109,406,255,255,,,,1561,603,1489,566,23,8,41,22,8,7,37,111,66
E02000434,Harrow 002,Middle Super Output Areas and Intermediate Zones,MSOAIZ,HA,8525,3138,5697,2142,2449,1116,3248,1026,14,8,725,250,315,138,410,112,112,,,,1989,686,1849,617,40,22,54,25,46,22,69,100,52
E02000435,Harrow 003,Middle Super Output Areas and Intermediate Zones,MSOAIZ,HA,7322,2728,4467,1706,1861,885,2606,821,42,19,1453,527,1005,402,448,125,125,,,,1278,430,967,322,178,60,28,12,105,36,108,82,46
E02000436,Harrow 004,Middle Super Output Areas and Intermediate Zones,MSOAIZ,HA,5721,2080,5001,1821,2149,977,2852,844,5,3,152,67,117,60,35,7,7,,,,510,168,491,156,2,2,15,8,2,2,12,53,21
E02000437,Harrow 005,Middle Super Output Areas and Intermediate Zones,MSOAIZ,HA,8298,3082,5968,2235,2224,1068,3744,1167,84,33,674,316,345,148,329,168,168,,,,1522,475,1445,440,7,2,69,32,1,1,35,50,23
E02000438,Harrow 006,Middle Super Output Areas and Intermediate Zones,MSOAIZ,HA,7821,2990,4498,1782,1732,903,2766,879,40,18,1761,620,1163,427,598,193,193,,,,1397,509,1343,486,9,4,29,13,16,6,23,125,61
E02000439,Harrow 007,Middle Super Output Areas and Intermediate Zones,MSOAIZ,HA,8206,2711,4864,1693,1891,809,2973,884,37,10,857,318,714,281,143,37,37,,,,2339,647,2230,609,17,4,75,28,17,6,38,109,43
E02000440,Harrow 008,Middle Super Output Areas and Intermediate Zones,MSOAIZ,HA,9518,3087,7446,2497,2630,1109,4816,1388,25,12,371,132,291,108,80,24,24,,,,1598,414,1485,377,20,7,70,23,23,7,37,78,32
E02000441,Harrow 009,Middle Super Output Areas and Intermediate Zones,MSOAIZ,HA,6680,2765,4321,1781,1826,933,2495,848,38,21,1261,541,954,426,307,115,115,,,,999,384,966,367,4,2,24,13,5,2,17,61,38
E02000442,Harrow 010,Middle Super Output Areas and Intermediate Zones,MSOAIZ,HA,8706,2532,5578,1743,2227,815,3351,928,26,8,453,121,215,65,238,56,56,,,,2516,616,2342,567,19,4,110,34,45,11,49,133,44
E02000443,Harrow 011,Middle Super Output Areas and Intermediate Zones,MSOAIZ,HA,9431,3203,4947,1746,1695,734,3252,1012,128,40,1489,506,728,288,761,218,218,,,,2790,873,2647,827,4,1,124,40,15,5,46,77,38
E02000444,Harrow 012,Middle Super Output Areas and Intermediate Zones,MSOAIZ,HA,8418,2682,5743,1914,2148,877,3595,1037,8,3,294,89,177,55,117,34,34,,,,2278,637,2175,602,0,0,82,27,21,8,35,95,39
E02000445,Harrow 013,Middle Super Output Areas and Intermediate Zones,MSOAIZ,HA,10211,3616,5322,1917,1823,821,3499,1096,216,105,1468,535,393,183,1075,352,352,,,,3127,1023,3013,982,14,4,60,22,40,15,41,78,36
E02000447,Harrow 015,Middle Super Output Areas and Intermediate Zones,MSOAIZ,HA,7052,2453,5194,1810,1998,854,3196,956,18,8,512,201,295,111,217,90,90,,,,1262,407,1192,382,7,2,53,20,10,3,25,66,27
E02000448,Harrow 016,Middle Super Output Areas and Intermediate Zones,MSOAIZ,HA,6606,2730,5015,2039,2324,1154,2691,885,12,8,429,230,262,125,167,105,105,,,,1088,418,1048,396,8,5,16,9,16,8,22,62,35
E02000449,Harrow 017,Middle Super Output Areas and Intermediate Zones,MSOAIZ,NW,8131,2531,4713,1465,2067,734,2646,731,66,19,1166,452,792,329,374,123,123,,,,2068,551,1988,527,19,5,38,11,23,8,24,118,44
E02000451,Harrow 019,Middle Super Output Areas and Intermediate Zones,MSOAIZ,HA,6531,2341,5325,1937,2202,992,3123,945,67,37,119,49,64,28,55,21,21,,,,983,297,923,278,14,4,46,15,0,0,19,37,21
E02000452,Harrow 020,Middle Super Output Areas and Intermediate Zones,MSOAIZ,HA,8125,3039,3878,1486,1451,630,2427,856,84,34,402,133,61,21,341,112,112,,,,3712,1366,3613,1325,25,8,57,27,17,6,41,49,20
E02000453,Harrow 021,Middle Super Output Areas and Intermediate Zones,MSOAIZ,HA,7606,2800,4698,1756,1752,772,2946,984,92,54,441,180,203,93,238,87,87,,,,2320,781,2221,734,5,3,79,36,15,8,47,55,29
E02000454,Harrow 022,Middle Super Output Areas and Intermediate Zones,MSOAIZ,HA,7079,2550,6084,2214,2257,1057,3827,1157,3,1,213,93,156,74,57,19,19,,,,724,222,692,206,0,0,23,13,9,3,16,55,20
E02000455,Harrow 023,Middle Super Output Areas and Intermediate Zones,MSOAIZ,HA,8050,3306,3608,1497,1402,718,2206,779,117,61,1030,459,445,210,585,249,249,,,,3181,1224,2979,1148,15,5,81,35,106,36,76,114,65
E02000456,Harrow 024,Middle Super Output Areas and Intermediate Zones,MSOAIZ,HA,7028,2512,4411,1589,1543,684,2868,905,52,36,708,244,422,165,286,79,79,,,,1761,609,1691,585,4,2,50,17,16,5,24,96,34
E02000457,Harrow 025,Middle Super Output Areas and Intermediate Zones,MSOAIZ,HA,6309,2200,4707,1657,1882,829,2825,828,23,9,296,120,38,16,258,104,104,,,,1233,395,1150,363,10,3,71,27,2,2,32,50,19
E02000459,Harrow 027,Middle Super Output Areas and Intermediate Zones,MSOAIZ,HA,8227,3159,3929,1533,1365,666,2564,867,163,70,1407,622,805,395,602,227,227,,,,2641,891,2504,843,3,2,91,32,43,14,48,87,43
E02000460,Harrow 028,Middle Super Output Areas and Intermediate Zones,MSOAIZ,HA,6488,2189,2976,1043,966,422,2010,621,56,22,1973,666,465,177,1508,489,489,,,,1404,427,1312,395,7,2,44,15,41,15,32,79,31
E02000461,Harrow 029,Middle Super Output Areas and Intermediate Zones,MSOAIZ,UB,6066,2556,3338,1424,1249,642,2089,782,86,37,277,128,218,108,59,20,20,,,,2096,840,1933,768,100,41,52,25,11,6,72,269,127
E02000462,Harrow 030,Middle Super Output Areas and Intermediate Zones,MSOAIZ,UB,6624,2210,4131,1423,1412,627,2719,796,41,11,358,139,72,27,286,112,112,,,,2028,609,1890,565,9,3,102,31,27,10,44,66,28
E02000463,Harrow 031,Middle Super Output Areas and Intermediate Zones,MSOAIZ,UB,8422,2788,5124,1672,1492,611,3632,1061,31,12,1522,586,1057,443,465,143,143,,,,1670,480,1592,450,1,1,56,22,21,7,30,75,38
E02000464,Havering 001,Middle Super Output Areas and Intermediate Zones,MSOAIZ,RM,6338,2597,3740,1551,1362,741,2378,810,62,30,2022,817,1784,733,238,84,84,,,,467,174,437,161,7,2,23,11,0,0,13,47,25
E02000465,Havering 002,Middle Super Output Areas and Intermediate Zones,MSOAIZ,RM,7929,3256,4339,1701,1190,626,3149,1075,49,16,2788,1234,2479,1100,309,134,134,,,,696,263,633,237,0,0,58,24,5,2,26,57,42
E02000466,Havering 003,Middle Super Output Areas and Intermediate Zones,MSOAIZ,RM,8188,3235,5355,2145,1930,988,3425,1157,48,20,2094,797,1663,660,431,137,137,,,,620,230,571,206,2,1,36,18,11,5,24,71,43
E02000467,Havering 004,Middle Super Output Areas and Intermediate Zones,MSOAIZ,RM,9604,4087,4004,1615,961,542,3043,1073,39,13,4643,2103,4280,1970,363,133,133,,,,833,314,767,281,6,3,45,22,15,8,33,85,42
E02000468,Havering 005,Middle Super Output Areas and Intermediate Zones,MSOAIZ,RM,7705,3099,6004,2392,2152,1129,3852,1263,41,20,832,355,599,268,233,87,87,,,,763,296,719,277,7,4,31,12,6,3,19,65,36
E02000469,Havering 006,Middle Super Output Areas and Intermediate Zones,MSOAIZ,RM,6332,2664,3787,1537,1160,614,2627,923,48,21,1826,848,1534,713,292,135,135,,,,632,240,574,217,7,2,42,15,9,6,23,39,18
E02000470,Havering 007,Middle Super Output Areas and Intermediate Zones,MSOAIZ,RM,7854,3487,6348,2752,2591,1388,3757,1364,16,6,534,277,231,126,303,151,151,,,,906,427,854,403,4,2,44,18,4,4,24,50,25
E02000471,Havering 008,Middle Super Output Areas and Intermediate Zones,MSOAIZ,RM,7449,2961,6934,2759,2932,1516,4002,1243,5,2,150,52,143,50,7,2,2,,,,337,134,321,124,0,0,16,10,0,0,10,23,14
E02000472,Havering 009,Middle Super Output Areas and Intermediate Zones,MSOAIZ,RM,8954,3544,7498,2920,2741,1365,4757,1555,25,11,620,289,558,264,62,25,25,,,,768,299,726,279,4,2,34,16,4,2,20,43,25
E02000473,Havering 010,Middle Super Output Areas and Intermediate Zones,MSOAIZ,RM,9555,3841,8199,3219,2854,1469,5345,1750,56,30,484,236,268,114,216,122,122,,,,770,327,718,302,8,3,35,18,9,4,25,46,29
E02000474,Havering 011,Middle Super Output Areas and Intermediate Zones,MSOAIZ,RM,8297,3514,5932,2444,1953,1035,3979,1409,72,31,1152,549,840,419,312,130,130,,,,1102,463,1062,444,0,0,32,16,8,3,19,39,27
E02000475,Havering 012,Middle Super Output Areas and Intermediate Zones,MSOAIZ,RM,9107,3933,7001,2880,2848,1399,4153,1481,75,34,744,401,493,268,251,133,133,,,,1232,587,1181,559,7,3,43,24,1,1,28,55,31
E02000476,Havering 013,Middle Super Output Areas and Intermediate Zones,MSOAIZ,RM,8330,4023,3917,1777,1379,767,2538,1010,258,162,1985,988,930,480,1055,508,508,,,,2104,1060,2015,1013,6,3,74,39,9,5,47,66,36
E02000477,Havering 014,Middle Super Output Areas and Intermediate Zones,MSOAIZ,RM,9347,3725,8295,3243,3266,1603,5029,1640,16,8,232,108,153,66,79,42,42,,,,774,349,727,323,9,3,37,22,1,1,26,30,17
E02000478,Havering 015,Middle Super Output Areas and Intermediate Zones,MSOAIZ,RM,5811,2156,5373,1939,2430,1102,2943,837,5,1,139,107,16,8,123,99,99,,,,265,93,249,88,6,2,9,2,1,1,5,29,16
E02000479,Havering 016,Middle Super Output Areas and Intermediate Zones,MSOAIZ,RM,8022,3529,5388,2324,1634,876,3754,1448,46,22,785,357,629,300,156,57,57,,,,1751,797,1686,764,6,2,53,28,6,3,33,52,29
E02000480,Havering 017,Middle Super Output Areas and Intermediate Zones,MSOAIZ,RM,9676,3872,6751,2648,2062,1052,4689,1596,48,19,1332,567,902,367,430,200,200,,,,1473,609,1380,565,5,2,68,31,20,11,44,72,29
E02000481,Havering 018,Middle Super Output Areas and Intermediate Zones,MSOAIZ,RM,7672,3254,6560,2748,2928,1555,3632,1193,20,9,504,249,468,236,36,13,13,,,,533,215,483,193,7,4,40,17,3,1,22,55,33
E02000482,Havering 019,Middle Super Output Areas and Intermediate Zones,MSOAIZ,RM,6374,2546,5922,2349,2688,1366,3234,983,7,4,64,28,55,24,9,4,4,,,,356,149,318,133,9,2,27,13,2,1,16,25,16
E02000483,Havering 020,Middle Super Output Areas and Intermediate Zones,MSOAIZ,RM,7562,3423,5490,2331,2276,1244,3214,1087,35,19,986,547,627,355,359,192,192,,,,996,493,922,456,8,4,61,30,5,3,37,55,33
E02000484,Havering 021,Middle Super Output Areas and Intermediate Zones,MSOAIZ,RM,8187,3180,7092,2688,2535,1225,4557,1463,22,9,426,211,313,160,113,51,51,,,,606,249,552,225,2,1,52,23,0,0,24,41,23
E02000485,Havering 022,Middle Super Output Areas and Intermediate Zones,MSOAIZ,RM,7956,3375,6401,2710,2445,1338,3956,1372,14,9,557,211,511,195,46,16,16,,,,957,429,876,390,8,3,69,34,4,2,39,27,16
E02000486,Havering 023,Middle Super Output Areas and Intermediate Zones,MSOAIZ,RM,7300,3039,6256,2554,2521,1295,3735,1259,9,5,228,105,170,80,58,25,25,,,,759,341,725,318,0,0,31,21,3,2,23,48,34
E02000487,Havering 024,Middle Super Output Areas and Intermediate Zones,MSOAIZ,RM,7748,2970,7319,2812,3174,1574,4145,1238,12,4,108,30,95,25,13,5,5,,,,258,102,231,87,7,4,13,7,7,4,15,51,22
E02000488,Havering 025,Middle Super Output Areas and Intermediate Zones,MSOAIZ,RM,7431,2967,6809,2722,2891,1449,3918,1273,6,2,157,58,106,43,51,15,15,,,,431,169,405,154,3,1,22,13,1,1,15,28,16
E02000489,Havering 026,Middle Super Output Areas and Intermediate Zones,MSOAIZ,RM,7884,3155,5861,2309,2177,1109,3684,1200,50,19,1111,514,968,428,143,86,86,,,,824,291,777,271,3,1,35,16,9,3,20,38,22
E02000490,Havering 027,Middle Super Output Areas and Intermediate Zones,MSOAIZ,RM,7828,3169,6227,2500,2439,1275,3788,1225,25,8,869,399,629,291,240,108,108,,,,661,238,631,221,2,1,25,15,3,1,17,46,24
E02000491,Havering 028,Middle Super Output Areas and Intermediate Zones,MSOAIZ,RM,8774,3603,5726,2294,1990,1056,3736,1238,47,26,2048,917,1025,482,1023,435,435,,,,906,339,846,313,0,0,49,21,11,5,26,47,27
E02000492,Havering 029,Middle Super Output Areas and Intermediate Zones,MSOAIZ,RM,6247,2524,5486,2215,2491,1269,2995,946,22,8,213,85,74,31,139,54,54,,,,497,201,460,185,1,1,33,12,3,3,16,29,15
E02000493,Havering 030,Middle Super Output Areas and Intermediate Zones,MSOAIZ,RM,6210,2471,4152,1620,1328,658,2824,962,34,18,898,360,534,208,364,152,152,,,,1103,459,980,412,14,4,99,38,10,5,47,23,14
E02000494,Hillingdon 001,Middle Super Output Areas and Intermediate Zones,MSOAIZ,WD,7388,3115,5459,2187,2663,1239,2796,948,23,11,708,433,202,107,506,326,326,,,,1101,444,994,390,55,26,12,10,40,18,54,97,40
E02000495,Hillingdon 002,Middle Super Output Areas and Intermediate Zones,MSOAIZ,UB,9348,4141,5871,2534,2504,1320,3367,1214,37,19,1040,530,690,341,350,189,189,,,,2296,1005,2146,945,39,14,86,36,25,10,60,104,53
E02000496,Hillingdon 003,Middle Super Output Areas and Intermediate Zones,MSOAIZ,WD,7181,3008,4627,1933,1633,855,2994,1078,43,12,1712,723,1337,601,375,122,122,,,,728,307,635,269,42,13,34,18,17,7,38,71,33
E02000497,Hillingdon 004,Middle Super Output Areas and Intermediate Zones,MSOAIZ,TW,8468,3440,5931,2418,2177,1131,3754,1287,51,21,1527,642,1038,456,489,186,186,,,,896,334,782,293,24,7,70,26,20,8,41,63,25
E02000498,Hillingdon 005,Middle Super Output Areas and Intermediate Zones,MSOAIZ,UB,6020,2561,4607,1896,1714,880,2893,1016,67,27,828,421,486,267,342,154,154,,,,472,196,432,178,8,3,25,12,7,3,18,46,21
E02000499,Hillingdon 006,Middle Super Output Areas and Intermediate Zones,MSOAIZ,HA,7765,3001,6472,2493,2774,1351,3698,1142,10,6,389,164,309,138,80,26,26,,,,861,318,798,289,4,3,35,19,24,7,29,33,20
E02000500,Hillingdon 007,Middle Super Output Areas and Intermediate Zones,MSOAIZ,HA,7664,3093,6019,2324,2619,1271,3400,1053,52,32,349,189,26,14,323,175,175,,,,1182,517,1107,483,24,8,34,19,17,7,34,62,31
E02000501,Hillingdon 008,Middle Super Output Areas and Intermediate Zones,MSOAIZ,HA,8197,3163,6684,2592,2402,1165,4282,1427,23,7,561,232,316,127,245,105,105,,,,876,306,826,286,5,3,43,16,2,1,20,53,26
E02000502,Hillingdon 009,Middle Super Output Areas and Intermediate Zones,MSOAIZ,UB,7512,3097,5200,2236,1833,1001,3367,1235,40,18,379,137,286,102,93,35,35,,,,1847,683,1273,512,297,85,45,21,232,65,171,46,23
E02000503,Hillingdon 010,Middle Super Output Areas and Intermediate Zones,MSOAIZ,HA,8560,3235,7042,2685,2276,1102,4766,1583,93,30,346,116,123,43,223,73,73,,,,1023,381,724,276,136,48,63,25,100,32,105,56,23
E02000504,Hillingdon 011,Middle Super Output Areas and Intermediate Zones,MSOAIZ,UB,7359,2891,6324,2467,2574,1305,3750,1162,15,7,255,125,213,104,42,21,21,,,,723,270,547,213,85,25,44,15,47,17,57,42,22
E02000506,Hillingdon 013,Middle Super Output Areas and Intermediate Zones,MSOAIZ,UB,7455,2725,6360,2300,2729,1239,3631,1061,12,5,262,137,76,36,186,101,101,,,,771,262,695,235,34,12,20,7,22,8,27,50,21
E02000507,Hillingdon 014,Middle Super Output Areas and Intermediate Zones,MSOAIZ,UB,7943,2756,6012,2115,1828,843,4184,1272,50,17,733,278,531,219,202,59,59,,,,1091,324,1047,309,5,2,32,11,7,2,15,57,22
E02000508,Hillingdon 015,Middle Super Output Areas and Intermediate Zones,MSOAIZ,UB,7014,3075,3605,1569,1454,768,2151,801,46,22,1079,560,662,364,417,196,196,,,,2211,887,1673,696,296,103,52,25,190,63,191,73,37
E02000509,Hillingdon 016,Middle Super Output Areas and Intermediate Zones,MSOAIZ,UB,7651,3112,3492,1438,1197,598,2295,840,119,57,1541,744,1033,557,508,187,187,,,,2418,834,2298,790,9,5,67,28,44,11,44,81,39
E02000510,Hillingdon 017,Middle Super Output Areas and Intermediate Zones,MSOAIZ,UB,8554,3196,5802,2158,1980,950,3822,1208,68,24,891,412,366,175,525,237,237,,,,1723,565,1657,538,13,6,37,15,16,6,27,70,37
E02000511,Hillingdon 018,Middle Super Output Areas and Intermediate Zones,MSOAIZ,UB,9357,3211,6743,2349,2105,976,4638,1373,190,81,636,261,351,152,285,109,109,,,,1715,490,1625,462,21,5,46,17,23,6,28,73,30
E02000512,Hillingdon 019,Middle Super Output Areas and Intermediate Zones,MSOAIZ,UB,7989,2968,4024,1520,1257,604,2767,916,136,55,2189,844,1491,614,698,230,230,,,,1583,527,1547,511,9,3,25,12,2,1,16,57,22
E02000513,Hillingdon 020,Middle Super Output Areas and Intermediate Zones,MSOAIZ,UB,8967,3234,4211,1578,1068,521,3143,1057,170,59,2766,988,2043,762,723,226,226,,,,1684,563,1600,535,10,2,50,18,24,8,28,136,46
E02000514,Hillingdon 021,Middle Super Output Areas and Intermediate Zones,MSOAIZ,UB,9791,3044,6313,2041,2132,850,4181,1191,110,41,618,215,303,113,315,102,102,,,,2627,703,2434,650,14,5,111,33,68,15,53,123,44
E02000515,Hillingdon 022,Middle Super Output Areas and Intermediate Zones,MSOAIZ,UB,10388,4303,4903,2100,1465,768,3438,1332,312,129,2371,936,1532,654,839,282,282,,,,2742,1110,2660,1070,11,6,49,27,22,7,40,60,28
E02000516,Hillingdon 023,Middle Super Output Areas and Intermediate Zones,MSOAIZ,UB,8263,2764,4655,1606,1452,600,3203,1006,181,68,1465,490,151,49,1314,441,441,,,,1816,548,1736,519,4,1,57,22,19,6,29,146,52
E02000517,Hillingdon 024,Middle Super Output Areas and Intermediate Zones,MSOAIZ,UB,8570,2917,4349,1498,1093,510,3256,988,117,44,2215,806,1511,584,704,222,222,,,,1798,533,1741,513,13,3,29,13,15,4,20,91,36
E02000518,Hillingdon 025,Middle Super Output Areas and Intermediate Zones,MSOAIZ,UB,8593,3099,4235,1610,1254,616,2981,994,105,40,2700,988,1861,736,839,252,252,,,,1494,432,1409,405,3,1,51,17,31,9,27,59,29
E02000519,Hillingdon 026,Middle Super Output Areas and Intermediate Zones,MSOAIZ,UB,8645,2890,3878,1229,1127,449,2751,780,190,65,2708,1057,1738,731,970,326,326,,,,1781,501,1708,483,5,2,45,12,23,4,18,88,38
E02000520,Hillingdon 027,Middle Super Output Areas and Intermediate Zones,MSOAIZ,UB,11068,3645,5681,1846,1637,682,4044,1164,133,48,2152,803,1232,495,920,308,308,,,,2982,900,2798,847,32,10,110,35,42,8,53,120,48
E02000521,Hillingdon 028,Middle Super Output Areas and Intermediate Zones,MSOAIZ,UB,9904,3397,4783,1642,1336,620,3447,1022,330,118,2992,1053,1385,503,1607,550,550,,,,1748,560,1661,531,4,2,63,22,20,5,29,51,24
E02000522,Hillingdon 029,Middle Super Output Areas and Intermediate Zones,MSOAIZ,UB,8581,3269,4285,1725,1561,766,2724,959,159,58,2350,868,1371,527,979,341,341,,,,1705,577,1604,545,8,4,67,20,26,8,32,82,41
E02000523,Hillingdon 030,Middle Super Output Areas and Intermediate Zones,MSOAIZ,UB,9535,2939,5517,1760,1733,718,3784,1042,233,106,1188,356,244,81,944,275,275,,,,2535,694,2427,663,11,3,66,21,31,7,31,62,23
E02000524,Hillingdon 031,Middle Super Output Areas and Intermediate Zones,MSOAIZ,UB,6271,2462,3140,1308,1195,631,1945,677,48,14,840,306,333,127,507,179,179,,,,2170,801,2076,764,30,13,37,15,27,9,37,73,33
E02000525,Hillingdon 032,Middle Super Output Areas and Intermediate Zones,MSOAIZ,UB,8822,3142,4142,1531,1334,596,2808,935,66,21,1696,602,1178,422,518,180,180,,,,2814,949,2707,911,15,7,57,21,35,10,38,104,39
E02000526,Hounslow 001,Middle Super Output Areas and Intermediate Zones,MSOAIZ,W,8292,3536,4929,1995,2198,985,2731,1010,25,7,810,398,396,188,414,210,210,,,,2430,1090,2347,1048,15,6,57,32,11,4,42,98,46
E02000528,Hounslow 003,Middle Super Output Areas and Intermediate Zones,MSOAIZ,W,10603,4770,2988,1460,997,571,1991,889,385,202,4999,2122,3867,1655,1132,467,467,,,,2104,935,2021,894,7,4,52,26,24,11,41,127,51
E02000529,Hounslow 004,Middle Super Output Areas and Intermediate Zones,MSOAIZ,UB,8448,2776,4610,1471,1598,605,3012,866,98,35,1526,593,1082,413,444,180,180,,,,2116,640,2000,606,9,3,75,24,32,7,34,98,37
E02000530,Hounslow 005,Middle Super Output Areas and Intermediate Zones,MSOAIZ,UB,6836,2314,2538,782,857,327,1681,455,20,7,2976,1134,2560,972,416,162,162,,,,1186,340,1125,319,2,1,56,18,3,2,21,116,51
E02000531,Hounslow 006,Middle Super Output Areas and Intermediate Zones,MSOAIZ,W,9472,4269,4485,1952,1581,786,2904,1166,304,162,2280,1107,1799,798,481,309,309,,,,2262,979,2141,928,10,4,72,35,39,12,51,141,69
E02000532,Hounslow 007,Middle Super Output Areas and Intermediate Zones,MSOAIZ,W,9149,4001,5357,2224,2221,1058,3136,1166,34,17,1804,906,1436,684,368,222,222,,,,1846,791,1785,756,7,4,44,26,10,5,35,108,63
E02000533,Hounslow 008,Middle Super Output Areas and Intermediate Zones,MSOAIZ,W,8406,3835,4693,2032,1773,881,2920,1151,18,9,1412,778,958,532,454,246,246,,,,2215,973,2135,934,12,3,60,32,8,4,39,68,43
E02000534,Hounslow 009,Middle Super Output Areas and Intermediate Zones,MSOAIZ,TW,8029,2917,4989,1817,1907,838,3082,979,153,77,582,195,140,47,442,148,148,,,,2229,789,2149,757,27,8,45,19,8,5,32,76,39
E02000535,Hounslow 010,Middle Super Output Areas and Intermediate Zones,MSOAIZ,TW,9287,2852,5878,1780,2226,805,3652,975,101,32,909,393,502,251,407,142,142,,,,2289,607,2149,570,24,7,79,21,37,9,37,110,40
E02000536,Hounslow 011,Middle Super Output Areas and Intermediate Zones,MSOAIZ,TW,9189,2925,5337,1688,1947,732,3390,956,64,29,1354,492,470,146,884,346,346,,,,2354,688,2235,657,18,5,95,24,6,2,31,80,28
E02000537,Hounslow 012,Middle Super Output Areas and Intermediate Zones,MSOAIZ,TW,8612,2841,4974,1744,2291,938,2683,806,17,9,231,70,111,38,120,32,32,,,,3334,993,3202,949,11,5,107,34,14,5,44,56,25
E02000538,Hounslow 013,Middle Super Output Areas and Intermediate Zones,MSOAIZ,TW,8680,2648,4511,1378,1763,650,2748,728,56,14,1292,464,1075,394,217,70,70,,,,2716,750,2475,677,79,25,66,20,96,28,73,105,42
E02000539,Hounslow 014,Middle Super Output Areas and Intermediate Zones,MSOAIZ,TW,10662,4299,4784,2123,1285,675,3499,1448,337,153,2958,1058,1449,538,1509,520,520,,,,2478,922,2351,868,12,5,86,39,29,10,54,105,43
E02000540,Hounslow 015,Middle Super Output Areas and Intermediate Zones,MSOAIZ,TW,9211,3564,4353,1657,1637,755,2716,902,289,136,1397,711,712,379,685,332,332,,,,3079,1022,2929,973,16,4,87,29,47,16,49,93,38
E02000541,Hounslow 016,Middle Super Output Areas and Intermediate Zones,MSOAIZ,TW,8866,2846,3684,1131,1617,574,2067,557,78,28,2457,966,896,371,1561,595,595,,,,2488,666,2393,637,1,1,51,16,43,12,29,159,55
E02000542,Hounslow 017,Middle Super Output Areas and Intermediate Zones,MSOAIZ,TW,9298,3166,3930,1274,1522,562,2408,712,259,102,1763,775,1275,563,488,212,212,,,,3276,979,3115,934,21,3,59,19,81,23,45,70,36
E02000543,Hounslow 018,Middle Super Output Areas and Intermediate Zones,MSOAIZ,TW,11652,4170,4639,1642,1689,691,2950,951,395,173,1350,571,652,275,698,296,296,,,,5155,1743,5006,1684,28,9,72,34,49,16,59,113,41
E02000544,Hounslow 019,Middle Super Output Areas and Intermediate Zones,MSOAIZ,TW,8199,2793,5846,2051,2042,907,3804,1144,86,34,414,159,220,87,194,72,72,,,,1798,522,1713,494,10,2,53,17,22,9,28,55,27
E02000545,Hounslow 020,Middle Super Output Areas and Intermediate Zones,MSOAIZ,TW,8137,3299,3404,1441,1037,513,2367,928,95,33,3160,1214,2801,1083,359,131,131,,,,1350,552,1281,523,10,4,33,17,26,8,29,128,59
E02000546,Hounslow 021,Middle Super Output Areas and Intermediate Zones,MSOAIZ,TW,9568,3018,5087,1567,1698,626,3389,941,214,84,1501,531,644,255,857,276,276,,,,2659,800,2549,765,3,1,81,28,26,6,35,107,36
E02000547,Hounslow 022,Middle Super Output Areas and Intermediate Zones,MSOAIZ,TW,9360,3547,5491,2084,1588,785,3903,1299,104,39,1833,757,1487,640,346,117,117,,,,1825,618,1699,573,20,5,88,31,18,9,45,107,49
E02000548,Hounslow 023,Middle Super Output Areas and Intermediate Zones,MSOAIZ,TW,9085,3539,3652,1424,1074,522,2578,902,750,347,3127,1170,1762,679,1365,491,491,,,,1463,559,1368,520,6,1,69,25,20,13,39,93,39
E02000549,Hounslow 024,Middle Super Output Areas and Intermediate Zones,MSOAIZ,TW,10865,3937,6801,2526,2157,1056,4644,1470,184,65,2009,751,1337,525,672,226,226,,,,1772,545,1671,511,10,3,67,25,24,6,34,99,50
E02000550,Hounslow 025,Middle Super Output Areas and Intermediate Zones,MSOAIZ,TW,10403,3840,3961,1476,831,404,3130,1072,469,233,3826,1373,2293,827,1533,546,546,,,,2052,724,1975,695,2,1,49,16,26,12,29,95,34
E02000551,Hounslow 026,Middle Super Output Areas and Intermediate Zones,MSOAIZ,TW,8614,3294,3292,1254,917,449,2375,805,107,46,4033,1577,2284,945,1749,632,632,,,,1062,363,995,336,0,0,60,22,7,5,27,120,54
E02000552,Hounslow 027,Middle Super Output Areas and Intermediate Zones,MSOAIZ,TW,8098,3266,4834,2032,1277,678,3557,1354,292,112,1000,344,472,165,528,179,179,,,,1916,753,1811,711,8,3,83,32,14,7,42,56,25
E02000553,Hounslow 028,Middle Super Output Areas and Intermediate Zones,MSOAIZ,TW,6605,2605,4097,1647,1303,667,2794,980,113,44,1564,613,1317,528,247,85,85,,,,771,272,711,247,15,3,38,20,7,2,25,60,29
E02000554,Islington 001,Middle Super Output Areas and Intermediate Zones,MSOAIZ,N,9132,4226,2187,1010,636,319,1551,691,48,29,4973,2285,3862,1737,1111,548,548,,,,1837,860,1750,815,3,2,64,32,20,11,45,87,42
E02000555,Islington 002,Middle Super Output Areas and Intermediate Zones,MSOAIZ,N,9355,3986,3469,1458,1225,553,2244,905,81,43,3461,1495,2432,1034,1029,461,461,,,,2234,941,2132,894,9,4,79,37,14,6,47,110,49
E02000556,Islington 003,Middle Super Output Areas and Intermediate Zones,MSOAIZ,N,9990,4561,3050,1387,996,499,2054,888,94,48,3545,1639,2157,1006,1388,633,633,,,,3196,1435,3099,1395,11,4,69,28,17,8,40,105,52
E02000557,Islington 004,Middle Super Output Areas and Intermediate Zones,MSOAIZ,NW,8066,3929,2114,1007,700,382,1414,625,102,57,3744,1868,2023,990,1721,878,878,,,,2007,950,1927,908,12,6,55,29,13,7,42,99,47
E02000558,Islington 005,Middle Super Output Areas and Intermediate Zones,MSOAIZ,N,8693,3780,1134,513,420,201,714,312,61,23,5619,2421,4034,1751,1585,670,670,,,,1758,772,1690,741,14,4,45,22,9,5,31,121,51
E02000559,Islington 006,Middle Super Output Areas and Intermediate Zones,MSOAIZ,N,8778,3882,3382,1440,1279,599,2103,841,127,66,2204,963,1193,496,1011,467,467,,,,2996,1377,2888,1321,5,3,98,49,5,4,56,69,36
E02000560,Islington 007,Middle Super Output Areas and Intermediate Zones,MSOAIZ,N,6888,3177,2087,1034,748,389,1339,645,42,24,1744,812,1016,434,728,378,378,,,,2915,1257,2811,1207,2,2,82,40,20,8,50,100,50
E02000561,Islington 008,Middle Super Output Areas and Intermediate Zones,MSOAIZ,N,7632,3413,3704,1533,1445,647,2259,886,47,25,1658,850,548,276,1110,574,574,,,,2135,966,2025,915,12,3,65,33,33,15,51,88,39
E02000562,Islington 009,Middle Super Output Areas and Intermediate Zones,MSOAIZ,N,7814,3594,2782,1246,1056,488,1726,758,28,12,3133,1481,2487,1143,646,338,338,,,,1759,807,1674,766,5,2,64,31,16,8,41,112,48
E02000563,Islington 010,Middle Super Output Areas and Intermediate Zones,MSOAIZ,N,8028,3652,1780,830,567,287,1213,543,67,37,4025,1855,2913,1367,1112,488,488,,,,2045,871,1921,813,7,3,62,29,55,26,58,111,59
E02000564,Islington 011,Middle Super Output Areas and Intermediate Zones,MSOAIZ,N,10465,5004,2392,1162,775,393,1617,769,416,240,3739,1809,2009,993,1730,816,816,,,,3749,1724,3608,1653,4,2,117,57,20,12,71,169,69
E02000565,Islington 012,Middle Super Output Areas and Intermediate Zones,MSOAIZ,N,7974,3610,1874,897,520,267,1354,630,78,49,4197,1817,3362,1382,835,435,435,,,,1733,795,1656,759,6,2,50,25,21,9,36,92,52
E02000566,Islington 013,Middle Super Output Areas and Intermediate Zones,MSOAIZ,N,8164,3662,3425,1484,1503,675,1922,809,53,27,2362,1061,1296,557,1066,504,504,,,,2251,1049,2144,1001,10,4,81,36,16,8,48,73,41
E02000567,Islington 014,Middle Super Output Areas and Intermediate Zones,MSOAIZ,N,10358,4937,3012,1446,983,486,2029,960,115,57,4437,2122,3396,1573,1041,549,549,,,,2705,1269,2596,1213,8,4,88,45,13,7,56,89,43
E02000568,Islington 015,Middle Super Output Areas and Intermediate Zones,MSOAIZ,N,8661,4063,1513,736,528,285,985,451,232,133,4670,2177,2303,1115,2367,1062,1062,,,,2108,961,1934,882,13,7,68,28,93,44,79,138,56
E02000569,Islington 016,Middle Super Output Areas and Intermediate Zones,MSOAIZ,N,10015,4745,2593,1241,1123,586,1470,655,132,57,4961,2354,3233,1530,1728,824,824,,,,2173,1015,2023,939,30,12,101,54,19,10,76,156,78
E02000570,Islington 017,Middle Super Output Areas and Intermediate Zones,MSOAIZ,N,8595,4119,3675,1715,1687,804,1988,911,22,9,2249,1071,1160,543,1089,528,528,,,,2573,1283,2482,1235,10,5,74,37,7,6,48,76,41
E02000571,Islington 018,Middle Super Output Areas and Intermediate Zones,MSOAIZ,N,7998,3777,1964,1000,653,354,1311,646,76,40,4230,1947,2949,1365,1281,582,582,,,,1616,734,1514,679,10,6,74,40,18,9,55,112,56
E02000572,Islington 019,Middle Super Output Areas and Intermediate Zones,MSOAIZ,N,8108,3490,1152,513,423,201,729,312,114,61,4996,2135,2143,920,2853,1215,1215,,,,1720,729,1649,695,1,1,48,20,22,13,34,126,52
E02000573,Islington 020,Middle Super Output Areas and Intermediate Zones,MSOAIZ,N,8507,4204,3224,1580,1537,783,1687,797,52,29,2423,1201,1400,699,1023,502,502,,,,2670,1327,2570,1280,9,4,79,36,12,7,47,138,67
E02000574,Islington 021,Middle Super Output Areas and Intermediate Zones,MSOAIZ,WC,7708,3840,1923,1004,735,414,1188,590,101,68,2924,1432,1854,893,1070,539,539,,,,2650,1289,2537,1231,7,3,84,43,22,12,58,110,47
E02000575,Islington 022,Middle Super Output Areas and Intermediate Zones,MSOAIZ,WC,10418,5583,2796,1570,1098,669,1698,901,55,34,4182,2060,3346,1592,836,468,468,,,,3239,1830,3008,1702,27,12,132,66,72,50,128,146,89
E02000576,Islington 023,Middle Super Output Areas and Intermediate Zones,MSOAIZ,N,8787,4322,1353,758,506,306,847,452,83,39,5242,2487,3600,1618,1642,869,869,,,,1972,976,1832,910,18,4,71,35,51,27,66,137,62
E02000577,Kensington and Chelsea 001,Middle Super Output Areas and Intermediate Zones,MSOAIZ,W,7195,3163,685,330,264,127,421,203,129,60,5498,2344,3333,1421,2165,923,923,,,,821,396,759,365,4,2,25,14,33,15,31,62,33
E02000578,Kensington and Chelsea 002,Middle Super Output Areas and Intermediate Zones,MSOAIZ,W,5706,2454,645,310,268,135,377,175,159,81,4292,1778,1133,469,3159,1309,1309,,,,500,238,452,215,0,0,24,11,24,12,23,110,47
E02000579,Kensington and Chelsea 003,Middle Super Output Areas and Intermediate Zones,MSOAIZ,W,8570,4013,3052,1316,1483,685,1569,631,155,86,3580,1700,1221,522,2359,1178,1178,,,,1682,859,1597,817,9,3,65,31,11,8,42,101,52
E02000580,Kensington and Chelsea 004,Middle Super Output Areas and Intermediate Zones,MSOAIZ,W,8619,4517,1791,941,930,506,861,435,93,50,4515,2275,1247,547,3268,1728,1728,,,,2130,1212,2022,1151,16,9,66,41,26,11,61,90,39
E02000581,Kensington and Chelsea 005,Middle Super Output Areas and Intermediate Zones,MSOAIZ,W,7292,3311,963,413,467,218,496,195,92,60,5256,2383,3179,1364,2077,1019,1019,,,,864,401,797,372,8,4,26,13,33,12,29,117,54
E02000582,Kensington and Chelsea 006,Middle Super Output Areas and Intermediate Zones,MSOAIZ,W,7317,3946,3318,1601,2058,1053,1260,548,76,44,841,502,234,111,607,391,391,,,,2891,1698,2649,1572,96,50,102,50,44,26,126,191,101
E02000583,Kensington and Chelsea 007,Middle Super Output Areas and Intermediate Zones,MSOAIZ,W,7290,3496,3686,1590,2335,1041,1351,549,41,21,1216,648,206,97,1010,551,551,,,,2200,1166,2089,1102,24,13,65,40,22,11,64,147,71
E02000584,Kensington and Chelsea 008,Middle Super Output Areas and Intermediate Zones,MSOAIZ,W,7952,3922,3969,1870,2642,1314,1327,556,27,14,516,276,328,166,188,110,110,,,,3073,1559,2888,1472,74,29,63,34,48,24,87,367,203
E02000585,Kensington and Chelsea 009,Middle Super Output Areas and Intermediate Zones,MSOAIZ,W,8361,3919,3865,1757,2329,1093,1536,664,81,36,1098,522,264,125,834,397,397,,,,3054,1469,2929,1404,20,9,77,40,28,16,65,263,135
E02000586,Kensington and Chelsea 010,Middle Super Output Areas and Intermediate Zones,MSOAIZ,W,7566,3729,3323,1587,2167,1086,1156,501,45,19,255,148,31,15,224,133,133,,,,3511,1765,3330,1689,51,22,75,30,55,24,76,432,210
E02000587,Kensington and Chelsea 011,Middle Super Output Areas and Intermediate Zones,MSOAIZ,W,7488,3536,3807,1695,2511,1174,1296,521,18,12,214,130,42,21,172,109,109,,,,3232,1592,3113,1527,31,14,53,29,35,22,65,217,107
E02000588,Kensington and Chelsea 012,Middle Super Output Areas and Intermediate Zones,MSOAIZ,SW,8158,4458,3047,1647,2093,1172,954,475,37,18,258,144,5,2,253,142,142,,,,4115,2298,3945,2202,30,20,89,46,51,30,96,701,351
E02000589,Kensington and Chelsea 013,Middle Super Output Areas and Intermediate Zones,MSOAIZ,W,8138,4422,2835,1529,1655,941,1180,588,49,25,748,465,181,90,567,375,375,,,,4235,2258,4026,2163,54,17,110,54,45,24,95,271,145
E02000590,Kensington and Chelsea 014,Middle Super Output Areas and Intermediate Zones,MSOAIZ,SW,7010,3890,2105,1147,1452,847,653,300,16,10,2379,1174,817,345,1562,829,829,,,,2303,1436,2177,1356,26,11,31,23,69,46,80,207,123
E02000591,Kensington and Chelsea 015,Middle Super Output Areas and Intermediate Zones,MSOAIZ,W,6648,3589,1860,1012,1028,585,832,427,90,50,1876,1032,217,114,1659,918,918,,,,2689,1417,2581,1369,18,7,50,23,40,18,48,133,78
E02000592,Kensington and Chelsea 016,Middle Super Output Areas and Intermediate Zones,MSOAIZ,SW,6724,3583,2902,1494,1838,1024,1064,470,20,11,322,181,22,11,300,170,170,,,,3230,1763,3068,1673,62,36,66,31,34,23,90,250,134
E02000593,Kensington and Chelsea 017,Middle Super Output Areas and Intermediate Zones,MSOAIZ,SW,7601,4067,3141,1601,1557,834,1584,767,51,37,1020,624,226,125,794,499,499,,,,3219,1712,3061,1628,38,13,105,58,15,13,84,170,93
E02000594,Kensington and Chelsea 018,Middle Super Output Areas and Intermediate Zones,MSOAIZ,SW,6958,3710,3296,1681,2263,1188,1033,493,30,17,826,505,266,126,560,379,379,,,,2468,1329,2304,1241,68,30,73,45,23,13,88,338,178
E02000595,Kensington and Chelsea 019,Middle Super Output Areas and Intermediate Zones,MSOAIZ,SW,7107,3747,3543,1763,2350,1243,1193,520,19,13,873,545,627,397,246,148,148,,,,2415,1297,2267,1225,42,14,81,42,25,16,72,257,129
E02000596,Kensington and Chelsea 020,Middle Super Output Areas and Intermediate Zones,MSOAIZ,SW,7119,3605,3455,1686,2074,1075,1381,611,20,13,725,336,306,158,419,178,178,,,,2726,1468,2606,1402,13,8,75,39,32,19,66,193,102
E02000597,Kensington and Chelsea 021,Middle Super Output Areas and Intermediate Zones,MSOAIZ,SW,7120,3459,2086,1037,1117,592,969,445,42,23,3326,1559,2191,975,1135,584,584,,,,1521,775,1435,731,18,7,58,30,10,7,44,145,65
E02000598,Kingston upon Thames 001,Middle Super Output Areas and Intermediate Zones,MSOAIZ,TW,7837,3001,6164,2339,2177,1052,3987,1287,57,27,500,227,185,76,315,151,151,,,,1071,381,1003,357,3,2,53,20,12,2,24,45,27
E02000599,Kingston upon Thames 002,Middle Super Output Areas and Intermediate Zones,MSOAIZ,SW,6688,2368,5096,1853,2304,1006,2792,847,26,9,200,73,148,54,52,19,19,,,,1290,391,1254,375,16,5,16,8,4,3,16,76,42
E02000600,Kingston upon Thames 003,Middle Super Output Areas and Intermediate Zones,MSOAIZ,KT,8084,3354,4130,1770,1519,796,2611,974,2,2,1183,466,1065,416,118,50,50,,,,2673,1073,2510,1004,42,16,89,37,32,16,69,96,43
E02000601,Kingston upon Thames 004,Middle Super Output Areas and Intermediate Zones,MSOAIZ,KT,10277,4245,6006,2367,1912,907,4094,1460,84,48,1237,577,666,338,571,239,239,,,,2846,1205,2474,1058,191,68,48,28,133,51,147,104,48
E02000602,Kingston upon Thames 005,Middle Super Output Areas and Intermediate Zones,MSOAIZ,KT,9213,3997,3612,1576,1116,573,2496,1003,108,51,2819,1313,2296,1066,523,247,247,,,,2576,1007,2431,940,34,16,94,44,17,7,67,98,50
E02000603,Kingston upon Thames 006,Middle Super Output Areas and Intermediate Zones,MSOAIZ,KT,7809,2798,3938,1460,1196,573,2742,887,124,50,1931,697,1313,477,618,220,220,,,,1753,560,1626,517,0,0,92,33,35,10,43,63,31
E02000604,Kingston upon Thames 007,Middle Super Output Areas and Intermediate Zones,MSOAIZ,KT,8558,3343,5591,2162,2042,1005,3549,1157,37,21,458,214,363,177,95,37,37,,,,2370,902,2235,854,8,4,80,27,47,17,48,102,44
E02000605,Kingston upon Thames 008,Middle Super Output Areas and Intermediate Zones,MSOAIZ,KT,7782,3013,5799,2274,2191,1071,3608,1203,27,12,376,168,313,142,63,26,26,,,,1519,529,1426,496,14,5,53,21,26,7,33,61,30
E02000606,Kingston upon Thames 009,Middle Super Output Areas and Intermediate Zones,MSOAIZ,KT,9827,4799,4772,2390,1723,1021,3049,1369,39,24,578,322,282,142,296,180,180,,,,4366,2022,4163,1918,16,10,111,48,76,46,104,72,41
E02000607,Kingston upon Thames 010,Middle Super Output Areas and Intermediate Zones,MSOAIZ,KT,6117,2497,4152,1672,1473,717,2679,955,7,4,360,202,229,140,131,62,62,,,,1549,594,1468,565,12,5,58,19,11,5,29,49,25
E02000608,Kingston upon Thames 011,Middle Super Output Areas and Intermediate Zones,MSOAIZ,KT,6104,3182,2832,1498,859,543,1973,955,40,20,528,312,149,93,379,219,219,,,,2637,1317,2514,1258,21,8,82,40,20,11,59,67,35
E02000609,Kingston upon Thames 012,Middle Super Output Areas and Intermediate Zones,MSOAIZ,KT,7380,2741,5285,1954,2017,964,3268,990,35,15,864,392,759,345,105,47,47,,,,1144,357,1054,329,11,3,61,19,18,6,28,52,23
E02000610,Kingston upon Thames 013,Middle Super Output Areas and Intermediate Zones,MSOAIZ,KT,7441,3785,3320,1720,1167,731,2153,989,41,18,1196,660,808,442,388,218,218,,,,2821,1349,2726,1303,3,1,74,38,18,7,46,63,38
E02000611,Kingston upon Thames 014,Middle Super Output Areas and Intermediate Zones,MSOAIZ,KT,7313,2649,6485,2367,2480,1179,4005,1188,39,17,110,56,74,42,36,14,14,,,,642,195,609,185,8,1,15,6,10,3,10,37,14
E02000612,Kingston upon Thames 015,Middle Super Output Areas and Intermediate Zones,MSOAIZ,KT,7936,3051,6600,2543,2611,1247,3989,1296,6,3,373,141,264,102,109,39,39,,,,902,333,867,317,2,1,32,14,1,1,16,55,31
E02000613,Kingston upon Thames 016,Middle Super Output Areas and Intermediate Zones,MSOAIZ,KT,7660,3174,5083,2084,1550,809,3533,1275,48,19,834,382,508,232,326,150,150,,,,1651,671,1576,642,8,4,54,20,13,5,29,44,18
E02000614,Kingston upon Thames 017,Middle Super Output Areas and Intermediate Zones,MSOAIZ,KT,8359,3072,5748,2139,1760,852,3988,1287,98,39,613,278,441,205,172,73,73,,,,1851,594,1710,540,24,10,81,29,36,15,54,49,22
E02000615,Kingston upon Thames 018,Middle Super Output Areas and Intermediate Zones,MSOAIZ,KT,7471,2916,5854,2314,1986,1015,3868,1299,42,13,598,231,494,195,104,36,36,,,,921,328,843,296,16,4,50,24,12,4,32,56,30
E02000616,Kingston upon Thames 019,Middle Super Output Areas and Intermediate Zones,MSOAIZ,KT,6013,2363,4999,2006,1507,766,3492,1240,58,23,385,127,209,75,176,52,52,,,,562,201,504,178,0,0,52,20,6,3,23,9,6
E02000617,Kingston upon Thames 020,Middle Super Output Areas and Intermediate Zones,MSOAIZ,KT,8489,3291,5726,2274,1739,900,3987,1374,48,19,1835,664,1239,493,596,171,171,,,,800,303,694,259,25,9,66,30,15,5,44,80,31
E02000619,Lambeth 002,Middle Super Output Areas and Intermediate Zones,MSOAIZ,SE,7987,3743,1853,960,689,378,1164,582,107,56,4446,2015,3504,1584,942,431,431,,,,1474,664,1374,617,13,6,53,29,34,12,47,107,48
E02000620,Lambeth 003,Middle Super Output Areas and Intermediate Zones,MSOAIZ,SE,9350,4398,2255,1141,742,420,1513,721,375,219,4267,1932,2813,1215,1454,717,717,,,,2357,1058,2182,979,43,19,93,42,39,18,79,96,48
E02000621,Lambeth 004,Middle Super Output Areas and Intermediate Zones,MSOAIZ,SW,10271,5083,2709,1370,984,523,1725,847,350,225,3432,1619,1270,576,2162,1043,1043,,,,3659,1794,3427,1670,59,36,140,67,33,21,124,121,75
E02000622,Lambeth 005,Middle Super Output Areas and Intermediate Zones,MSOAIZ,SW,8031,3482,2074,1014,689,357,1385,657,44,21,3036,1282,1707,719,1329,563,563,,,,2816,1132,2688,1076,11,4,86,36,31,16,56,61,33
E02000623,Lambeth 006,Middle Super Output Areas and Intermediate Zones,MSOAIZ,SW,7979,3409,1727,756,580,274,1147,482,38,24,4260,1851,2458,1029,1802,822,822,,,,1851,736,1746,694,6,2,77,32,22,8,42,103,42
E02000624,Lambeth 007,Middle Super Output Areas and Intermediate Zones,MSOAIZ,SW,7933,3500,1643,783,393,207,1250,576,42,21,4126,1826,2605,1093,1521,733,733,,,,2067,843,1924,785,2,1,106,45,35,12,58,55,27
E02000625,Lambeth 008,Middle Super Output Areas and Intermediate Zones,MSOAIZ,SW,8310,3383,1521,693,374,191,1147,502,96,49,4541,1769,2980,1090,1561,679,679,,,,2078,839,1976,796,4,2,66,27,32,14,43,74,33
E02000626,Lambeth 009,Middle Super Output Areas and Intermediate Zones,MSOAIZ,SW,8256,3443,1403,562,276,124,1127,438,68,41,5268,2280,4456,1875,812,405,405,,,,1432,521,1306,471,10,3,100,38,16,9,50,85,39
E02000627,Lambeth 010,Middle Super Output Areas and Intermediate Zones,MSOAIZ,SW,9496,4042,2209,1000,789,350,1420,650,196,121,3827,1673,1299,544,2528,1129,1129,,,,3166,1197,3027,1130,10,6,100,48,29,13,67,98,51
E02000628,Lambeth 011,Middle Super Output Areas and Intermediate Zones,MSOAIZ,SW,9676,3972,1490,647,325,156,1165,491,63,40,5819,2353,3412,1347,2407,1006,1006,,,,2196,881,2008,794,13,5,135,63,40,19,87,108,51
E02000629,Lambeth 012,Middle Super Output Areas and Intermediate Zones,MSOAIZ,SW,9004,3973,2868,1276,882,404,1986,872,118,63,2445,1133,1563,701,882,432,432,,,,3461,1454,3316,1391,8,4,110,49,27,10,63,112,47
E02000630,Lambeth 013,Middle Super Output Areas and Intermediate Zones,MSOAIZ,SW,7265,3336,2631,1257,1050,507,1581,750,77,49,1850,846,1465,660,385,186,186,,,,2635,1144,2497,1077,24,12,94,45,20,10,67,72,40
E02000631,Lambeth 014,Middle Super Output Areas and Intermediate Zones,MSOAIZ,SW,8798,3723,3594,1480,1214,556,2380,924,39,14,2229,1037,527,231,1702,806,806,,,,2841,1148,2686,1078,24,11,102,45,29,14,70,95,44
E02000632,Lambeth 015,Middle Super Output Areas and Intermediate Zones,MSOAIZ,SW,9484,4148,2860,1401,902,434,1958,967,67,44,1975,907,695,298,1280,609,609,,,,4526,1765,4344,1683,17,5,140,62,25,15,82,56,31
E02000633,Lambeth 016,Middle Super Output Areas and Intermediate Zones,MSOAIZ,SW,8581,3872,1922,922,618,298,1304,624,210,107,3893,1758,2187,931,1706,827,827,,,,2445,1023,2319,961,0,0,85,41,41,21,62,111,62
E02000634,Lambeth 017,Middle Super Output Areas and Intermediate Zones,MSOAIZ,SW,6740,3021,1586,761,525,270,1061,491,84,42,2880,1321,2378,1040,502,281,281,,,,2134,866,2030,826,13,3,77,31,14,6,40,56,31
E02000635,Lambeth 018,Middle Super Output Areas and Intermediate Zones,MSOAIZ,SW,9138,4066,2763,1202,888,406,1875,796,165,81,3400,1573,1200,536,2200,1037,1037,,,,2718,1161,2586,1101,1,1,92,40,39,19,60,92,49
E02000636,Lambeth 019,Middle Super Output Areas and Intermediate Zones,MSOAIZ,SW,7613,3076,4060,1612,1589,655,2471,957,33,18,976,426,667,287,309,139,139,,,,2512,1004,2408,964,8,2,83,32,13,6,40,32,16
E02000637,Lambeth 020,Middle Super Output Areas and Intermediate Zones,MSOAIZ,SW,8637,3935,3406,1569,1098,548,2308,1021,79,33,1755,840,709,325,1046,515,515,,,,3304,1456,3151,1385,9,5,119,50,25,16,71,93,37
E02000638,Lambeth 021,Middle Super Output Areas and Intermediate Zones,MSOAIZ,SW,9509,4104,2694,1249,716,363,1978,886,222,115,3601,1588,2483,1118,1118,470,470,,,,2920,1116,2764,1049,13,7,109,44,34,16,67,72,36
E02000639,Lambeth 022,Middle Super Output Areas and Intermediate Zones,MSOAIZ,SW,8090,3398,1561,757,468,257,1093,500,49,28,4302,1731,1742,652,2560,1079,1079,,,,2093,844,1973,787,8,3,54,21,58,33,57,85,38
E02000640,Lambeth 023,Middle Super Output Areas and Intermediate Zones,MSOAIZ,SW,9110,3785,4176,1806,1294,621,2882,1185,44,16,2185,972,1226,522,959,450,450,,,,2634,958,2499,907,4,1,102,40,29,10,51,71,33
E02000641,Lambeth 024,Middle Super Output Areas and Intermediate Zones,MSOAIZ,SW,8638,3442,1789,766,416,207,1373,559,96,52,5034,2013,2731,1093,2303,920,920,,,,1651,582,1580,554,8,3,50,17,13,8,28,68,29
E02000642,Lambeth 025,Middle Super Output Areas and Intermediate Zones,MSOAIZ,SW,9617,4162,3846,1651,1249,621,2597,1030,92,47,3141,1342,1028,440,2113,902,902,,,,2481,1091,2371,1037,0,0,99,48,11,6,54,57,31
E02000643,Lambeth 026,Middle Super Output Areas and Intermediate Zones,MSOAIZ,SW,8347,3589,3352,1456,1015,470,2337,986,78,38,2068,925,1614,674,454,251,251,,,,2771,1139,2647,1083,6,3,99,45,19,8,56,78,31
E02000644,Lambeth 027,Middle Super Output Areas and Intermediate Zones,MSOAIZ,SW,8524,3565,3866,1627,1157,533,2709,1094,53,26,1586,725,863,366,723,359,359,,,,2923,1144,2792,1092,24,6,95,38,12,8,52,96,43
E02000645,Lambeth 028,Middle Super Output Areas and Intermediate Zones,MSOAIZ,SE,8992,3870,3909,1646,1085,510,2824,1136,63,31,1712,788,914,412,798,376,376,,,,3244,1371,3097,1303,6,4,114,52,27,12,68,64,34
E02000646,Lambeth 029,Middle Super Output Areas and Intermediate Zones,MSOAIZ,SW,8983,3842,4047,1710,1406,648,2641,1062,26,13,967,492,445,212,522,280,280,,,,3858,1587,3717,1524,10,5,98,44,33,14,63,85,40
E02000647,Lambeth 030,Middle Super Output Areas and Intermediate Zones,MSOAIZ,SW,8325,3444,4437,1843,1423,675,3014,1168,154,64,1469,664,908,436,561,228,228,,,,2181,837,2122,810,0,0,43,18,16,9,27,84,36
E02000648,Lambeth 031,Middle Super Output Areas and Intermediate Zones,MSOAIZ,SW,7683,3232,2401,1025,559,300,1842,725,112,63,3724,1592,2709,1212,1015,380,380,,,,1398,527,1300,486,9,3,42,21,47,17,41,48,25
E02000649,Lambeth 032,Middle Super Output Areas and Intermediate Zones,MSOAIZ,SW,10973,4887,4006,1842,1057,525,2949,1317,101,47,1680,732,1001,418,679,314,314,,,,5088,2223,4964,2165,6,5,99,47,19,6,58,98,43
E02000650,Lambeth 033,Middle Super Output Areas and Intermediate Zones,MSOAIZ,SE,7424,3233,2639,1167,585,310,2054,857,50,22,2878,1206,2138,886,740,320,320,,,,1774,803,1676,757,12,5,65,31,21,10,46,83,35
E02000651,Lambeth 034,Middle Super Output Areas and Intermediate Zones,MSOAIZ,SW,8456,3492,4107,1630,1348,618,2759,1012,107,57,1175,574,611,294,564,280,280,,,,2997,1199,2932,1174,1,1,40,16,24,8,25,70,32
E02000652,Lambeth 035,Middle Super Output Areas and Intermediate Zones,MSOAIZ,SW,7324,2527,3763,1471,1395,668,2368,803,108,40,1120,386,338,112,782,274,274,,,,2267,608,2150,573,0,0,85,23,32,12,35,66,22
E02000653,Lewisham 001,Middle Super Output Areas and Intermediate Zones,MSOAIZ,SE,8525,3547,1285,630,296,174,989,456,340,168,4731,1881,2617,1062,2114,819,819,,,,2066,827,1985,795,2,1,36,18,43,13,32,103,41
E02000654,Lewisham 002,Middle Super Output Areas and Intermediate Zones,MSOAIZ,SE,8055,3336,1140,518,299,141,841,377,141,74,5153,2062,3804,1546,1349,516,516,,,,1525,643,1442,613,6,3,55,19,22,8,30,96,39
E02000655,Lewisham 003,Middle Super Output Areas and Intermediate Zones,MSOAIZ,SE,7887,3366,2127,987,447,227,1680,760,170,72,2703,1144,1796,833,907,311,311,,,,2834,1140,2721,1094,19,5,84,36,10,5,46,53,23
E02000657,Lewisham 005,Middle Super Output Areas and Intermediate Zones,MSOAIZ,SE,8566,3776,2425,1069,777,379,1648,690,109,53,2772,1305,1467,651,1305,654,654,,,,3162,1310,2998,1249,7,4,114,44,43,13,61,98,39
E02000658,Lewisham 006,Middle Super Output Areas and Intermediate Zones,MSOAIZ,SE,8295,3538,2799,1128,983,411,1816,717,72,40,2735,1215,1607,703,1128,512,512,,,,2584,1110,2502,1069,4,2,56,26,22,13,41,105,45
E02000659,Lewisham 007,Middle Super Output Areas and Intermediate Zones,MSOAIZ,SE,7611,3284,2941,1314,1004,506,1937,808,23,10,2969,1194,2397,918,572,276,276,,,,1615,737,1522,696,17,4,69,33,7,4,41,63,29
E02000660,Lewisham 008,Middle Super Output Areas and Intermediate Zones,MSOAIZ,SE,7945,3659,2728,1273,703,372,2025,901,134,66,2093,932,1371,599,722,333,333,,,,2921,1347,2683,1257,18,8,208,75,12,7,90,69,41
E02000661,Lewisham 009,Middle Super Output Areas and Intermediate Zones,MSOAIZ,SE,6275,3139,3030,1460,1251,662,1779,798,8,6,1221,656,910,465,311,191,191,,,,1973,996,1906,963,13,5,45,24,9,4,33,43,21
E02000662,Lewisham 010,Middle Super Output Areas and Intermediate Zones,MSOAIZ,SE,8093,3317,2441,1041,612,285,1829,756,125,68,3306,1293,2399,930,907,363,363,,,,2153,889,1922,816,0,0,203,62,28,11,73,68,26
E02000663,Lewisham 011,Middle Super Output Areas and Intermediate Zones,MSOAIZ,SE,7186,2903,3369,1430,1056,509,2313,921,20,10,1855,711,647,287,1208,424,424,,,,1903,731,1666,659,13,3,207,62,17,7,72,39,21
E02000664,Lewisham 012,Middle Super Output Areas and Intermediate Zones,MSOAIZ,SE,9797,4452,2631,1208,827,423,1804,785,321,171,3223,1547,1615,728,1608,819,819,,,,3510,1475,3381,1427,6,4,80,28,43,16,48,112,51
E02000665,Lewisham 013,Middle Super Output Areas and Intermediate Zones,MSOAIZ,SE,7907,3504,3962,1672,1240,604,2722,1068,70,41,1776,870,816,385,960,485,485,,,,2051,897,1963,852,7,3,63,31,18,11,45,48,24
E02000666,Lewisham 014,Middle Super Output Areas and Intermediate Zones,MSOAIZ,SE,7214,2859,3487,1409,1029,483,2458,926,24,15,1586,651,710,284,876,367,367,,,,1914,720,1814,677,4,3,90,35,6,5,43,203,64
E02000667,Lewisham 015,Middle Super Output Areas and Intermediate Zones,MSOAIZ,SE,6526,2595,3954,1604,1247,594,2707,1010,83,39,852,327,298,114,554,213,213,,,,1593,606,1511,574,1,1,67,27,14,4,32,44,19
E02000668,Lewisham 016,Middle Super Output Areas and Intermediate Zones,MSOAIZ,SE,6647,2816,4187,1721,1543,757,2644,964,41,19,961,472,358,176,603,296,296,,,,1428,583,1329,545,10,2,81,33,8,3,38,30,21
E02000669,Lewisham 017,Middle Super Output Areas and Intermediate Zones,MSOAIZ,SE,7403,3270,3419,1502,887,421,2532,1081,78,47,1297,569,354,148,943,421,421,,,,2545,1127,2448,1082,0,0,72,37,25,8,45,64,25
E02000670,Lewisham 018,Middle Super Output Areas and Intermediate Zones,MSOAIZ,SE,6522,2748,2725,1178,823,420,1902,758,11,7,1769,771,356,170,1413,601,601,,,,1956,762,1915,738,4,1,26,17,11,6,24,61,30
E02000671,Lewisham 019,Middle Super Output Areas and Intermediate Zones,MSOAIZ,SE,8375,3668,4401,1842,1215,596,3186,1246,90,53,1471,728,583,283,888,445,445,,,,2332,1009,2237,959,10,5,67,35,18,10,50,81,36
E02000672,Lewisham 020,Middle Super Output Areas and Intermediate Zones,MSOAIZ,SE,8206,3509,3423,1417,1041,502,2382,915,35,18,1746,912,800,425,946,487,487,,,,2939,1131,2795,1069,15,5,78,37,51,20,62,63,31
E02000673,Lewisham 021,Middle Super Output Areas and Intermediate Zones,MSOAIZ,SE,7988,3490,4421,1849,1415,704,3006,1145,28,17,1391,655,636,313,755,342,342,,,,2080,939,1994,895,19,7,53,28,14,9,44,68,30
E02000674,Lewisham 022,Middle Super Output Areas and Intermediate Zones,MSOAIZ,SE,7944,3020,5275,2031,1432,677,3843,1354,40,19,891,378,247,102,644,276,276,,,,1680,562,1552,513,0,0,98,38,30,11,49,58,30
E02000675,Lewisham 023,Middle Super Output Areas and Intermediate Zones,MSOAIZ,SE,8165,3419,5255,2121,1673,835,3582,1286,38,21,1357,639,217,108,1140,531,531,,,,1439,602,1361,570,5,1,67,29,6,2,32,76,36
E02000676,Lewisham 024,Middle Super Output Areas and Intermediate Zones,MSOAIZ,SE,7694,3252,4208,1709,1144,529,3064,1180,51,20,1457,681,420,211,1037,470,470,,,,1922,814,1830,765,5,2,63,38,24,9,49,56,28
E02000677,Lewisham 025,Middle Super Output Areas and Intermediate Zones,MSOAIZ,SE,7103,2692,4771,1726,1356,624,3415,1102,27,18,734,340,224,102,510,238,238,,,,1514,577,1452,557,0,0,43,14,19,6,20,57,31
E02000678,Lewisham 026,Middle Super Output Areas and Intermediate Zones,MSOAIZ,SE,6087,2432,3068,1231,725,382,2343,849,32,11,1805,761,545,220,1260,541,541,,,,1140,407,1067,378,0,0,51,21,22,8,29,42,22
E02000679,Lewisham 027,Middle Super Output Areas and Intermediate Zones,MSOAIZ,SE,7867,3455,3620,1516,1140,558,2480,958,140,76,2333,1099,1693,784,640,315,315,,,,1692,729,1622,693,1,1,61,29,8,6,36,82,35
E02000680,Lewisham 028,Middle Super Output Areas and Intermediate Zones,MSOAIZ,SE,6750,3016,2716,1235,848,464,1868,771,45,29,2456,1060,1107,479,1349,581,581,,,,1454,652,1354,602,8,5,50,23,42,22,50,79,40
E02000681,Lewisham 029,Middle Super Output Areas and Intermediate Zones,MSOAIZ,SE,8094,3268,3942,1541,1019,515,2923,1026,101,37,2636,1176,1149,535,1487,641,641,,,,1370,492,1280,457,8,2,59,27,23,6,35,45,22
E02000682,Lewisham 030,Middle Super Output Areas and Intermediate Zones,MSOAIZ,SE,8147,3095,3886,1492,1288,643,2598,849,40,19,2794,1145,1052,409,1742,736,736,,,,1335,404,1243,372,6,1,70,24,16,7,32,92,35
E02000683,Lewisham 031,Middle Super Output Areas and Intermediate Zones,MSOAIZ,SE,6443,2763,2774,1186,847,452,1927,734,82,45,2251,1011,472,214,1779,797,797,,,,1280,502,1199,474,0,0,70,24,11,4,28,56,19
E02000685,Lewisham 033,Middle Super Output Areas and Intermediate Zones,MSOAIZ,SE,7584,3357,3124,1374,898,484,2226,890,34,14,2850,1278,1517,684,1333,594,594,,,,1486,649,1401,608,0,0,65,30,20,11,41,90,42
E02000686,Lewisham 034,Middle Super Output Areas and Intermediate Zones,MSOAIZ,SE,6672,2839,2121,909,520,290,1601,619,73,36,3447,1513,1576,674,1871,839,839,,,,985,356,902,321,3,1,51,24,29,10,35,46,25
E02000687,Lewisham 035,Middle Super Output Areas and Intermediate Zones,MSOAIZ,SE,7828,3436,3527,1541,1087,554,2440,987,44,23,2386,1082,1336,664,1050,418,418,,,,1803,763,1721,726,11,3,52,24,19,10,37,68,27
E02000689,Merton 001,Middle Super Output Areas and Intermediate Zones,MSOAIZ,SW,8239,3230,5379,1994,2012,868,3367,1126,171,103,520,225,119,57,401,168,168,,,,2107,885,2042,854,2,2,58,27,5,2,31,62,23
E02000690,Merton 002,Middle Super Output Areas and Intermediate Zones,MSOAIZ,SW,5527,2300,4077,1625,2372,1047,1705,578,6,3,272,182,57,37,215,145,145,,,,1048,430,978,400,28,8,37,19,5,3,30,124,60
E02000691,Merton 003,Middle Super Output Areas and Intermediate Zones,MSOAIZ,SW,7168,2968,3945,1557,1480,666,2465,891,69,35,614,262,180,62,434,200,200,,,,2494,1086,2399,1046,6,2,68,30,21,8,40,46,28
E02000692,Merton 004,Middle Super Output Areas and Intermediate Zones,MSOAIZ,SW,7567,3686,3937,1871,2092,1071,1845,800,20,9,430,322,45,21,385,301,301,,,,3046,1416,2923,1347,11,6,91,46,21,17,69,134,68
E02000693,Merton 005,Middle Super Output Areas and Intermediate Zones,MSOAIZ,SW,8935,3973,4157,1961,1202,622,2955,1339,87,44,813,334,177,66,636,268,268,,,,3820,1598,3655,1526,29,8,114,53,22,11,72,58,36
E02000694,Merton 006,Middle Super Output Areas and Intermediate Zones,MSOAIZ,SW,8714,3828,4675,2058,1442,752,3233,1306,25,13,1110,539,254,113,856,426,426,,,,2839,1188,2742,1147,17,4,64,28,16,9,41,65,30
E02000695,Merton 007,Middle Super Output Areas and Intermediate Zones,MSOAIZ,SW,8269,2813,5063,1880,1995,895,3068,985,36,11,268,94,48,13,220,81,81,,,,2835,799,2656,743,23,4,109,36,47,16,56,67,29
E02000696,Merton 008,Middle Super Output Areas and Intermediate Zones,MSOAIZ,SW,8072,3185,3451,1427,902,429,2549,998,49,22,1577,594,396,151,1181,443,443,,,,2941,1115,2840,1073,5,2,93,38,3,2,42,54,27
E02000697,Merton 009,Middle Super Output Areas and Intermediate Zones,MSOAIZ,SW,8134,3577,4322,1888,1628,805,2694,1083,22,13,335,149,70,27,265,122,122,,,,3405,1494,3260,1431,24,11,117,50,4,2,63,50,33
E02000698,Merton 010,Middle Super Output Areas and Intermediate Zones,MSOAIZ,SW,7699,3146,5625,2294,2458,1183,3167,1111,16,8,375,162,106,43,269,119,119,,,,1606,644,1529,608,26,9,46,24,5,3,36,77,38
E02000699,Merton 011,Middle Super Output Areas and Intermediate Zones,MSOAIZ,SW,7666,3205,4976,2064,1785,858,3191,1206,26,8,320,159,104,34,216,125,125,,,,2285,946,2196,908,14,4,60,28,15,6,38,59,28
E02000700,Merton 012,Middle Super Output Areas and Intermediate Zones,MSOAIZ,SW,8290,3367,2966,1311,840,437,2126,874,84,40,2963,1135,887,323,2076,812,812,,,,2222,851,2119,805,2,1,71,32,30,13,46,55,30
E02000701,Merton 013,Middle Super Output Areas and Intermediate Zones,MSOAIZ,CR,8410,3006,4411,1618,1305,626,3106,992,125,64,1277,484,315,109,962,375,375,,,,2509,805,2366,754,13,4,98,35,32,12,51,88,35
E02000702,Merton 014,Middle Super Output Areas and Intermediate Zones,MSOAIZ,SW,7626,2964,4097,1645,1168,598,2929,1047,103,42,1880,760,621,259,1259,501,501,,,,1459,490,1379,459,0,0,72,27,8,4,31,87,27
E02000703,Merton 015,Middle Super Output Areas and Intermediate Zones,MSOAIZ,SW,7825,2961,5880,2273,2598,1204,3282,1069,26,13,291,131,64,25,227,106,106,,,,1562,520,1470,490,24,7,49,17,19,6,30,66,24
E02000704,Merton 016,Middle Super Output Areas and Intermediate Zones,MSOAIZ,SW,7633,3409,4004,1841,1426,776,2578,1065,17,5,1040,480,332,149,708,331,331,,,,2497,1046,2336,984,27,9,104,46,30,7,62,75,37
E02000705,Merton 017,Middle Super Output Areas and Intermediate Zones,MSOAIZ,SW,8083,2836,5928,2191,1801,886,4127,1305,71,28,365,130,69,22,296,108,108,,,,1655,464,1583,437,2,1,63,23,7,3,27,64,23
E02000706,Merton 018,Middle Super Output Areas and Intermediate Zones,MSOAIZ,SW,8605,3259,3209,1233,784,411,2425,822,123,50,3362,1336,1111,436,2251,900,900,,,,1824,599,1689,552,3,3,100,30,32,14,47,87,41
E02000707,Merton 019,Middle Super Output Areas and Intermediate Zones,MSOAIZ,CR,7482,2683,4033,1450,1044,506,2989,944,51,19,2268,840,140,50,2128,790,790,,,,1071,353,1011,329,2,1,46,17,12,6,24,59,21
E02000708,Merton 020,Middle Super Output Areas and Intermediate Zones,MSOAIZ,SW,8262,3011,6308,2365,2168,1043,4140,1322,66,28,333,108,124,35,209,73,73,,,,1489,483,1418,454,5,2,53,23,13,4,29,66,27
E02000709,Merton 021,Middle Super Output Areas and Intermediate Zones,MSOAIZ,SW,7681,2874,6473,2437,2596,1222,3877,1215,21,9,265,127,111,48,154,79,79,,,,881,285,813,259,0,0,66,25,2,1,26,41,16
E02000710,Merton 022,Middle Super Output Areas and Intermediate Zones,MSOAIZ,SW,8062,3208,4521,1838,1553,818,2968,1020,99,46,1672,690,491,188,1181,502,502,,,,1704,607,1625,572,2,2,62,28,15,5,35,66,27
E02000711,Merton 023,Middle Super Output Areas and Intermediate Zones,MSOAIZ,SW,8133,3140,3963,1635,1204,649,2759,986,23,10,1778,697,765,286,1013,411,411,,,,2291,767,2152,721,11,4,81,30,47,12,46,78,31
E02000712,Merton 024,Middle Super Output Areas and Intermediate Zones,MSOAIZ,SM,8681,3328,4535,1780,1336,706,3199,1074,82,33,2741,1092,794,307,1947,785,785,,,,1246,389,1145,353,3,1,67,23,31,12,36,77,34
E02000713,Merton 025,Middle Super Output Areas and Intermediate Zones,MSOAIZ,SW,7454,2800,6346,2453,2121,1082,4225,1371,38,15,216,70,86,26,130,44,44,,,,806,243,755,226,6,2,44,14,1,1,17,48,19
E02000714,Newham 001,Middle Super Output Areas and Intermediate Zones,MSOAIZ,E,8131,2733,2764,999,915,399,1849,600,181,69,2218,767,1105,373,1113,394,394,,,,2866,866,2773,833,6,2,50,20,37,11,33,102,32
E02000715,Newham 002,Middle Super Output Areas and Intermediate Zones,MSOAIZ,E,7311,2234,2603,761,803,305,1800,456,36,10,1589,612,1240,482,349,130,130,,,,2966,816,2881,791,0,0,57,15,28,10,25,117,35
E02000716,Newham 003,Middle Super Output Areas and Intermediate Zones,MSOAIZ,E,7239,2320,2743,838,900,331,1843,507,114,39,1413,555,636,258,777,297,297,,,,2883,854,2775,820,10,4,59,16,39,14,34,86,34
E02000717,Newham 004,Middle Super Output Areas and Intermediate Zones,MSOAIZ,E,8101,2400,3058,842,1029,334,2029,508,94,37,1566,568,989,349,577,219,219,,,,3304,921,3164,881,11,2,86,28,43,10,40,79,32
E02000718,Newham 005,Middle Super Output Areas and Intermediate Zones,MSOAIZ,E,6840,2210,2233,683,666,240,1567,443,60,22,2602,970,2116,826,486,144,144,,,,1852,503,1794,486,8,2,36,11,14,4,17,93,32
E02000719,Newham 006,Middle Super Output Areas and Intermediate Zones,MSOAIZ,E,8141,2937,2229,814,778,333,1451,481,138,65,2282,922,1066,428,1216,494,494,,,,3433,1104,3337,1074,6,2,62,18,28,10,30,59,32
E02000720,Newham 007,Middle Super Output Areas and Intermediate Zones,MSOAIZ,E,7469,2220,3688,1057,1369,471,2319,586,46,21,868,339,332,124,536,215,215,,,,2772,776,2643,733,2,1,78,29,49,13,43,95,27
E02000721,Newham 008,Middle Super Output Areas and Intermediate Zones,MSOAIZ,E,9398,2737,3927,1000,1682,481,2245,519,89,27,1352,531,627,251,725,280,280,,,,3910,1139,3738,1083,9,3,99,29,64,24,56,120,40
E02000722,Newham 009,Middle Super Output Areas and Intermediate Zones,MSOAIZ,E,8085,2943,1998,799,758,331,1240,468,193,106,2087,824,949,382,1138,442,442,,,,3753,1189,3642,1152,0,0,80,28,31,9,37,54,25
E02000723,Newham 010,Middle Super Output Areas and Intermediate Zones,MSOAIZ,E,10591,2737,5291,1342,2466,704,2825,638,66,14,974,307,543,180,431,127,127,,,,4141,1039,3935,982,30,9,125,31,51,17,57,119,35
E02000724,Newham 011,Middle Super Output Areas and Intermediate Zones,MSOAIZ,E,9349,2434,4466,1180,1745,531,2721,649,67,19,831,273,459,158,372,115,115,,,,3873,932,3706,888,7,3,121,29,39,12,44,112,30
E02000725,Newham 012,Middle Super Output Areas and Intermediate Zones,MSOAIZ,E,8773,3671,1570,730,496,257,1074,473,351,212,2790,1207,1446,598,1344,609,609,,,,3949,1475,3846,1422,4,2,40,23,59,28,53,113,47
E02000726,Newham 013,Middle Super Output Areas and Intermediate Zones,MSOAIZ,E,8874,3666,1784,721,579,243,1205,478,266,147,2673,1128,1818,787,855,341,341,,,,4083,1640,3989,1600,5,3,63,27,26,10,40,68,30
E02000727,Newham 014,Middle Super Output Areas and Intermediate Zones,MSOAIZ,E,8301,2251,3373,908,1529,455,1844,453,63,16,934,336,527,191,407,145,145,,,,3855,966,3695,921,13,3,104,28,43,14,45,76,25
E02000728,Newham 015,Middle Super Output Areas and Intermediate Zones,MSOAIZ,E,8227,2237,3909,1065,1386,454,2523,611,75,16,607,210,289,110,318,100,100,,,,3570,918,3375,868,7,2,144,37,44,11,50,66,28
E02000729,Newham 016,Middle Super Output Areas and Intermediate Zones,MSOAIZ,E,7062,2207,2937,879,1253,421,1684,458,77,31,1258,473,394,121,864,352,352,,,,2716,794,2575,742,9,5,88,30,44,17,52,74,30
E02000730,Newham 017,Middle Super Output Areas and Intermediate Zones,MSOAIZ,E,8956,2443,4157,1073,1923,563,2234,510,41,10,894,353,251,83,643,270,270,,,,3763,978,3580,927,14,4,126,32,43,15,51,101,29
E02000731,Newham 018,Middle Super Output Areas and Intermediate Zones,MSOAIZ,E,10073,2825,4057,1141,1492,502,2565,639,23,7,962,387,561,200,401,187,187,,,,4920,1253,4714,1193,19,8,139,37,48,15,60,111,37
E02000732,Newham 019,Middle Super Output Areas and Intermediate Zones,MSOAIZ,E,7560,2326,2226,652,808,282,1418,370,77,28,2606,905,1716,606,890,299,299,,,,2535,706,2461,683,5,1,50,15,19,7,23,116,35
E02000733,Newham 020,Middle Super Output Areas and Intermediate Zones,MSOAIZ,E,9752,3465,2432,908,623,280,1809,628,94,41,4187,1568,3413,1293,774,275,275,,,,2941,907,2839,875,10,4,79,23,13,5,32,98,41
E02000734,Newham 021,Middle Super Output Areas and Intermediate Zones,MSOAIZ,E,7640,2672,1626,587,623,250,1003,337,180,88,3494,1327,2146,864,1348,463,463,,,,2198,621,2095,587,7,3,57,20,39,11,34,142,49
E02000735,Newham 022,Middle Super Output Areas and Intermediate Zones,MSOAIZ,E,7547,2355,2817,866,981,371,1836,495,72,23,1713,665,1012,398,701,267,267,,,,2869,769,2784,741,0,0,61,20,24,8,28,76,32
E02000736,Newham 023,Middle Super Output Areas and Intermediate Zones,MSOAIZ,IG,8531,2574,3292,996,697,308,2595,688,64,19,2293,780,1822,632,471,148,148,,,,2799,750,2667,709,0,0,102,30,30,11,41,83,29
E02000737,Newham 024,Middle Super Output Areas and Intermediate Zones,MSOAIZ,E,9434,3068,4170,1420,1177,524,2993,896,54,21,2153,830,1691,674,462,156,156,,,,2970,764,2843,728,0,0,92,27,35,9,36,87,33
E02000738,Newham 025,Middle Super Output Areas and Intermediate Zones,MSOAIZ,E,8466,2563,4410,1406,1234,517,3176,889,59,20,813,271,423,148,390,123,123,,,,3109,840,2977,795,7,2,94,35,31,8,45,75,26
E02000739,Newham 026,Middle Super Output Areas and Intermediate Zones,MSOAIZ,E,6880,2286,2129,724,628,263,1501,461,173,64,2228,801,1235,452,993,349,349,,,,2276,670,2158,633,10,5,59,19,49,13,37,74,27
E02000740,Newham 027,Middle Super Output Areas and Intermediate Zones,MSOAIZ,E,6768,2556,1494,582,328,170,1166,412,45,19,3167,1289,2015,762,1152,527,527,,,,1986,637,1870,594,4,2,56,22,56,19,43,76,29
E02000741,Newham 028,Middle Super Output Areas and Intermediate Zones,MSOAIZ,E,8223,2767,3600,1273,1013,448,2587,825,85,31,1788,625,1143,414,645,211,211,,,,2708,816,2614,790,11,3,55,16,28,7,26,42,22
E02000742,Newham 029,Middle Super Output Areas and Intermediate Zones,MSOAIZ,E,7952,2498,3366,1083,770,368,2596,715,48,16,2074,714,1565,556,509,158,158,,,,2417,662,2305,630,0,0,61,18,51,14,32,47,23
E02000743,Newham 030,Middle Super Output Areas and Intermediate Zones,MSOAIZ,E,7830,2893,1917,681,501,240,1416,441,100,34,3611,1458,2939,1180,672,278,278,,,,2082,678,1930,631,11,4,83,24,58,19,47,120,42
E02000744,Newham 031,Middle Super Output Areas and Intermediate Zones,MSOAIZ,E,8025,2942,2225,831,634,305,1591,526,64,24,2256,884,1440,546,816,338,338,,,,3405,1168,3335,1137,0,0,47,21,23,10,31,75,35
E02000745,Newham 032,Middle Super Output Areas and Intermediate Zones,MSOAIZ,E,8135,2782,2642,923,628,260,2014,663,124,49,2682,990,1288,470,1394,520,520,,,,2613,790,2521,762,6,1,61,18,25,9,28,74,30
E02000746,Newham 033,Middle Super Output Areas and Intermediate Zones,MSOAIZ,IG,6908,2574,1433,575,249,113,1184,462,181,88,3299,1161,651,251,2648,910,910,,,,1926,721,1822,664,9,3,24,13,71,41,57,69,29
E02000747,Newham 034,Middle Super Output Areas and Intermediate Zones,MSOAIZ,N,10630,4371,1906,788,503,241,1403,547,363,179,4123,1613,3155,1206,968,407,407,,,,4111,1737,4009,1698,10,4,51,19,41,16,39,127,54
E02000748,Newham 035,Middle Super Output Areas and Intermediate Zones,MSOAIZ,E,5954,2230,2286,890,493,250,1793,640,65,22,1231,498,562,229,669,269,269,,,,2294,793,2232,764,1,1,38,18,23,10,29,78,27
E02000749,Newham 036,Middle Super Output Areas and Intermediate Zones,MSOAIZ,E,8183,3022,1836,691,423,201,1413,490,254,111,4134,1607,2790,1105,1344,502,502,,,,1861,574,1775,544,2,1,47,16,37,13,30,98,39
E02000750,Newham 037,Middle Super Output Areas and Intermediate Zones,MSOAIZ,E,10670,4370,2354,1114,471,247,1883,867,136,61,3516,1344,2253,905,1263,439,439,,,,4576,1804,4473,1757,22,9,61,29,20,9,47,88,47
E02000751,Redbridge 001,Middle Super Output Areas and Intermediate Zones,MSOAIZ,IG,10265,4277,8511,3485,3846,1935,4665,1550,28,12,333,190,180,78,153,112,112,,,,1272,536,1219,505,10,5,35,22,8,4,31,121,54
E02000752,Redbridge 002,Middle Super Output Areas and Intermediate Zones,MSOAIZ,RM,6815,2864,3747,1561,1227,666,2520,895,48,20,2097,938,1613,745,484,193,193,,,,822,298,771,275,7,3,35,16,9,4,23,101,47
E02000753,Redbridge 003,Middle Super Output Areas and Intermediate Zones,MSOAIZ,IG,6088,2420,3728,1498,1177,605,2551,893,98,41,1257,503,950,400,307,103,103,,,,952,350,895,323,0,0,56,26,1,1,27,53,28
E02000754,Redbridge 004,Middle Super Output Areas and Intermediate Zones,MSOAIZ,IG,6440,2607,4470,1785,1468,738,3002,1047,36,13,881,395,626,271,255,124,124,,,,998,379,944,359,2,1,49,18,3,1,20,55,35
E02000755,Redbridge 005,Middle Super Output Areas and Intermediate Zones,MSOAIZ,IG,5211,2151,3800,1534,1298,646,2502,888,18,7,560,260,461,203,99,57,57,,,,801,327,752,302,0,0,39,20,10,5,25,32,23
E02000756,Redbridge 006,Middle Super Output Areas and Intermediate Zones,MSOAIZ,IG,12625,4966,8906,3461,3040,1495,5866,1966,92,41,1053,481,797,332,256,149,149,,,,2445,916,2331,871,3,2,94,36,17,7,45,129,67
E02000757,Redbridge 007,Middle Super Output Areas and Intermediate Zones,MSOAIZ,IG,11474,4969,7572,3094,2614,1338,4958,1756,198,125,810,406,298,156,512,250,250,,,,2810,1295,2640,1222,36,10,117,54,17,9,73,84,49
E02000758,Redbridge 008,Middle Super Output Areas and Intermediate Zones,MSOAIZ,IG,5953,2159,4521,1618,1687,787,2834,831,16,5,572,268,456,211,116,57,57,,,,811,248,742,225,5,1,60,21,4,1,23,33,20
E02000759,Redbridge 009,Middle Super Output Areas and Intermediate Zones,MSOAIZ,IG,12020,4703,7786,3013,2406,1176,5380,1837,35,14,1867,750,1423,557,444,193,193,,,,2217,881,2098,829,6,2,97,42,16,8,52,115,45
E02000760,Redbridge 010,Middle Super Output Areas and Intermediate Zones,MSOAIZ,IG,6915,2613,4458,1665,1591,788,2867,877,68,28,1021,445,599,248,422,197,197,,,,1306,444,1234,417,2,2,59,20,11,5,27,62,31
E02000762,Redbridge 012,Middle Super Output Areas and Intermediate Zones,MSOAIZ,IG,6273,2087,5105,1699,1866,824,3239,875,8,3,167,74,134,61,33,13,13,,,,965,293,886,263,9,4,54,22,16,4,30,28,18
E02000763,Redbridge 013,Middle Super Output Areas and Intermediate Zones,MSOAIZ,RM,6910,2385,4581,1593,1457,672,3124,921,114,41,789,311,525,201,264,110,110,,,,1363,413,1295,385,0,0,63,27,5,1,28,63,27
E02000764,Redbridge 014,Middle Super Output Areas and Intermediate Zones,MSOAIZ,E,11690,5435,7603,3376,3128,1651,4475,1725,42,22,1030,640,597,287,433,353,353,,,,2892,1326,2744,1251,17,7,115,58,16,10,75,123,71
E02000765,Redbridge 015,Middle Super Output Areas and Intermediate Zones,MSOAIZ,IG,6313,2190,4421,1496,1598,713,2823,783,25,8,269,128,145,64,124,64,64,,,,1557,532,1474,502,4,2,64,22,15,6,30,41,26
E02000767,Redbridge 017,Middle Super Output Areas and Intermediate Zones,MSOAIZ,IG,7475,2620,4910,1675,1630,730,3280,945,128,74,598,254,308,140,290,114,114,,,,1790,593,1695,555,14,5,63,26,18,7,38,49,24
E02000768,Redbridge 018,Middle Super Output Areas and Intermediate Zones,MSOAIZ,E,5660,2240,4357,1657,1816,838,2541,819,2,2,544,276,191,92,353,184,184,,,,715,284,663,261,6,2,37,18,9,3,23,42,21
E02000769,Redbridge 019,Middle Super Output Areas and Intermediate Zones,MSOAIZ,RM,14146,5160,9317,3368,2834,1340,6483,2028,284,116,1388,516,457,166,931,350,350,,,,3025,1099,2912,1049,3,1,85,38,25,11,50,132,61
E02000770,Redbridge 020,Middle Super Output Areas and Intermediate Zones,MSOAIZ,IG,7542,2425,4812,1521,1599,664,3213,857,42,14,442,164,271,89,171,75,75,,,,2179,700,2050,663,4,1,75,24,50,12,37,67,26
E02000772,Redbridge 022,Middle Super Output Areas and Intermediate Zones,MSOAIZ,RM,7783,2565,4506,1452,1268,549,3238,903,90,31,705,287,251,83,454,204,204,,,,2408,764,2301,727,5,3,67,26,35,8,37,74,31
E02000773,Redbridge 023,Middle Super Output Areas and Intermediate Zones,MSOAIZ,IG,9193,2819,5534,1674,1704,643,3830,1031,170,76,1066,359,247,75,819,284,284,,,,2351,685,2274,661,15,5,40,11,22,8,24,72,25
E02000774,Redbridge 024,Middle Super Output Areas and Intermediate Zones,MSOAIZ,IG,7180,2208,4235,1272,1594,571,2641,701,21,5,344,104,194,55,150,49,49,,,,2512,795,2377,755,4,1,106,32,25,7,40,68,32
E02000776,Redbridge 026,Middle Super Output Areas and Intermediate Zones,MSOAIZ,IG,6338,2031,3788,1189,1611,582,2177,607,27,9,283,109,127,42,156,67,67,,,,2168,694,2080,661,2,2,72,25,14,6,33,72,30
E02000777,Redbridge 027,Middle Super Output Areas and Intermediate Zones,MSOAIZ,E,5852,2365,4288,1635,1677,742,2611,893,27,9,696,383,471,254,225,129,129,,,,793,317,729,293,7,2,48,18,9,4,24,48,21
E02000779,Redbridge 029,Middle Super Output Areas and Intermediate Zones,MSOAIZ,IG,7658,2753,3438,1054,1295,470,2143,584,24,14,702,318,438,176,264,142,142,,,,3396,1325,3338,1297,4,3,50,22,4,3,28,98,42
E02000780,Redbridge 030,Middle Super Output Areas and Intermediate Zones,MSOAIZ,IG,14643,4443,6852,2013,2574,891,4278,1122,170,73,1375,477,809,287,566,190,190,,,,6087,1820,5843,1741,17,5,180,58,47,16,79,159,60
E02000781,Redbridge 031,Middle Super Output Areas and Intermediate Zones,MSOAIZ,IG,13646,4257,9653,3050,3037,1302,6616,1748,110,43,869,325,467,177,402,148,148,,,,2931,799,2760,745,4,2,121,38,46,14,54,83,40
E02000782,Redbridge 032,Middle Super Output Areas and Intermediate Zones,MSOAIZ,IG,9141,2851,3818,1137,1305,479,2513,658,212,87,1527,559,553,199,974,360,360,,,,3481,1026,3342,984,7,2,103,26,29,14,42,103,42
E02000783,Redbridge 033,Middle Super Output Areas and Intermediate Zones,MSOAIZ,IG,7196,2250,3052,959,920,367,2132,592,49,20,1853,602,725,229,1128,373,373,,,,2164,641,2004,594,16,5,108,31,36,11,47,78,28
E02000784,Richmond upon Thames 001,Middle Super Output Areas and Intermediate Zones,MSOAIZ,SW,10248,4296,6178,2470,3049,1366,3129,1104,22,12,1612,771,544,230,1068,541,541,,,,2300,975,2150,924,62,16,64,29,24,6,51,136,68
E02000785,Richmond upon Thames 002,Middle Super Output Areas and Intermediate Zones,MSOAIZ,TW,9585,4304,6413,2748,2989,1483,3424,1265,23,11,478,271,76,41,402,230,230,,,,2582,1226,2490,1180,27,13,59,29,6,4,46,89,48
E02000786,Richmond upon Thames 003,Middle Super Output Areas and Intermediate Zones,MSOAIZ,SW,10865,4941,6426,2870,2552,1308,3874,1562,39,26,1647,790,430,212,1217,578,578,,,,2669,1199,2514,1121,10,4,122,64,23,10,78,84,56
E02000787,Richmond upon Thames 004,Middle Super Output Areas and Intermediate Zones,MSOAIZ,TW,10768,4800,5752,2472,2002,1033,3750,1439,152,87,2012,970,487,214,1525,756,756,,,,2722,1199,2616,1145,29,10,58,33,19,11,54,130,72
E02000788,Richmond upon Thames 005,Middle Super Output Areas and Intermediate Zones,MSOAIZ,TW,8676,3666,6059,2439,2269,1123,3790,1316,11,5,563,327,145,69,418,258,258,,,,1974,852,1859,808,12,4,91,37,12,3,44,69,43
E02000789,Richmond upon Thames 006,Middle Super Output Areas and Intermediate Zones,MSOAIZ,TW,6106,2966,3240,1489,1484,777,1756,712,18,7,1030,583,57,32,973,551,551,,,,1749,853,1693,821,7,4,33,19,16,9,32,69,34
E02000790,Richmond upon Thames 007,Middle Super Output Areas and Intermediate Zones,MSOAIZ,TW,6193,2609,4439,1762,1576,745,2863,1017,47,29,229,104,23,10,206,94,94,,,,1404,678,1346,647,2,1,55,29,1,1,31,74,36
E02000791,Richmond upon Thames 008,Middle Super Output Areas and Intermediate Zones,MSOAIZ,TW,5846,2986,3140,1506,1596,845,1544,661,24,15,289,218,18,14,271,204,204,,,,2292,1187,2193,1133,38,16,44,27,17,11,54,101,60
E02000792,Richmond upon Thames 009,Middle Super Output Areas and Intermediate Zones,MSOAIZ,TW,6832,3209,4277,1887,1655,875,2622,1012,11,6,284,183,52,28,232,155,155,,,,2178,1084,2095,1048,18,6,54,24,11,6,36,82,49
E02000793,Richmond upon Thames 010,Middle Super Output Areas and Intermediate Zones,MSOAIZ,TW,7990,3144,5574,2216,2044,1024,3530,1192,55,26,857,364,199,86,658,278,278,,,,1432,505,1219,434,77,25,72,27,64,19,71,72,33
E02000794,Richmond upon Thames 011,Middle Super Output Areas and Intermediate Zones,MSOAIZ,TW,6577,2660,4918,1971,1752,868,3166,1103,61,31,241,91,59,23,182,68,68,,,,1306,542,1232,512,11,4,50,22,13,4,30,51,25
E02000795,Richmond upon Thames 012,Middle Super Output Areas and Intermediate Zones,MSOAIZ,TW,6544,2623,4922,1966,2351,1120,2571,846,28,13,497,242,126,56,371,186,186,,,,1001,354,936,329,27,8,13,7,25,10,25,96,48
E02000796,Richmond upon Thames 013,Middle Super Output Areas and Intermediate Zones,MSOAIZ,UB,10284,3918,6710,2560,2612,1251,4098,1309,86,36,2051,830,681,267,1370,563,563,,,,1347,446,1285,417,4,2,43,22,15,5,29,90,46
E02000797,Richmond upon Thames 014,Middle Super Output Areas and Intermediate Zones,MSOAIZ,TW,6894,3273,4483,2033,1410,757,3073,1276,48,31,290,197,44,30,246,167,167,,,,2016,975,1914,923,20,10,72,38,10,4,52,57,37
E02000798,Richmond upon Thames 015,Middle Super Output Areas and Intermediate Zones,MSOAIZ,TW,10479,4280,7605,3068,2288,1192,5317,1876,40,18,1170,493,395,162,775,331,331,,,,1590,656,1492,613,12,7,75,31,11,5,43,74,45
E02000799,Richmond upon Thames 016,Middle Super Output Areas and Intermediate Zones,MSOAIZ,TW,5657,2418,4276,1730,1685,810,2591,920,8,4,305,186,82,53,223,133,133,,,,1009,466,950,433,1,1,49,27,9,5,33,59,32
E02000800,Richmond upon Thames 017,Middle Super Output Areas and Intermediate Zones,MSOAIZ,TW,5184,2159,3001,1298,1142,613,1859,685,59,22,1266,535,457,196,809,339,339,,,,779,267,724,248,12,3,31,10,12,6,19,79,37
E02000801,Richmond upon Thames 018,Middle Super Output Areas and Intermediate Zones,MSOAIZ,TW,6599,2880,4960,2091,1716,888,3244,1203,69,31,271,138,61,27,210,111,111,,,,1253,598,1205,565,5,3,37,25,6,5,33,46,22
E02000802,Richmond upon Thames 019,Middle Super Output Areas and Intermediate Zones,MSOAIZ,TW,6615,2840,4944,2027,1732,890,3212,1137,8,4,481,241,106,46,375,195,195,,,,1147,549,1072,509,17,7,35,20,23,13,40,35,19
E02000803,Richmond upon Thames 020,Middle Super Output Areas and Intermediate Zones,MSOAIZ,TW,9346,4086,5887,2537,2292,1205,3595,1332,155,78,1973,918,506,245,1467,673,673,,,,1215,506,1110,462,16,6,73,31,16,7,44,116,47
E02000804,Richmond upon Thames 021,Middle Super Output Areas and Intermediate Zones,MSOAIZ,TW,7013,3148,4746,1987,1834,915,2912,1072,21,17,610,354,157,85,453,269,269,,,,1585,767,1510,732,19,7,42,22,14,6,35,51,23
E02000805,Richmond upon Thames 022,Middle Super Output Areas and Intermediate Zones,MSOAIZ,TW,9929,4455,6671,2778,2606,1333,4065,1445,66,46,1205,671,277,161,928,510,510,,,,1892,898,1734,806,25,8,77,40,56,44,92,95,62
E02000806,Richmond upon Thames 023,Middle Super Output Areas and Intermediate Zones,MSOAIZ,TW,9868,4174,7057,2845,2713,1335,4344,1510,101,46,1136,574,392,164,744,410,410,,,,1483,658,1364,600,31,11,56,30,32,17,58,91,51
E02000807,Southwark 001,Middle Super Output Areas and Intermediate Zones,MSOAIZ,SE,8305,3705,3103,1506,871,450,2232,1056,251,135,1663,714,570,241,1093,473,473,,,,3209,1304,3063,1234,19,8,97,45,30,17,70,79,46
E02000808,Southwark 002,Middle Super Output Areas and Intermediate Zones,MSOAIZ,SE,8312,4167,1729,996,547,352,1182,644,231,139,3290,1561,1759,796,1531,765,765,,,,2921,1386,2457,1198,211,78,134,63,119,47,188,141,85
E02000809,Southwark 003,Middle Super Output Areas and Intermediate Zones,MSOAIZ,SE,11536,5936,3494,1969,1040,647,2454,1322,123,63,2524,1142,2048,930,476,212,212,,,,5199,2655,4965,2537,9,6,180,86,45,26,118,196,107
E02000810,Southwark 004,Middle Super Output Areas and Intermediate Zones,MSOAIZ,SE,9131,4137,1775,905,472,266,1303,639,467,259,4962,2159,3783,1649,1179,510,510,,,,1845,769,1717,710,18,6,92,45,18,8,59,82,45
E02000812,Southwark 006,Middle Super Output Areas and Intermediate Zones,MSOAIZ,SE,9697,4385,1783,909,417,241,1366,668,185,109,4943,2198,3740,1590,1203,608,608,,,,2666,1108,2440,1012,37,19,166,65,23,12,96,120,61
E02000813,Southwark 007,Middle Super Output Areas and Intermediate Zones,MSOAIZ,SE,8561,3746,1577,764,422,228,1155,536,188,79,4689,2057,3866,1645,823,412,412,,,,1992,798,1882,753,21,6,67,32,22,7,45,115,48
E02000814,Southwark 008,Middle Super Output Areas and Intermediate Zones,MSOAIZ,SE,8563,3876,2639,1396,815,460,1824,936,133,66,2151,905,564,225,1587,680,680,,,,3543,1458,3422,1404,2,1,89,40,30,13,54,97,51
E02000815,Southwark 009,Middle Super Output Areas and Intermediate Zones,MSOAIZ,SE,5774,2516,1049,520,296,169,753,351,227,137,2446,960,2031,787,415,173,173,,,,1985,864,1839,803,13,5,115,44,18,12,61,67,35
E02000816,Southwark 010,Middle Super Output Areas and Intermediate Zones,MSOAIZ,SE,9030,3959,1855,901,479,264,1376,637,431,190,4366,1934,2989,1393,1377,541,541,,,,2279,894,2171,851,0,0,90,36,18,7,43,99,40
E02000817,Southwark 011,Middle Super Output Areas and Intermediate Zones,MSOAIZ,SE,6425,2809,801,363,230,118,571,245,76,36,4309,1993,3138,1502,1171,491,491,,,,1185,385,1143,368,0,0,32,13,10,4,17,54,32
E02000818,Southwark 012,Middle Super Output Areas and Intermediate Zones,MSOAIZ,SE,7507,3217,1226,546,298,156,928,390,139,76,3654,1635,2503,1103,1151,532,532,,,,2402,922,2272,880,10,3,69,24,51,15,42,86,38
E02000819,Southwark 013,Middle Super Output Areas and Intermediate Zones,MSOAIZ,SE,8301,3415,1288,580,334,168,954,412,100,48,4894,2055,2948,1262,1946,793,793,,,,1940,699,1803,642,1,1,68,26,68,30,57,79,33
E02000820,Southwark 014,Middle Super Output Areas and Intermediate Zones,MSOAIZ,SE,8369,3873,1712,857,502,289,1210,568,158,73,4255,1959,3395,1555,860,404,404,,,,2145,937,2017,886,18,6,93,37,17,8,51,99,47
E02000821,Southwark 015,Middle Super Output Areas and Intermediate Zones,MSOAIZ,SE,8368,3097,1041,418,304,151,737,267,47,19,5738,2103,5152,1828,586,275,275,,,,1469,524,1357,490,2,1,77,22,33,11,34,73,33
E02000822,Southwark 016,Middle Super Output Areas and Intermediate Zones,MSOAIZ,SE,8096,3294,830,365,208,110,622,255,46,13,5705,2338,4689,1879,1016,459,459,,,,1438,542,1341,508,0,0,77,25,20,9,34,77,36
E02000823,Southwark 017,Middle Super Output Areas and Intermediate Zones,MSOAIZ,SE,7726,3155,1746,791,487,251,1259,540,112,46,3868,1600,3588,1472,280,128,128,,,,1908,687,1839,657,0,0,55,23,14,7,30,92,31
E02000824,Southwark 018,Middle Super Output Areas and Intermediate Zones,MSOAIZ,SE,9559,3553,1310,506,331,154,979,352,106,42,6590,2504,5492,2102,1098,402,402,,,,1436,460,1338,426,4,1,56,20,38,13,34,117,41
E02000825,Southwark 019,Middle Super Output Areas and Intermediate Zones,MSOAIZ,SE,9580,3545,1482,559,180,77,1302,482,217,83,6230,2329,4244,1598,1986,731,731,,,,1563,541,1453,506,0,0,72,23,38,12,35,88,33
E02000826,Southwark 020,Middle Super Output Areas and Intermediate Zones,MSOAIZ,SE,8714,3539,1834,830,434,229,1400,601,133,67,4820,1950,3782,1474,1038,476,476,,,,1823,656,1740,629,4,1,69,22,10,4,27,104,36
E02000827,Southwark 021,Middle Super Output Areas and Intermediate Zones,MSOAIZ,SE,10170,4304,1377,613,369,190,1008,423,134,64,6413,2764,4366,1819,2047,945,945,,,,2136,814,2007,763,9,6,105,38,15,7,51,110,49
E02000828,Southwark 022,Middle Super Output Areas and Intermediate Zones,MSOAIZ,SE,8345,3180,1645,641,395,191,1250,450,215,96,4534,1793,3680,1454,854,339,339,,,,1834,604,1745,571,14,4,48,19,27,10,33,117,46
E02000829,Southwark 023,Middle Super Output Areas and Intermediate Zones,MSOAIZ,SE,10232,4334,2700,1160,725,342,1975,818,190,92,4486,2120,3117,1496,1369,624,624,,,,2728,914,2580,850,6,2,99,40,43,22,64,128,48
E02000830,Southwark 024,Middle Super Output Areas and Intermediate Zones,MSOAIZ,SE,8819,3783,3542,1547,1105,530,2437,1017,106,51,2587,1167,1722,773,865,394,394,,,,2478,972,2302,905,5,2,149,56,22,9,67,106,46
E02000831,Southwark 025,Middle Super Output Areas and Intermediate Zones,MSOAIZ,SE,9281,3918,3508,1518,1047,509,2461,1009,250,129,2888,1270,1564,674,1324,596,596,,,,2483,948,2327,890,4,1,87,39,65,18,58,152,53
E02000832,Southwark 026,Middle Super Output Areas and Intermediate Zones,MSOAIZ,SE,9851,4106,2775,1161,650,332,2125,829,267,126,4827,2066,3013,1399,1814,667,667,,,,1873,704,1792,674,0,0,59,23,22,7,30,109,49
E02000833,Southwark 027,Middle Super Output Areas and Intermediate Zones,MSOAIZ,SE,7334,2973,2251,1009,639,337,1612,672,72,25,3649,1460,3323,1335,326,125,125,,,,1261,445,1146,403,11,5,86,29,18,8,42,101,34
E02000834,Southwark 028,Middle Super Output Areas and Intermediate Zones,MSOAIZ,SE,9161,4198,4315,1844,1209,598,3106,1246,64,38,1911,974,715,332,1196,642,642,,,,2780,1301,2684,1255,6,3,74,35,16,8,46,91,41
E02000835,Southwark 029,Middle Super Output Areas and Intermediate Zones,MSOAIZ,SE,7194,2930,3697,1497,1085,525,2612,972,47,18,1949,837,1526,638,423,199,199,,,,1435,546,1370,518,3,1,62,27,0,0,28,66,32
E02000836,Southwark 030,Middle Super Output Areas and Intermediate Zones,MSOAIZ,SE,8219,3362,5005,1924,1486,660,3519,1264,45,15,1276,612,695,341,581,271,271,,,,1821,776,1752,745,20,8,44,19,5,4,31,72,35
E02000837,Southwark 031,Middle Super Output Areas and Intermediate Zones,MSOAIZ,SE,9020,3300,6406,2247,2548,1069,3858,1178,7,2,967,413,692,291,275,122,122,,,,1562,601,1472,556,34,17,35,19,21,9,45,78,37
E02000838,Southwark 032,Middle Super Output Areas and Intermediate Zones,MSOAIZ,SE,9120,3862,4954,1995,1389,660,3565,1335,53,30,1893,874,947,422,946,452,452,,,,2162,931,2066,887,7,3,71,31,18,10,44,58,32
E02000839,Southwark 033,Middle Super Output Areas and Intermediate Zones,MSOAIZ,SE,7869,3381,4087,1805,1637,829,2450,976,106,56,2014,836,1827,761,187,75,75,,,,1553,632,1456,588,42,16,41,23,14,5,44,109,52
E02000840,Sutton 001,Middle Super Output Areas and Intermediate Zones,MSOAIZ,SM,8146,3206,3648,1353,685,353,2963,1000,70,25,3598,1497,2747,1144,851,353,353,,,,765,302,715,281,0,0,38,16,12,5,21,65,29
E02000841,Sutton 002,Middle Super Output Areas and Intermediate Zones,MSOAIZ,SM,8624,3335,3938,1442,844,411,3094,1031,171,64,3286,1386,2858,1199,428,187,187,,,,1197,426,1131,403,0,0,55,17,11,6,23,32,17
E02000842,Sutton 003,Middle Super Output Areas and Intermediate Zones,MSOAIZ,SM,7666,2879,6374,2390,2275,1097,4099,1293,39,13,298,138,139,53,159,85,85,,,,918,315,848,293,2,1,66,20,2,1,22,37,23
E02000843,Sutton 004,Middle Super Output Areas and Intermediate Zones,MSOAIZ,SM,7495,3271,4810,2116,1290,703,3520,1413,96,46,1216,464,953,359,263,105,105,,,,1341,626,1255,588,4,4,70,30,12,4,38,32,19
E02000844,Sutton 005,Middle Super Output Areas and Intermediate Zones,MSOAIZ,SM,7779,3117,5203,2046,1361,698,3842,1348,44,15,1632,696,1148,476,484,220,220,,,,861,339,788,310,2,1,61,21,10,7,29,39,21
E02000845,Sutton 006,Middle Super Output Areas and Intermediate Zones,MSOAIZ,KT,8850,3472,6430,2545,1827,938,4603,1607,46,20,745,258,250,83,495,175,175,,,,1595,626,1508,592,8,2,69,29,10,3,34,34,23
E02000846,Sutton 007,Middle Super Output Areas and Intermediate Zones,MSOAIZ,SM,6956,2708,5487,2144,1790,907,3697,1237,32,14,484,196,289,97,195,99,99,,,,914,333,819,292,16,10,73,28,6,3,41,39,21
E02000847,Sutton 008,Middle Super Output Areas and Intermediate Zones,MSOAIZ,SM,8708,3489,7397,2969,2854,1469,4543,1500,32,15,291,156,75,22,216,134,134,,,,931,326,849,292,6,2,76,32,0,0,34,57,23
E02000848,Sutton 009,Middle Super Output Areas and Intermediate Zones,MSOAIZ,SM,7889,2886,6990,2544,2252,1089,4738,1455,7,5,100,37,35,16,65,21,21,,,,761,285,708,262,9,3,42,18,2,2,23,31,15
E02000849,Sutton 010,Middle Super Output Areas and Intermediate Zones,MSOAIZ,SM,7432,3099,5241,2124,1547,823,3694,1301,83,35,1091,483,642,276,449,207,207,,,,986,438,914,410,8,2,59,22,5,4,28,31,19
E02000850,Sutton 011,Middle Super Output Areas and Intermediate Zones,MSOAIZ,SM,10301,4037,8323,3224,2535,1267,5788,1957,36,13,828,365,536,241,292,124,124,,,,1058,409,975,375,13,5,61,25,9,4,34,56,26
E02000851,Sutton 012,Middle Super Output Areas and Intermediate Zones,MSOAIZ,SM,8297,4098,4131,1944,1332,777,2799,1167,196,112,1935,1047,1405,725,530,322,322,,,,1973,956,1886,917,9,6,62,24,16,9,39,62,39
E02000852,Sutton 013,Middle Super Output Areas and Intermediate Zones,MSOAIZ,SM,7424,3136,5633,2343,1661,892,3972,1451,50,16,373,198,111,58,262,140,140,,,,1343,567,1250,524,3,1,77,36,13,6,43,25,12
E02000853,Sutton 014,Middle Super Output Areas and Intermediate Zones,MSOAIZ,SM,7592,3164,5516,2269,1537,812,3979,1457,38,15,698,333,482,224,216,109,109,,,,1307,533,1232,500,0,0,67,30,8,3,33,33,14
E02000854,Sutton 015,Middle Super Output Areas and Intermediate Zones,MSOAIZ,SM,7067,2932,5469,2186,1887,957,3582,1229,10,5,511,246,199,99,312,147,147,,,,1034,476,965,446,18,6,48,22,3,2,30,43,19
E02000855,Sutton 016,Middle Super Output Areas and Intermediate Zones,MSOAIZ,SM,7767,3035,6490,2467,2358,1184,4132,1283,6,4,206,98,129,59,77,39,39,,,,1013,436,946,406,19,6,48,24,0,0,30,52,30
E02000856,Sutton 017,Middle Super Output Areas and Intermediate Zones,MSOAIZ,SM,8137,3486,6148,2467,2014,1016,4134,1451,46,23,399,222,139,66,260,156,156,,,,1507,751,1437,716,4,2,59,27,7,6,35,37,23
E02000857,Sutton 018,Middle Super Output Areas and Intermediate Zones,MSOAIZ,SM,7646,4004,4125,2235,1611,1024,2514,1211,23,13,402,287,165,107,237,180,180,,,,3051,1442,2937,1380,9,4,99,53,6,5,62,45,27
E02000858,Sutton 019,Middle Super Output Areas and Intermediate Zones,MSOAIZ,SM,7686,3139,2623,1035,760,389,1863,646,237,116,4110,1721,790,340,3320,1381,1381,,,,663,237,624,218,8,3,29,15,2,1,19,53,30
E02000859,Sutton 020,Middle Super Output Areas and Intermediate Zones,MSOAIZ,SM,7986,3453,5943,2479,2361,1242,3582,1237,11,5,903,478,361,171,542,307,307,,,,1064,456,1016,434,6,2,37,17,5,3,22,65,35
E02000860,Sutton 021,Middle Super Output Areas and Intermediate Zones,MSOAIZ,SM,7423,3925,3330,1764,1228,777,2102,987,10,5,1358,773,655,327,703,446,446,,,,2666,1347,2550,1287,1,1,94,50,21,9,60,59,36
E02000861,Sutton 022,Middle Super Output Areas and Intermediate Zones,MSOAIZ,SM,7479,2789,6639,2452,2759,1256,3880,1196,8,3,224,85,187,71,37,14,14,,,,556,229,544,222,2,2,7,4,3,1,7,52,20
E02000863,Sutton 024,Middle Super Output Areas and Intermediate Zones,MSOAIZ,SM,6283,2319,5309,1930,1908,885,3401,1045,25,9,493,208,461,195,32,13,13,,,,430,161,369,134,25,11,24,11,12,5,27,26,11
E02000864,Tower Hamlets 001,Middle Super Output Areas and Intermediate Zones,MSOAIZ,E,8296,3468,1366,646,458,242,908,404,136,69,4858,1985,1523,619,3335,1366,1366,,,,1869,742,1803,707,0,0,49,24,17,11,35,67,26
E02000865,Tower Hamlets 002,Middle Super Output Areas and Intermediate Zones,MSOAIZ,E,6977,2763,1057,478,336,168,721,310,140,61,4099,1532,2377,856,1722,676,676,,,,1606,666,1519,626,18,8,51,23,18,9,40,75,26
E02000866,Tower Hamlets 003,Middle Super Output Areas and Intermediate Zones,MSOAIZ,E,9610,3829,3059,1307,1100,540,1959,767,118,53,3490,1380,815,303,2675,1077,1077,,,,2834,1046,2709,991,6,2,107,47,12,6,55,109,43
E02000867,Tower Hamlets 004,Middle Super Output Areas and Intermediate Zones,MSOAIZ,E,9761,4307,2204,1120,542,302,1662,818,300,173,3616,1410,1588,564,2028,846,846,,,,3519,1548,3381,1482,10,3,104,53,24,10,66,122,56
E02000868,Tower Hamlets 005,Middle Super Output Areas and Intermediate Zones,MSOAIZ,W,6416,2618,1413,685,441,245,972,440,64,26,2636,941,1218,429,1418,512,512,,,,2250,940,2105,885,10,4,91,37,44,14,55,53,26
E02000869,Tower Hamlets 006,Middle Super Output Areas and Intermediate Zones,MSOAIZ,E,5679,2485,1469,684,508,262,961,422,41,21,2643,1165,1833,764,810,401,401,,,,1474,592,1364,547,5,3,70,29,35,13,45,52,23
E02000870,Tower Hamlets 007,Middle Super Output Areas and Intermediate Zones,MSOAIZ,E,6430,2560,1434,678,480,251,954,427,100,50,3168,1166,1927,712,1241,454,454,,,,1649,636,1575,604,3,1,63,26,8,5,32,79,30
E02000871,Tower Hamlets 008,Middle Super Output Areas and Intermediate Zones,MSOAIZ,E,8591,3107,1282,489,323,138,959,351,192,102,4994,1730,1522,489,3472,1241,1241,,,,1978,739,1861,695,5,1,57,25,55,18,44,145,47
E02000872,Tower Hamlets 009,Middle Super Output Areas and Intermediate Zones,MSOAIZ,E,7480,3088,1433,671,453,225,980,446,75,38,3382,1253,2432,911,950,342,342,,,,2501,1096,2395,1046,4,2,79,35,23,13,50,89,30
E02000873,Tower Hamlets 010,Middle Super Output Areas and Intermediate Zones,MSOAIZ,E,7467,2792,1564,661,472,224,1092,437,134,66,3572,1295,2882,1018,690,277,277,,,,2126,746,1631,579,2,2,68,25,425,140,167,71,24
E02000874,Tower Hamlets 011,Middle Super Output Areas and Intermediate Zones,MSOAIZ,E,6879,2494,1355,463,406,164,949,299,59,26,3710,1328,2689,861,1021,467,467,,,,1679,644,1598,603,1,1,30,12,50,28,41,76,33
E02000875,Tower Hamlets 012,Middle Super Output Areas and Intermediate Zones,MSOAIZ,E,9379,3437,1283,551,338,160,945,391,118,54,5418,1857,2097,670,3321,1187,1187,,,,2420,925,2282,875,7,3,93,36,38,11,50,140,50
E02000876,Tower Hamlets 013,Middle Super Output Areas and Intermediate Zones,MSOAIZ,E,6900,2750,1447,651,411,219,1036,432,81,29,2856,1029,1690,567,1166,462,462,,,,2426,1007,2293,953,0,0,93,40,40,14,54,90,34
E02000877,Tower Hamlets 014,Middle Super Output Areas and Intermediate Zones,MSOAIZ,E,9748,3252,1671,618,446,193,1225,425,41,22,5312,1749,1969,574,3343,1175,1175,,,,2627,833,2489,787,0,0,91,29,47,17,46,97,30
E02000878,Tower Hamlets 015,Middle Super Output Areas and Intermediate Zones,MSOAIZ,EC,9451,3900,2391,1002,778,377,1613,625,76,50,3478,1244,1498,482,1980,762,762,,,,3400,1559,3200,1471,4,4,91,41,105,43,88,106,45
E02000879,Tower Hamlets 016,Middle Super Output Areas and Intermediate Zones,MSOAIZ,E,7417,2855,1706,694,562,278,1144,416,95,43,3465,1314,1504,541,1961,773,773,,,,2041,755,1896,691,7,4,90,37,48,23,64,110,49
E02000880,Tower Hamlets 017,Middle Super Output Areas and Intermediate Zones,MSOAIZ,E,5634,2090,1343,504,382,167,961,337,56,33,2496,908,1891,704,605,204,204,,,,1663,621,1569,586,7,3,41,18,46,14,35,76,24
E02000881,Tower Hamlets 018,Middle Super Output Areas and Intermediate Zones,MSOAIZ,E,6909,2379,1257,520,401,197,856,323,186,104,4055,1291,1531,458,2524,833,833,,,,1339,437,1248,401,6,2,29,11,56,23,36,72,27
E02000882,Tower Hamlets 019,Middle Super Output Areas and Intermediate Zones,MSOAIZ,E,8563,2884,1143,425,288,140,855,285,480,266,5687,1785,2129,721,3558,1064,1064,,,,1121,371,1041,343,0,0,36,16,44,12,28,132,37
E02000883,Tower Hamlets 020,Middle Super Output Areas and Intermediate Zones,MSOAIZ,E,7853,2880,1157,438,357,178,800,260,121,61,4792,1731,1729,553,3063,1178,1178,,,,1721,622,1630,585,10,3,34,17,47,17,37,62,28
E02000884,Tower Hamlets 021,Middle Super Output Areas and Intermediate Zones,MSOAIZ,E,9021,3707,1508,685,565,254,943,431,147,91,2999,998,1072,342,1927,656,656,,,,4264,1893,4119,1833,25,13,69,26,51,21,60,103,40
E02000885,Tower Hamlets 022,Middle Super Output Areas and Intermediate Zones,MSOAIZ,E,6873,2509,1168,422,350,153,818,269,204,97,3893,1421,1430,501,2463,920,920,,,,1518,535,1432,504,0,0,41,15,45,16,31,90,34
E02000886,Tower Hamlets 023,Middle Super Output Areas and Intermediate Zones,MSOAIZ,E,7326,3185,2210,1033,670,356,1540,677,91,49,2509,984,1961,740,548,244,244,,,,2431,1087,2340,1039,15,6,59,31,17,11,48,85,32
E02000887,Tower Hamlets 024,Middle Super Output Areas and Intermediate Zones,MSOAIZ,E,8585,3165,1551,614,476,213,1075,401,141,75,4622,1633,2648,889,1974,744,744,,,,2184,806,2060,759,5,2,67,27,52,18,47,87,37
E02000888,Tower Hamlets 025,Middle Super Output Areas and Intermediate Zones,MSOAIZ,E,8210,3306,2099,906,565,280,1534,626,233,140,3194,1062,1505,511,1689,551,551,,,,2547,1144,2433,1092,4,3,73,37,37,12,52,137,54
E02000889,Tower Hamlets 026,Middle Super Output Areas and Intermediate Zones,MSOAIZ,EC,6549,2879,1934,952,665,364,1269,588,107,64,2317,853,1138,420,1179,433,433,,,,2103,969,1984,916,10,4,79,39,30,10,53,88,41
E02000890,Tower Hamlets 027,Middle Super Output Areas and Intermediate Zones,MSOAIZ,EC,5795,3093,2526,1430,983,615,1543,815,66,40,833,359,530,246,303,113,113,,,,2292,1223,2150,1146,48,25,71,39,23,13,77,78,41
E02000891,Tower Hamlets 028,Middle Super Output Areas and Intermediate Zones,MSOAIZ,E,12678,5742,2648,1345,794,452,1854,893,397,209,4088,1397,1543,471,2545,926,926,,,,5393,2717,5220,2628,15,8,103,53,55,28,89,152,74
E02000893,Tower Hamlets 030,Middle Super Output Areas and Intermediate Zones,MSOAIZ,E,6783,2912,1947,900,597,307,1350,593,58,25,2596,1081,677,235,1919,846,846,,,,2091,863,1997,823,2,1,59,28,33,11,40,91,43
E02000894,Tower Hamlets 031,Middle Super Output Areas and Intermediate Zones,MSOAIZ,E,10137,4510,2994,1486,811,446,2183,1040,110,58,2255,757,452,140,1803,617,617,,,,4654,2143,4525,2083,9,3,91,44,29,13,60,124,66
E02000895,Waltham Forest 001,Middle Super Output Areas and Intermediate Zones,MSOAIZ,E,7962,3271,5362,2181,2111,1111,3251,1070,68,27,1650,738,930,328,720,410,410,,,,817,290,748,263,17,4,36,16,16,7,27,65,35
E02000896,Waltham Forest 002,Middle Super Output Areas and Intermediate Zones,MSOAIZ,E,8719,3758,6605,2736,2687,1384,3918,1352,37,12,740,385,300,161,440,224,224,,,,1275,588,1204,553,25,11,44,23,2,1,35,62,37
E02000897,Waltham Forest 003,Middle Super Output Areas and Intermediate Zones,MSOAIZ,IG,7991,3345,4753,1986,1711,919,3042,1067,41,17,2340,997,1951,842,389,155,155,,,,791,314,740,292,5,2,42,17,4,3,22,66,31
E02000898,Waltham Forest 004,Middle Super Output Areas and Intermediate Zones,MSOAIZ,E,7677,3065,5290,2064,1820,908,3470,1156,90,32,1555,689,665,296,890,393,393,,,,692,256,640,236,6,1,30,15,16,4,20,50,24
E02000899,Waltham Forest 005,Middle Super Output Areas and Intermediate Zones,MSOAIZ,E,7866,3090,5993,2309,2163,1075,3830,1234,27,11,698,348,416,181,282,167,167,,,,1104,403,1020,372,12,4,67,24,5,3,31,44,19
E02000900,Waltham Forest 006,Middle Super Output Areas and Intermediate Zones,MSOAIZ,E,8062,2986,5206,1964,1773,845,3433,1119,35,10,1579,581,545,195,1034,386,386,,,,1129,393,1060,363,9,3,45,20,15,7,30,113,38
E02000901,Waltham Forest 007,Middle Super Output Areas and Intermediate Zones,MSOAIZ,IG,9302,3553,7060,2613,2328,1088,4732,1525,80,34,943,408,781,330,162,78,78,,,,1158,471,1092,442,5,2,44,21,17,6,29,61,27
E02000902,Waltham Forest 008,Middle Super Output Areas and Intermediate Zones,MSOAIZ,E,8229,3101,4994,1907,1565,757,3429,1150,41,22,1661,621,1119,390,542,231,231,,,,1426,510,1358,487,0,0,45,14,23,9,23,107,41
E02000903,Waltham Forest 009,Middle Super Output Areas and Intermediate Zones,MSOAIZ,E,9043,3179,3792,1368,915,426,2877,942,81,28,3353,1183,2321,769,1032,414,414,,,,1696,551,1587,518,6,3,72,21,31,9,33,121,49
E02000904,Waltham Forest 010,Middle Super Output Areas and Intermediate Zones,MSOAIZ,IG,8213,2900,4760,1776,1392,646,3368,1130,135,46,1077,402,363,137,714,265,265,,,,2211,661,2095,622,11,4,96,30,9,5,39,30,15
E02000905,Waltham Forest 011,Middle Super Output Areas and Intermediate Zones,MSOAIZ,E,9512,3465,4885,1839,1384,619,3501,1220,99,48,1520,622,585,232,935,390,390,,,,2913,916,2758,865,6,2,99,33,50,16,51,95,40
E02000906,Waltham Forest 012,Middle Super Output Areas and Intermediate Zones,MSOAIZ,E,9246,3507,3943,1665,1215,552,2728,1113,74,27,2286,825,1091,352,1195,473,473,,,,2846,952,2731,907,1,1,98,37,16,7,45,97,38
E02000907,Waltham Forest 013,Middle Super Output Areas and Intermediate Zones,MSOAIZ,E,9634,3885,2968,1181,852,410,2116,771,68,27,4253,1827,3437,1417,816,410,410,,,,2215,794,2112,751,9,3,50,21,44,19,43,130,56
E02000908,Waltham Forest 014,Middle Super Output Areas and Intermediate Zones,MSOAIZ,N,10516,4348,4382,1899,1143,558,3239,1341,204,102,2217,960,939,385,1278,575,575,,,,3629,1341,3495,1285,3,1,92,38,39,17,56,84,46
E02000909,Waltham Forest 015,Middle Super Output Areas and Intermediate Zones,MSOAIZ,E,8635,3459,4556,1792,1443,658,3113,1134,61,34,1542,662,1014,396,528,266,266,,,,2372,932,2267,880,32,17,54,24,19,11,52,104,39
E02000910,Waltham Forest 016,Middle Super Output Areas and Intermediate Zones,MSOAIZ,E,10647,4005,4982,1856,1821,713,3161,1143,91,39,1400,611,643,271,757,340,340,,,,4054,1448,3904,1384,14,4,80,36,56,24,64,120,51
E02000911,Waltham Forest 017,Middle Super Output Areas and Intermediate Zones,MSOAIZ,E,10868,4115,4335,1671,1471,579,2864,1092,169,79,2168,902,1251,521,917,381,381,,,,4084,1424,3954,1375,16,6,85,32,29,11,49,112,39
E02000912,Waltham Forest 018,Middle Super Output Areas and Intermediate Zones,MSOAIZ,E,9143,3151,4143,1474,1473,578,2670,896,124,56,2096,780,1012,371,1084,409,409,,,,2701,811,2578,772,1,1,98,29,24,9,39,79,30
E02000913,Waltham Forest 019,Middle Super Output Areas and Intermediate Zones,MSOAIZ,E,8660,2968,4785,1644,1945,777,2840,867,85,36,897,362,244,82,653,280,280,,,,2816,893,2709,853,8,2,62,23,37,15,40,77,33
E02000914,Waltham Forest 020,Middle Super Output Areas and Intermediate Zones,MSOAIZ,E,10499,3689,3603,1153,1380,484,2223,669,109,51,3186,1326,968,393,2218,933,933,,,,3475,1118,3299,1057,17,7,107,29,52,25,61,126,41
E02000915,Waltham Forest 021,Middle Super Output Areas and Intermediate Zones,MSOAIZ,E,8399,3305,3866,1468,1477,608,2389,860,34,19,1434,600,261,91,1173,509,509,,,,3006,1190,2918,1146,7,3,62,32,19,9,44,59,28
E02000916,Waltham Forest 022,Middle Super Output Areas and Intermediate Zones,MSOAIZ,E,9482,3506,4091,1644,1165,538,2926,1106,149,64,1332,464,514,182,818,282,282,,,,3819,1297,3687,1239,4,1,91,44,37,13,58,91,37
E02000917,Waltham Forest 023,Middle Super Output Areas and Intermediate Zones,MSOAIZ,E,9148,3396,3766,1524,1161,530,2605,994,38,15,870,362,199,75,671,287,287,,,,4407,1473,4264,1430,4,1,107,33,32,9,43,67,22
E02000918,Waltham Forest 024,Middle Super Output Areas and Intermediate Zones,MSOAIZ,E,9041,3449,3452,1312,1221,502,2231,810,158,74,2364,944,1509,593,855,351,351,,,,2966,1076,2846,1029,15,6,84,32,21,9,47,101,43
E02000919,Waltham Forest 025,Middle Super Output Areas and Intermediate Zones,MSOAIZ,E,9200,3225,3954,1474,1544,640,2410,834,35,14,802,332,184,54,618,278,278,,,,4331,1371,4200,1321,11,4,85,31,35,15,50,78,34
E02000920,Waltham Forest 026,Middle Super Output Areas and Intermediate Zones,MSOAIZ,E,9471,3434,3257,1144,1415,528,1842,616,123,58,2804,1074,635,202,2169,872,872,,,,3205,1126,3074,1083,10,5,72,23,49,15,43,82,32
E02000921,Waltham Forest 027,Middle Super Output Areas and Intermediate Zones,MSOAIZ,E,10979,3966,2847,1081,1012,405,1835,676,46,19,4327,1647,2069,794,2258,853,853,,,,3679,1190,3552,1147,6,2,82,28,39,13,43,80,29
E02000922,Waltham Forest 028,Middle Super Output Areas and Intermediate Zones,MSOAIZ,E,10471,3740,4121,1636,1236,558,2885,1078,42,17,1883,724,958,361,925,363,363,,,,4280,1313,4090,1247,13,4,150,54,27,8,66,145,50
E02000923,Wandsworth 001,Middle Super Output Areas and Intermediate Zones,MSOAIZ,SW,7337,3632,3490,1830,1663,941,1827,889,87,53,878,436,710,336,168,100,100,,,,2761,1240,2606,1167,9,4,111,56,35,13,73,121,73
E02000924,Wandsworth 002,Middle Super Output Areas and Intermediate Zones,MSOAIZ,SW,11128,5295,2625,1349,934,509,1691,840,449,291,4323,1946,3335,1472,988,474,474,,,,3605,1653,3425,1570,10,4,134,64,36,15,83,126,56
E02000925,Wandsworth 003,Middle Super Output Areas and Intermediate Zones,MSOAIZ,SW,7811,3412,2166,1004,848,425,1318,579,67,35,3640,1593,3365,1432,275,161,161,,,,1868,745,1783,703,1,1,71,34,13,7,42,70,35
E02000926,Wandsworth 004,Middle Super Output Areas and Intermediate Zones,MSOAIZ,SW,8876,4283,3369,1763,1256,711,2113,1052,224,127,1738,783,946,391,792,392,392,,,,3447,1561,3260,1477,21,7,138,65,28,12,84,98,49
E02000927,Wandsworth 005,Middle Super Output Areas and Intermediate Zones,MSOAIZ,SW,6790,3228,2160,1072,702,368,1458,704,28,17,2614,1277,678,351,1936,926,926,,,,1931,831,1834,784,18,9,64,30,15,8,47,57,31
E02000928,Wandsworth 006,Middle Super Output Areas and Intermediate Zones,MSOAIZ,SW,8448,3635,5175,2141,2237,1031,2938,1110,15,6,692,375,455,243,237,132,132,,,,2478,1072,2337,1005,28,14,104,48,9,5,67,88,41
E02000929,Wandsworth 007,Middle Super Output Areas and Intermediate Zones,MSOAIZ,SW,7277,3201,1453,695,503,256,950,439,154,100,4167,1831,3659,1596,508,235,235,,,,1448,551,1404,529,5,2,33,16,6,4,22,55,24
E02000930,Wandsworth 008,Middle Super Output Areas and Intermediate Zones,MSOAIZ,SW,9649,4382,3810,1836,1205,664,2605,1172,46,21,1563,737,1035,465,528,272,272,,,,4138,1737,3980,1664,22,10,126,59,10,4,73,92,51
E02000931,Wandsworth 009,Middle Super Output Areas and Intermediate Zones,MSOAIZ,SW,8474,3532,4850,2032,1644,779,3206,1253,32,13,537,272,113,48,424,224,224,,,,3022,1198,2913,1151,2,1,106,45,1,1,47,33,17
E02000932,Wandsworth 010,Middle Super Output Areas and Intermediate Zones,MSOAIZ,SW,10296,4777,4828,2259,1758,888,3070,1371,189,120,520,289,246,130,274,159,159,,,,4659,2059,4389,1953,66,17,171,75,33,14,106,100,50
E02000933,Wandsworth 011,Middle Super Output Areas and Intermediate Zones,MSOAIZ,SW,8760,3872,4875,2127,2350,1134,2525,993,56,29,838,428,623,320,215,108,108,,,,2913,1245,2686,1149,70,28,115,52,42,16,96,78,43
E02000934,Wandsworth 012,Middle Super Output Areas and Intermediate Zones,MSOAIZ,SW,9040,4325,3630,1785,1192,606,2438,1179,182,99,1897,962,272,152,1625,810,810,,,,3235,1439,3060,1362,11,5,134,62,30,10,77,96,40
E02000935,Wandsworth 013,Middle Super Output Areas and Intermediate Zones,MSOAIZ,SW,5946,2468,1256,551,574,292,682,259,37,14,3082,1406,2908,1318,174,88,88,,,,1473,455,1411,436,6,2,48,14,8,3,19,98,42
E02000936,Wandsworth 014,Middle Super Output Areas and Intermediate Zones,MSOAIZ,SW,8252,4057,3304,1791,1489,904,1815,887,81,48,1207,562,914,395,293,167,167,,,,3558,1602,3308,1478,58,25,155,77,37,22,124,102,54
E02000937,Wandsworth 015,Middle Super Output Areas and Intermediate Zones,MSOAIZ,SW,7711,3130,4710,1814,1806,759,2904,1055,17,9,777,377,279,130,498,247,247,,,,2149,898,2068,856,3,1,70,35,8,6,42,58,32
E02000938,Wandsworth 016,Middle Super Output Areas and Intermediate Zones,MSOAIZ,SW,9271,4032,3671,1710,1469,797,2202,913,212,108,2850,1292,2597,1173,253,119,119,,,,2454,880,2331,809,3,2,67,27,53,42,71,84,42
E02000939,Wandsworth 017,Middle Super Output Areas and Intermediate Zones,MSOAIZ,SW,7760,2915,5387,1921,2359,918,3028,1003,2,2,634,327,324,142,310,185,185,,,,1651,625,1564,587,10,5,69,29,8,4,38,86,40
E02000940,Wandsworth 018,Middle Super Output Areas and Intermediate Zones,MSOAIZ,SW,7814,3494,2634,1284,729,396,1905,888,232,145,2345,1027,1827,748,518,279,279,,,,2526,1012,2405,959,14,4,84,36,23,13,53,77,26
E02000941,Wandsworth 019,Middle Super Output Areas and Intermediate Zones,MSOAIZ,SW,9841,4125,5802,2326,1810,797,3992,1529,41,15,1202,583,386,156,816,427,427,,,,2719,1169,2584,1104,10,6,101,52,24,7,65,77,32
E02000942,Wandsworth 020,Middle Super Output Areas and Intermediate Zones,MSOAIZ,SW,9633,3794,5929,2318,2132,1000,3797,1318,61,34,514,242,357,156,157,86,86,,,,3043,1156,2787,1061,127,40,83,39,46,16,95,86,44
E02000943,Wandsworth 021,Middle Super Output Areas and Intermediate Zones,MSOAIZ,SW,8388,3708,4281,1823,1519,715,2762,1108,92,44,878,439,442,208,436,231,231,,,,3059,1367,2938,1313,18,6,93,44,10,4,54,78,35
E02000944,Wandsworth 022,Middle Super Output Areas and Intermediate Zones,MSOAIZ,SW,6923,2856,1981,943,628,359,1353,584,106,58,2395,991,2092,865,303,126,126,,,,2376,839,2255,786,38,16,59,26,24,11,53,65,25
E02000945,Wandsworth 023,Middle Super Output Areas and Intermediate Zones,MSOAIZ,SW,7044,2764,2002,872,664,348,1338,524,55,28,2516,1114,2246,954,270,160,160,,,,2430,731,2356,702,19,8,37,14,18,7,29,41,19
E02000946,Wandsworth 024,Middle Super Output Areas and Intermediate Zones,MSOAIZ,SW,7621,3172,3344,1512,938,482,2406,1030,163,80,1723,622,1337,442,386,180,180,,,,2310,938,2184,887,30,7,94,43,2,1,51,81,20
E02000947,Wandsworth 025,Middle Super Output Areas and Intermediate Zones,MSOAIZ,SW,8675,3820,5034,2241,1547,788,3487,1453,94,49,700,351,324,146,376,205,205,,,,2798,1152,2671,1092,8,4,102,49,17,7,60,49,27
E02000948,Wandsworth 026,Middle Super Output Areas and Intermediate Zones,MSOAIZ,SW,9818,4493,4501,2101,1445,700,3056,1401,92,52,1096,548,403,179,693,369,369,,,,4063,1753,3926,1685,3,1,116,59,18,8,68,66,39
E02000949,Wandsworth 027,Middle Super Output Areas and Intermediate Zones,MSOAIZ,SW,9525,4072,5767,2351,2206,1007,3561,1344,78,45,612,291,164,66,448,225,225,,,,2981,1337,2838,1269,38,17,102,48,3,3,68,87,48
E02000950,Wandsworth 028,Middle Super Output Areas and Intermediate Zones,MSOAIZ,SW,7541,3233,3396,1622,1321,706,2075,916,51,20,1231,518,1163,489,68,29,29,,,,2793,1033,2683,987,11,2,88,39,11,5,46,70,40
E02000951,Wandsworth 029,Middle Super Output Areas and Intermediate Zones,MSOAIZ,SW,6522,2946,3065,1330,1172,559,1893,771,48,21,916,447,304,133,612,314,314,,,,2433,1120,2351,1076,5,3,71,37,6,4,44,60,28
E02000952,Wandsworth 030,Middle Super Output Areas and Intermediate Zones,MSOAIZ,SW,6205,2644,3025,1152,1090,444,1935,708,8,5,1081,542,265,109,816,433,433,,,,2050,924,1992,893,3,2,47,25,8,4,31,41,21
E02000953,Wandsworth 031,Middle Super Output Areas and Intermediate Zones,MSOAIZ,SW,6758,3113,3255,1485,865,438,2390,1047,25,11,1313,741,539,222,774,519,519,,,,2111,848,2000,795,20,12,77,32,14,9,53,54,28
E02000954,Wandsworth 032,Middle Super Output Areas and Intermediate Zones,MSOAIZ,SW,6426,2299,3269,1258,1401,582,1868,676,40,15,675,269,457,163,218,106,106,,,,2388,739,2317,712,10,3,38,17,23,7,27,54,18
E02000955,Wandsworth 033,Middle Super Output Areas and Intermediate Zones,MSOAIZ,SW,6712,2527,2780,1089,1155,487,1625,602,37,14,1437,642,1216,546,221,96,96,,,,2387,755,2237,709,14,4,119,38,17,4,46,71,27
E02000956,Wandsworth 034,Middle Super Output Areas and Intermediate Zones,MSOAIZ,SW,7664,3066,1954,975,715,369,1239,606,80,41,1637,693,1054,457,583,236,236,,,,3908,1317,3764,1264,9,4,126,43,9,6,53,85,40
E02000957,Wandsworth 035,Middle Super Output Areas and Intermediate Zones,MSOAIZ,SW,10496,4238,4089,1820,1501,705,2588,1115,182,81,1172,564,304,136,868,428,428,,,,4928,1715,4740,1641,9,4,131,56,48,14,74,125,58
E02000958,Wandsworth 036,Middle Super Output Areas and Intermediate Zones,MSOAIZ,SW,8065,2973,4999,1827,1747,738,3252,1089,33,13,981,450,658,294,323,156,156,,,,1948,649,1870,618,5,3,69,25,4,3,31,104,34
E02000959,Wandsworth 037,Middle Super Output Areas and Intermediate Zones,MSOAIZ,SW,7151,2980,3112,1384,926,465,2186,919,117,48,1265,549,459,189,806,360,360,,,,2597,972,2519,938,3,1,60,26,15,7,34,60,27
E02000960,Westminster 001,Middle Super Output Areas and Intermediate Zones,MSOAIZ,NW,6499,3055,2686,1327,1738,908,948,419,34,16,649,322,517,247,132,75,75,,,,2878,1252,2609,1137,154,58,49,30,66,27,115,252,138
E02000961,Westminster 002,Middle Super Output Areas and Intermediate Zones,MSOAIZ,W,9380,4064,3521,1551,1829,874,1692,677,23,14,1946,836,1170,468,776,368,368,,,,3670,1569,3574,1530,17,5,68,28,11,6,39,220,94
E02000962,Westminster 003,Middle Super Output Areas and Intermediate Zones,MSOAIZ,W,8614,4424,2695,1437,1599,912,1096,525,44,26,1993,1093,860,416,1133,677,677,,,,3578,1719,3432,1645,51,19,73,41,22,14,74,304,149
E02000963,Westminster 004,Middle Super Output Areas and Intermediate Zones,MSOAIZ,W,10303,4141,2165,973,849,398,1316,575,130,57,6226,2356,4225,1603,2001,753,753,,,,1651,706,1562,661,7,4,60,31,22,10,45,131,49
E02000964,Westminster 005,Middle Super Output Areas and Intermediate Zones,MSOAIZ,W,12458,5638,2361,1207,834,445,1527,762,123,60,6286,2653,1579,581,4707,2072,2072,,,,3534,1646,3383,1570,5,4,103,52,43,20,76,154,72
E02000965,Westminster 006,Middle Super Output Areas and Intermediate Zones,MSOAIZ,W,8604,3981,2884,1425,1114,576,1770,849,38,20,1587,718,557,207,1030,511,511,,,,3962,1753,3837,1693,4,2,81,43,40,15,60,133,65
E02000966,Westminster 007,Middle Super Output Areas and Intermediate Zones,MSOAIZ,W,9661,4714,4085,2027,2069,1098,2016,929,41,17,1162,584,395,160,767,424,424,,,,4157,1971,4023,1894,20,8,93,55,21,14,77,216,115
E02000967,Westminster 008,Middle Super Output Areas and Intermediate Zones,MSOAIZ,W,7093,3653,2733,1467,1639,927,1094,540,56,34,440,186,194,87,246,99,99,,,,3608,1825,3427,1740,38,16,99,48,44,21,85,256,141
E02000968,Westminster 009,Middle Super Output Areas and Intermediate Zones,MSOAIZ,W,14199,5713,2135,993,1073,528,1062,465,101,49,8415,3145,5887,2218,2528,927,927,,,,3320,1421,3207,1366,6,5,62,30,45,20,55,228,105
E02000969,Westminster 010,Middle Super Output Areas and Intermediate Zones,MSOAIZ,WC,9060,3719,1358,650,580,296,778,354,157,81,5268,2041,3182,1294,2086,747,747,,,,2053,856,1972,819,5,3,46,21,30,13,37,224,91
E02000970,Westminster 011,Middle Super Output Areas and Intermediate Zones,MSOAIZ,W,8916,4874,2799,1503,1777,1005,1022,498,33,19,1021,506,133,62,888,444,444,,,,4616,2600,4352,2470,60,34,67,36,137,60,130,447,246
E02000971,Westminster 012,Middle Super Output Areas and Intermediate Zones,MSOAIZ,W,8191,4354,2452,1305,1350,787,1102,518,27,15,671,371,211,105,460,266,266,,,,4723,2512,4535,2417,35,18,75,38,78,39,95,318,151
E02000972,Westminster 013,Middle Super Output Areas and Intermediate Zones,MSOAIZ,WC,7617,4503,1622,983,866,543,756,440,43,26,2155,1240,819,481,1336,759,759,,,,3474,2078,3277,1980,57,28,70,37,70,33,98,323,176
E02000973,Westminster 014,Middle Super Output Areas and Intermediate Zones,MSOAIZ,W,10031,5312,3649,1852,1871,991,1778,861,59,35,2587,1335,1176,545,1411,790,790,,,,3558,1985,3389,1905,11,5,132,63,26,12,80,178,105
E02000974,Westminster 015,Middle Super Output Areas and Intermediate Zones,MSOAIZ,W,8448,4380,2907,1460,1711,924,1196,536,60,30,899,456,228,97,671,359,359,,,,4169,2242,4021,2160,22,12,62,36,64,34,82,413,192
E02000975,Westminster 016,Middle Super Output Areas and Intermediate Zones,MSOAIZ,W,8391,4621,2632,1457,1380,810,1252,647,56,37,752,362,339,146,413,216,216,,,,4774,2655,4596,2563,13,5,116,61,49,26,92,177,110
E02000976,Westminster 017,Middle Super Output Areas and Intermediate Zones,MSOAIZ,W,9766,5041,2968,1546,1650,893,1318,653,56,23,1174,599,966,473,208,126,126,,,,5271,2717,5067,2615,35,8,112,65,57,29,102,297,156
E02000977,Westminster 018,Middle Super Output Areas and Intermediate Zones,MSOAIZ,WC,6719,3895,1651,987,1073,656,578,331,39,17,1448,866,387,215,1061,651,651,,,,3182,1810,2894,1667,96,42,54,31,138,70,143,399,215
E02000978,Westminster 019,Middle Super Output Areas and Intermediate Zones,MSOAIZ,W,7862,3882,3643,1793,2545,1333,1098,460,32,20,318,150,65,25,253,125,125,,,,3082,1531,2797,1398,93,37,86,41,106,55,133,787,388
E02000979,Westminster 020,Middle Super Output Areas and Intermediate Zones,MSOAIZ,WC,7317,3892,2230,1227,1424,822,806,405,59,39,2129,1096,140,72,1989,1024,1024,,,,2540,1335,2043,1118,272,107,68,40,157,70,217,359,195
E02000980,Westminster 021,Middle Super Output Areas and Intermediate Zones,MSOAIZ,SW,8626,4498,2365,1332,1229,745,1136,587,126,66,3788,1848,2530,1238,1258,610,610,,,,2169,1144,1997,1051,33,13,114,65,25,15,93,178,108
E02000981,Westminster 022,Middle Super Output Areas and Intermediate Zones,MSOAIZ,WC,8866,4853,3122,1730,1619,970,1503,760,99,55,2143,1175,241,84,1902,1091,1091,,,,3332,1791,3106,1679,15,8,173,87,38,17,112,170,102
E02000982,Westminster 023,Middle Super Output Areas and Intermediate Zones,MSOAIZ,SW,8198,4143,1943,1003,1088,604,855,399,167,109,3927,1888,1960,920,1967,968,968,,,,2038,1077,1848,982,59,27,85,43,46,25,95,123,66
E02000983,Westminster 024,Middle Super Output Areas and Intermediate Zones,MSOAIZ,SW,8389,4422,1870,1052,1079,647,791,405,40,20,3370,1522,1912,799,1458,723,723,,,,2983,1754,2833,1672,16,6,94,49,40,27,82,126,74
E02000984,Bolton 001,Middle Super Output Areas and Intermediate Zones,MSOAIZ,BL,7777,3146,6983,2793,2735,1332,4248,1461,8,4,69,27,57,22,12,5,5,,,,666,300,604,271,3,2,49,23,10,4,29,51,22
E02000985,Bolton 002,Middle Super Output Areas and Intermediate Zones,MSOAIZ,BL,7566,3205,6723,2828,2967,1550,3756,1278,8,5,248,129,89,46,159,83,83,,,,562,226,517,202,5,4,39,19,1,1,24,25,17
E02000986,Bolton 003,Middle Super Output Areas and Intermediate Zones,MSOAIZ,BL,8345,3682,6804,2883,2653,1406,4151,1477,32,17,315,178,244,126,71,52,52,,,,1105,552,1013,504,0,0,85,44,7,4,48,89,52
E02000987,Bolton 004,Middle Super Output Areas and Intermediate Zones,MSOAIZ,BL,7052,3288,4654,2074,1741,957,2913,1117,53,31,1246,649,896,432,350,217,217,,,,1018,483,905,429,8,4,96,47,9,3,54,81,51
E02000988,Bolton 005,Middle Super Output Areas and Intermediate Zones,MSOAIZ,BL,8371,3496,5449,2105,2293,979,3156,1126,9,9,1632,760,1238,582,394,178,178,,,,1149,555,1057,510,3,1,75,36,14,8,45,132,67
E02000989,Bolton 006,Middle Super Output Areas and Intermediate Zones,MSOAIZ,BL,8242,3637,7352,3208,3356,1804,3996,1404,24,19,321,180,141,86,180,94,94,,,,493,199,406,162,6,2,74,32,7,3,37,52,31
E02000990,Bolton 007,Middle Super Output Areas and Intermediate Zones,MSOAIZ,BL,7636,3286,6083,2567,2177,1131,3906,1436,16,10,549,266,348,150,201,116,116,,,,949,421,874,388,7,3,67,29,1,1,33,39,22
E02000991,Bolton 008,Middle Super Output Areas and Intermediate Zones,MSOAIZ,BL,7662,3316,6326,2662,2445,1274,3881,1388,29,10,344,204,192,99,152,105,105,,,,887,409,776,357,0,0,99,47,12,5,52,76,31
E02000992,Bolton 009,Middle Super Output Areas and Intermediate Zones,MSOAIZ,WN,5737,2518,4830,2077,1884,1006,2946,1071,13,6,357,181,315,164,42,17,17,,,,495,229,451,207,0,0,40,20,4,2,22,42,25
E02000993,Bolton 010,Middle Super Output Areas and Intermediate Zones,MSOAIZ,BL,7142,3135,2744,1118,820,433,1924,685,48,19,3199,1438,2866,1261,333,177,177,,,,1050,498,1001,468,2,2,39,22,8,6,30,101,62
E02000994,Bolton 011,Middle Super Output Areas and Intermediate Zones,MSOAIZ,BL,7914,3343,3771,1319,1699,641,2072,678,64,24,2726,1359,1590,878,1136,481,481,,,,1189,553,1092,514,4,1,82,33,11,5,39,164,88
E02000995,Bolton 012,Middle Super Output Areas and Intermediate Zones,MSOAIZ,BL,8108,3430,5352,2288,2353,1248,2999,1040,24,15,1902,752,1747,652,155,100,100,,,,737,317,676,286,4,3,40,19,17,9,31,93,58
E02000996,Bolton 013,Middle Super Output Areas and Intermediate Zones,MSOAIZ,BL,7683,3321,2998,1271,1047,578,1951,693,6,4,3946,1748,3637,1583,309,165,165,,,,573,213,531,193,3,3,34,15,5,2,20,160,85
E02000997,Bolton 014,Middle Super Output Areas and Intermediate Zones,MSOAIZ,WN,5586,2372,4193,1726,1723,871,2470,855,15,6,929,458,627,277,302,181,181,,,,419,164,375,145,0,0,41,18,3,1,19,30,18
E02000998,Bolton 015,Middle Super Output Areas and Intermediate Zones,MSOAIZ,BL,8558,3654,4758,1800,2219,911,2539,889,19,8,1175,550,690,331,485,219,219,,,,2462,1225,2329,1161,11,5,100,45,22,14,64,144,71
E02000999,Bolton 016,Middle Super Output Areas and Intermediate Zones,MSOAIZ,BL,7091,3580,2082,724,1028,369,1054,355,61,26,3490,2093,2470,1476,1020,617,617,,,,1203,606,1124,568,0,0,48,21,31,17,38,255,131
E02001000,Bolton 017,Middle Super Output Areas and Intermediate Zones,MSOAIZ,BL,8873,4123,5541,2436,2187,1151,3354,1285,29,15,1306,673,636,322,670,351,351,,,,1883,935,1723,868,5,2,136,57,19,8,67,114,64
E02001001,Bolton 018,Middle Super Output Areas and Intermediate Zones,MSOAIZ,BL,7903,3197,5805,2275,2296,1060,3509,1215,17,14,644,245,520,177,124,68,68,,,,1335,615,1262,582,3,2,70,31,0,0,33,102,48
E02001002,Bolton 019,Middle Super Output Areas and Intermediate Zones,MSOAIZ,BL,9445,4018,6464,2722,2380,1228,4084,1494,56,25,1984,862,1250,565,734,297,297,,,,868,365,769,321,2,1,88,39,9,4,44,73,44
E02001003,Bolton 020,Middle Super Output Areas and Intermediate Zones,MSOAIZ,BL,7249,2850,6607,2596,3190,1487,3417,1109,19,10,96,49,42,19,54,30,30,,,,472,171,439,157,0,0,29,12,4,2,14,55,24
E02001004,Bolton 021,Middle Super Output Areas and Intermediate Zones,MSOAIZ,BL,8240,3185,3830,1196,2477,799,1353,397,22,6,2835,1369,2171,1089,664,280,280,,,,1248,484,1144,448,15,3,55,22,34,11,36,305,130
E02001005,Bolton 022,Middle Super Output Areas and Intermediate Zones,MSOAIZ,BL,7860,3130,4291,1479,1747,723,2544,756,88,44,1670,811,721,380,949,431,431,,,,1637,723,1531,679,2,1,86,35,18,8,44,174,73
E02001006,Bolton 023,Middle Super Output Areas and Intermediate Zones,MSOAIZ,BL,7685,2801,4969,1720,2491,927,2478,793,35,19,1012,411,403,175,609,236,236,,,,1539,596,1359,542,20,4,98,31,62,19,54,130,55
E02001007,Bolton 024,Middle Super Output Areas and Intermediate Zones,MSOAIZ,M,10261,4396,8073,3342,3275,1667,4798,1675,67,31,1086,558,807,415,279,143,143,,,,970,422,831,359,7,4,118,53,14,6,63,65,43
E02001008,Bolton 025,Middle Super Output Areas and Intermediate Zones,MSOAIZ,BL,8067,2843,3776,1162,1838,589,1938,573,44,20,2890,1160,2110,820,780,340,340,,,,1120,414,1025,382,2,1,67,21,26,10,32,237,87
E02001009,Bolton 026,Middle Super Output Areas and Intermediate Zones,MSOAIZ,M,6684,2975,4078,1649,1632,805,2446,844,20,6,1464,822,622,325,842,497,497,,,,1040,451,962,411,7,3,56,31,15,6,40,82,47
E02001010,Bolton 027,Middle Super Output Areas and Intermediate Zones,MSOAIZ,BL,5867,2468,3525,1339,1360,596,2165,743,61,30,1149,565,726,352,423,213,213,,,,1063,505,972,462,5,4,60,25,26,14,43,69,29
E02001011,Bolton 028,Middle Super Output Areas and Intermediate Zones,MSOAIZ,BL,9853,4125,8276,3381,2849,1448,5427,1933,48,25,390,202,163,79,227,123,123,,,,1094,489,983,439,1,1,108,47,2,2,50,45,28
E02001012,Bolton 029,Middle Super Output Areas and Intermediate Zones,MSOAIZ,BL,7824,2919,5427,2038,1874,919,3553,1119,16,8,1473,534,1388,506,85,28,28,,,,789,285,726,268,0,0,45,15,18,2,17,119,54
E02001013,Bolton 030,Middle Super Output Areas and Intermediate Zones,MSOAIZ,M,5990,2495,5075,2090,2145,1070,2930,1020,38,23,320,134,223,93,97,41,41,,,,519,225,471,200,0,0,44,22,4,3,25,38,23
E02001014,Bolton 031,Middle Super Output Areas and Intermediate Zones,MSOAIZ,WN,8168,3650,5280,2226,1694,871,3586,1355,35,16,1709,856,1201,550,508,306,306,,,,1075,507,963,457,8,4,98,42,6,4,50,69,45
E02001015,Bolton 032,Middle Super Output Areas and Intermediate Zones,MSOAIZ,BL,7743,3762,4511,1936,1546,809,2965,1127,54,29,1891,1143,1189,696,702,447,447,,,,1170,572,1050,511,8,5,93,45,19,11,61,117,82
E02001016,Bolton 033,Middle Super Output Areas and Intermediate Zones,MSOAIZ,BL,8221,3354,3624,1440,1031,532,2593,908,84,51,3566,1473,2932,1156,634,317,317,,,,815,323,754,295,7,2,40,22,14,4,28,132,67
E02001017,Bolton 034,Middle Super Output Areas and Intermediate Zones,MSOAIZ,M,10849,4663,7874,3201,2522,1300,5352,1901,15,7,1622,784,1341,629,281,155,155,,,,1271,630,1143,573,10,5,109,46,9,6,57,67,41
E02001018,Bolton 035,Middle Super Output Areas and Intermediate Zones,MSOAIZ,WN,7603,3008,6431,2499,1862,907,4569,1592,27,13,502,202,152,62,350,140,140,,,,603,268,543,236,2,1,54,28,4,3,32,40,26
E02001019,Bury 001,Middle Super Output Areas and Intermediate Zones,MSOAIZ,BL,8732,3982,6590,2866,2349,1252,4241,1614,20,13,831,439,563,280,268,159,159,,,,1201,617,1087,559,14,4,88,47,12,7,58,90,47
E02001020,Bury 002,Middle Super Output Areas and Intermediate Zones,MSOAIZ,BL,5901,2483,5305,2217,2513,1291,2792,926,0,0,203,99,191,94,12,5,5,,,,352,143,303,118,7,4,40,20,2,1,25,41,24
E02001021,Bury 003,Middle Super Output Areas and Intermediate Zones,MSOAIZ,BL,7638,3115,6795,2701,2271,1135,4524,1566,6,4,113,80,76,58,37,22,22,,,,656,295,597,267,1,1,55,25,3,2,28,68,35
E02001022,Bury 004,Middle Super Output Areas and Intermediate Zones,MSOAIZ,BL,7693,3326,5787,2434,2377,1229,3410,1205,40,25,862,433,756,360,106,73,73,,,,916,394,805,349,4,2,100,40,7,3,45,88,40
E02001023,Bury 005,Middle Super Output Areas and Intermediate Zones,MSOAIZ,BL,5825,2324,4314,1685,1653,808,2661,877,2,1,1005,417,864,334,141,83,83,,,,463,196,433,181,0,0,30,15,0,0,15,41,25
E02001024,Bury 006,Middle Super Output Areas and Intermediate Zones,MSOAIZ,BL,8032,3341,6943,2845,2381,1233,4562,1612,8,4,343,168,251,124,92,44,44,,,,694,300,617,264,0,0,65,32,12,4,36,44,24
E02001025,Bury 007,Middle Super Output Areas and Intermediate Zones,MSOAIZ,BL,7495,3349,3797,1615,1354,723,2443,892,32,16,2757,1304,2397,1096,360,208,208,,,,775,350,669,303,13,3,84,38,9,6,47,134,64
E02001026,Bury 008,Middle Super Output Areas and Intermediate Zones,MSOAIZ,BL,8839,3671,5047,1889,1819,748,3228,1141,45,21,1358,704,493,264,865,440,440,,,,2225,978,2057,914,15,5,121,46,32,13,64,164,79
E02001027,Bury 009,Middle Super Output Areas and Intermediate Zones,MSOAIZ,M,6552,3029,4401,1940,1336,744,3065,1196,22,10,591,347,477,285,114,62,62,,,,1454,687,1342,640,4,2,95,41,13,4,47,84,45
E02001028,Bury 010,Middle Super Output Areas and Intermediate Zones,MSOAIZ,BL,7388,3108,6922,2860,3044,1599,3878,1261,2,1,162,119,74,51,88,68,68,,,,264,103,231,90,7,2,25,10,1,1,13,38,25
E02001029,Bury 011,Middle Super Output Areas and Intermediate Zones,MSOAIZ,BL,6898,2880,4465,1715,1568,776,2897,939,31,10,1124,612,481,284,643,328,328,,,,1151,472,1056,433,7,2,84,34,4,3,39,127,71
E02001030,Bury 012,Middle Super Output Areas and Intermediate Zones,MSOAIZ,M,5758,2346,4882,1954,1685,834,3197,1120,23,14,343,181,250,128,93,53,53,,,,467,172,425,157,3,1,35,13,4,1,15,43,25
E02001031,Bury 013,Middle Super Output Areas and Intermediate Zones,MSOAIZ,M,6463,2841,4339,1789,1535,786,2804,1003,15,11,1002,547,529,315,473,232,232,,,,1047,457,958,420,0,0,78,30,11,7,37,60,37
E02001032,Bury 014,Middle Super Output Areas and Intermediate Zones,MSOAIZ,M,7445,3120,5962,2461,2064,1078,3898,1383,38,19,518,246,480,227,38,19,19,,,,882,370,786,327,5,2,91,41,0,0,43,45,24
E02001033,Bury 015,Middle Super Output Areas and Intermediate Zones,MSOAIZ,M,5603,2390,3566,1489,1102,589,2464,900,29,15,959,415,523,195,436,220,220,,,,983,442,918,411,0,0,52,23,13,8,31,66,29
E02001034,Bury 016,Middle Super Output Areas and Intermediate Zones,MSOAIZ,M,7736,3831,3561,1543,1101,593,2460,950,41,17,2516,1478,1423,854,1093,624,624,,,,1542,739,1417,690,0,0,117,46,8,3,49,76,54
E02001035,Bury 017,Middle Super Output Areas and Intermediate Zones,MSOAIZ,M,7190,2981,6315,2612,2765,1419,3550,1193,13,5,231,99,154,58,77,41,41,,,,582,234,512,201,4,3,62,29,4,1,33,49,31
E02001036,Bury 018,Middle Super Output Areas and Intermediate Zones,MSOAIZ,M,7252,3011,5046,2051,1628,822,3418,1229,6,3,1211,526,1042,437,169,89,89,,,,935,401,849,360,2,1,80,38,4,2,41,54,30
E02001037,Bury 019,Middle Super Output Areas and Intermediate Zones,MSOAIZ,M,7032,3016,6167,2601,2655,1396,3512,1205,15,9,96,52,61,30,35,22,22,,,,682,321,636,297,1,1,40,21,5,2,24,72,33
E02001038,Bury 020,Middle Super Output Areas and Intermediate Zones,MSOAIZ,M,5567,2637,3565,1582,1192,675,2373,907,10,6,962,550,795,448,167,102,102,,,,939,447,893,419,0,0,41,24,5,4,28,91,52
E02001039,Bury 021,Middle Super Output Areas and Intermediate Zones,MSOAIZ,M,8174,3443,4595,1858,1355,721,3240,1137,17,8,2615,1182,927,347,1688,835,835,,,,883,363,826,338,2,1,50,21,5,3,25,64,32
E02001040,Bury 022,Middle Super Output Areas and Intermediate Zones,MSOAIZ,M,5887,2548,5059,2104,2021,1047,3038,1057,12,7,126,80,96,59,30,21,21,,,,649,328,596,298,4,2,46,26,3,2,30,41,29
E02001041,Bury 023,Middle Super Output Areas and Intermediate Zones,MSOAIZ,M,7613,3369,4843,2090,1575,850,3268,1240,31,16,1399,658,1124,470,275,188,188,,,,1262,564,1158,521,10,5,81,32,13,6,43,78,41
E02001042,Bury 024,Middle Super Output Areas and Intermediate Zones,MSOAIZ,M,6167,2875,4354,1811,1699,876,2655,935,7,3,536,398,190,135,346,263,263,,,,1215,625,1122,586,12,2,74,32,7,5,39,55,38
E02001043,Bury 025,Middle Super Output Areas and Intermediate Zones,MSOAIZ,M,5249,2307,3773,1584,1321,683,2452,901,16,4,768,415,571,284,197,131,131,,,,652,275,617,258,0,0,32,15,3,2,17,40,29
E02001044,Bury 026,Middle Super Output Areas and Intermediate Zones,MSOAIZ,M,8896,2790,6753,2099,2207,932,4546,1167,18,5,293,154,163,97,130,57,57,,,,1760,501,1580,458,6,1,168,41,6,1,43,72,31
E02001045,Manchester 001,Middle Super Output Areas and Intermediate Zones,MSOAIZ,M,7897,3622,3534,1561,1363,731,2171,830,35,15,3372,1625,2604,1171,768,454,454,,,,869,364,798,330,5,2,58,27,8,5,34,87,57
E02001046,Manchester 002,Middle Super Output Areas and Intermediate Zones,MSOAIZ,M,9309,3956,4230,1743,1334,683,2896,1060,118,54,3577,1558,2843,1190,734,368,368,,,,1306,558,1190,505,6,2,82,41,28,10,53,78,43
E02001047,Manchester 003,Middle Super Output Areas and Intermediate Zones,MSOAIZ,OL,9856,4369,4814,1922,1384,713,3430,1209,36,19,3744,1868,3114,1526,630,342,342,,,,1158,492,1057,446,6,2,85,37,10,7,46,104,68
E02001048,Manchester 004,Middle Super Output Areas and Intermediate Zones,MSOAIZ,M,8455,3560,5241,2049,1918,959,3323,1090,38,22,1205,639,711,320,494,319,319,,,,1871,805,1733,744,1,1,123,54,14,6,61,100,45
E02001049,Manchester 005,Middle Super Output Areas and Intermediate Zones,MSOAIZ,M,9520,4049,6413,2664,2251,1167,4162,1497,43,22,2040,909,1569,663,471,246,246,,,,927,395,848,357,0,0,73,34,6,4,38,97,59
E02001050,Manchester 006,Middle Super Output Areas and Intermediate Zones,MSOAIZ,M,7072,3195,2782,1205,1008,517,1774,688,73,42,1723,889,1092,546,631,343,343,,,,2413,1016,2324,978,5,4,76,29,8,5,38,81,43
E02001051,Manchester 007,Middle Super Output Areas and Intermediate Zones,MSOAIZ,M,7975,3393,4633,1945,1726,906,2907,1039,14,8,1001,510,582,299,419,211,211,,,,2226,883,2106,827,4,1,95,46,21,9,56,101,47
E02001052,Manchester 008,Middle Super Output Areas and Intermediate Zones,MSOAIZ,M,12588,4384,5925,1767,2532,872,3393,895,122,63,1815,804,414,209,1401,595,595,,,,4500,1667,4271,1590,6,3,174,57,49,17,77,226,83
E02001053,Manchester 009,Middle Super Output Areas and Intermediate Zones,MSOAIZ,M,9950,4494,2024,839,706,353,1318,486,90,40,5709,2763,4060,1924,1649,839,839,,,,1942,750,1818,706,15,4,91,28,18,12,44,185,102
E02001055,Manchester 011,Middle Super Output Areas and Intermediate Zones,MSOAIZ,M,8434,3829,3558,1534,1210,635,2348,899,36,18,3014,1488,2141,1021,873,467,467,,,,1691,712,1603,667,15,5,61,34,12,6,45,135,77
E02001056,Manchester 012,Middle Super Output Areas and Intermediate Zones,MSOAIZ,M,8119,3463,2101,857,783,389,1318,468,39,16,4621,2046,2241,975,2380,1071,1071,,,,1217,478,1148,446,1,1,34,15,34,16,32,141,66
E02001057,Manchester 013,Middle Super Output Areas and Intermediate Zones,MSOAIZ,M,8028,4018,1526,675,457,224,1069,451,22,14,3842,1846,2248,1043,1594,803,803,,,,2532,1411,2444,1364,2,1,52,25,34,21,47,106,72
E02001059,Manchester 015,Middle Super Output Areas and Intermediate Zones,MSOAIZ,M,9772,4369,2574,1091,816,422,1758,669,109,56,4305,1989,1098,500,3207,1489,1489,,,,2559,1140,2407,1075,15,6,97,36,40,23,65,225,93
E02001061,Manchester 017,Middle Super Output Areas and Intermediate Zones,MSOAIZ,M,8907,3863,3215,1361,1187,619,2028,742,77,41,3385,1608,804,384,2581,1224,1224,,,,2105,789,2010,742,2,1,61,26,32,20,47,125,64
E02001062,Manchester 018,Middle Super Output Areas and Intermediate Zones,MSOAIZ,M,8178,3546,1489,520,480,205,1009,315,41,16,5006,2324,2985,1424,2021,900,900,,,,1444,597,1284,527,25,9,69,24,66,37,70,198,89
E02001063,Manchester 019,Middle Super Output Areas and Intermediate Zones,MSOAIZ,M,7682,3629,1388,705,309,173,1079,532,34,13,2784,1370,742,352,2042,1018,1018,,,,3371,1489,3209,1413,4,2,104,48,54,26,76,105,52
E02001064,Manchester 020,Middle Super Output Areas and Intermediate Zones,MSOAIZ,M,8994,3624,2937,1047,862,391,2075,656,14,6,4032,1807,1895,776,2137,1031,1031,,,,1805,673,1656,616,9,2,86,33,54,22,57,206,91
E02001065,Manchester 021,Middle Super Output Areas and Intermediate Zones,MSOAIZ,M,8658,3787,4385,1901,1542,829,2843,1072,62,28,1222,630,343,170,879,460,460,,,,2788,1151,2640,1083,4,2,118,52,26,14,68,201,77
E02001066,Manchester 022,Middle Super Output Areas and Intermediate Zones,MSOAIZ,M,9775,3533,2763,780,1101,374,1662,406,42,15,1833,885,425,184,1408,701,701,,,,4980,1793,4772,1717,13,3,111,34,84,39,76,157,60
E02001067,Manchester 023,Middle Super Output Areas and Intermediate Zones,MSOAIZ,M,9495,3791,2324,934,633,334,1691,600,102,47,4579,1867,1445,543,3134,1324,1324,,,,2313,870,2200,819,3,1,71,33,39,17,51,177,73
E02001068,Manchester 024,Middle Super Output Areas and Intermediate Zones,MSOAIZ,M,9667,3696,1532,629,565,269,967,360,29,17,5834,2180,1590,632,4244,1548,1548,,,,2008,772,1833,710,0,0,93,35,82,27,62,264,98
E02001069,Manchester 025,Middle Super Output Areas and Intermediate Zones,MSOAIZ,M,10654,4059,2252,933,908,443,1344,490,97,33,3098,1291,607,242,2491,1049,1049,,,,5021,1721,4821,1637,8,3,157,65,35,16,84,186,81
E02001070,Manchester 026,Middle Super Output Areas and Intermediate Zones,MSOAIZ,M,8802,3294,3047,989,1090,427,1957,562,38,24,1865,788,737,242,1128,546,546,,,,3702,1420,3487,1337,7,3,121,45,87,35,83,150,73
E02001071,Manchester 027,Middle Super Output Areas and Intermediate Zones,MSOAIZ,M,13199,4566,5881,1918,1906,755,3975,1163,93,29,2419,971,420,170,1999,801,801,,,,4488,1548,4221,1455,9,5,174,61,84,27,93,318,100
E02001072,Manchester 028,Middle Super Output Areas and Intermediate Zones,MSOAIZ,M,8426,3741,3548,1360,1249,516,2299,844,48,25,1343,728,157,56,1186,672,672,,,,3361,1585,3196,1523,14,4,122,46,29,12,62,126,43
E02001073,Manchester 029,Middle Super Output Areas and Intermediate Zones,MSOAIZ,M,9555,4015,5886,2218,2073,917,3813,1301,22,6,611,406,52,17,559,389,389,,,,2975,1361,2850,1309,15,4,90,37,20,11,52,61,24
E02001074,Manchester 030,Middle Super Output Areas and Intermediate Zones,MSOAIZ,M,11296,4299,4778,1625,1555,614,3223,1011,77,44,3689,1505,2050,737,1639,768,768,,,,2617,1059,2414,995,20,5,143,47,40,12,64,135,66
E02001075,Manchester 031,Middle Super Output Areas and Intermediate Zones,MSOAIZ,M,8199,3320,3960,1530,1128,547,2832,983,125,47,1060,466,174,59,886,407,407,,,,2956,1242,2795,1176,7,2,124,54,30,10,66,98,35
E02001076,Manchester 032,Middle Super Output Areas and Intermediate Zones,MSOAIZ,M,9186,2965,2099,756,896,380,1203,376,53,17,700,336,226,92,474,244,244,,,,6280,1827,6100,1758,3,1,115,36,62,32,69,54,29
E02001077,Manchester 033,Middle Super Output Areas and Intermediate Zones,MSOAIZ,M,7745,3117,4882,1827,1838,816,3044,1011,32,19,539,276,145,52,394,224,224,,,,2238,965,2162,939,5,3,57,19,14,4,26,54,30
E02001078,Manchester 034,Middle Super Output Areas and Intermediate Zones,MSOAIZ,M,10462,3835,6657,2375,2464,1056,4193,1319,88,43,1166,558,235,87,931,471,471,,,,2444,817,2257,745,5,1,128,54,54,17,72,107,42
E02001079,Manchester 035,Middle Super Output Areas and Intermediate Zones,MSOAIZ,M,8961,3341,2931,1137,1037,457,1894,680,84,31,3000,1271,1311,501,1689,770,770,,,,2819,844,2703,801,4,1,103,39,9,3,43,127,58
E02001080,Manchester 036,Middle Super Output Areas and Intermediate Zones,MSOAIZ,M,9509,3367,2301,988,1067,518,1234,470,50,26,892,458,298,124,594,334,334,,,,6174,1853,6052,1802,2,1,100,43,20,7,51,92,42
E02001081,Manchester 037,Middle Super Output Areas and Intermediate Zones,MSOAIZ,M,6213,2776,4005,1720,1280,660,2725,1060,38,25,920,452,256,107,664,345,345,,,,1214,554,1126,515,9,2,65,28,14,9,39,36,25
E02001082,Manchester 038,Middle Super Output Areas and Intermediate Zones,MSOAIZ,M,6706,2921,2642,1138,1002,484,1640,654,22,10,748,333,254,104,494,229,229,,,,3251,1415,3127,1361,4,2,109,48,11,4,54,43,25
E02001083,Manchester 039,Middle Super Output Areas and Intermediate Zones,MSOAIZ,M,7813,3902,2790,1356,620,333,2170,1023,39,19,1263,593,480,201,783,392,392,,,,3644,1898,3536,1850,3,1,75,34,30,13,48,77,36
E02001084,Manchester 040,Middle Super Output Areas and Intermediate Zones,MSOAIZ,M,8600,3325,3902,1591,1439,707,2463,884,20,12,1413,641,562,204,851,437,437,,,,3194,1047,3077,997,18,9,85,34,14,7,50,71,34
E02001085,Manchester 041,Middle Super Output Areas and Intermediate Zones,MSOAIZ,SK,8241,3177,3254,1180,917,410,2337,770,43,26,3982,1609,1930,731,2052,878,878,,,,806,296,707,256,5,2,76,29,18,9,40,156,66
E02001086,Manchester 042,Middle Super Output Areas and Intermediate Zones,MSOAIZ,M,6490,2949,3100,1409,913,517,2187,892,36,17,1907,858,846,331,1061,527,527,,,,1339,619,1274,588,0,0,62,28,3,3,31,108,46
E02001087,Manchester 043,Middle Super Output Areas and Intermediate Zones,MSOAIZ,M,9410,4402,5942,2585,2274,1175,3668,1410,11,7,652,417,138,69,514,348,348,,,,2707,1331,2553,1253,20,7,106,58,28,13,78,98,62
E02001088,Manchester 044,Middle Super Output Areas and Intermediate Zones,MSOAIZ,M,8822,3780,4164,1780,1056,580,3108,1200,33,20,3467,1499,1661,675,1806,824,824,,,,1021,420,917,374,7,3,63,31,34,12,46,137,61
E02001089,Manchester 045,Middle Super Output Areas and Intermediate Zones,MSOAIZ,M,7852,3123,5857,2296,2356,1112,3501,1184,66,35,292,142,76,26,216,116,116,,,,1523,600,1456,568,4,3,57,27,6,2,32,114,50
E02001090,Manchester 046,Middle Super Output Areas and Intermediate Zones,MSOAIZ,M,6650,3100,4522,1960,1645,861,2877,1099,53,25,1001,615,305,158,696,457,457,,,,1003,461,940,428,3,1,53,28,7,4,33,71,39
E02001091,Manchester 047,Middle Super Output Areas and Intermediate Zones,MSOAIZ,WA,8137,3876,4917,2164,1485,822,3432,1342,74,48,2116,1163,796,373,1320,790,790,,,,967,455,886,414,2,1,74,36,5,4,41,63,46
E02001092,Manchester 048,Middle Super Output Areas and Intermediate Zones,MSOAIZ,M,8485,3724,4154,1704,1008,561,3146,1143,47,28,3195,1514,1599,721,1596,793,793,,,,1008,423,909,381,3,1,91,38,5,3,42,81,55
E02001093,Manchester 049,Middle Super Output Areas and Intermediate Zones,MSOAIZ,M,9008,3778,3088,1330,606,337,2482,993,27,14,4404,1787,1495,595,2909,1192,1192,,,,1407,595,1338,562,3,1,48,22,18,10,33,82,52
E02001094,Manchester 050,Middle Super Output Areas and Intermediate Zones,MSOAIZ,M,9001,3805,1871,738,440,225,1431,513,32,11,5875,2591,2002,853,3873,1738,1738,,,,1070,391,993,359,0,0,50,19,27,13,32,153,74
E02001095,Manchester 051,Middle Super Output Areas and Intermediate Zones,MSOAIZ,M,8225,3580,3389,1369,897,467,2492,902,87,35,3568,1695,1634,709,1934,986,986,,,,1068,418,906,351,73,26,66,27,23,14,67,113,63
E02001096,Manchester 052,Middle Super Output Areas and Intermediate Zones,MSOAIZ,M,7394,3311,3889,1632,1250,654,2639,978,48,25,2649,1307,959,446,1690,861,861,,,,746,307,662,268,7,3,64,30,13,6,39,62,40
E02001097,Manchester 053,Middle Super Output Areas and Intermediate Zones,MSOAIZ,WA,7988,3452,3370,1396,945,481,2425,915,50,20,3274,1514,1282,570,1992,944,944,,,,1184,455,1085,407,0,0,81,39,18,9,48,110,67
E02001098,Oldham 001,Middle Super Output Areas and Intermediate Zones,MSOAIZ,OL,6063,2756,4818,2121,2265,1201,2553,920,31,17,724,392,479,230,245,162,162,,,,432,193,382,167,0,0,42,22,8,4,26,58,33
E02001099,Oldham 002,Middle Super Output Areas and Intermediate Zones,MSOAIZ,OL,6041,2724,4093,1749,1425,778,2668,971,50,22,933,514,315,159,618,355,355,,,,907,406,840,373,0,0,60,30,7,3,33,58,33
E02001100,Oldham 003,Middle Super Output Areas and Intermediate Zones,MSOAIZ,OL,5992,2586,4733,1963,1949,972,2784,991,11,5,601,348,376,219,225,129,129,,,,587,237,532,217,0,0,50,18,5,2,20,60,33
E02001101,Oldham 004,Middle Super Output Areas and Intermediate Zones,MSOAIZ,OL,5968,2457,5087,2090,2073,1063,3014,1027,9,6,425,183,285,115,140,68,68,,,,411,163,363,141,0,0,41,20,7,2,22,36,15
E02001102,Oldham 005,Middle Super Output Areas and Intermediate Zones,MSOAIZ,OL,6095,2475,5112,2040,1581,813,3531,1227,24,12,271,126,144,68,127,58,58,,,,652,277,552,235,4,3,87,35,9,4,42,36,20
E02001103,Oldham 006,Middle Super Output Areas and Intermediate Zones,MSOAIZ,OL,5541,2353,4593,1855,2051,1006,2542,849,27,20,448,240,178,97,270,143,143,,,,428,207,354,171,7,3,50,27,17,6,36,45,31
E02001104,Oldham 007,Middle Super Output Areas and Intermediate Zones,MSOAIZ,OL,6864,2726,4999,1940,1259,637,3740,1303,11,7,1265,535,899,366,366,169,169,,,,563,230,485,196,0,0,77,33,1,1,34,26,14
E02001105,Oldham 008,Middle Super Output Areas and Intermediate Zones,MSOAIZ,OL,5957,2631,4496,1835,1832,942,2664,893,53,32,980,567,535,309,445,258,258,,,,389,169,319,134,0,0,62,31,8,4,35,39,28
E02001106,Oldham 009,Middle Super Output Areas and Intermediate Zones,MSOAIZ,OL,5934,2668,4428,1844,1618,870,2810,974,20,9,779,494,192,122,587,372,372,,,,678,302,613,267,0,0,62,32,3,3,35,29,19
E02001107,Oldham 010,Middle Super Output Areas and Intermediate Zones,MSOAIZ,OL,6150,2390,4731,1760,1715,855,3016,905,26,13,669,342,438,218,231,124,124,,,,659,244,573,209,3,2,72,29,11,4,35,65,31
E02001108,Oldham 011,Middle Super Output Areas and Intermediate Zones,MSOAIZ,OL,4994,2148,2436,1027,730,399,1706,628,39,18,1703,738,1097,466,606,272,272,,,,788,350,704,316,4,1,78,31,2,2,34,28,15
E02001109,Oldham 012,Middle Super Output Areas and Intermediate Zones,MSOAIZ,OL,7252,3332,4375,1775,1254,652,3121,1123,23,15,1915,1108,1053,597,862,511,511,,,,848,389,754,350,2,1,65,27,27,11,39,91,45
E02001110,Oldham 013,Middle Super Output Areas and Intermediate Zones,MSOAIZ,OL,6177,2742,5300,2307,2345,1212,2955,1095,22,8,86,38,34,13,52,25,25,,,,721,361,653,322,3,2,56,32,9,5,39,48,28
E02001111,Oldham 014,Middle Super Output Areas and Intermediate Zones,MSOAIZ,OL,6638,2928,1909,671,587,278,1322,393,45,23,3880,1885,2434,1125,1446,760,760,,,,667,294,585,259,15,7,49,19,18,9,35,137,55
E02001112,Oldham 015,Middle Super Output Areas and Intermediate Zones,MSOAIZ,OL,5938,2371,5527,2192,2196,1075,3331,1117,0,0,57,21,10,4,47,17,17,,,,321,138,245,104,4,2,72,32,0,0,34,33,20
E02001113,Oldham 016,Middle Super Output Areas and Intermediate Zones,MSOAIZ,OL,9499,2664,5438,1320,1757,494,3681,826,32,8,2551,896,692,338,1859,558,558,,,,1317,389,1127,332,7,3,171,50,12,4,57,161,51
E02001114,Oldham 017,Middle Super Output Areas and Intermediate Zones,MSOAIZ,OL,8016,3381,5508,2121,1728,869,3780,1252,23,13,1469,858,992,551,477,307,307,,,,942,346,799,288,16,5,105,42,22,11,58,74,43
E02001115,Oldham 018,Middle Super Output Areas and Intermediate Zones,MSOAIZ,OL,5881,2539,4364,1821,1513,807,2851,1014,15,7,831,391,524,243,307,148,148,,,,634,297,560,258,1,1,66,34,7,4,39,37,23
E02001116,Oldham 019,Middle Super Output Areas and Intermediate Zones,MSOAIZ,OL,6405,2358,4422,1566,1724,703,2698,863,36,16,443,183,176,83,267,100,100,,,,1330,537,1178,479,3,1,130,50,19,7,58,174,56
E02001117,Oldham 020,Middle Super Output Areas and Intermediate Zones,MSOAIZ,OL,5906,2529,4818,1991,2122,1074,2696,917,16,10,406,215,217,111,189,104,104,,,,629,294,572,268,6,3,44,21,7,2,26,37,19
E02001118,Oldham 021,Middle Super Output Areas and Intermediate Zones,MSOAIZ,OL,6234,2602,5209,2099,2017,1027,3192,1072,8,4,374,191,231,111,143,80,80,,,,576,273,522,249,5,2,48,21,1,1,24,67,35
E02001119,Oldham 022,Middle Super Output Areas and Intermediate Zones,MSOAIZ,OL,10597,2840,6853,1675,3665,937,3188,738,46,12,1929,557,441,156,1488,401,401,,,,1479,505,1231,421,3,2,178,61,67,21,84,290,91
E02001121,Oldham 024,Middle Super Output Areas and Intermediate Zones,MSOAIZ,OL,6490,2224,3688,1084,1557,536,2131,548,15,4,1265,596,489,247,776,349,349,,,,1353,483,1200,438,3,1,129,36,21,8,45,169,57
E02001123,Oldham 026,Middle Super Output Areas and Intermediate Zones,MSOAIZ,OL,6423,2751,3256,1330,1067,551,2189,779,20,7,2425,1082,1554,691,871,391,391,,,,644,284,568,249,0,0,56,24,20,11,35,78,48
E02001124,Oldham 027,Middle Super Output Areas and Intermediate Zones,MSOAIZ,OL,5725,2507,2962,1193,1016,498,1946,695,18,9,1857,933,836,389,1021,544,544,,,,834,338,771,310,3,1,47,19,13,8,28,54,34
E02001125,Oldham 028,Middle Super Output Areas and Intermediate Zones,MSOAIZ,OL,7990,3351,6091,2533,2151,1123,3940,1410,25,8,827,368,393,194,434,174,174,,,,1003,417,901,374,11,3,83,34,8,6,43,44,25
E02001126,Oldham 029,Middle Super Output Areas and Intermediate Zones,MSOAIZ,OL,7419,3141,3345,1364,973,514,2372,850,6,4,2823,1203,526,247,2297,956,956,,,,1147,518,1042,466,4,2,81,39,20,11,52,98,52
E02001127,Oldham 030,Middle Super Output Areas and Intermediate Zones,MSOAIZ,OL,7080,2790,3060,1198,1096,558,1964,640,13,6,3283,1263,419,180,2864,1083,1083,,,,657,289,625,269,2,1,20,13,10,6,20,67,34
E02001128,Oldham 031,Middle Super Output Areas and Intermediate Zones,MSOAIZ,OL,7458,3271,5349,2272,1999,1047,3350,1225,12,7,883,451,376,174,507,277,277,,,,1151,506,1054,455,6,4,80,40,11,7,51,63,35
E02001129,Oldham 032,Middle Super Output Areas and Intermediate Zones,MSOAIZ,M,5704,2622,3067,1360,942,525,2125,835,15,6,1423,691,563,267,860,424,424,,,,1133,530,1052,488,3,2,68,33,10,7,42,66,35
E02001130,Oldham 033,Middle Super Output Areas and Intermediate Zones,MSOAIZ,OL,5739,2520,4480,1833,1593,840,2887,993,4,4,837,483,503,285,334,198,198,,,,357,162,299,137,9,2,38,19,11,4,25,61,38
E02001131,Oldham 034,Middle Super Output Areas and Intermediate Zones,MSOAIZ,M,5304,2298,4257,1822,1786,980,2471,842,8,3,551,265,266,127,285,138,138,,,,447,180,380,156,0,0,59,22,8,2,24,41,28
E02001132,Rochdale 001,Middle Super Output Areas and Intermediate Zones,MSOAIZ,OL,6406,2860,4636,2014,1714,924,2922,1090,5,3,661,302,540,240,121,62,62,,,,1052,509,967,465,12,5,70,36,3,3,44,52,32
E02001133,Rochdale 002,Middle Super Output Areas and Intermediate Zones,MSOAIZ,OL,6175,2544,5038,2042,1822,930,3216,1112,4,2,390,178,325,145,65,33,33,,,,694,299,618,261,5,2,71,36,0,0,38,49,23
E02001134,Rochdale 003,Middle Super Output Areas and Intermediate Zones,MSOAIZ,OL,6113,2583,5237,2132,1946,979,3291,1153,5,3,139,93,129,88,10,5,5,,,,678,325,618,298,13,4,42,20,5,3,27,54,30
E02001135,Rochdale 004,Middle Super Output Areas and Intermediate Zones,MSOAIZ,OL,7539,3052,3232,1130,952,416,2280,714,37,22,3484,1558,2882,1208,602,350,350,,,,693,291,621,262,5,1,60,25,7,3,29,93,51
E02001136,Rochdale 005,Middle Super Output Areas and Intermediate Zones,MSOAIZ,OL,8753,3667,6617,2654,2365,1199,4252,1455,23,9,1079,516,822,398,257,118,118,,,,939,439,856,400,0,0,76,36,7,3,39,95,49
E02001137,Rochdale 006,Middle Super Output Areas and Intermediate Zones,MSOAIZ,OL,6198,2497,5432,2167,1964,951,3468,1216,7,2,132,52,76,26,56,26,26,,,,573,251,505,219,3,3,62,27,3,2,32,54,25
E02001138,Rochdale 007,Middle Super Output Areas and Intermediate Zones,MSOAIZ,OL,8883,3647,7477,2948,2964,1451,4513,1497,15,10,506,307,465,285,41,22,22,,,,830,350,732,310,4,1,80,34,14,5,40,55,32
E02001139,Rochdale 008,Middle Super Output Areas and Intermediate Zones,MSOAIZ,OL,9244,2906,6030,1692,2306,734,3724,958,28,11,1578,581,661,316,917,265,265,,,,1424,565,1279,520,0,0,104,36,41,9,45,184,57
E02001140,Rochdale 009,Middle Super Output Areas and Intermediate Zones,MSOAIZ,OL,7451,2958,4420,1714,1653,779,2767,935,11,5,1852,741,1506,586,346,155,155,,,,1117,467,1011,425,9,2,93,38,4,2,42,51,31
E02001141,Rochdale 010,Middle Super Output Areas and Intermediate Zones,MSOAIZ,OL,12246,5181,5688,1803,2233,859,3455,944,47,22,4038,2342,3201,1887,837,455,455,,,,2025,852,1866,790,17,5,112,45,30,12,62,448,162
E02001142,Rochdale 011,Middle Super Output Areas and Intermediate Zones,MSOAIZ,OL,5844,2396,5085,2062,2389,1188,2696,874,14,5,185,66,133,45,52,21,21,,,,539,249,487,225,4,2,46,20,2,2,24,21,14
E02001143,Rochdale 012,Middle Super Output Areas and Intermediate Zones,MSOAIZ,OL,10580,3988,5989,2140,1906,871,4083,1269,23,8,2992,1176,1726,707,1266,469,469,,,,1448,607,1322,559,2,2,111,40,13,6,48,128,57
E02001144,Rochdale 013,Middle Super Output Areas and Intermediate Zones,MSOAIZ,OL,6103,2702,4156,1723,1409,743,2747,980,8,5,983,508,805,406,178,102,102,,,,923,440,875,413,6,2,41,24,1,1,27,33,26
E02001145,Rochdale 014,Middle Super Output Areas and Intermediate Zones,MSOAIZ,OL,7077,3024,5406,2209,1934,961,3472,1248,26,9,749,387,632,308,117,79,79,,,,797,363,722,330,2,1,65,28,8,4,33,99,56
E02001146,Rochdale 015,Middle Super Output Areas and Intermediate Zones,MSOAIZ,OL,9041,2896,5715,1602,2769,861,2946,741,24,7,1388,587,402,204,986,383,383,,,,1713,631,1555,581,22,4,99,32,37,14,50,201,69
E02001147,Rochdale 016,Middle Super Output Areas and Intermediate Zones,MSOAIZ,OL,9029,3878,4216,1650,1383,678,2833,972,28,9,3722,1719,3324,1569,398,150,150,,,,956,438,877,398,0,0,71,35,8,5,40,107,62
E02001148,Rochdale 017,Middle Super Output Areas and Intermediate Zones,MSOAIZ,OL,9806,4257,6873,2784,2533,1293,4340,1491,35,23,1268,703,859,455,409,248,248,,,,1491,685,1377,628,4,1,90,46,20,10,57,139,62
E02001149,Rochdale 018,Middle Super Output Areas and Intermediate Zones,MSOAIZ,OL,9674,4671,5002,2157,1726,951,3276,1206,68,33,2959,1693,2160,1210,799,483,483,,,,1537,715,1411,654,5,3,110,50,11,8,61,108,73
E02001150,Rochdale 019,Middle Super Output Areas and Intermediate Zones,MSOAIZ,OL,8418,3591,4948,2022,1700,846,3248,1176,6,4,2625,1201,707,356,1918,845,845,,,,763,325,670,284,3,1,74,31,16,9,41,76,39
E02001151,Rochdale 020,Middle Super Output Areas and Intermediate Zones,MSOAIZ,OL,9258,3867,7095,2879,2452,1231,4643,1648,62,32,776,372,483,236,293,136,136,,,,1262,547,1161,501,3,1,94,43,4,2,46,63,37
E02001152,Rochdale 021,Middle Super Output Areas and Intermediate Zones,MSOAIZ,M,9029,3984,5676,2350,1908,1006,3768,1344,80,43,2182,1052,1784,872,398,180,180,,,,998,476,904,425,9,5,72,38,13,8,51,93,63
E02001153,Rochdale 022,Middle Super Output Areas and Intermediate Zones,MSOAIZ,OL,9947,4452,4361,1811,1280,674,3081,1137,38,21,4462,2156,1283,598,3179,1558,1558,,,,975,399,918,369,2,2,44,23,11,5,30,111,65
E02001154,Rochdale 023,Middle Super Output Areas and Intermediate Zones,MSOAIZ,M,10163,4387,7301,2972,2008,1056,5293,1916,26,11,1498,757,1127,548,371,209,209,,,,1256,601,1095,528,3,2,151,68,7,3,73,82,46
E02001155,Rochdale 024,Middle Super Output Areas and Intermediate Zones,MSOAIZ,M,6859,3433,4546,2086,1570,873,2976,1213,38,21,1259,812,1041,654,218,158,158,,,,939,468,841,422,6,2,73,35,19,9,46,77,46
E02001156,Rochdale 025,Middle Super Output Areas and Intermediate Zones,MSOAIZ,M,9716,4131,8213,3406,3593,1880,4620,1526,33,20,788,388,691,324,97,64,64,,,,593,264,557,244,0,0,33,18,3,2,20,89,53
E02001157,Salford 001,Middle Super Output Areas and Intermediate Zones,MSOAIZ,M,7225,3183,2664,1108,804,423,1860,685,35,15,3656,1679,2600,1138,1056,541,541,,,,747,316,682,285,5,3,50,24,10,4,31,123,65
E02001158,Salford 002,Middle Super Output Areas and Intermediate Zones,MSOAIZ,M,5895,2700,3099,1342,1023,542,2076,800,11,3,1840,943,1326,664,514,279,279,,,,802,336,753,314,4,2,39,17,6,3,22,143,76
E02001159,Salford 003,Middle Super Output Areas and Intermediate Zones,MSOAIZ,M,5706,2579,3204,1389,990,541,2214,848,51,23,1508,748,939,451,569,297,297,,,,877,379,811,348,7,1,50,25,9,5,31,66,40
E02001160,Salford 004,Middle Super Output Areas and Intermediate Zones,MSOAIZ,M,6199,2555,2895,1218,998,514,1897,704,12,4,2650,1086,1989,768,661,318,318,,,,549,200,507,184,0,0,36,12,6,4,16,93,47
E02001161,Salford 005,Middle Super Output Areas and Intermediate Zones,MSOAIZ,M,5848,2680,3963,1718,1438,764,2525,954,7,4,878,475,532,253,346,222,222,,,,927,442,875,417,4,2,36,18,12,5,25,73,41
E02001162,Salford 006,Middle Super Output Areas and Intermediate Zones,MSOAIZ,M,5782,2709,3711,1651,1585,848,2126,803,4,3,1183,620,728,380,455,240,240,,,,825,400,758,372,10,3,53,22,4,3,28,59,35
E02001163,Salford 007,Middle Super Output Areas and Intermediate Zones,MSOAIZ,M,9273,4182,7025,3043,2654,1422,4371,1621,37,22,1068,565,672,321,396,244,244,,,,1067,503,960,451,11,5,84,37,12,10,52,76,49
E02001164,Salford 008,Middle Super Output Areas and Intermediate Zones,MSOAIZ,M,6257,2677,3387,1401,987,513,2400,888,26,11,1930,870,1383,603,547,267,267,,,,842,358,774,332,6,2,47,20,15,4,26,72,37
E02001165,Salford 009,Middle Super Output Areas and Intermediate Zones,MSOAIZ,M,6147,2664,4066,1752,1348,742,2718,1010,10,6,1268,557,1074,459,194,98,98,,,,742,317,673,283,0,0,63,33,6,1,34,61,32
E02001166,Salford 010,Middle Super Output Areas and Intermediate Zones,MSOAIZ,M,6799,2343,3720,1080,1351,564,2369,516,33,9,949,560,388,220,561,340,340,,,,1976,642,1775,592,1,1,175,39,25,10,50,121,52
E02001167,Salford 011,Middle Super Output Areas and Intermediate Zones,MSOAIZ,M,6158,2710,3246,1394,1229,655,2017,739,14,6,1407,593,1187,451,220,142,142,,,,1386,666,1300,630,13,4,65,29,8,3,36,105,51
E02001168,Salford 012,Middle Super Output Areas and Intermediate Zones,MSOAIZ,M,9291,4093,5746,2423,1846,1007,3900,1416,34,12,2177,1073,1399,655,778,418,418,,,,1230,526,1109,469,3,2,96,45,22,10,57,104,59
E02001169,Salford 013,Middle Super Output Areas and Intermediate Zones,MSOAIZ,M,10513,4252,9298,3711,3331,1651,5967,2060,9,7,233,112,136,66,97,46,46,,,,917,391,835,355,12,5,62,28,8,3,36,56,31
E02001170,Salford 014,Middle Super Output Areas and Intermediate Zones,MSOAIZ,M,9644,4130,8452,3523,3490,1796,4962,1727,15,7,208,143,71,43,137,100,100,,,,902,417,813,372,8,5,81,40,0,0,45,67,40
E02001171,Salford 015,Middle Super Output Areas and Intermediate Zones,MSOAIZ,M,5567,2336,4828,2003,1859,973,2969,1030,14,6,173,89,64,28,109,61,61,,,,530,229,492,210,2,1,35,17,1,1,19,22,9
E02001172,Salford 016,Middle Super Output Areas and Intermediate Zones,MSOAIZ,M,11658,4989,2678,997,984,446,1694,551,134,62,5408,2718,1980,1088,3428,1630,1630,,,,3116,1067,2912,1001,13,3,159,45,32,18,66,322,145
E02001173,Salford 017,Middle Super Output Areas and Intermediate Zones,MSOAIZ,M,6793,3153,1789,815,685,390,1104,425,47,17,3281,1535,2337,1057,944,478,478,,,,1515,707,1480,693,3,1,27,11,5,2,14,161,79
E02001174,Salford 018,Middle Super Output Areas and Intermediate Zones,MSOAIZ,M,5472,2362,4140,1748,1488,762,2652,986,14,9,265,176,29,14,236,162,162,,,,982,400,936,377,0,0,37,17,9,6,23,71,29
E02001175,Salford 019,Middle Super Output Areas and Intermediate Zones,MSOAIZ,M,6936,2914,3863,1634,1312,690,2551,944,11,5,2052,803,1447,521,605,282,282,,,,923,423,873,400,6,2,31,16,13,5,23,87,49
E02001176,Salford 020,Middle Super Output Areas and Intermediate Zones,MSOAIZ,M,10759,5147,6649,2712,2382,1220,4267,1492,45,24,2019,1327,1192,779,827,548,548,,,,1932,1000,1787,934,5,4,113,48,27,14,66,114,84
E02001177,Salford 021,Middle Super Output Areas and Intermediate Zones,MSOAIZ,M,11521,5293,5893,2537,2230,1185,3663,1352,30,13,2843,1455,1863,904,980,551,551,,,,2598,1199,2478,1141,1,1,112,50,7,7,58,157,89
E02001178,Salford 022,Middle Super Output Areas and Intermediate Zones,MSOAIZ,M,9892,5633,1653,922,488,284,1165,638,70,46,3453,2022,2477,1432,976,590,590,,,,4584,2557,4345,2432,26,12,92,53,121,60,125,132,86
E02001179,Salford 023,Middle Super Output Areas and Intermediate Zones,MSOAIZ,M,5795,2874,2911,1408,1139,625,1772,783,126,71,1066,613,297,179,769,434,434,,,,1607,738,1511,696,4,1,80,35,12,6,42,85,44
E02001180,Salford 024,Middle Super Output Areas and Intermediate Zones,MSOAIZ,M,5218,2981,472,217,164,98,308,119,21,9,4012,2367,2954,1787,1058,580,580,,,,583,306,562,296,4,1,6,2,11,7,10,130,82
E02001181,Salford 025,Middle Super Output Areas and Intermediate Zones,MSOAIZ,M,5647,2606,2572,1117,832,460,1740,657,16,8,2408,1180,1507,741,901,439,439,,,,559,250,502,222,2,1,55,27,0,0,28,92,51
E02001182,Salford 026,Middle Super Output Areas and Intermediate Zones,MSOAIZ,M,5909,2858,2563,1085,754,391,1809,694,67,29,2248,1296,1209,733,1039,563,563,,,,938,395,854,356,5,2,52,25,27,12,39,93,53
E02001183,Salford 027,Middle Super Output Areas and Intermediate Zones,MSOAIZ,M,6001,2782,3387,1542,1071,601,2316,941,85,40,1203,581,562,294,641,287,287,,,,1230,573,1158,536,3,3,50,26,19,8,37,96,46
E02001184,Salford 028,Middle Super Output Areas and Intermediate Zones,MSOAIZ,M,10404,5710,2255,1242,537,330,1718,912,34,21,3303,1656,2616,1281,687,375,375,,,,4680,2711,4573,2649,7,5,87,48,13,9,62,132,80
E02001185,Salford 029,Middle Super Output Areas and Intermediate Zones,MSOAIZ,M,10074,4208,6778,2811,2227,1193,4551,1618,13,6,2304,977,1336,520,968,457,457,,,,913,377,832,339,7,3,66,28,8,7,38,66,37
E02001186,Salford 030,Middle Super Output Areas and Intermediate Zones,MSOAIZ,WA,9963,4253,6358,2583,1871,973,4487,1610,33,10,2173,1000,1423,631,750,369,369,,,,1293,595,1162,538,13,6,79,35,39,16,57,106,65
E02001187,Stockport 001,Middle Super Output Areas and Intermediate Zones,MSOAIZ,SK,7188,3076,5549,2328,1847,973,3702,1355,10,5,729,358,418,166,311,192,192,,,,860,367,807,342,0,0,49,24,4,1,25,40,18
E02001188,Stockport 002,Middle Super Output Areas and Intermediate Zones,MSOAIZ,SK,7915,3503,4523,1937,1276,695,3247,1242,118,70,1766,785,1255,523,511,262,262,,,,1427,658,1338,616,0,0,80,39,9,3,42,81,53
E02001189,Stockport 003,Middle Super Output Areas and Intermediate Zones,MSOAIZ,SK,8382,3616,6649,2736,2345,1220,4304,1516,37,25,680,366,443,206,237,160,160,,,,966,458,871,415,6,2,86,39,3,2,43,50,31
E02001190,Stockport 004,Middle Super Output Areas and Intermediate Zones,MSOAIZ,SK,6607,3053,2117,859,663,351,1454,508,110,48,3899,1918,3681,1784,218,134,134,,,,363,149,325,127,1,1,29,16,8,5,22,118,79
E02001191,Stockport 005,Middle Super Output Areas and Intermediate Zones,MSOAIZ,SK,5812,2618,4567,1880,1882,960,2685,920,42,28,740,500,535,352,205,148,148,,,,419,180,372,155,1,1,42,22,4,2,25,44,30
E02001192,Stockport 006,Middle Super Output Areas and Intermediate Zones,MSOAIZ,SK,6304,2831,4873,1925,1817,906,3056,1019,3,3,283,201,112,74,171,127,127,,,,1103,677,1044,646,9,6,45,23,5,2,31,42,25
E02001193,Stockport 007,Middle Super Output Areas and Intermediate Zones,MSOAIZ,SK,6067,2952,3943,1822,1356,755,2587,1067,7,4,995,556,672,368,323,188,188,,,,1065,538,983,495,4,2,71,38,7,3,43,57,32
E02001194,Stockport 008,Middle Super Output Areas and Intermediate Zones,MSOAIZ,SK,5754,2493,4829,1924,2050,1002,2779,922,8,5,108,84,12,6,96,78,78,,,,778,460,757,446,4,2,16,11,1,1,14,31,20
E02001195,Stockport 009,Middle Super Output Areas and Intermediate Zones,MSOAIZ,SK,7361,3208,5919,2544,2075,1100,3844,1444,84,48,307,120,201,72,106,48,48,,,,1021,473,908,417,12,7,81,39,20,10,56,30,23
E02001196,Stockport 010,Middle Super Output Areas and Intermediate Zones,MSOAIZ,SK,7535,3339,5979,2572,2565,1384,3414,1188,32,15,875,458,627,316,248,142,142,,,,560,247,511,224,7,2,32,17,10,4,23,89,47
E02001197,Stockport 011,Middle Super Output Areas and Intermediate Zones,MSOAIZ,SK,6219,2610,4922,1972,1882,926,3040,1046,19,14,669,363,496,240,173,123,123,,,,572,241,531,226,0,0,37,13,4,2,15,37,20
E02001198,Stockport 012,Middle Super Output Areas and Intermediate Zones,MSOAIZ,SK,7458,3341,4885,2111,1927,1058,2958,1053,99,51,1895,904,709,326,1186,578,578,,,,525,239,480,215,0,0,40,20,5,4,24,54,36
E02001199,Stockport 013,Middle Super Output Areas and Intermediate Zones,MSOAIZ,SK,7777,3413,6502,2736,2524,1297,3978,1439,27,19,72,58,8,3,64,55,55,,,,1103,566,1012,528,2,2,75,31,14,5,38,73,34
E02001200,Stockport 014,Middle Super Output Areas and Intermediate Zones,MSOAIZ,SK,6263,3446,2270,992,757,391,1513,601,96,63,2686,1776,1822,1242,864,534,534,,,,1131,556,1050,512,13,5,45,24,23,15,44,80,59
E02001201,Stockport 015,Middle Super Output Areas and Intermediate Zones,MSOAIZ,SK,5749,2431,4624,1932,1458,781,3166,1151,35,22,245,104,115,41,130,63,63,,,,807,350,727,311,0,0,76,36,4,3,39,38,23
E02001202,Stockport 016,Middle Super Output Areas and Intermediate Zones,MSOAIZ,SK,6064,2998,3531,1651,951,541,2580,1110,55,38,1039,641,631,405,408,236,236,,,,1386,641,1311,599,6,5,59,30,10,7,42,53,27
E02001203,Stockport 017,Middle Super Output Areas and Intermediate Zones,MSOAIZ,SK,5777,2387,5286,2145,2515,1233,2771,912,4,2,84,42,74,37,10,5,5,,,,355,179,316,158,0,0,29,16,10,5,21,48,19
E02001204,Stockport 018,Middle Super Output Areas and Intermediate Zones,MSOAIZ,SK,8875,3803,6657,2822,2121,1100,4536,1722,98,42,963,427,779,297,184,130,130,,,,1122,496,1033,454,4,3,79,35,6,4,42,35,16
E02001205,Stockport 019,Middle Super Output Areas and Intermediate Zones,MSOAIZ,SK,7753,3645,5242,2222,1718,892,3524,1330,75,38,1245,788,442,297,803,491,491,,,,1149,568,1070,528,3,1,60,33,16,6,40,42,29
E02001206,Stockport 020,Middle Super Output Areas and Intermediate Zones,MSOAIZ,SK,6792,2940,5429,2274,2429,1274,3000,1000,11,8,685,363,402,215,283,148,148,,,,638,275,557,237,3,1,64,30,14,7,38,29,20
E02001207,Stockport 021,Middle Super Output Areas and Intermediate Zones,MSOAIZ,SK,6989,2942,6016,2447,2211,1122,3805,1325,7,3,418,256,138,72,280,184,184,,,,506,213,443,186,2,1,56,22,5,4,27,42,23
E02001208,Stockport 022,Middle Super Output Areas and Intermediate Zones,MSOAIZ,SK,7222,3261,5290,2268,1613,875,3677,1393,14,9,798,493,428,280,370,213,213,,,,1058,455,979,415,10,4,64,32,5,4,40,62,36
E02001209,Stockport 023,Middle Super Output Areas and Intermediate Zones,MSOAIZ,SK,7593,3382,5188,2242,1575,839,3613,1403,77,54,700,373,468,259,232,114,114,,,,1568,685,1466,633,4,2,91,47,7,3,52,60,28
E02001210,Stockport 024,Middle Super Output Areas and Intermediate Zones,MSOAIZ,SK,6832,2889,4182,1692,1447,768,2735,924,54,30,2104,965,1478,632,626,333,333,,,,420,167,363,145,0,0,51,20,6,2,22,72,35
E02001211,Stockport 025,Middle Super Output Areas and Intermediate Zones,MSOAIZ,SK,5941,2413,5225,2083,1948,1007,3277,1076,27,16,151,86,24,16,127,70,70,,,,496,203,443,187,14,2,35,12,4,2,16,42,25
E02001212,Stockport 026,Middle Super Output Areas and Intermediate Zones,MSOAIZ,SK,6440,2563,2769,1111,661,342,2108,769,76,33,2986,1183,2312,866,674,317,317,,,,552,204,514,193,0,0,38,11,0,0,11,57,32
E02001213,Stockport 027,Middle Super Output Areas and Intermediate Zones,MSOAIZ,SK,8969,3991,7074,2988,2467,1341,4607,1647,130,91,415,296,78,40,337,256,256,,,,1301,588,1189,538,12,3,86,38,14,9,50,49,28
E02001214,Stockport 028,Middle Super Output Areas and Intermediate Zones,MSOAIZ,SK,7423,3081,5887,2318,2543,1311,3344,1007,42,22,814,459,721,391,93,68,68,,,,585,235,506,199,4,2,70,32,5,2,36,95,47
E02001215,Stockport 029,Middle Super Output Areas and Intermediate Zones,MSOAIZ,SK,5731,2502,4746,2026,2167,1135,2579,891,21,16,512,255,354,176,158,79,79,,,,425,186,363,159,10,4,37,17,15,6,27,27,19
E02001216,Stockport 030,Middle Super Output Areas and Intermediate Zones,MSOAIZ,SK,7276,2986,6456,2607,2658,1353,3798,1254,28,18,214,99,177,80,37,19,19,,,,539,239,475,206,10,4,52,28,2,1,33,39,23
E02001217,Stockport 031,Middle Super Output Areas and Intermediate Zones,MSOAIZ,SK,6567,3066,4682,2148,1749,997,2933,1151,66,42,618,335,529,267,89,68,68,,,,1114,500,1025,460,5,2,71,33,13,5,40,87,41
E02001218,Stockport 032,Middle Super Output Areas and Intermediate Zones,MSOAIZ,SK,5833,2375,5093,2033,2104,1058,2989,975,18,8,335,166,68,28,267,138,138,,,,358,153,335,143,0,0,23,10,0,0,10,29,15
E02001219,Stockport 033,Middle Super Output Areas and Intermediate Zones,MSOAIZ,SK,5452,2240,5118,2097,2108,1111,3010,986,10,4,19,7,7,3,12,4,4,,,,281,118,250,100,2,2,29,16,0,0,18,24,14
E02001220,Stockport 034,Middle Super Output Areas and Intermediate Zones,MSOAIZ,SK,5525,2270,4665,1824,1826,897,2839,927,28,14,458,269,293,170,165,99,99,,,,328,139,286,118,1,1,38,19,3,1,21,46,24
E02001221,Stockport 035,Middle Super Output Areas and Intermediate Zones,MSOAIZ,SK,5936,2361,5508,2171,2329,1169,3179,1002,18,14,111,55,56,20,55,35,35,,,,285,115,268,106,0,0,17,9,0,0,9,14,6
E02001222,Stockport 036,Middle Super Output Areas and Intermediate Zones,MSOAIZ,SK,6146,2375,5539,2163,2363,1198,3176,965,14,6,60,16,48,14,12,2,2,,,,478,164,420,145,12,4,46,15,0,0,19,55,26
E02001223,Stockport 037,Middle Super Output Areas and Intermediate Zones,MSOAIZ,SK,6795,2797,6046,2464,2462,1274,3584,1190,31,22,56,33,20,7,36,26,26,,,,619,251,578,228,5,3,34,18,2,2,23,43,27
E02001224,Stockport 038,Middle Super Output Areas and Intermediate Zones,MSOAIZ,SK,5775,2577,5325,2362,2607,1407,2718,955,9,5,80,48,61,35,19,13,13,,,,315,136,282,122,5,2,21,9,7,3,14,46,26
E02001225,Stockport 039,Middle Super Output Areas and Intermediate Zones,MSOAIZ,SK,7075,2947,6179,2490,2474,1265,3705,1225,7,4,233,123,206,107,27,16,16,,,,614,304,551,277,6,2,50,23,7,2,27,42,26
E02001226,Stockport 040,Middle Super Output Areas and Intermediate Zones,MSOAIZ,SK,6744,2722,5598,2247,2148,1098,3450,1149,37,20,405,196,184,95,221,101,101,,,,657,235,559,198,2,1,96,36,0,0,37,47,24
E02001227,Stockport 041,Middle Super Output Areas and Intermediate Zones,MSOAIZ,SK,5680,2376,5338,2208,2435,1273,2903,935,4,4,52,37,10,3,42,34,34,,,,247,108,238,101,0,0,9,7,0,0,7,39,19
E02001228,Stockport 042,Middle Super Output Areas and Intermediate Zones,MSOAIZ,SK,5319,2160,4885,1943,2184,1082,2701,861,8,4,94,58,77,46,17,12,12,,,,301,136,278,121,1,1,17,11,5,3,15,31,19
E02001229,Tameside 001,Middle Super Output Areas and Intermediate Zones,MSOAIZ,SK,9647,4417,7302,3211,2487,1312,4815,1899,17,11,722,393,133,76,589,317,317,,,,1531,757,1390,689,12,4,117,55,12,9,68,75,45
E02001230,Tameside 002,Middle Super Output Areas and Intermediate Zones,MSOAIZ,OL,6147,2392,5098,1943,2153,1016,2945,927,9,4,515,241,148,68,367,173,173,,,,475,174,415,153,8,2,48,17,4,2,21,50,30
E02001231,Tameside 003,Middle Super Output Areas and Intermediate Zones,MSOAIZ,SK,7150,2846,4966,1897,1448,733,3518,1164,15,6,1612,706,477,204,1135,502,502,,,,520,211,450,179,4,2,56,26,10,4,32,37,26
E02001232,Tameside 004,Middle Super Output Areas and Intermediate Zones,MSOAIZ,OL,8120,3504,4794,2026,1687,892,3107,1134,17,7,1870,857,554,252,1316,605,605,,,,1374,574,1283,535,4,1,74,29,13,9,39,65,40
E02001233,Tameside 005,Middle Super Output Areas and Intermediate Zones,MSOAIZ,OL,7455,3258,4990,2024,1859,920,3131,1104,40,25,1699,885,529,273,1170,612,612,,,,654,278,581,243,2,1,59,28,12,6,35,72,46
E02001234,Tameside 006,Middle Super Output Areas and Intermediate Zones,MSOAIZ,OL,7511,3256,3991,1652,1322,686,2669,966,18,8,2376,1083,821,334,1555,749,749,,,,1078,482,1006,442,4,2,51,27,17,11,40,48,31
E02001235,Tameside 007,Middle Super Output Areas and Intermediate Zones,MSOAIZ,SK,6440,2814,4555,1896,1720,859,2835,1037,13,10,529,275,158,74,371,201,201,,,,1293,604,1170,548,14,3,95,46,14,7,56,50,29
E02001236,Tameside 008,Middle Super Output Areas and Intermediate Zones,MSOAIZ,SK,5635,2509,2779,1164,902,473,1877,691,13,9,2082,971,626,290,1456,681,681,,,,703,325,642,291,5,1,39,24,17,9,34,58,40
E02001237,Tameside 009,Middle Super Output Areas and Intermediate Zones,MSOAIZ,SK,6740,2932,3951,1640,1073,558,2878,1082,17,8,1681,750,570,244,1111,506,506,,,,1034,499,931,456,4,2,82,32,17,9,43,57,35
E02001238,Tameside 010,Middle Super Output Areas and Intermediate Zones,MSOAIZ,OL,7740,3422,5680,2322,1961,1014,3719,1308,33,18,1073,639,200,113,873,526,526,,,,889,402,794,355,7,2,64,34,24,11,47,65,41
E02001239,Tameside 011,Middle Super Output Areas and Intermediate Zones,MSOAIZ,M,9033,3897,5996,2476,2007,1049,3989,1427,9,5,1252,653,310,161,942,492,492,,,,1684,714,1550,658,3,1,118,48,13,7,56,92,49
E02001240,Tameside 012,Middle Super Output Areas and Intermediate Zones,MSOAIZ,M,6184,2597,4958,2066,1785,931,3173,1135,11,5,178,95,20,7,158,88,88,,,,1004,408,911,367,2,2,90,38,1,1,41,33,23
E02001241,Tameside 013,Middle Super Output Areas and Intermediate Zones,MSOAIZ,SK,9441,4252,3526,1293,1298,571,2228,722,27,10,3474,1873,290,173,3184,1700,1700,,,,2286,1010,2132,934,10,5,101,44,43,27,76,128,66
E02001242,Tameside 014,Middle Super Output Areas and Intermediate Zones,MSOAIZ,M,5657,2360,4842,1988,1936,984,2906,1004,20,8,144,77,19,5,125,72,72,,,,607,265,535,227,8,4,61,31,3,3,38,44,22
E02001243,Tameside 015,Middle Super Output Areas and Intermediate Zones,MSOAIZ,SK,7854,3529,6079,2514,2471,1208,3608,1306,37,21,782,502,194,125,588,377,377,,,,898,455,830,421,8,4,57,28,3,2,34,58,37
E02001244,Tameside 016,Middle Super Output Areas and Intermediate Zones,MSOAIZ,SK,5495,2275,4813,1997,1884,972,2929,1025,8,3,188,75,76,31,112,44,44,,,,446,177,389,148,7,3,42,21,8,5,29,40,23
E02001245,Tameside 017,Middle Super Output Areas and Intermediate Zones,MSOAIZ,SK,7779,3573,4876,2029,1452,742,3424,1287,7,4,1763,970,433,240,1330,730,730,,,,1079,532,991,484,7,5,69,37,12,6,48,54,38
E02001246,Tameside 018,Middle Super Output Areas and Intermediate Zones,MSOAIZ,SK,7189,3118,4278,1719,1393,736,2885,983,11,6,2281,1128,715,332,1566,796,796,,,,560,229,499,202,0,0,40,17,21,10,27,59,36
E02001247,Tameside 019,Middle Super Output Areas and Intermediate Zones,MSOAIZ,SK,6868,3064,4442,1837,1452,742,2990,1095,18,12,1590,835,353,170,1237,665,665,,,,766,344,655,294,10,4,92,42,9,4,50,52,36
E02001248,Tameside 020,Middle Super Output Areas and Intermediate Zones,MSOAIZ,SK,10252,4547,5698,2402,1492,808,4206,1594,16,8,3098,1473,953,431,2145,1042,1042,,,,1352,615,1216,558,4,3,119,47,13,7,57,88,49
E02001249,Tameside 021,Middle Super Output Areas and Intermediate Zones,MSOAIZ,M,6269,2811,4314,1880,1550,843,2764,1037,12,9,769,349,206,82,563,267,267,,,,1137,547,1042,504,8,2,75,35,12,6,43,37,26
E02001250,Tameside 022,Middle Super Output Areas and Intermediate Zones,MSOAIZ,SK,6470,2679,5540,2207,1853,898,3687,1309,35,20,342,184,90,44,252,140,140,,,,516,244,463,217,3,1,45,23,5,3,27,37,24
E02001251,Tameside 023,Middle Super Output Areas and Intermediate Zones,MSOAIZ,SK,5995,2750,4592,2021,1899,1003,2693,1018,32,25,606,305,133,67,473,238,238,,,,736,381,659,340,2,2,50,29,25,10,41,29,18
E02001252,Tameside 024,Middle Super Output Areas and Intermediate Zones,MSOAIZ,SK,7488,3293,6635,2857,2660,1489,3975,1368,4,2,182,121,16,7,166,114,114,,,,620,279,539,239,0,0,77,37,4,3,40,47,34
E02001253,Tameside 025,Middle Super Output Areas and Intermediate Zones,MSOAIZ,M,5161,2267,3866,1678,1382,751,2484,927,3,3,584,249,216,84,368,165,165,,,,669,309,593,279,1,1,69,27,6,2,30,39,28
E02001254,Tameside 026,Middle Super Output Areas and Intermediate Zones,MSOAIZ,M,5796,2484,3996,1674,1498,767,2498,907,8,7,1208,561,317,154,891,407,407,,,,532,211,448,178,5,1,71,29,8,3,33,52,31
E02001255,Tameside 027,Middle Super Output Areas and Intermediate Zones,MSOAIZ,SK,6071,2672,2436,979,779,386,1657,593,16,7,3229,1517,978,452,2251,1065,1065,,,,338,128,314,117,0,0,18,8,6,3,11,52,41
E02001256,Tameside 028,Middle Super Output Areas and Intermediate Zones,MSOAIZ,SK,9939,4015,5898,2218,1699,833,4199,1385,45,30,2123,986,373,170,1750,816,816,,,,1784,742,1631,682,0,0,136,50,17,10,60,89,39
E02001257,Tameside 029,Middle Super Output Areas and Intermediate Zones,MSOAIZ,M,9053,4272,5299,2359,2125,1173,3174,1186,30,11,2841,1482,468,251,2373,1231,1231,,,,779,352,709,316,9,3,37,20,24,13,36,104,68
E02001258,Tameside 030,Middle Super Output Areas and Intermediate Zones,MSOAIZ,SK,7157,3148,6033,2589,2518,1339,3515,1250,17,7,390,203,94,39,296,164,164,,,,679,325,616,289,2,2,53,31,8,3,36,38,24
E02001259,Trafford 001,Middle Super Output Areas and Intermediate Zones,MSOAIZ,M,10145,4162,3887,1415,1801,687,2086,728,52,22,3949,1810,1037,524,2912,1286,1286,,,,2067,846,1960,805,5,3,86,30,16,8,41,190,69
E02001260,Trafford 002,Middle Super Output Areas and Intermediate Zones,MSOAIZ,M,7598,3031,6408,2505,2285,1135,4123,1370,29,13,582,284,289,128,293,156,156,,,,519,199,457,171,1,1,60,26,1,1,28,60,30
E02001261,Trafford 003,Middle Super Output Areas and Intermediate Zones,MSOAIZ,M,8267,3451,5042,2092,1539,770,3503,1322,24,10,1465,642,566,229,899,413,413,,,,1675,678,1561,624,4,1,101,47,9,6,54,61,29
E02001262,Trafford 004,Middle Super Output Areas and Intermediate Zones,MSOAIZ,M,8433,3009,5763,1905,2286,919,3477,986,31,9,1433,668,646,229,787,439,439,,,,1097,368,1021,341,0,0,45,17,31,10,27,109,59
E02001263,Trafford 005,Middle Super Output Areas and Intermediate Zones,MSOAIZ,M,8000,3293,7056,2854,2784,1453,4272,1401,21,18,253,141,145,80,108,61,61,,,,619,250,561,226,0,0,57,23,1,1,24,51,30
E02001264,Trafford 006,Middle Super Output Areas and Intermediate Zones,MSOAIZ,M,8149,3230,6119,2386,2122,1051,3997,1335,37,17,1018,443,424,150,594,293,293,,,,914,350,806,309,1,1,97,36,10,4,41,61,34
E02001265,Trafford 007,Middle Super Output Areas and Intermediate Zones,MSOAIZ,M,8108,3369,6374,2528,2103,1075,4271,1453,25,17,1125,585,548,256,577,329,329,,,,535,209,499,193,0,0,31,14,5,2,16,49,30
E02001266,Trafford 008,Middle Super Output Areas and Intermediate Zones,MSOAIZ,M,6629,3033,4096,1709,1399,738,2697,971,52,36,1849,1012,662,325,1187,687,687,,,,570,235,512,214,0,0,56,20,2,1,21,62,41
E02001267,Trafford 009,Middle Super Output Areas and Intermediate Zones,MSOAIZ,M,7252,3363,5040,2098,1725,884,3315,1214,75,34,1079,683,314,172,765,511,511,,,,986,508,936,482,3,1,38,20,9,5,26,72,40
E02001268,Trafford 010,Middle Super Output Areas and Intermediate Zones,MSOAIZ,M,7060,2972,6105,2503,2365,1254,3740,1249,54,35,375,213,131,70,244,143,143,,,,474,194,434,178,6,3,30,11,4,2,16,52,27
E02001269,Trafford 011,Middle Super Output Areas and Intermediate Zones,MSOAIZ,M,8240,3628,5284,2142,1908,982,3376,1160,24,12,1449,809,526,250,923,559,559,,,,1434,636,1339,593,11,3,71,33,13,7,43,49,29
E02001270,Trafford 012,Middle Super Output Areas and Intermediate Zones,MSOAIZ,M,7849,3418,5991,2481,2056,1052,3935,1429,32,19,439,270,119,61,320,209,209,,,,1314,610,1236,578,0,0,72,30,6,2,32,73,38
E02001271,Trafford 013,Middle Super Output Areas and Intermediate Zones,MSOAIZ,M,6547,2874,4572,1915,1594,835,2978,1080,13,5,1322,673,337,146,985,527,527,,,,586,245,534,216,10,4,40,23,2,2,29,54,36
E02001272,Trafford 014,Middle Super Output Areas and Intermediate Zones,MSOAIZ,M,7821,3396,6484,2712,2619,1349,3865,1363,7,2,322,189,87,41,235,148,148,,,,967,473,909,439,0,0,53,31,5,3,34,41,20
E02001273,Trafford 015,Middle Super Output Areas and Intermediate Zones,MSOAIZ,M,8798,4242,5674,2540,2139,1161,3535,1379,61,39,437,316,91,59,346,257,257,,,,2578,1313,2478,1263,5,3,76,37,19,10,50,48,34
E02001274,Trafford 016,Middle Super Output Areas and Intermediate Zones,MSOAIZ,M,7782,3188,6958,2767,3054,1539,3904,1228,19,7,211,154,61,40,150,114,114,,,,536,228,492,208,2,1,38,17,4,2,20,58,32
E02001275,Trafford 017,Middle Super Output Areas and Intermediate Zones,MSOAIZ,WA,8360,3544,4078,1705,1302,709,2776,996,18,9,3440,1477,386,186,3054,1291,1291,,,,739,310,664,272,4,1,53,29,18,8,38,85,43
E02001276,Trafford 018,Middle Super Output Areas and Intermediate Zones,MSOAIZ,M,7931,3299,5311,2138,1774,932,3537,1206,18,10,1927,873,1078,445,849,428,428,,,,614,237,559,212,5,2,43,20,7,3,25,61,41
E02001277,Trafford 019,Middle Super Output Areas and Intermediate Zones,MSOAIZ,WA,8822,3786,4525,1852,1116,580,3409,1272,159,80,3343,1501,475,180,2868,1321,1321,,,,730,315,656,285,2,1,57,25,15,4,30,65,38
E02001278,Trafford 020,Middle Super Output Areas and Intermediate Zones,MSOAIZ,WA,8101,3271,6891,2648,2455,1210,4436,1438,57,40,283,194,35,21,248,173,173,,,,838,370,755,340,7,2,68,23,8,5,30,32,19
E02001279,Trafford 021,Middle Super Output Areas and Intermediate Zones,MSOAIZ,WA,8397,3229,7720,2918,2869,1375,4851,1543,8,5,166,106,46,24,120,82,82,,,,482,190,433,174,0,0,47,15,2,1,16,21,10
E02001280,Trafford 022,Middle Super Output Areas and Intermediate Zones,MSOAIZ,WA,8237,3558,5137,2088,1729,906,3408,1182,93,44,2364,1127,771,325,1593,802,802,,,,568,249,529,231,4,2,27,12,8,4,18,75,50
E02001281,Trafford 023,Middle Super Output Areas and Intermediate Zones,MSOAIZ,WA,7737,3078,6940,2737,2815,1412,4125,1325,20,15,168,84,44,22,124,62,62,,,,571,222,530,205,8,3,33,14,0,0,17,38,20
E02001282,Trafford 024,Middle Super Output Areas and Intermediate Zones,MSOAIZ,WA,8968,3883,6281,2668,2118,1100,4163,1568,32,15,561,308,189,96,372,212,212,,,,2049,869,1978,837,6,3,53,24,12,5,32,45,23
E02001283,Trafford 025,Middle Super Output Areas and Intermediate Zones,MSOAIZ,WA,8456,3748,6064,2541,2568,1323,3496,1218,64,33,810,383,291,130,519,253,253,,,,1400,721,1309,673,20,10,47,23,24,15,48,118,70
E02001284,Trafford 026,Middle Super Output Areas and Intermediate Zones,MSOAIZ,WA,8082,3131,6830,2563,2393,1124,4437,1439,12,5,165,88,55,25,110,63,63,,,,1034,452,996,426,0,0,33,23,5,3,26,41,23
E02001285,Trafford 027,Middle Super Output Areas and Intermediate Zones,MSOAIZ,WA,7679,3251,5929,2423,2645,1293,3284,1130,31,19,532,268,177,87,355,181,181,,,,1109,503,1040,474,16,5,40,18,13,6,29,78,38
E02001286,Trafford 028,Middle Super Output Areas and Intermediate Zones,MSOAIZ,WA,7829,3047,6805,2607,3082,1474,3723,1133,0,0,327,184,128,72,199,112,112,,,,644,221,602,204,5,2,37,15,0,0,17,53,35
E02001287,Wigan 001,Middle Super Output Areas and Intermediate Zones,MSOAIZ,WN,5671,2321,4800,1930,1817,910,2983,1020,6,4,320,152,263,106,57,46,46,,,,485,201,437,180,0,0,42,19,6,2,21,60,34
E02001288,Wigan 002,Middle Super Output Areas and Intermediate Zones,MSOAIZ,WN,7477,3173,6086,2485,2442,1235,3644,1250,0,0,732,371,685,339,47,32,32,,,,597,275,554,257,3,2,28,12,12,4,18,62,42
E02001289,Wigan 003,Middle Super Output Areas and Intermediate Zones,MSOAIZ,WN,10082,4248,8699,3610,3721,1903,4978,1707,13,7,596,272,494,218,102,54,54,,,,682,307,615,275,0,0,67,32,0,0,32,92,52
E02001290,Wigan 004,Middle Super Output Areas and Intermediate Zones,MSOAIZ,WN,6040,2615,4589,1886,1898,947,2691,939,11,3,897,451,857,419,40,32,32,,,,469,231,424,208,2,1,33,17,10,5,23,74,44
E02001291,Wigan 005,Middle Super Output Areas and Intermediate Zones,MSOAIZ,WN,7666,3199,4770,1968,1832,950,2938,1018,11,4,2116,874,2028,827,88,47,47,,,,694,306,620,271,11,6,47,23,16,6,35,75,47
E02001292,Wigan 006,Middle Super Output Areas and Intermediate Zones,MSOAIZ,WN,7795,3528,6227,2677,2882,1490,3345,1187,5,5,380,211,314,158,66,53,53,,,,1118,597,1037,556,23,10,44,25,14,6,41,65,38
E02001293,Wigan 007,Middle Super Output Areas and Intermediate Zones,MSOAIZ,WN,6137,2583,4853,2006,1903,961,2950,1045,18,12,769,353,475,258,294,95,95,,,,470,194,404,169,2,1,53,19,11,5,25,27,18
E02001294,Wigan 008,Middle Super Output Areas and Intermediate Zones,MSOAIZ,WN,7767,3492,5721,2432,2164,1117,3557,1315,7,3,472,322,182,98,290,224,224,,,,1511,705,1408,661,10,4,91,39,2,1,44,56,30
E02001295,Wigan 009,Middle Super Output Areas and Intermediate Zones,MSOAIZ,WN,7279,3641,3031,1264,1118,579,1913,685,23,13,3095,1818,2553,1532,542,286,286,,,,962,450,897,417,1,1,56,27,8,5,33,168,96
E02001296,Wigan 010,Middle Super Output Areas and Intermediate Zones,MSOAIZ,WN,8878,3745,2415,941,647,328,1768,613,24,10,5474,2398,5295,2314,179,84,84,,,,768,282,720,264,1,1,35,14,12,3,18,197,114
E02001297,Wigan 011,Middle Super Output Areas and Intermediate Zones,MSOAIZ,WN,6637,2958,4397,1834,1617,824,2780,1010,5,4,1503,775,1329,646,174,129,129,,,,656,297,581,260,2,1,62,29,11,7,37,76,48
E02001298,Wigan 012,Middle Super Output Areas and Intermediate Zones,MSOAIZ,WN,8054,3372,3743,1543,1251,659,2492,884,14,6,3045,1264,2707,1094,338,170,170,,,,1125,489,1027,445,0,0,83,37,15,7,44,127,70
E02001299,Wigan 013,Middle Super Output Areas and Intermediate Zones,MSOAIZ,WN,8722,3708,6577,2700,2202,1132,4375,1568,8,3,885,450,807,403,78,47,47,,,,1162,513,1054,467,0,0,100,42,8,4,46,90,42
E02001300,Wigan 014,Middle Super Output Areas and Intermediate Zones,MSOAIZ,WN,7794,3413,5318,2285,2121,1114,3197,1171,17,8,1326,587,1112,466,214,121,121,,,,1047,481,961,445,5,2,66,29,15,5,36,86,52
E02001301,Wigan 015,Middle Super Output Areas and Intermediate Zones,MSOAIZ,WN,7972,3823,4301,1857,1370,720,2931,1137,22,11,2018,1133,1501,810,517,323,323,,,,1540,764,1457,723,8,2,65,33,10,6,41,91,58
E02001302,Wigan 016,Middle Super Output Areas and Intermediate Zones,MSOAIZ,WN,7804,3251,5079,2014,1760,866,3319,1148,14,5,2076,962,1909,852,167,110,110,,,,549,211,528,199,0,0,19,10,2,2,12,86,59
E02001303,Wigan 017,Middle Super Output Areas and Intermediate Zones,MSOAIZ,M,8475,3740,4026,1662,1391,709,2635,953,6,4,3616,1734,3479,1669,137,65,65,,,,701,264,655,242,3,1,35,17,8,4,22,126,76
E02001304,Wigan 018,Middle Super Output Areas and Intermediate Zones,MSOAIZ,WN,12240,5320,10288,4341,4257,2244,6031,2097,6,5,947,509,892,482,55,27,27,,,,907,407,820,364,4,2,77,37,6,4,43,92,58
E02001305,Wigan 019,Middle Super Output Areas and Intermediate Zones,MSOAIZ,WN,8160,3376,7078,2915,2772,1398,4306,1517,17,7,366,168,346,160,20,8,8,,,,641,261,559,226,4,2,70,29,8,4,35,58,25
E02001306,Wigan 020,Middle Super Output Areas and Intermediate Zones,MSOAIZ,WN,7302,2989,6149,2505,2564,1262,3585,1243,16,7,643,274,553,229,90,45,45,,,,466,186,404,155,2,2,60,29,0,0,31,28,17
E02001307,Wigan 021,Middle Super Output Areas and Intermediate Zones,MSOAIZ,WN,11264,4334,10673,4097,3450,1683,7223,2414,12,6,50,18,37,13,13,5,5,,,,498,197,429,168,4,2,65,27,0,0,29,31,16
E02001308,Wigan 022,Middle Super Output Areas and Intermediate Zones,MSOAIZ,M,5913,2672,4461,1934,1832,949,2629,985,34,16,695,376,573,331,122,45,45,,,,637,302,586,280,3,1,47,20,1,1,22,86,44
E02001309,Wigan 023,Middle Super Output Areas and Intermediate Zones,MSOAIZ,WN,7647,3565,5682,2510,2109,1149,3573,1361,35,16,658,361,561,288,97,73,73,,,,1197,636,1101,588,3,1,87,44,6,3,48,75,42
E02001310,Wigan 024,Middle Super Output Areas and Intermediate Zones,MSOAIZ,WN,8915,3766,5300,2137,1711,836,3589,1301,8,3,1980,893,1529,658,451,235,235,,,,1537,680,1457,642,2,1,68,31,10,6,38,90,53
E02001311,Wigan 025,Middle Super Output Areas and Intermediate Zones,MSOAIZ,M,8307,3706,5813,2488,2014,1060,3799,1428,23,12,1391,660,1209,570,182,90,90,,,,1011,503,934,465,2,1,65,33,10,4,38,69,43
E02001312,Wigan 026,Middle Super Output Areas and Intermediate Zones,MSOAIZ,WN,7571,3202,5188,2168,1807,913,3381,1255,14,6,1124,481,990,409,134,72,72,,,,1177,505,1080,464,0,0,96,40,1,1,41,68,42
E02001313,Wigan 027,Middle Super Output Areas and Intermediate Zones,MSOAIZ,WN,7816,3409,4344,1819,1401,749,2943,1070,9,7,2633,1198,2475,1088,158,110,110,,,,712,315,651,284,5,2,52,26,4,3,31,118,70
E02001314,Wigan 028,Middle Super Output Areas and Intermediate Zones,MSOAIZ,M,8026,3157,6461,2467,1929,905,4532,1562,30,16,973,409,916,380,57,29,29,,,,525,244,472,217,0,0,50,25,3,2,27,37,21
E02001315,Wigan 029,Middle Super Output Areas and Intermediate Zones,MSOAIZ,WN,7689,3326,6181,2628,2318,1202,3863,1426,6,2,782,367,756,354,26,13,13,,,,629,282,550,238,0,0,71,42,8,2,44,91,47
E02001316,Wigan 030,Middle Super Output Areas and Intermediate Zones,MSOAIZ,WN,6525,3095,3953,1820,1352,773,2601,1047,12,9,622,276,336,148,286,128,128,,,,1863,949,1759,899,6,2,95,46,3,2,50,75,41
E02001317,Wigan 031,Middle Super Output Areas and Intermediate Zones,MSOAIZ,WN,8229,3602,5453,2226,1884,956,3569,1270,48,26,1928,941,1797,862,131,79,79,,,,731,366,690,343,1,1,39,21,1,1,23,69,43
E02001318,Wigan 032,Middle Super Output Areas and Intermediate Zones,MSOAIZ,WN,7869,3397,5560,2259,2301,1166,3259,1093,11,4,1660,831,1601,806,59,25,25,,,,556,251,520,234,0,0,35,16,1,1,17,82,52
E02001319,Wigan 033,Middle Super Output Areas and Intermediate Zones,MSOAIZ,WN,7323,3159,4417,1871,1573,815,2844,1056,2,1,1561,701,1107,434,454,267,267,,,,1311,566,1235,530,3,2,62,29,11,5,36,32,20
E02001320,Wigan 034,Middle Super Output Areas and Intermediate Zones,MSOAIZ,WN,7663,3475,5170,2253,2092,1091,3078,1162,35,21,1382,665,1237,585,145,80,80,,,,1024,501,941,459,9,3,66,34,8,5,42,52,35
E02001321,Wigan 035,Middle Super Output Areas and Intermediate Zones,MSOAIZ,WN,8350,3375,6767,2677,2230,1133,4537,1544,18,8,709,317,654,298,55,19,19,,,,794,340,725,313,0,0,65,25,4,2,27,62,33
E02001322,Wigan 036,Middle Super Output Areas and Intermediate Zones,MSOAIZ,WN,7344,3159,5992,2526,2480,1273,3512,1253,6,4,484,225,447,210,37,15,15,,,,797,364,723,331,0,0,73,32,1,1,33,65,40
E02001323,Wigan 037,Middle Super Output Areas and Intermediate Zones,MSOAIZ,WN,7535,3356,5405,2286,1978,1062,3427,1224,32,18,1309,672,1102,520,207,152,152,,,,713,337,645,301,1,1,59,32,8,3,36,76,43
E02001324,Wigan 038,Middle Super Output Areas and Intermediate Zones,MSOAIZ,WA,8436,3607,5457,2275,1883,972,3574,1303,30,15,1650,723,1424,616,226,107,107,,,,1212,546,1129,511,6,3,77,32,0,0,35,87,48
E02001325,Wigan 039,Middle Super Output Areas and Intermediate Zones,MSOAIZ,WA,7718,3241,6610,2717,2436,1239,4174,1478,20,12,477,242,404,210,73,32,32,,,,571,251,502,223,7,2,55,24,7,2,28,40,19
E02001326,Wigan 040,Middle Super Output Areas and Intermediate Zones,MSOAIZ,WN,7702,3288,6165,2546,2306,1172,3859,1374,11,8,752,369,648,292,104,77,77,,,,700,319,605,276,2,1,92,41,1,1,43,74,46
E02001327,Knowsley 001,Middle Super Output Areas and Intermediate Zones,MSOAIZ,L,7445,2883,3301,1270,798,392,2503,878,26,11,3329,1293,1936,742,1393,551,551,,,,714,271,657,249,1,1,46,14,10,7,22,75,38
E02001328,Knowsley 002,Middle Super Output Areas and Intermediate Zones,MSOAIZ,L,10145,4090,8453,3300,2245,1085,6208,2215,66,37,657,325,331,151,326,174,174,,,,916,402,840,364,0,0,66,33,10,5,38,53,26
E02001329,Knowsley 003,Middle Super Output Areas and Intermediate Zones,MSOAIZ,L,7553,3422,3716,1492,1121,592,2595,900,15,6,2832,1458,1227,688,1605,770,770,,,,885,404,850,386,0,0,23,11,12,7,18,105,62
E02001330,Knowsley 004,Middle Super Output Areas and Intermediate Zones,MSOAIZ,L,8633,3651,5431,2219,1652,852,3779,1367,19,8,1799,831,870,416,929,415,415,,,,1321,557,1252,524,4,1,59,27,6,5,33,63,36
E02001331,Knowsley 005,Middle Super Output Areas and Intermediate Zones,MSOAIZ,WA,10060,4260,5789,2402,2151,1125,3638,1277,20,13,2988,1290,1396,591,1592,699,699,,,,1121,474,1031,437,9,4,64,27,17,6,37,142,81
E02001332,Knowsley 006,Middle Super Output Areas and Intermediate Zones,MSOAIZ,L,6600,3060,2993,1188,955,456,2038,732,72,29,3002,1586,329,172,2673,1414,1414,,,,475,214,441,200,0,0,26,11,8,3,14,58,43
E02001333,Knowsley 007,Middle Super Output Areas and Intermediate Zones,MSOAIZ,L,8113,3754,4349,1863,1489,809,2860,1054,32,21,2608,1314,1314,652,1294,662,662,,,,1009,487,926,443,8,3,54,31,21,10,44,115,69
E02001334,Knowsley 008,Middle Super Output Areas and Intermediate Zones,MSOAIZ,L,5780,2468,1939,792,616,326,1323,466,10,3,3436,1488,1954,827,1482,661,661,,,,306,130,288,122,0,0,15,7,3,1,8,89,55
E02001335,Knowsley 009,Middle Super Output Areas and Intermediate Zones,MSOAIZ,L,7599,3088,6089,2394,1971,1026,4118,1368,13,6,636,314,309,151,327,163,163,,,,825,350,758,321,1,1,66,28,0,0,29,36,24
E02001336,Knowsley 010,Middle Super Output Areas and Intermediate Zones,MSOAIZ,L,6744,2963,2672,1099,859,458,1813,641,3,2,3332,1530,1827,805,1505,725,725,,,,634,271,596,254,0,0,36,15,2,2,17,103,61
E02001337,Knowsley 011,Middle Super Output Areas and Intermediate Zones,MSOAIZ,L,5933,2403,3978,1564,1302,668,2676,896,42,17,1284,571,561,241,723,330,330,,,,586,226,542,205,1,1,37,17,6,3,21,43,25
E02001338,Knowsley 012,Middle Super Output Areas and Intermediate Zones,MSOAIZ,L,5890,2466,3721,1493,1160,618,2561,875,7,2,1228,556,537,229,691,327,327,,,,879,382,819,360,7,1,53,21,0,0,22,55,33
E02001339,Knowsley 013,Middle Super Output Areas and Intermediate Zones,MSOAIZ,L,6739,2771,4004,1604,1224,656,2780,948,57,19,2065,876,1212,498,853,378,378,,,,531,230,479,210,0,0,44,17,8,3,20,82,42
E02001340,Knowsley 014,Middle Super Output Areas and Intermediate Zones,MSOAIZ,L,8959,3641,7970,3209,3046,1586,4924,1623,7,4,206,111,83,41,123,70,70,,,,748,301,695,278,0,0,46,21,7,2,23,28,16
E02001341,Knowsley 015,Middle Super Output Areas and Intermediate Zones,MSOAIZ,L,6810,3033,4102,1715,1416,767,2686,948,29,21,1914,913,965,456,949,457,457,,,,682,327,615,293,0,0,60,29,7,5,34,83,57
E02001342,Knowsley 016,Middle Super Output Areas and Intermediate Zones,MSOAIZ,L,6989,2874,6397,2604,2532,1329,3865,1275,29,21,111,40,16,6,95,34,34,,,,393,184,341,162,6,2,46,20,0,0,22,59,25
E02001343,Knowsley 017,Middle Super Output Areas and Intermediate Zones,MSOAIZ,WA,7114,2878,6373,2558,2322,1189,4051,1369,11,5,158,70,46,24,112,46,46,,,,516,216,453,189,8,3,49,21,6,3,27,56,29
E02001344,Knowsley 018,Middle Super Output Areas and Intermediate Zones,MSOAIZ,L,5183,2231,3697,1419,1077,532,2620,887,21,10,1088,628,411,246,677,382,382,,,,332,138,296,123,0,0,25,9,11,6,15,45,36
E02001345,Knowsley 019,Middle Super Output Areas and Intermediate Zones,MSOAIZ,L,5637,2302,5016,2023,1774,903,3242,1120,113,52,109,64,29,17,80,47,47,,,,376,151,326,132,0,0,47,18,3,1,19,23,12
E02001346,Knowsley 020,Middle Super Output Areas and Intermediate Zones,MSOAIZ,L,7064,3085,4095,1688,1273,663,2822,1025,42,27,2276,1075,1163,526,1113,549,549,,,,612,265,552,236,0,0,59,28,1,1,29,39,30
E02001347,Liverpool 001,Middle Super Output Areas and Intermediate Zones,MSOAIZ,L,7628,3204,4835,1875,1392,690,3443,1185,21,10,1835,920,504,252,1331,668,668,,,,877,355,764,297,58,29,30,16,25,13,58,60,44
E02001348,Liverpool 002,Middle Super Output Areas and Intermediate Zones,MSOAIZ,L,7222,3148,5200,2156,1808,914,3392,1242,5,3,352,182,43,21,309,161,161,,,,1602,769,1516,725,4,1,79,41,3,2,44,63,38
E02001349,Liverpool 003,Middle Super Output Areas and Intermediate Zones,MSOAIZ,L,7943,3422,5915,2382,1928,955,3987,1427,16,5,396,226,81,44,315,182,182,,,,1550,774,1470,734,0,0,68,33,12,7,40,66,35
E02001350,Liverpool 004,Middle Super Output Areas and Intermediate Zones,MSOAIZ,L,7714,3417,3836,1499,989,491,2847,1008,55,29,2647,1344,731,325,1916,1019,1019,,,,1075,475,1004,446,5,1,52,20,14,8,29,101,70
E02001351,Liverpool 005,Middle Super Output Areas and Intermediate Zones,MSOAIZ,L,8141,3515,3781,1494,1211,583,2570,911,6,3,3329,1511,816,365,2513,1146,1146,,,,962,464,901,431,0,0,39,20,22,13,33,63,43
E02001352,Liverpool 006,Middle Super Output Areas and Intermediate Zones,MSOAIZ,L,6620,3046,3093,1259,981,508,2112,751,2,2,1834,924,328,162,1506,762,762,,,,1619,815,1538,778,7,2,59,27,15,8,37,72,46
E02001353,Liverpool 007,Middle Super Output Areas and Intermediate Zones,MSOAIZ,L,7526,2959,6195,2368,1354,672,4841,1696,108,46,424,195,103,43,321,152,152,,,,770,332,701,301,15,5,37,18,17,8,31,29,18
E02001354,Liverpool 008,Middle Super Output Areas and Intermediate Zones,MSOAIZ,L,7611,3312,3867,1616,1353,699,2514,917,22,9,2907,1276,830,376,2077,900,900,,,,724,357,686,337,0,0,22,12,16,8,20,91,54
E02001355,Liverpool 009,Middle Super Output Areas and Intermediate Zones,MSOAIZ,L,6660,3108,3769,1583,1420,711,2349,872,31,16,1389,726,185,85,1204,641,641,,,,1412,744,1344,699,0,0,48,31,20,14,45,59,39
E02001356,Liverpool 010,Middle Super Output Areas and Intermediate Zones,MSOAIZ,L,5584,2364,1790,749,602,318,1188,431,10,4,3137,1338,756,331,2381,1007,1007,,,,613,250,564,230,0,0,15,7,34,13,20,34,23
E02001357,Liverpool 011,Middle Super Output Areas and Intermediate Zones,MSOAIZ,L,6955,2858,2936,1191,1163,594,1773,597,6,4,3418,1409,980,400,2438,1009,1009,,,,518,209,481,191,0,0,21,12,16,6,18,77,45
E02001358,Liverpool 012,Middle Super Output Areas and Intermediate Zones,MSOAIZ,L,7041,3450,3435,1546,1314,685,2121,861,16,7,1341,672,111,59,1230,613,613,,,,2182,1186,2093,1144,2,2,73,33,14,7,42,67,39
E02001359,Liverpool 013,Middle Super Output Areas and Intermediate Zones,MSOAIZ,L,5740,2328,4412,1690,1511,710,2901,980,12,6,754,368,153,73,601,295,295,,,,498,231,460,215,3,1,33,14,2,1,16,64,33
E02001360,Liverpool 014,Middle Super Output Areas and Intermediate Zones,MSOAIZ,L,8289,4130,2824,1276,1193,631,1631,645,52,26,3784,1977,864,466,2920,1511,1511,,,,1538,799,1447,755,16,5,57,30,18,9,44,91,52
E02001361,Liverpool 015,Middle Super Output Areas and Intermediate Zones,MSOAIZ,L,7618,3388,4158,1744,1518,784,2640,960,29,15,2279,1045,329,161,1950,884,884,,,,1073,531,997,486,0,0,55,36,21,9,45,79,53
E02001362,Liverpool 016,Middle Super Output Areas and Intermediate Zones,MSOAIZ,L,7401,3161,5118,2071,1873,986,3245,1085,29,13,1540,781,507,234,1033,547,547,,,,636,248,585,223,1,1,30,18,20,6,25,78,48
E02001363,Liverpool 017,Middle Super Output Areas and Intermediate Zones,MSOAIZ,L,7788,3481,3417,1404,1029,542,2388,862,25,10,3153,1504,797,359,2356,1145,1145,,,,1112,514,1041,482,4,1,59,25,8,6,32,81,49
E02001364,Liverpool 018,Middle Super Output Areas and Intermediate Zones,MSOAIZ,L,5203,2532,1766,772,773,399,993,373,29,12,2066,1066,152,80,1914,986,986,,,,1264,641,1230,621,0,0,30,17,4,3,20,78,41
E02001365,Liverpool 019,Middle Super Output Areas and Intermediate Zones,MSOAIZ,L,8950,4059,4333,1870,1653,863,2680,1007,24,10,1103,505,95,40,1008,465,465,,,,3366,1612,3254,1558,3,2,83,38,26,14,54,124,62
E02001366,Liverpool 020,Middle Super Output Areas and Intermediate Zones,MSOAIZ,L,8912,4081,5213,2162,1815,921,3398,1241,65,33,1227,680,219,111,1008,569,569,,,,2327,1163,2206,1091,9,7,97,54,15,11,72,80,43
E02001367,Liverpool 021,Middle Super Output Areas and Intermediate Zones,MSOAIZ,L,9296,3939,7592,3008,2888,1483,4704,1525,2,2,551,343,77,48,474,295,295,,,,1058,530,948,477,12,4,89,46,9,3,53,93,56
E02001368,Liverpool 022,Middle Super Output Areas and Intermediate Zones,MSOAIZ,L,5771,2918,1401,634,488,256,913,378,90,48,3539,1810,782,402,2757,1408,1408,,,,649,367,598,338,3,2,25,15,23,12,29,92,59
E02001369,Liverpool 023,Middle Super Output Areas and Intermediate Zones,MSOAIZ,L,7637,3877,2173,1003,932,468,1241,535,48,27,3887,2000,679,363,3208,1637,1637,,,,1446,786,1357,740,4,1,58,32,27,13,46,83,61
E02001370,Liverpool 024,Middle Super Output Areas and Intermediate Zones,MSOAIZ,L,6155,3153,1362,609,580,306,782,303,40,15,3590,1882,510,250,3080,1632,1632,,,,1063,587,1011,548,2,2,31,23,19,14,39,100,60
E02001371,Liverpool 025,Middle Super Output Areas and Intermediate Zones,MSOAIZ,L,7347,3076,3704,1500,922,494,2782,1006,5,4,2776,1195,764,347,2012,848,848,,,,809,343,754,319,3,1,41,19,11,4,24,53,34
E02001372,Liverpool 026,Middle Super Output Areas and Intermediate Zones,MSOAIZ,L,6014,2728,3898,1550,1291,648,2607,902,44,22,1344,794,286,159,1058,635,635,,,,685,332,632,302,4,4,36,22,13,4,30,43,30
E02001373,Liverpool 027,Middle Super Output Areas and Intermediate Zones,MSOAIZ,L,9210,4089,5494,2252,2010,1012,3484,1240,13,6,1572,795,237,104,1335,691,691,,,,2017,971,1866,896,12,5,115,58,24,12,75,114,65
E02001374,Liverpool 028,Middle Super Output Areas and Intermediate Zones,MSOAIZ,L,8051,4105,2898,1205,1151,552,1747,653,39,19,1989,1177,166,106,1823,1071,1071,,,,2992,1636,2867,1569,6,1,84,42,35,24,67,133,68
E02001375,Liverpool 029,Middle Super Output Areas and Intermediate Zones,MSOAIZ,L,7100,3202,4472,1930,1637,880,2835,1050,13,5,1263,641,251,120,1012,521,521,,,,1269,573,1198,537,2,2,50,27,19,7,36,83,53
E02001376,Liverpool 030,Middle Super Output Areas and Intermediate Zones,MSOAIZ,L,8445,3789,2581,1165,1164,634,1417,531,39,16,2278,1034,257,132,2021,902,902,,,,3366,1493,3234,1429,0,0,98,48,34,16,64,181,81
E02001377,Liverpool 031,Middle Super Output Areas and Intermediate Zones,MSOAIZ,L,8525,4063,1596,772,806,446,790,326,53,22,2930,1551,381,179,2549,1372,1372,,,,3837,1658,3659,1563,16,8,80,39,82,48,95,109,60
E02001378,Liverpool 032,Middle Super Output Areas and Intermediate Zones,MSOAIZ,L,7733,3557,4601,1862,1542,774,3059,1088,42,20,1669,936,334,176,1335,760,760,,,,1334,682,1241,635,1,1,77,42,15,4,47,87,57
E02001380,Liverpool 034,Middle Super Output Areas and Intermediate Zones,MSOAIZ,L,7519,3117,6427,2556,2425,1213,4002,1343,17,10,340,172,107,45,233,127,127,,,,695,356,651,333,0,0,36,18,8,5,23,40,23
E02001381,Liverpool 035,Middle Super Output Areas and Intermediate Zones,MSOAIZ,L,9280,4312,3553,1675,1415,768,2138,907,26,12,1886,971,162,77,1724,894,894,,,,3723,1604,3561,1531,5,2,131,58,26,13,73,92,50
E02001382,Liverpool 036,Middle Super Output Areas and Intermediate Zones,MSOAIZ,L,7093,2782,6321,2437,2212,1064,4109,1373,4,2,167,75,44,14,123,61,61,,,,557,246,495,217,13,5,44,22,5,2,29,44,22
E02001383,Liverpool 037,Middle Super Output Areas and Intermediate Zones,MSOAIZ,L,7125,4260,661,329,260,145,401,184,103,57,3949,2425,377,198,3572,2227,2227,,,,2330,1400,2066,1225,19,13,58,27,187,135,175,82,49
E02001384,Liverpool 038,Middle Super Output Areas and Intermediate Zones,MSOAIZ,L,10739,3941,2833,1295,1229,637,1604,658,105,39,1211,618,114,46,1097,572,572,,,,6491,1953,6200,1856,18,5,233,77,40,15,97,99,36
E02001385,Liverpool 039,Middle Super Output Areas and Intermediate Zones,MSOAIZ,L,8106,3631,1261,489,666,282,595,207,77,30,4607,2147,800,323,3807,1824,1824,,,,1938,893,1764,831,24,9,70,26,80,27,62,223,72
E02001386,Liverpool 040,Middle Super Output Areas and Intermediate Zones,MSOAIZ,L,7518,3572,3316,1437,1256,664,2060,773,131,72,3491,1771,536,265,2955,1506,1506,,,,466,213,421,185,0,0,34,23,11,5,28,114,79
E02001387,Liverpool 041,Middle Super Output Areas and Intermediate Zones,MSOAIZ,L,7955,3162,6717,2645,2535,1264,4182,1381,7,3,126,59,17,9,109,50,50,,,,1045,421,987,396,2,1,50,22,6,2,25,60,34
E02001388,Liverpool 042,Middle Super Output Areas and Intermediate Zones,MSOAIZ,L,8802,4170,3962,1784,1479,776,2483,1008,36,11,607,410,70,52,537,358,358,,,,4141,1934,3433,1327,5,4,167,72,536,531,607,56,31
E02001389,Liverpool 043,Middle Super Output Areas and Intermediate Zones,MSOAIZ,L,5919,3740,1158,567,518,264,640,303,53,31,1942,1358,138,92,1804,1266,1266,,,,2701,1740,2600,1685,12,9,68,30,21,16,55,65,44
E02001390,Liverpool 044,Middle Super Output Areas and Intermediate Zones,MSOAIZ,L,8689,4094,1970,839,822,409,1148,430,132,65,5117,2462,756,371,4361,2091,2091,,,,1318,637,1190,569,0,0,77,31,51,37,68,152,91
E02001391,Liverpool 045,Middle Super Output Areas and Intermediate Zones,MSOAIZ,L,5887,2481,2877,1193,1035,528,1842,665,49,32,2388,1021,420,179,1968,842,842,,,,535,210,484,188,4,2,24,11,23,9,22,38,25
E02001392,Liverpool 046,Middle Super Output Areas and Intermediate Zones,MSOAIZ,L,5699,2556,4915,2156,2428,1259,2487,897,20,13,178,86,19,8,159,78,78,,,,533,273,473,240,12,5,45,27,3,1,33,53,28
E02001393,Liverpool 047,Middle Super Output Areas and Intermediate Zones,MSOAIZ,L,7203,2845,6598,2574,2915,1401,3683,1173,4,3,117,53,32,9,85,44,44,,,,448,194,403,173,2,1,37,16,6,4,21,36,21
E02001394,Liverpool 048,Middle Super Output Areas and Intermediate Zones,MSOAIZ,L,8158,4290,3820,1787,1465,795,2355,992,26,12,1506,1091,63,43,1443,1048,1048,,,,2743,1359,2569,1269,30,15,116,60,28,15,90,63,41
E02001395,Liverpool 049,Middle Super Output Areas and Intermediate Zones,MSOAIZ,L,6056,2612,4963,2103,1894,991,3069,1112,14,10,155,101,28,16,127,85,85,,,,896,382,803,339,9,6,70,34,14,3,43,28,16
E02001396,Liverpool 050,Middle Super Output Areas and Intermediate Zones,MSOAIZ,L,7973,3918,3700,1744,1454,770,2246,974,14,5,1785,878,330,159,1455,719,719,,,,2405,1250,2303,1192,2,1,81,47,19,10,58,69,41
E02001397,Liverpool 051,Middle Super Output Areas and Intermediate Zones,MSOAIZ,L,7606,3848,4944,2234,2098,1159,2846,1075,12,7,1461,954,208,109,1253,845,845,,,,1112,594,1052,562,4,2,45,26,11,4,32,77,59
E02001398,Liverpool 052,Middle Super Output Areas and Intermediate Zones,MSOAIZ,L,7286,3595,4085,1834,1570,831,2515,1003,34,14,1117,752,46,36,1071,716,716,,,,1989,962,1896,910,0,0,84,47,9,5,52,61,33
E02001399,Liverpool 053,Middle Super Output Areas and Intermediate Zones,MSOAIZ,L,7188,2866,6268,2450,2557,1265,3711,1185,5,2,391,215,21,10,370,205,205,,,,484,180,456,167,6,2,20,10,2,1,13,40,19
E02001400,Liverpool 054,Middle Super Output Areas and Intermediate Zones,MSOAIZ,L,6525,2839,4408,1779,1550,813,2858,966,11,4,1444,752,373,197,1071,555,555,,,,567,255,503,226,4,1,48,23,12,5,29,95,49
E02001401,Liverpool 055,Middle Super Output Areas and Intermediate Zones,MSOAIZ,L,7813,3395,6145,2548,2647,1368,3498,1180,27,15,534,318,95,45,439,273,273,,,,1060,483,990,454,16,4,39,22,15,3,29,47,31
E02001402,Liverpool 056,Middle Super Output Areas and Intermediate Zones,MSOAIZ,L,8241,3762,6438,2707,2534,1300,3904,1407,16,11,463,318,68,40,395,278,278,,,,1268,694,1177,633,3,1,76,50,12,10,61,56,32
E02001403,Liverpool 057,Middle Super Output Areas and Intermediate Zones,MSOAIZ,L,6010,2841,2873,1262,957,495,1916,767,44,31,1698,802,237,108,1461,694,694,,,,1346,719,1277,682,0,0,55,29,14,8,37,49,27
E02001404,Liverpool 058,Middle Super Output Areas and Intermediate Zones,MSOAIZ,L,7229,3155,3237,1375,1002,562,2235,813,5,4,2963,1288,567,263,2396,1025,1025,,,,980,457,923,425,3,3,42,23,12,6,32,44,31
E02001405,Liverpool 059,Middle Super Output Areas and Intermediate Zones,MSOAIZ,L,9574,4154,3270,1371,1067,585,2203,786,21,13,5113,2254,1217,559,3896,1695,1695,,,,1076,463,1015,432,0,0,38,20,23,11,31,94,53
E02001406,St. Helens 001,Middle Super Output Areas and Intermediate Zones,MSOAIZ,WN,7732,3445,6742,2962,3447,1807,3295,1155,14,10,438,219,105,60,333,159,159,,,,455,211,389,182,20,6,30,16,16,7,29,83,43
E02001407,St. Helens 002,Middle Super Output Areas and Intermediate Zones,MSOAIZ,WN,6106,2617,5275,2224,2543,1300,2732,924,5,4,476,237,124,56,352,181,181,,,,292,118,262,107,0,0,22,9,8,2,11,58,34
E02001408,St. Helens 003,Middle Super Output Areas and Intermediate Zones,MSOAIZ,WN,5741,2368,4948,2044,2122,1052,2826,992,0,0,426,165,199,76,227,89,89,,,,323,131,273,111,10,3,37,16,3,1,20,44,28
E02001409,St. Helens 004,Middle Super Output Areas and Intermediate Zones,MSOAIZ,WA,9799,4325,6817,2895,2786,1450,4031,1445,23,9,2260,1104,688,311,1572,793,793,,,,589,253,502,220,9,2,68,25,10,6,33,110,64
E02001410,St. Helens 005,Middle Super Output Areas and Intermediate Zones,MSOAIZ,WN,5796,2498,3778,1634,1482,778,2296,856,5,2,1481,610,547,215,934,395,395,,,,478,212,427,188,0,0,38,19,13,5,24,54,40
E02001411,St. Helens 006,Middle Super Output Areas and Intermediate Zones,MSOAIZ,WA,5851,2520,4385,1827,1651,873,2734,954,46,32,768,375,249,106,519,269,269,,,,603,251,538,220,0,0,56,25,9,6,31,49,35
E02001412,St. Helens 007,Middle Super Output Areas and Intermediate Zones,MSOAIZ,WA,8757,3686,6553,2725,2647,1387,3906,1338,14,9,1354,575,403,155,951,420,420,,,,756,327,666,288,6,3,78,32,6,4,39,80,50
E02001413,St. Helens 008,Middle Super Output Areas and Intermediate Zones,MSOAIZ,WA,9659,4085,7265,3039,3129,1572,4136,1467,27,11,1686,736,583,249,1103,487,487,,,,605,251,526,215,0,0,68,30,11,6,36,76,48
E02001414,St. Helens 009,Middle Super Output Areas and Intermediate Zones,MSOAIZ,WA,5320,2253,4973,2098,2420,1260,2553,838,19,12,73,32,32,13,41,19,19,,,,218,87,202,75,2,1,13,10,1,1,12,37,24
E02001415,St. Helens 010,Middle Super Output Areas and Intermediate Zones,MSOAIZ,WA,6571,2737,4124,1638,1244,638,2880,1000,36,13,1768,795,620,266,1148,529,529,,,,587,246,542,222,0,0,42,21,3,3,24,56,45
E02001416,St. Helens 011,Middle Super Output Areas and Intermediate Zones,MSOAIZ,WA,5864,2540,2838,1208,989,545,1849,663,27,10,2171,970,785,343,1386,627,627,,,,738,310,682,282,5,2,41,19,10,7,28,90,42
E02001417,St. Helens 012,Middle Super Output Areas and Intermediate Zones,MSOAIZ,WA,7026,3623,3471,1642,1147,659,2324,983,88,45,2020,1178,398,226,1622,952,952,,,,1343,690,1280,659,4,2,39,19,20,10,31,104,68
E02001418,St. Helens 013,Middle Super Output Areas and Intermediate Zones,MSOAIZ,WA,5235,2487,2927,1286,976,524,1951,762,100,54,1377,719,352,187,1025,532,532,,,,773,391,705,355,5,3,55,27,8,6,36,58,37
E02001419,St. Helens 014,Middle Super Output Areas and Intermediate Zones,MSOAIZ,WA,6642,3188,2962,1383,1171,657,1791,726,40,19,2010,972,635,271,1375,701,701,,,,1533,754,1458,714,3,2,54,28,18,10,40,97,60
E02001420,St. Helens 015,Middle Super Output Areas and Intermediate Zones,MSOAIZ,WA,10105,4348,6416,2713,2260,1191,4156,1522,72,45,2648,1110,716,271,1932,839,839,,,,882,421,832,397,2,1,41,18,7,5,24,87,59
E02001421,St. Helens 016,Middle Super Output Areas and Intermediate Zones,MSOAIZ,WA,10489,4658,7403,3250,2803,1521,4600,1729,53,31,1465,619,412,163,1053,456,456,,,,1476,698,1370,652,2,1,89,41,15,4,46,92,60
E02001422,St. Helens 017,Middle Super Output Areas and Intermediate Zones,MSOAIZ,WA,6358,2651,2910,1171,942,487,1968,684,28,14,2306,988,954,412,1352,576,576,,,,1034,431,965,403,0,0,63,25,6,3,28,80,47
E02001423,St. Helens 018,Middle Super Output Areas and Intermediate Zones,MSOAIZ,WA,6249,2657,5215,2126,2142,1092,3073,1034,7,5,538,298,165,87,373,211,211,,,,440,195,418,185,0,0,21,9,1,1,10,49,33
E02001424,St. Helens 019,Middle Super Output Areas and Intermediate Zones,MSOAIZ,WA,13412,5700,8194,3294,2724,1398,5470,1896,89,56,3666,1695,1235,539,2431,1156,1156,,,,1341,573,1213,516,8,2,92,41,28,14,57,122,82
E02001425,St. Helens 020,Middle Super Output Areas and Intermediate Zones,MSOAIZ,WA,10388,4523,7558,3229,3190,1632,4368,1597,22,10,1839,835,462,197,1377,638,638,,,,877,399,795,358,4,3,76,37,2,1,41,92,50
E02001426,St. Helens 021,Middle Super Output Areas and Intermediate Zones,MSOAIZ,WA,5315,2299,4458,1894,1984,1029,2474,865,7,4,307,163,49,29,258,134,134,,,,512,216,469,194,0,0,40,20,3,2,22,31,22
E02001427,St. Helens 022,Middle Super Output Areas and Intermediate Zones,MSOAIZ,WA,10213,4276,6443,2632,2367,1163,4076,1469,53,27,2574,1127,865,345,1709,782,782,,,,1081,452,977,407,9,4,87,35,8,6,45,62,38
E02001428,St. Helens 023,Middle Super Output Areas and Intermediate Zones,MSOAIZ,L,5330,2252,4855,2038,2310,1200,2545,838,9,5,165,75,28,13,137,62,62,,,,277,119,244,106,0,0,33,13,0,0,13,24,15
E02001429,Sefton 001,Middle Super Output Areas and Intermediate Zones,MSOAIZ,PR,6751,3059,5718,2643,2708,1524,3010,1119,20,11,277,107,66,28,211,79,79,,,,698,277,616,234,0,0,75,39,7,4,43,38,21
E02001430,Sefton 002,Middle Super Output Areas and Intermediate Zones,MSOAIZ,PR,7071,3011,6104,2585,2715,1451,3389,1134,3,2,176,78,45,17,131,61,61,,,,747,319,661,281,2,1,80,34,4,3,38,41,27
E02001431,Sefton 003,Middle Super Output Areas and Intermediate Zones,MSOAIZ,PR,6879,3639,4995,2467,2690,1577,2305,890,42,29,755,537,131,70,624,467,467,,,,1009,557,952,521,5,2,43,27,9,7,36,78,49
E02001432,Sefton 004,Middle Super Output Areas and Intermediate Zones,MSOAIZ,PR,7838,4486,3363,1803,1757,1085,1606,718,156,95,482,367,26,12,456,355,355,,,,3746,2167,3616,2087,20,12,95,59,15,9,80,91,54
E02001433,Sefton 005,Middle Super Output Areas and Intermediate Zones,MSOAIZ,PR,7642,3140,5467,2262,1872,982,3595,1280,13,6,706,293,119,48,587,245,245,,,,1402,551,1275,495,7,2,113,51,7,3,56,54,28
E02001434,Sefton 006,Middle Super Output Areas and Intermediate Zones,MSOAIZ,PR,7051,2868,5431,2165,1741,883,3690,1282,55,23,329,162,14,6,315,156,156,,,,1169,479,1058,430,5,2,101,46,5,1,49,67,39
E02001435,Sefton 007,Middle Super Output Areas and Intermediate Zones,MSOAIZ,PR,7884,3411,5018,2094,1835,965,3183,1129,41,26,203,89,29,8,174,81,81,,,,2532,1157,2376,1098,19,5,128,50,9,4,59,90,45
E02001436,Sefton 008,Middle Super Output Areas and Intermediate Zones,MSOAIZ,PR,8614,3558,6560,2711,2490,1275,4070,1436,47,22,651,272,35,15,616,257,257,,,,1302,522,1169,460,7,2,115,54,11,6,62,54,31
E02001437,Sefton 009,Middle Super Output Areas and Intermediate Zones,MSOAIZ,PR,9105,4309,7387,3306,3791,2068,3596,1238,67,48,317,218,14,3,303,215,215,,,,1257,688,1195,649,5,3,53,34,4,2,39,77,49
E02001438,Sefton 010,Middle Super Output Areas and Intermediate Zones,MSOAIZ,PR,7487,3065,6268,2554,2387,1204,3881,1350,10,5,310,155,104,48,206,107,107,,,,868,328,776,290,5,2,82,33,5,3,38,31,23
E02001439,Sefton 011,Middle Super Output Areas and Intermediate Zones,MSOAIZ,PR,6258,2733,4346,1887,1699,952,2647,935,28,21,1109,507,333,145,776,362,362,,,,702,272,624,240,7,3,66,26,5,3,32,73,46
E02001440,Sefton 012,Middle Super Output Areas and Intermediate Zones,MSOAIZ,PR,5809,2600,5419,2436,3016,1594,2403,842,18,10,27,13,12,7,15,6,6,,,,313,122,261,98,11,8,30,11,11,5,24,32,19
E02001441,Sefton 013,Middle Super Output Areas and Intermediate Zones,MSOAIZ,L,6438,2688,6064,2531,3170,1592,2894,939,2,2,47,23,5,1,42,22,22,,,,295,113,244,94,15,5,24,11,12,3,19,30,19
E02001442,Sefton 014,Middle Super Output Areas and Intermediate Zones,MSOAIZ,L,5819,2609,4944,2167,2402,1288,2542,879,32,19,296,162,75,38,221,124,124,,,,495,229,449,206,7,4,35,16,4,3,23,52,32
E02001443,Sefton 015,Middle Super Output Areas and Intermediate Zones,MSOAIZ,L,5594,2279,5217,2105,2475,1255,2742,850,6,2,103,62,38,18,65,44,44,,,,239,96,212,82,0,0,25,12,2,2,14,29,14
E02001444,Sefton 016,Middle Super Output Areas and Intermediate Zones,MSOAIZ,L,5697,2397,4991,2109,2204,1176,2787,933,6,4,99,44,46,17,53,27,27,,,,558,220,483,190,25,10,41,16,9,4,30,43,20
E02001445,Sefton 017,Middle Super Output Areas and Intermediate Zones,MSOAIZ,L,6992,2942,6360,2638,2769,1412,3591,1226,5,3,178,95,80,40,98,55,55,,,,406,186,362,166,0,0,43,19,1,1,20,43,20
E02001446,Sefton 018,Middle Super Output Areas and Intermediate Zones,MSOAIZ,L,6711,2855,6142,2589,2752,1478,3390,1111,7,3,156,75,26,13,130,62,62,,,,375,171,315,139,4,1,53,28,3,3,32,31,17
E02001447,Sefton 019,Middle Super Output Areas and Intermediate Zones,MSOAIZ,L,5862,2555,5017,2115,2236,1178,2781,937,38,28,349,201,105,54,244,147,147,,,,406,175,376,162,0,0,30,13,0,0,13,52,36
E02001448,Sefton 020,Middle Super Output Areas and Intermediate Zones,MSOAIZ,L,6902,2789,6339,2512,2585,1298,3754,1214,1,1,120,84,24,18,96,66,66,,,,402,172,346,149,6,2,44,19,6,2,23,40,20
E02001449,Sefton 021,Middle Super Output Areas and Intermediate Zones,MSOAIZ,L,9207,3865,7431,3031,3047,1559,4384,1472,7,2,1083,521,535,238,548,283,283,,,,603,259,532,228,0,0,61,25,10,6,31,83,52
E02001450,Sefton 022,Middle Super Output Areas and Intermediate Zones,MSOAIZ,L,8064,3523,7105,2989,3115,1636,3990,1353,5,4,130,87,22,8,108,79,79,,,,762,407,702,372,0,0,53,32,7,3,35,62,36
E02001451,Sefton 023,Middle Super Output Areas and Intermediate Zones,MSOAIZ,L,6025,2623,3577,1509,1294,685,2283,824,41,17,1804,855,974,436,830,419,419,,,,523,199,484,183,0,0,37,15,2,1,16,80,43
E02001452,Sefton 024,Middle Super Output Areas and Intermediate Zones,MSOAIZ,L,6476,2871,3006,1258,994,541,2012,717,24,9,2854,1370,1412,652,1442,718,718,,,,504,182,440,157,3,1,36,16,25,8,25,88,52
E02001453,Sefton 025,Middle Super Output Areas and Intermediate Zones,MSOAIZ,L,8621,3498,7660,3014,2863,1451,4797,1563,8,4,352,229,60,30,292,199,199,,,,536,220,501,202,0,0,34,17,1,1,18,65,31
E02001454,Sefton 026,Middle Super Output Areas and Intermediate Zones,MSOAIZ,L,7028,2912,6186,2518,2403,1248,3783,1270,3,2,351,165,140,66,211,99,99,,,,450,203,386,173,6,4,54,23,4,3,30,38,24
E02001455,Sefton 027,Middle Super Output Areas and Intermediate Zones,MSOAIZ,L,7197,2913,6179,2496,2224,1151,3955,1345,16,6,436,182,91,33,345,149,149,,,,518,204,465,183,8,3,38,15,7,3,21,48,25
E02001456,Sefton 028,Middle Super Output Areas and Intermediate Zones,MSOAIZ,L,7449,3254,5843,2411,2083,1107,3760,1304,10,6,383,212,38,21,345,191,191,,,,1154,588,1074,547,10,5,68,34,2,2,41,59,37
E02001457,Sefton 029,Middle Super Output Areas and Intermediate Zones,MSOAIZ,L,6768,2980,3505,1431,1101,587,2404,844,112,56,2625,1251,1051,497,1574,754,754,,,,457,196,406,172,0,0,48,23,3,1,24,69,46
E02001458,Sefton 030,Middle Super Output Areas and Intermediate Zones,MSOAIZ,L,7652,3211,5827,2288,1802,896,4025,1392,16,8,368,216,81,43,287,173,173,,,,1401,677,1301,636,4,1,90,36,6,4,41,40,22
E02001459,Sefton 031,Middle Super Output Areas and Intermediate Zones,MSOAIZ,L,7267,2928,4684,1862,1522,778,3162,1084,8,5,1595,646,802,315,793,331,331,,,,933,389,889,369,0,0,36,17,8,3,20,47,26
E02001460,Sefton 032,Middle Super Output Areas and Intermediate Zones,MSOAIZ,L,7327,3696,3738,1612,1415,722,2323,890,54,26,2362,1440,604,349,1758,1091,1091,,,,1093,576,1009,540,0,0,67,27,17,9,36,80,42
E02001461,Sefton 033,Middle Super Output Areas and Intermediate Zones,MSOAIZ,L,6326,2646,5054,2021,1686,895,3368,1126,42,30,753,389,346,167,407,222,222,,,,437,179,382,156,2,2,52,20,1,1,23,40,27
E02001462,Sefton 034,Middle Super Output Areas and Intermediate Zones,MSOAIZ,L,7514,3406,2931,1219,902,464,2029,755,44,21,3301,1553,561,261,2740,1292,1292,,,,1186,573,1107,537,1,1,70,29,8,6,36,52,40
E02001463,Sefton 035,Middle Super Output Areas and Intermediate Zones,MSOAIZ,L,6807,2727,3833,1480,1138,586,2695,894,6,3,2389,1005,1141,472,1248,533,533,,,,515,202,459,180,0,0,52,20,4,2,22,64,37
E02001464,Sefton 036,Middle Super Output Areas and Intermediate Zones,MSOAIZ,L,6812,3102,3124,1364,1031,547,2093,817,66,34,1911,872,254,95,1657,777,777,,,,1661,803,1569,764,0,0,65,30,27,9,39,50,29
E02001465,Sefton 037,Middle Super Output Areas and Intermediate Zones,MSOAIZ,L,6225,3205,1898,881,679,388,1219,493,101,56,3131,1676,789,406,2342,1270,1270,,,,1026,550,976,521,5,2,29,18,16,9,29,69,42
E02001466,Sefton 038,Middle Super Output Areas and Intermediate Zones,MSOAIZ,L,8528,3577,5165,2074,1698,856,3467,1218,26,15,1850,850,503,216,1347,634,634,,,,1422,596,1349,561,5,3,51,24,17,8,35,65,42
E02001467,Wirral 001,Middle Super Output Areas and Intermediate Zones,MSOAIZ,L,7473,3732,4782,2187,1925,1075,2857,1112,33,15,529,355,46,25,483,330,330,,,,2076,1143,1977,1086,8,5,77,45,14,7,57,53,32
E02001468,Wirral 002,Middle Super Output Areas and Intermediate Zones,MSOAIZ,L,7610,3346,5217,2130,1665,870,3552,1260,25,15,337,205,60,29,277,176,176,,,,1973,959,1848,894,7,2,105,53,13,10,65,58,37
E02001469,Wirral 003,Middle Super Output Areas and Intermediate Zones,MSOAIZ,L,7810,3465,6294,2671,2610,1397,3684,1274,22,16,328,231,93,63,235,168,168,,,,1104,517,985,468,8,3,95,41,16,5,49,62,30
E02001470,Wirral 004,Middle Super Output Areas and Intermediate Zones,MSOAIZ,L,8564,3456,7391,2943,2895,1447,4496,1496,11,4,72,37,26,11,46,26,26,,,,1036,441,936,398,6,2,89,40,5,1,43,54,31
E02001471,Wirral 005,Middle Super Output Areas and Intermediate Zones,MSOAIZ,L,7397,3301,4267,1765,1380,696,2887,1069,36,22,695,438,174,106,521,332,332,,,,2346,1043,2208,975,0,0,128,59,10,9,68,53,33
E02001472,Wirral 006,Middle Super Output Areas and Intermediate Zones,MSOAIZ,L,7064,2969,4977,2069,1735,921,3242,1148,16,11,1187,519,209,84,978,435,435,,,,829,336,763,305,1,1,61,28,4,2,31,55,34
E02001473,Wirral 007,Middle Super Output Areas and Intermediate Zones,MSOAIZ,L,7571,3352,5606,2407,2180,1163,3426,1244,20,9,341,197,154,79,187,118,118,,,,1561,707,1468,660,3,2,84,41,6,4,47,43,32
E02001474,Wirral 008,Middle Super Output Areas and Intermediate Zones,MSOAIZ,L,7049,3248,2881,1217,1043,529,1838,688,6,5,1969,1042,508,251,1461,791,791,,,,2154,955,2073,912,6,1,58,31,17,11,43,39,29
E02001475,Wirral 009,Middle Super Output Areas and Intermediate Zones,MSOAIZ,L,6165,2777,2962,1255,945,523,2017,732,6,4,2417,1205,857,431,1560,774,774,,,,716,267,656,240,2,1,45,20,13,6,27,64,46
E02001476,Wirral 010,Middle Super Output Areas and Intermediate Zones,MSOAIZ,L,7624,3419,3617,1550,1211,640,2406,910,24,13,1905,860,795,342,1110,518,518,,,,2052,978,1933,920,4,1,99,48,16,9,58,26,18
E02001477,Wirral 011,Middle Super Output Areas and Intermediate Zones,MSOAIZ,L,7468,3296,2020,873,593,313,1427,560,3,2,4384,1942,2302,1019,2082,923,923,,,,1010,449,973,431,2,1,19,10,16,7,18,51,30
E02001478,Wirral 012,Middle Super Output Areas and Intermediate Zones,MSOAIZ,L,7860,3507,5620,2455,2373,1291,3247,1164,14,6,1190,618,633,293,557,325,325,,,,965,376,875,336,2,1,72,31,16,8,40,71,52
E02001479,Wirral 013,Middle Super Output Areas and Intermediate Zones,MSOAIZ,L,6132,2512,5491,2242,2019,1022,3472,1220,17,7,119,49,38,18,81,31,31,,,,475,198,415,170,2,1,51,21,7,6,28,30,16
E02001480,Wirral 014,Middle Super Output Areas and Intermediate Zones,MSOAIZ,L,7471,3326,6045,2604,2436,1326,3609,1278,19,10,199,133,86,56,113,77,77,,,,1153,553,1017,486,16,7,107,54,13,6,67,55,26
E02001481,Wirral 015,Middle Super Output Areas and Intermediate Zones,MSOAIZ,L,7909,3450,6201,2580,2289,1179,3912,1401,23,15,321,178,162,75,159,103,103,,,,1296,644,1191,597,0,0,97,45,8,2,47,68,33
E02001482,Wirral 016,Middle Super Output Areas and Intermediate Zones,MSOAIZ,L,7632,4206,1898,860,697,390,1201,470,75,49,3677,2222,815,426,2862,1796,1796,,,,1925,1038,1823,988,5,3,71,33,26,14,50,57,37
E02001483,Wirral 017,Middle Super Output Areas and Intermediate Zones,MSOAIZ,L,7382,3202,6428,2756,2386,1296,4042,1460,24,16,176,105,96,51,80,54,54,,,,705,298,603,259,2,1,95,37,5,1,39,49,27
E02001484,Wirral 018,Middle Super Output Areas and Intermediate Zones,MSOAIZ,L,7560,3368,6055,2604,2430,1311,3625,1293,52,28,674,365,317,163,357,202,202,,,,733,334,642,295,7,3,81,34,3,2,39,46,37
E02001485,Wirral 019,Middle Super Output Areas and Intermediate Zones,MSOAIZ,L,6333,2610,3365,1346,1107,583,2258,763,59,27,2081,905,1079,446,1002,459,459,,,,741,280,699,261,0,0,36,16,6,3,19,87,52
E02001486,Wirral 020,Middle Super Output Areas and Intermediate Zones,MSOAIZ,L,7800,4169,5218,2475,2300,1290,2918,1185,68,44,757,565,51,33,706,532,532,,,,1686,1050,1599,1000,10,4,72,43,5,3,50,71,35
E02001487,Wirral 021,Middle Super Output Areas and Intermediate Zones,MSOAIZ,L,9264,4321,4038,1784,1293,712,2745,1072,161,85,1835,984,233,138,1602,846,846,,,,3165,1427,3036,1356,2,2,115,62,12,7,71,65,41
E02001488,Wirral 022,Middle Super Output Areas and Intermediate Zones,MSOAIZ,L,8398,3843,5568,2391,1885,981,3683,1410,29,21,598,369,152,78,446,291,291,,,,2138,1020,1960,946,10,4,158,64,10,6,74,65,42
E02001489,Wirral 023,Middle Super Output Areas and Intermediate Zones,MSOAIZ,L,8238,3587,7492,3242,3380,1810,4112,1432,29,19,171,90,39,20,132,70,70,,,,491,206,446,181,2,1,42,23,1,1,25,55,30
E02001490,Wirral 024,Middle Super Output Areas and Intermediate Zones,MSOAIZ,L,8743,3451,7662,3018,2779,1373,4883,1645,19,10,194,84,121,52,73,32,32,,,,839,320,772,289,5,1,54,26,8,4,31,29,19
E02001491,Wirral 025,Middle Super Output Areas and Intermediate Zones,MSOAIZ,L,6747,3101,3312,1464,1144,661,2168,803,40,20,2257,1149,1320,631,937,518,518,,,,1053,409,964,369,6,1,67,32,16,7,40,85,59
E02001492,Wirral 026,Middle Super Output Areas and Intermediate Zones,MSOAIZ,L,7710,3539,5759,2559,2448,1403,3311,1156,32,18,508,282,213,94,295,188,188,,,,1324,628,1217,576,14,5,89,44,4,3,52,87,52
E02001493,Wirral 027,Middle Super Output Areas and Intermediate Zones,MSOAIZ,L,7855,3727,2881,1223,945,492,1936,731,62,36,2764,1416,1006,447,1758,969,969,,,,2080,1008,2001,972,2,1,61,29,16,6,36,68,44
E02001494,Wirral 028,Middle Super Output Areas and Intermediate Zones,MSOAIZ,L,7076,2990,6456,2724,3132,1591,3324,1133,10,5,142,68,48,17,94,51,51,,,,426,171,396,158,0,0,27,11,3,2,13,42,22
E02001495,Wirral 029,Middle Super Output Areas and Intermediate Zones,MSOAIZ,L,7680,3370,5446,2251,1995,1031,3451,1220,114,70,904,498,397,220,507,278,278,,,,1158,517,1084,480,2,1,66,33,6,3,37,58,34
E02001496,Wirral 030,Middle Super Output Areas and Intermediate Zones,MSOAIZ,L,5971,2470,5029,2004,2016,1037,3013,967,0,0,527,284,275,133,252,151,151,,,,378,161,339,144,0,0,36,16,3,1,17,37,21
E02001497,Wirral 031,Middle Super Output Areas and Intermediate Zones,MSOAIZ,L,7947,3663,3988,1782,1379,783,2609,999,25,18,2411,1135,980,401,1431,734,734,,,,1426,678,1335,633,16,8,58,29,17,8,45,97,50
E02001498,Wirral 032,Middle Super Output Areas and Intermediate Zones,MSOAIZ,L,7555,3108,6188,2502,2451,1256,3737,1246,6,5,570,255,307,122,263,133,133,,,,722,312,652,282,4,1,60,26,6,3,30,69,34
E02001499,Wirral 033,Middle Super Output Areas and Intermediate Zones,MSOAIZ,L,6691,2941,5919,2588,2774,1489,3145,1099,23,20,173,81,69,29,104,52,52,,,,533,220,464,188,0,0,56,26,13,6,32,43,32
E02001500,Wirral 034,Middle Super Output Areas and Intermediate Zones,MSOAIZ,L,7436,3234,6555,2808,2758,1471,3797,1337,18,8,303,184,92,48,211,136,136,,,,513,207,462,182,2,1,47,22,2,2,25,47,27
E02001501,Wirral 035,Middle Super Output Areas and Intermediate Zones,MSOAIZ,L,7911,3259,6598,2688,2566,1343,4032,1345,8,4,589,281,240,114,349,167,167,,,,663,256,591,225,0,0,66,28,6,3,31,53,30
E02001502,Wirral 036,Middle Super Output Areas and Intermediate Zones,MSOAIZ,L,8098,3665,5840,2535,2111,1134,3729,1401,11,6,962,534,195,101,767,433,433,,,,1216,545,1108,494,2,2,99,44,7,5,51,69,45
E02001503,Wirral 037,Middle Super Output Areas and Intermediate Zones,MSOAIZ,L,7449,3434,5990,2629,2710,1485,3280,1144,4,2,590,400,237,137,353,263,263,,,,821,372,767,346,4,2,43,20,7,4,26,44,31
E02001504,Wirral 038,Middle Super Output Areas and Intermediate Zones,MSOAIZ,L,7122,3066,6326,2696,3114,1611,3212,1085,16,11,37,20,5,2,32,18,18,,,,642,289,582,262,19,7,24,13,17,7,27,101,50
E02001505,Wirral 039,Middle Super Output Areas and Intermediate Zones,MSOAIZ,L,6365,2747,4742,1986,1818,973,2924,1013,6,3,938,445,469,191,469,254,254,,,,639,291,609,274,0,0,27,16,3,1,17,40,22
E02001506,Wirral 040,Middle Super Output Areas and Intermediate Zones,MSOAIZ,L,8943,3821,8437,3608,4320,2235,4117,1373,27,12,26,9,11,3,15,6,6,,,,417,171,383,157,5,2,24,11,5,1,14,36,21
E02001507,Wirral 041,Middle Super Output Areas and Intermediate Zones,MSOAIZ,L,7288,3009,6771,2776,2784,1458,3987,1318,10,6,95,53,31,10,64,43,43,,,,386,158,352,141,4,1,29,15,1,1,17,26,16
E02001508,Wirral 042,Middle Super Output Areas and Intermediate Zones,MSOAIZ,L,8023,3526,6155,2596,2221,1215,3934,1381,29,16,1005,537,537,277,468,260,260,,,,787,343,712,300,6,3,53,31,16,9,43,47,34
E02001509,Barnsley 001,Middle Super Output Areas and Intermediate Zones,MSOAIZ,S,6210,2696,4385,1788,1574,789,2811,999,13,11,1175,601,1072,530,103,71,71,,,,573,252,512,227,2,1,49,22,10,2,25,64,44
E02001510,Barnsley 002,Middle Super Output Areas and Intermediate Zones,MSOAIZ,S,5878,2537,4067,1701,1547,787,2520,914,21,15,1034,497,864,425,170,72,72,,,,688,279,635,254,1,1,48,23,4,1,25,68,45
E02001511,Barnsley 003,Middle Super Output Areas and Intermediate Zones,MSOAIZ,S,6162,2673,4571,1909,1726,875,2845,1034,6,4,811,442,741,403,70,39,39,,,,713,280,670,261,0,0,37,17,6,2,19,61,38
E02001512,Barnsley 004,Middle Super Output Areas and Intermediate Zones,MSOAIZ,S,7521,3358,5733,2441,2305,1185,3428,1256,11,6,1027,536,885,470,142,66,66,,,,672,320,593,285,12,4,61,28,6,3,35,78,55
E02001513,Barnsley 005,Middle Super Output Areas and Intermediate Zones,MSOAIZ,S,7766,3325,6249,2631,2547,1294,3702,1337,9,5,674,320,617,289,57,31,31,,,,777,337,716,305,3,1,54,29,4,2,32,57,32
E02001514,Barnsley 006,Middle Super Output Areas and Intermediate Zones,MSOAIZ,S,7141,2999,4323,1748,1506,721,2817,1027,37,17,1539,759,1075,564,464,195,195,,,,1187,439,1083,401,6,2,78,32,20,4,38,55,36
E02001515,Barnsley 007,Middle Super Output Areas and Intermediate Zones,MSOAIZ,S,9231,3918,4284,1741,1410,717,2874,1024,79,38,4111,1813,3806,1684,305,129,129,,,,610,240,546,212,10,5,48,20,6,3,28,147,86
E02001516,Barnsley 008,Middle Super Output Areas and Intermediate Zones,MSOAIZ,S,6045,2518,4015,1634,1249,641,2766,993,6,4,1118,489,1031,446,87,43,43,,,,823,346,744,311,0,0,74,31,5,4,35,83,45
E02001517,Barnsley 009,Middle Super Output Areas and Intermediate Zones,MSOAIZ,S,7834,3448,6143,2570,2525,1272,3618,1298,9,6,1016,582,862,508,154,74,74,,,,590,245,536,220,15,6,38,18,1,1,25,76,45
E02001518,Barnsley 010,Middle Super Output Areas and Intermediate Zones,MSOAIZ,S,9952,4376,6896,2887,2715,1393,4181,1494,16,12,1890,899,1537,752,353,147,147,,,,1024,502,935,456,4,2,77,41,8,3,46,126,76
E02001519,Barnsley 011,Middle Super Output Areas and Intermediate Zones,MSOAIZ,S,6617,2749,3759,1603,1487,774,2272,829,20,10,2120,833,1764,693,356,140,140,,,,646,260,592,236,8,4,45,19,1,1,24,72,43
E02001520,Barnsley 012,Middle Super Output Areas and Intermediate Zones,MSOAIZ,S,10601,4764,8678,3750,3996,2073,4682,1677,58,37,898,493,787,412,111,81,81,,,,889,435,808,392,2,1,71,39,8,3,43,78,49
E02001521,Barnsley 013,Middle Super Output Areas and Intermediate Zones,MSOAIZ,S,11197,5349,6620,2977,2451,1285,4169,1692,62,37,984,559,713,402,271,157,157,,,,3343,1675,3133,1574,13,9,160,70,37,22,101,188,101
E02001522,Barnsley 014,Middle Super Output Areas and Intermediate Zones,MSOAIZ,S,8611,3750,4893,2042,2147,1069,2746,973,52,26,2352,1124,1375,677,977,447,447,,,,1209,496,1105,454,4,2,91,37,9,3,42,105,62
E02001523,Barnsley 015,Middle Super Output Areas and Intermediate Zones,MSOAIZ,S,6677,3043,4977,2170,1941,1018,3036,1152,32,18,446,230,349,179,97,51,51,,,,1158,585,1079,542,3,2,73,38,3,3,43,64,40
E02001524,Barnsley 016,Middle Super Output Areas and Intermediate Zones,MSOAIZ,WF,5902,2566,4921,2036,2361,1150,2560,886,33,17,385,223,333,194,52,29,29,,,,503,253,449,227,5,2,35,16,14,8,26,60,37
E02001525,Barnsley 017,Middle Super Output Areas and Intermediate Zones,MSOAIZ,S,5933,2955,2682,1205,1036,555,1646,650,13,11,1881,1072,1290,722,591,350,350,,,,1246,598,1184,567,3,2,45,24,14,5,31,111,69
E02001526,Barnsley 018,Middle Super Output Areas and Intermediate Zones,MSOAIZ,S,5790,2487,2618,1082,942,475,1676,607,21,12,2548,1116,2194,954,354,162,162,,,,501,225,460,202,4,4,32,16,5,3,23,102,52
E02001527,Barnsley 019,Middle Super Output Areas and Intermediate Zones,MSOAIZ,S,5836,2573,4358,1820,1702,868,2656,952,3,1,878,473,827,445,51,28,28,,,,534,242,482,216,8,2,38,22,6,2,26,63,37
E02001528,Barnsley 020,Middle Super Output Areas and Intermediate Zones,MSOAIZ,S,10177,4424,6795,2878,2985,1489,3810,1389,44,26,1982,908,1735,806,247,102,102,,,,1213,544,1137,509,5,3,55,27,16,5,35,143,68
E02001529,Barnsley 021,Middle Super Output Areas and Intermediate Zones,MSOAIZ,S,9358,4180,5614,2424,2457,1272,3157,1152,23,13,2823,1321,2616,1204,207,117,117,,,,713,328,642,288,0,0,65,36,6,4,40,185,94
E02001530,Barnsley 022,Middle Super Output Areas and Intermediate Zones,MSOAIZ,S,6236,2748,3743,1583,1302,689,2441,894,8,4,1185,514,998,423,187,91,91,,,,1197,588,1153,567,8,3,31,15,5,3,21,103,59
E02001531,Barnsley 023,Middle Super Output Areas and Intermediate Zones,MSOAIZ,S,6398,2954,3930,1704,1553,807,2377,897,2,1,1254,636,1083,529,171,107,107,,,,1147,570,1073,530,2,1,57,31,15,8,40,65,43
E02001532,Barnsley 024,Middle Super Output Areas and Intermediate Zones,MSOAIZ,S,9487,4067,7528,3086,2794,1428,4734,1658,54,31,1086,556,782,414,304,142,142,,,,748,358,669,318,13,4,56,30,10,6,40,71,36
E02001533,Barnsley 025,Middle Super Output Areas and Intermediate Zones,MSOAIZ,S,7402,3125,4954,2054,1783,886,3171,1168,9,7,1048,519,974,475,74,44,44,,,,1343,516,1254,480,8,2,77,32,4,2,36,48,29
E02001534,Barnsley 026,Middle Super Output Areas and Intermediate Zones,MSOAIZ,S,9016,3800,5853,2409,1992,1035,3861,1374,19,11,2066,875,1857,793,209,82,82,,,,966,444,883,405,0,0,74,33,9,6,39,112,61
E02001535,Barnsley 027,Middle Super Output Areas and Intermediate Zones,MSOAIZ,S,6093,2595,4803,1950,2118,992,2685,958,20,7,568,302,448,256,120,46,46,,,,617,286,551,257,20,9,27,12,19,8,29,85,50
E02001536,Barnsley 028,Middle Super Output Areas and Intermediate Zones,MSOAIZ,S,8349,3807,6133,2624,2408,1248,3725,1376,47,30,1162,669,1072,613,90,56,56,,,,894,417,819,382,5,2,67,32,3,1,35,113,67
E02001537,Barnsley 029,Middle Super Output Areas and Intermediate Zones,MSOAIZ,S,8214,3525,5536,2297,1885,949,3651,1348,34,19,1434,657,1341,603,93,54,54,,,,1141,508,1064,473,0,0,66,31,11,4,35,69,44
E02001538,Barnsley 030,Middle Super Output Areas and Intermediate Zones,MSOAIZ,S,7905,3425,4823,2063,1959,1042,2864,1021,15,9,2326,1014,2224,966,102,48,48,,,,645,288,580,261,5,2,38,16,22,9,27,96,51
E02001539,Doncaster 001,Middle Super Output Areas and Intermediate Zones,MSOAIZ,DN,6018,2400,3805,1530,1380,694,2425,836,18,7,1402,522,1309,472,93,50,50,,,,722,305,641,266,1,1,78,36,2,2,39,71,36
E02001540,Doncaster 002,Middle Super Output Areas and Intermediate Zones,MSOAIZ,WF,11559,4810,8188,3313,3203,1579,4985,1734,18,12,1539,722,1443,677,96,45,45,,,,1653,670,1514,615,14,5,114,45,11,5,55,161,93
E02001541,Doncaster 003,Middle Super Output Areas and Intermediate Zones,MSOAIZ,DN,11125,4876,7294,3098,2861,1503,4433,1595,46,27,1835,878,1568,702,267,176,176,,,,1797,777,1620,698,9,5,156,65,12,9,79,153,96
E02001542,Doncaster 004,Middle Super Output Areas and Intermediate Zones,MSOAIZ,DN,7411,3071,4025,1610,1668,805,2357,805,14,6,2329,977,2159,864,170,113,113,,,,934,411,846,376,17,5,68,28,3,2,35,109,67
E02001543,Doncaster 005,Middle Super Output Areas and Intermediate Zones,MSOAIZ,DN,8394,3622,5348,2228,1961,1029,3387,1199,6,3,1950,886,1786,789,164,97,97,,,,978,436,892,400,5,2,79,33,2,1,36,112,69
E02001544,Doncaster 006,Middle Super Output Areas and Intermediate Zones,MSOAIZ,DN,8628,3526,5865,2415,2074,1054,3791,1361,17,9,1613,630,1565,611,48,19,19,,,,1047,420,912,372,4,2,129,45,2,1,48,86,52
E02001545,Doncaster 007,Middle Super Output Areas and Intermediate Zones,MSOAIZ,DN,8586,3726,7359,3121,3089,1632,4270,1489,33,20,367,222,310,194,57,28,28,,,,777,329,712,300,4,1,53,25,8,3,29,50,34
E02001546,Doncaster 008,Middle Super Output Areas and Intermediate Zones,MSOAIZ,DN,6541,2805,5483,2342,2580,1295,2903,1047,13,6,305,134,239,107,66,27,27,,,,681,290,596,256,11,3,70,28,4,3,34,59,33
E02001547,Doncaster 009,Middle Super Output Areas and Intermediate Zones,MSOAIZ,DN,10672,4223,6557,2588,2041,1019,4516,1569,18,9,2605,1046,2352,938,253,108,108,,,,1374,511,1252,463,4,4,116,42,2,2,48,118,69
E02001548,Doncaster 010,Middle Super Output Areas and Intermediate Zones,MSOAIZ,DN,7934,3397,3958,1609,1316,654,2642,955,32,18,2279,993,1830,722,449,271,271,,,,1579,721,1464,664,4,3,95,50,16,4,57,86,56
E02001549,Doncaster 011,Middle Super Output Areas and Intermediate Zones,MSOAIZ,DN,5951,2521,4761,1944,1800,934,2961,1010,15,5,472,270,392,216,80,54,54,,,,651,268,587,242,8,3,47,18,9,5,26,52,34
E02001550,Doncaster 012,Middle Super Output Areas and Intermediate Zones,MSOAIZ,DN,7441,3149,5359,2220,1820,979,3539,1241,23,11,1211,571,1193,561,18,10,10,,,,757,291,619,241,17,4,106,42,15,4,50,91,56
E02001551,Doncaster 013,Middle Super Output Areas and Intermediate Zones,MSOAIZ,DN,6006,2656,4212,1820,1639,842,2573,978,17,9,463,207,397,177,66,30,30,,,,1258,587,1161,539,18,7,71,36,8,5,48,56,33
E02001552,Doncaster 014,Middle Super Output Areas and Intermediate Zones,MSOAIZ,DN,7593,3151,4909,1989,1424,733,3485,1256,8,2,1148,542,1037,466,111,76,76,,,,1426,559,1335,516,8,4,76,34,7,5,43,102,59
E02001553,Doncaster 015,Middle Super Output Areas and Intermediate Zones,MSOAIZ,DN,10018,4193,6125,2565,2303,1216,3822,1349,13,4,2246,996,2079,879,167,117,117,,,,1492,548,1338,486,9,3,129,55,16,4,62,142,80
E02001554,Doncaster 016,Middle Super Output Areas and Intermediate Zones,MSOAIZ,DN,6401,2625,5413,2170,2065,1042,3348,1128,47,26,280,156,259,149,21,7,7,,,,595,237,535,217,0,0,58,19,2,1,20,66,36
E02001555,Doncaster 017,Middle Super Output Areas and Intermediate Zones,MSOAIZ,DN,5515,2463,4619,2040,1916,1022,2703,1018,24,11,259,143,241,133,18,10,10,,,,584,249,517,217,0,0,66,31,1,1,32,29,20
E02001556,Doncaster 018,Middle Super Output Areas and Intermediate Zones,MSOAIZ,DN,9239,3764,5120,2107,1653,883,3467,1224,17,6,2725,1148,2660,1112,65,36,36,,,,1237,433,1075,371,51,17,103,39,8,6,62,140,70
E02001557,Doncaster 019,Middle Super Output Areas and Intermediate Zones,MSOAIZ,DN,9217,3965,5857,2408,2224,1140,3633,1268,12,7,390,206,126,45,264,161,161,,,,2827,1284,2663,1207,25,12,112,57,27,8,77,131,60
E02001558,Doncaster 020,Middle Super Output Areas and Intermediate Zones,MSOAIZ,S,6087,2715,4823,2055,2254,1129,2569,926,36,20,435,263,359,225,76,38,38,,,,702,320,655,297,22,11,18,10,7,2,23,91,57
E02001559,Doncaster 021,Middle Super Output Areas and Intermediate Zones,MSOAIZ,DN,7702,3165,6691,2734,2792,1422,3899,1312,3,1,147,57,129,48,18,9,9,,,,779,332,699,294,16,8,58,28,6,2,38,82,41
E02001560,Doncaster 022,Middle Super Output Areas and Intermediate Zones,MSOAIZ,DN,9735,4318,3997,1727,1600,825,2397,902,46,18,1706,833,1231,542,475,291,291,,,,3833,1655,3672,1580,29,14,94,44,38,17,75,153,85
E02001561,Doncaster 023,Middle Super Output Areas and Intermediate Zones,MSOAIZ,DN,6263,2953,2954,1271,1002,510,1952,761,43,20,1707,1031,1497,879,210,152,152,,,,1460,572,1346,521,9,3,89,38,16,10,51,99,59
E02001562,Doncaster 024,Middle Super Output Areas and Intermediate Zones,MSOAIZ,DN,5858,2634,3771,1569,1377,720,2394,849,7,3,1391,761,1247,664,144,97,97,,,,588,228,533,208,4,2,48,17,3,1,20,101,73
E02001563,Doncaster 025,Middle Super Output Areas and Intermediate Zones,MSOAIZ,DN,7520,3254,5919,2519,2799,1434,3120,1085,17,12,671,300,506,220,165,80,80,,,,841,385,761,338,3,1,65,41,12,5,47,72,38
E02001564,Doncaster 026,Middle Super Output Areas and Intermediate Zones,MSOAIZ,DN,7531,3146,6629,2746,2948,1478,3681,1268,5,3,167,88,151,79,16,9,9,,,,665,268,581,233,15,6,65,26,4,3,35,65,41
E02001565,Doncaster 027,Middle Super Output Areas and Intermediate Zones,MSOAIZ,DN,6769,2860,5504,2271,2572,1265,2932,1006,32,21,167,74,115,57,52,17,17,,,,1016,467,933,430,4,2,73,33,6,2,37,50,27
E02001566,Doncaster 028,Middle Super Output Areas and Intermediate Zones,MSOAIZ,DN,7893,3330,4335,1715,1023,513,3312,1202,22,9,1229,566,940,430,289,136,136,,,,2183,973,2065,913,2,1,100,51,16,8,60,124,67
E02001567,Doncaster 029,Middle Super Output Areas and Intermediate Zones,MSOAIZ,DN,9099,3786,5590,2318,2107,1083,3483,1235,18,7,2233,941,1839,764,394,177,177,,,,1162,462,996,397,2,1,158,60,6,4,65,96,58
E02001568,Doncaster 030,Middle Super Output Areas and Intermediate Zones,MSOAIZ,S,5906,2623,3454,1440,1442,732,2012,708,16,7,1795,853,1725,821,70,32,32,,,,558,271,488,243,11,4,51,21,8,3,28,83,52
E02001569,Doncaster 031,Middle Super Output Areas and Intermediate Zones,MSOAIZ,S,9055,3926,5234,2147,1925,966,3309,1181,59,23,2035,955,1666,774,369,181,181,,,,1659,762,1554,715,5,4,86,37,14,6,47,68,39
E02001570,Doncaster 032,Middle Super Output Areas and Intermediate Zones,MSOAIZ,S,6898,3114,3311,1351,1187,582,2124,769,8,5,2632,1305,2300,1131,332,174,174,,,,789,364,707,325,6,1,69,33,7,5,39,158,89
E02001571,Doncaster 033,Middle Super Output Areas and Intermediate Zones,MSOAIZ,S,6052,2620,4834,2043,2163,1110,2671,933,10,7,364,193,351,186,13,7,7,,,,767,327,685,293,7,2,73,30,2,2,34,77,50
E02001572,Doncaster 034,Middle Super Output Areas and Intermediate Zones,MSOAIZ,DN,7192,2997,4449,1784,1470,747,2979,1037,6,3,1547,740,1345,627,202,113,113,,,,1085,417,984,379,15,8,82,28,4,2,38,105,53
E02001573,Doncaster 035,Middle Super Output Areas and Intermediate Zones,MSOAIZ,DN,7811,3126,5471,2141,1904,927,3567,1214,5,3,1338,575,1289,548,49,27,27,,,,880,333,788,295,4,1,84,36,4,1,38,117,74
E02001574,Doncaster 036,Middle Super Output Areas and Intermediate Zones,MSOAIZ,DN,6208,2596,5232,2176,1877,962,3355,1214,15,11,252,115,221,99,31,16,16,,,,680,279,599,247,13,5,61,25,7,2,32,29,15
E02001575,Doncaster 037,Middle Super Output Areas and Intermediate Zones,MSOAIZ,DN,7146,2941,3996,1566,1171,582,2825,984,10,4,2060,917,1999,888,61,29,29,,,,983,389,888,353,5,2,83,31,7,3,36,97,65
E02001576,Doncaster 038,Middle Super Output Areas and Intermediate Zones,MSOAIZ,DN,5801,2459,4198,1728,1527,801,2671,927,63,33,723,312,296,135,427,177,177,,,,769,350,694,318,2,1,61,27,12,4,32,48,36
E02001577,Doncaster 039,Middle Super Output Areas and Intermediate Zones,MSOAIZ,DN,6425,2981,5178,2342,2679,1410,2499,932,18,10,492,275,432,242,60,33,33,,,,639,294,552,259,4,1,63,27,20,7,35,98,60
E02001578,Rotherham 001,Middle Super Output Areas and Intermediate Zones,MSOAIZ,S,9366,3946,6579,2604,1899,945,4680,1659,14,7,1759,873,1650,816,109,57,57,,,,925,402,811,348,2,1,102,47,10,6,54,89,60
E02001579,Rotherham 002,Middle Super Output Areas and Intermediate Zones,MSOAIZ,S,9079,3919,5799,2359,2306,1168,3493,1191,50,25,2253,1076,1882,890,371,186,186,,,,867,388,809,359,6,2,48,24,4,3,29,110,71
E02001580,Rotherham 003,Middle Super Output Areas and Intermediate Zones,MSOAIZ,S,8212,3681,5988,2555,2730,1394,3258,1161,16,11,1402,716,1214,592,188,124,124,,,,722,343,654,311,6,3,56,24,6,5,32,84,56
E02001581,Rotherham 004,Middle Super Output Areas and Intermediate Zones,MSOAIZ,S,5814,2466,3903,1641,1537,791,2366,850,9,3,1510,644,1476,620,34,24,24,,,,325,140,286,122,0,0,36,15,3,3,18,67,38
E02001582,Rotherham 005,Middle Super Output Areas and Intermediate Zones,MSOAIZ,S,7174,3044,4749,1888,1816,892,2933,996,20,7,1915,934,1832,901,83,33,33,,,,417,171,369,150,2,2,42,17,4,2,21,73,44
E02001583,Rotherham 006,Middle Super Output Areas and Intermediate Zones,MSOAIZ,S,5661,2423,3826,1611,1395,721,2431,890,48,26,951,417,818,352,133,65,65,,,,789,340,709,307,5,1,73,31,2,1,33,47,29
E02001584,Rotherham 007,Middle Super Output Areas and Intermediate Zones,MSOAIZ,S,7080,2994,5666,2311,2283,1100,3383,1211,6,4,519,251,371,167,148,84,84,,,,809,392,740,364,4,1,37,15,28,12,28,80,36
E02001585,Rotherham 008,Middle Super Output Areas and Intermediate Zones,MSOAIZ,S,6131,2772,3161,1298,941,478,2220,820,19,8,1921,976,1593,818,328,158,158,,,,913,420,851,388,2,2,52,26,8,4,32,117,70
E02001586,Rotherham 009,Middle Super Output Areas and Intermediate Zones,MSOAIZ,S,8048,3992,4421,1875,1616,829,2805,1046,9,6,2908,1754,2700,1620,208,134,134,,,,609,284,537,246,1,1,53,29,18,8,38,101,73
E02001587,Rotherham 010,Middle Super Output Areas and Intermediate Zones,MSOAIZ,S,5774,2558,3002,1227,1115,543,1887,684,3,2,2093,1033,1809,891,284,142,142,,,,597,245,527,214,3,2,45,20,22,9,31,79,51
E02001588,Rotherham 011,Middle Super Output Areas and Intermediate Zones,MSOAIZ,S,7078,3022,3823,1519,1153,622,2670,897,5,3,2748,1286,2724,1277,24,9,9,,,,409,153,365,136,0,0,44,17,0,0,17,93,61
E02001589,Rotherham 012,Middle Super Output Areas and Intermediate Zones,MSOAIZ,S,8162,3448,6878,2838,2281,1183,4597,1655,21,17,416,224,381,209,35,15,15,,,,803,337,670,279,6,3,113,50,14,5,58,44,32
E02001590,Rotherham 013,Middle Super Output Areas and Intermediate Zones,MSOAIZ,S,7473,2913,2859,1048,833,375,2026,673,6,3,3790,1543,3555,1440,235,103,103,,,,656,236,587,211,10,4,49,18,10,3,25,162,83
E02001591,Rotherham 014,Middle Super Output Areas and Intermediate Zones,MSOAIZ,S,8219,3267,4202,1579,1614,720,2588,859,19,10,2573,1101,1936,737,637,364,364,,,,1291,504,1199,470,13,3,71,26,8,5,34,134,73
E02001592,Rotherham 015,Middle Super Output Areas and Intermediate Zones,MSOAIZ,S,8863,3766,6654,2773,2653,1350,4001,1423,48,24,1485,661,1378,591,107,70,70,,,,585,253,533,226,8,2,44,25,0,0,27,91,55
E02001593,Rotherham 016,Middle Super Output Areas and Intermediate Zones,MSOAIZ,S,7034,2853,3319,1197,1427,551,1892,646,24,7,1868,887,978,478,890,409,409,,,,1612,675,1512,635,9,3,74,32,17,5,40,211,87
E02001594,Rotherham 017,Middle Super Output Areas and Intermediate Zones,MSOAIZ,S,6564,2833,2667,1001,1174,488,1493,513,51,18,1746,914,1107,540,639,374,374,,,,1879,796,1802,760,3,2,48,20,26,14,36,221,104
E02001595,Rotherham 018,Middle Super Output Areas and Intermediate Zones,MSOAIZ,S,8658,3577,7197,2909,2376,1196,4821,1713,10,2,689,336,605,295,84,41,41,,,,668,271,581,233,10,3,77,35,0,0,38,94,59
E02001596,Rotherham 019,Middle Super Output Areas and Intermediate Zones,MSOAIZ,S,8557,3687,6027,2462,2432,1225,3595,1237,13,8,1174,599,954,455,220,144,144,,,,1262,581,1200,554,0,0,57,24,5,3,27,81,37
E02001597,Rotherham 020,Middle Super Output Areas and Intermediate Zones,MSOAIZ,S,9481,4060,5244,2212,2134,1100,3110,1112,19,10,2223,968,1205,538,1018,430,430,,,,1877,795,1752,746,5,3,88,34,32,12,49,118,75
E02001598,Rotherham 021,Middle Super Output Areas and Intermediate Zones,MSOAIZ,S,9575,4068,6980,2793,2824,1413,4156,1380,29,13,1558,806,1303,645,255,161,161,,,,895,390,828,357,7,3,57,27,3,3,33,113,66
E02001599,Rotherham 022,Middle Super Output Areas and Intermediate Zones,MSOAIZ,S,6250,2627,5293,2111,2034,1017,3259,1094,24,20,413,238,354,195,59,43,43,,,,465,227,401,194,6,2,55,29,3,2,33,55,31
E02001600,Rotherham 023,Middle Super Output Areas and Intermediate Zones,MSOAIZ,S,10729,4126,8398,3077,3834,1721,4564,1356,15,7,886,469,604,308,282,161,161,,,,1300,508,1182,472,9,4,78,28,31,4,36,130,65
E02001601,Rotherham 024,Middle Super Output Areas and Intermediate Zones,MSOAIZ,S,5027,2188,3876,1607,1624,827,2252,780,10,6,714,373,622,318,92,55,55,,,,377,168,333,146,4,2,37,18,3,2,22,50,34
E02001602,Rotherham 025,Middle Super Output Areas and Intermediate Zones,MSOAIZ,S,8960,3745,6801,2775,2696,1382,4105,1393,32,16,1058,528,839,437,219,91,91,,,,971,383,884,342,11,7,59,26,17,8,41,98,43
E02001603,Rotherham 026,Middle Super Output Areas and Intermediate Zones,MSOAIZ,S,6562,2794,4439,1823,1714,873,2725,950,16,7,992,509,973,501,19,8,8,,,,1012,394,950,364,4,2,56,26,2,2,30,103,61
E02001604,Rotherham 027,Middle Super Output Areas and Intermediate Zones,MSOAIZ,S,8455,3455,6100,2379,1807,877,4293,1502,13,6,1239,585,1154,545,85,40,40,,,,1020,430,936,396,6,2,72,30,6,2,34,83,55
E02001605,Rotherham 028,Middle Super Output Areas and Intermediate Zones,MSOAIZ,S,7216,3079,5503,2272,1836,927,3667,1345,7,5,684,361,479,250,205,111,111,,,,953,400,856,355,8,3,73,31,16,11,45,69,41
E02001606,Rotherham 029,Middle Super Output Areas and Intermediate Zones,MSOAIZ,S,7896,3306,5862,2396,2271,1153,3591,1243,14,7,820,376,760,334,60,42,42,,,,1126,486,1050,448,10,5,62,30,4,3,38,74,41
E02001607,Rotherham 030,Middle Super Output Areas and Intermediate Zones,MSOAIZ,S,8788,3755,6222,2601,2528,1292,3694,1309,9,5,1777,817,1524,741,253,76,76,,,,695,275,618,243,0,0,69,29,8,3,32,85,57
E02001608,Rotherham 031,Middle Super Output Areas and Intermediate Zones,MSOAIZ,S,6872,2818,5672,2274,1924,983,3748,1291,6,2,574,246,542,236,32,10,10,,,,567,266,510,239,0,0,48,22,9,5,27,53,30
E02001609,Rotherham 032,Middle Super Output Areas and Intermediate Zones,MSOAIZ,S,8353,3578,6962,2920,3208,1622,3754,1298,1,1,799,380,788,375,11,5,5,,,,535,236,469,205,7,2,54,26,5,3,31,56,41
E02001610,Rotherham 033,Middle Super Output Areas and Intermediate Zones,MSOAIZ,S,8223,3533,6505,2675,2526,1273,3979,1402,25,13,769,408,595,324,174,84,84,,,,826,373,758,333,7,4,51,29,10,7,40,98,64
E02001611,Sheffield 001,Middle Super Output Areas and Intermediate Zones,MSOAIZ,S,7463,3356,5645,2399,2279,1201,3366,1198,10,5,1043,595,950,542,93,53,53,,,,702,321,634,283,1,1,52,25,15,12,38,63,36
E02001612,Sheffield 002,Middle Super Output Areas and Intermediate Zones,MSOAIZ,S,5844,2539,4893,2046,1853,947,3040,1099,6,4,487,275,458,265,29,10,10,,,,424,191,394,177,0,0,30,14,0,0,14,34,23
E02001613,Sheffield 003,Middle Super Output Areas and Intermediate Zones,MSOAIZ,S,10425,4522,7720,3213,2928,1459,4792,1754,22,7,2030,993,1928,931,102,62,62,,,,589,274,549,251,0,0,35,18,5,5,23,64,35
E02001614,Sheffield 004,Middle Super Output Areas and Intermediate Zones,MSOAIZ,S,11083,4728,9490,3921,3409,1778,6081,2143,27,11,807,441,727,390,80,51,51,,,,698,324,613,280,7,3,73,38,5,3,44,61,31
E02001615,Sheffield 005,Middle Super Output Areas and Intermediate Zones,MSOAIZ,S,7457,3289,6446,2800,2998,1540,3448,1260,14,7,393,176,317,148,76,28,28,,,,557,274,503,248,9,4,40,21,5,1,26,47,32
E02001616,Sheffield 006,Middle Super Output Areas and Intermediate Zones,MSOAIZ,S,7086,3116,4815,1934,1711,867,3104,1067,21,12,1800,931,1739,890,61,41,41,,,,408,214,367,190,5,2,33,20,3,2,24,42,25
E02001617,Sheffield 007,Middle Super Output Areas and Intermediate Zones,MSOAIZ,S,5615,2287,2460,1002,598,330,1862,672,1,1,2720,1115,560,244,2160,871,871,,,,408,155,378,140,0,0,20,10,10,5,15,26,14
E02001618,Sheffield 008,Middle Super Output Areas and Intermediate Zones,MSOAIZ,S,9581,4057,7625,3071,2775,1368,4850,1703,33,17,983,498,723,377,260,121,121,,,,848,426,738,374,7,3,75,37,28,12,52,92,45
E02001619,Sheffield 009,Middle Super Output Areas and Intermediate Zones,MSOAIZ,S,9391,3996,4550,1886,1574,803,2976,1083,4,3,4383,1918,4273,1872,110,46,46,,,,420,167,343,133,2,1,71,30,4,3,34,34,22
E02001620,Sheffield 010,Middle Super Output Areas and Intermediate Zones,MSOAIZ,S,6563,2773,2937,1203,784,409,2153,794,39,18,2889,1236,1017,394,1872,842,842,,,,645,296,559,258,5,1,26,17,55,20,38,53,20
E02001621,Sheffield 011,Middle Super Output Areas and Intermediate Zones,MSOAIZ,S,5435,2305,2625,1070,945,488,1680,582,3,2,2337,1046,2043,899,294,147,147,,,,437,169,405,156,3,1,28,11,1,1,13,33,18
E02001622,Sheffield 012,Middle Super Output Areas and Intermediate Zones,MSOAIZ,S,8805,4004,4310,1885,1544,815,2766,1070,8,4,3836,1809,3484,1585,352,224,224,,,,614,279,544,245,3,1,50,25,17,8,34,37,27
E02001623,Sheffield 013,Middle Super Output Areas and Intermediate Zones,MSOAIZ,S,8163,3301,2926,1120,960,467,1966,653,28,9,4483,1928,3746,1626,737,302,302,,,,645,217,582,194,0,0,47,20,16,3,23,81,27
E02001624,Sheffield 014,Middle Super Output Areas and Intermediate Zones,MSOAIZ,S,9620,4020,6359,2641,2505,1177,3854,1464,17,11,1612,739,673,355,939,384,384,,,,1508,598,1398,554,8,2,94,39,8,3,44,124,31
E02001625,Sheffield 015,Middle Super Output Areas and Intermediate Zones,MSOAIZ,S,7712,3179,3249,1350,995,523,2254,827,9,3,3940,1624,3276,1351,664,273,273,,,,475,181,411,152,19,6,32,15,13,8,29,39,21
E02001626,Sheffield 016,Middle Super Output Areas and Intermediate Zones,MSOAIZ,S,5910,2474,4307,1764,1612,810,2695,954,10,4,896,386,112,38,784,348,348,,,,666,303,604,272,2,1,48,24,12,6,31,31,17
E02001627,Sheffield 017,Middle Super Output Areas and Intermediate Zones,MSOAIZ,S,6068,2788,3680,1701,1147,642,2533,1059,14,10,1009,401,877,325,132,76,76,,,,1305,646,1207,596,0,0,84,44,14,6,50,60,30
E02001628,Sheffield 018,Middle Super Output Areas and Intermediate Zones,MSOAIZ,S,6277,2235,3212,1027,1615,563,1597,464,39,15,1675,711,1084,505,591,206,206,,,,1222,438,1014,376,19,8,152,43,37,11,62,129,44
E02001629,Sheffield 019,Middle Super Output Areas and Intermediate Zones,MSOAIZ,S,6402,2858,2832,1119,1126,518,1706,601,38,17,2778,1408,2348,1205,430,203,203,,,,692,289,627,264,4,2,43,16,18,7,25,62,25
E02001630,Sheffield 020,Middle Super Output Areas and Intermediate Zones,MSOAIZ,S,8547,2802,5138,1618,2787,916,2351,702,31,9,1408,562,757,313,651,249,249,,,,1766,557,1658,521,6,2,74,24,28,10,36,204,56
E02001631,Sheffield 021,Middle Super Output Areas and Intermediate Zones,MSOAIZ,S,7746,3357,5647,2358,1959,987,3688,1371,13,5,1089,540,252,129,837,411,411,,,,959,430,849,373,6,3,82,41,22,13,57,38,24
E02001632,Sheffield 022,Middle Super Output Areas and Intermediate Zones,MSOAIZ,S,12188,4370,3949,1287,2046,687,1903,600,203,107,4542,1685,2916,1196,1626,489,489,,,,3225,1189,3084,1133,2,1,82,35,57,20,56,269,102
E02001633,Sheffield 023,Middle Super Output Areas and Intermediate Zones,MSOAIZ,S,7393,3177,6267,2576,2716,1372,3551,1204,2,2,681,396,520,310,161,86,86,,,,402,183,329,153,8,2,59,25,6,3,30,41,20
E02001634,Sheffield 024,Middle Super Output Areas and Intermediate Zones,MSOAIZ,S,9214,4398,6001,2849,2337,1263,3664,1586,30,13,916,496,579,299,337,197,197,,,,2204,1008,2040,933,6,2,147,68,11,5,75,63,32
E02001635,Sheffield 025,Middle Super Output Areas and Intermediate Zones,MSOAIZ,S,6001,2930,4223,1853,1751,930,2472,923,2,1,1481,939,1429,908,52,31,31,,,,260,119,197,90,0,0,57,25,6,4,29,35,18
E02001636,Sheffield 026,Middle Super Output Areas and Intermediate Zones,MSOAIZ,S,8757,4176,2837,1261,1056,540,1781,721,39,22,3775,2083,2904,1772,871,311,311,,,,1991,764,1820,704,5,2,106,39,60,19,60,115,46
E02001637,Sheffield 027,Middle Super Output Areas and Intermediate Zones,MSOAIZ,S,6925,2350,2888,855,1150,375,1738,480,50,16,2596,1078,1244,651,1352,427,427,,,,1275,362,1139,328,4,1,87,21,45,12,34,116,39
E02001638,Sheffield 028,Middle Super Output Areas and Intermediate Zones,MSOAIZ,S,6318,2218,2057,942,785,437,1272,505,39,13,175,103,128,83,47,20,20,,,,4001,1136,3777,1060,6,2,180,68,38,6,76,46,24
E02001639,Sheffield 029,Middle Super Output Areas and Intermediate Zones,MSOAIZ,S,6100,2779,3548,1664,1468,813,2080,851,25,10,324,229,257,188,67,41,41,,,,2142,845,1974,779,5,2,158,61,5,3,66,61,31
E02001640,Sheffield 030,Middle Super Output Areas and Intermediate Zones,MSOAIZ,S,8178,2871,2346,967,955,456,1391,511,57,27,736,470,265,180,471,290,290,,,,4976,1378,4853,1337,0,0,80,29,43,12,41,63,29
E02001642,Sheffield 032,Middle Super Output Areas and Intermediate Zones,MSOAIZ,S,9589,4011,7418,3020,2713,1349,4705,1671,17,7,875,471,776,429,99,42,42,,,,1205,483,1066,419,3,2,122,56,14,6,64,74,30
E02001643,Sheffield 033,Middle Super Output Areas and Intermediate Zones,MSOAIZ,S,6288,2729,5354,2182,2420,1223,2934,959,6,4,443,312,327,226,116,86,86,,,,427,199,393,180,0,0,30,17,4,2,19,58,32
E02001646,Sheffield 036,Middle Super Output Areas and Intermediate Zones,MSOAIZ,S,7938,2758,2355,1029,1052,552,1303,477,39,13,658,289,283,121,375,168,168,,,,4822,1398,4173,1239,67,28,48,21,534,110,159,64,29
E02001647,Sheffield 037,Middle Super Output Areas and Intermediate Zones,MSOAIZ,S,6052,2682,4325,1825,1654,890,2671,935,30,17,1217,629,629,292,588,337,337,,,,454,193,376,164,7,2,66,23,5,4,29,26,18
E02001648,Sheffield 038,Middle Super Output Areas and Intermediate Zones,MSOAIZ,S,6851,2769,4276,1870,1930,1013,2346,857,14,5,449,145,60,20,389,125,125,,,,2072,726,1370,561,29,12,44,24,629,129,165,40,23
E02001649,Sheffield 039,Middle Super Output Areas and Intermediate Zones,MSOAIZ,S,9424,4178,3023,1217,752,395,2271,822,29,13,5199,2436,1564,800,3635,1636,1636,,,,1088,476,942,406,12,6,72,34,62,30,70,85,36
E02001650,Sheffield 040,Middle Super Output Areas and Intermediate Zones,MSOAIZ,S,7687,3391,1775,696,715,328,1060,368,18,5,2399,1252,1764,949,635,303,303,,,,3392,1391,3263,1338,17,7,65,29,47,17,53,103,47
E02001651,Sheffield 041,Middle Super Output Areas and Intermediate Zones,MSOAIZ,S,8145,3306,7481,3015,3402,1718,4079,1297,10,6,129,65,117,61,12,4,4,,,,474,197,426,172,2,2,42,22,4,1,25,51,23
E02001652,Sheffield 042,Middle Super Output Areas and Intermediate Zones,MSOAIZ,S,10310,3791,3317,1162,1200,472,2117,690,65,36,1533,594,719,341,814,253,253,,,,5232,1944,4825,1815,20,6,170,69,217,54,129,163,55
E02001653,Sheffield 043,Middle Super Output Areas and Intermediate Zones,MSOAIZ,S,6756,3101,2211,992,744,381,1467,611,70,33,3374,1557,2230,1070,1144,487,487,,,,1063,494,950,450,10,6,48,24,55,14,44,38,25
E02001654,Sheffield 044,Middle Super Output Areas and Intermediate Zones,MSOAIZ,S,6265,2639,4558,1827,1619,827,2939,1000,58,39,1238,595,747,309,491,286,286,,,,386,163,359,146,0,0,22,12,5,5,17,25,15
E02001655,Sheffield 045,Middle Super Output Areas and Intermediate Zones,MSOAIZ,S,7621,3419,4371,1811,1480,760,2891,1051,11,6,2611,1330,1670,952,941,378,378,,,,597,253,527,219,0,0,52,25,18,9,34,31,19
E02001656,Sheffield 046,Middle Super Output Areas and Intermediate Zones,MSOAIZ,S,7769,3042,4822,2012,1872,986,2950,1026,23,7,154,65,70,25,84,40,40,,,,2711,929,2560,874,13,4,109,46,29,5,55,59,29
E02001657,Sheffield 047,Middle Super Output Areas and Intermediate Zones,MSOAIZ,S,8985,3619,7466,3019,2810,1454,4656,1565,20,11,125,66,32,15,93,51,51,,,,1332,502,1245,469,8,3,78,29,1,1,33,42,21
E02001658,Sheffield 048,Middle Super Output Areas and Intermediate Zones,MSOAIZ,S,5360,2321,1783,738,485,256,1298,482,6,3,3132,1401,2919,1295,213,106,106,,,,400,158,334,142,0,0,13,7,53,9,16,39,21
E02001659,Sheffield 049,Middle Super Output Areas and Intermediate Zones,MSOAIZ,S,6063,2976,3197,1372,1041,558,2156,814,11,9,2318,1355,2125,1218,193,137,137,,,,500,219,455,199,8,2,31,15,6,3,20,37,21
E02001660,Sheffield 050,Middle Super Output Areas and Intermediate Zones,MSOAIZ,S,9702,4084,6494,2501,2478,1118,4016,1383,80,45,494,296,134,62,360,234,234,,,,2542,1199,2370,1126,11,4,119,55,42,14,73,92,43
E02001661,Sheffield 051,Middle Super Output Areas and Intermediate Zones,MSOAIZ,S,7717,3647,3526,1566,1255,636,2271,930,20,8,3118,1619,2661,1398,457,221,221,,,,988,423,831,363,3,2,81,41,73,17,60,65,31
E02001662,Sheffield 052,Middle Super Output Areas and Intermediate Zones,MSOAIZ,S,7523,3394,5304,2324,1999,1094,3305,1230,7,4,1390,704,831,448,559,256,256,,,,773,333,643,283,3,2,111,38,16,10,50,49,29
E02001663,Sheffield 053,Middle Super Output Areas and Intermediate Zones,MSOAIZ,S,7616,3343,5470,2322,1668,837,3802,1485,11,6,330,144,92,35,238,109,109,,,,1755,849,1625,792,5,2,112,50,13,5,57,50,22
E02001664,Sheffield 054,Middle Super Output Areas and Intermediate Zones,MSOAIZ,S,6150,2768,4622,2048,1912,1034,2710,1014,5,2,1007,493,949,462,58,31,31,,,,487,208,434,185,0,0,48,21,5,2,23,29,17
E02001665,Sheffield 055,Middle Super Output Areas and Intermediate Zones,MSOAIZ,S,9406,3794,8707,3459,3833,1906,4874,1553,9,6,196,99,88,44,108,55,55,,,,451,202,411,184,10,3,26,13,4,2,18,43,28
E02001666,Sheffield 056,Middle Super Output Areas and Intermediate Zones,MSOAIZ,S,6187,2584,3912,1557,1124,579,2788,978,30,15,1611,750,1293,618,318,132,132,,,,606,246,539,216,3,3,53,24,11,3,30,28,16
E02001669,Sheffield 059,Middle Super Output Areas and Intermediate Zones,MSOAIZ,S,7642,3500,5580,2507,1894,1031,3686,1476,13,7,474,217,391,178,83,39,39,,,,1523,744,1378,678,9,4,124,58,12,4,66,52,25
E02001670,Sheffield 060,Middle Super Output Areas and Intermediate Zones,MSOAIZ,S,5912,2766,2677,1169,924,512,1753,657,12,8,2732,1377,2528,1238,204,139,139,,,,454,188,376,164,7,3,47,16,24,5,24,37,24
E02001671,Sheffield 061,Middle Super Output Areas and Intermediate Zones,MSOAIZ,S,5965,2669,4802,2070,1918,984,2884,1086,25,16,823,423,548,303,275,120,120,,,,279,140,240,120,0,0,37,19,2,1,20,36,20
E02001672,Sheffield 062,Middle Super Output Areas and Intermediate Zones,MSOAIZ,S,6080,2734,4619,1949,1819,979,2800,970,5,5,959,553,872,494,87,59,59,,,,458,199,381,171,5,2,68,25,4,1,28,39,28
E02001673,Sheffield 063,Middle Super Output Areas and Intermediate Zones,MSOAIZ,S,5525,2195,4857,1911,1376,664,3481,1247,21,9,218,72,129,38,89,34,34,,,,408,191,380,177,1,1,27,13,0,0,14,21,12
E02001674,Sheffield 064,Middle Super Output Areas and Intermediate Zones,MSOAIZ,S,8612,3904,7412,3169,3252,1706,4160,1463,13,7,650,454,428,307,222,147,147,,,,481,238,396,198,10,4,64,32,11,4,40,56,36
E02001675,Sheffield 065,Middle Super Output Areas and Intermediate Zones,MSOAIZ,S,8992,4149,5887,2559,2054,1091,3833,1468,15,6,2425,1305,2056,1114,369,191,191,,,,632,255,530,210,13,4,76,35,13,6,45,33,24
E02001676,Sheffield 066,Middle Super Output Areas and Intermediate Zones,MSOAIZ,S,5977,2514,5457,2230,2152,1127,3305,1103,1,1,252,151,241,146,11,5,5,,,,250,119,216,102,6,3,22,10,6,4,17,17,13
E02001678,Sheffield 068,Middle Super Output Areas and Intermediate Zones,MSOAIZ,S,9960,4344,8743,3712,4263,2206,4480,1506,7,3,459,280,419,260,40,20,20,,,,679,312,611,283,29,9,36,18,3,2,29,72,37
E02001679,Sheffield 069,Middle Super Output Areas and Intermediate Zones,MSOAIZ,S,6273,3011,3341,1493,1273,724,2068,769,18,9,2350,1275,2236,1203,114,72,72,,,,527,215,460,189,15,1,48,22,4,3,26,37,19
E02001680,Sheffield 070,Middle Super Output Areas and Intermediate Zones,MSOAIZ,S,6084,3133,2281,1017,770,434,1511,583,27,15,3289,1879,3146,1775,143,104,104,,,,437,191,386,166,0,0,47,23,4,2,25,50,31
E02001681,Sheffield 071,Middle Super Output Areas and Intermediate Zones,MSOAIZ,S,7400,3332,6263,2702,2655,1418,3608,1284,11,7,712,413,531,287,181,126,126,,,,376,185,334,162,7,2,35,21,0,0,23,38,25
E02001682,Gateshead 001,Middle Super Output Areas and Intermediate Zones,MSOAIZ,NE,7819,3431,5773,2405,2159,1128,3614,1277,24,10,1491,770,1064,524,427,246,246,,,,479,218,418,189,0,0,60,28,1,1,29,52,28
E02001683,Gateshead 002,Middle Super Output Areas and Intermediate Zones,MSOAIZ,NE,9034,4002,7092,3072,2706,1419,4386,1653,31,14,894,442,832,392,62,50,50,,,,979,451,885,406,9,4,73,36,12,5,45,38,23
E02001684,Gateshead 003,Middle Super Output Areas and Intermediate Zones,MSOAIZ,NE,6813,3311,3012,1402,1088,585,1924,817,46,26,2658,1324,2274,1049,384,275,275,,,,1056,528,953,471,0,0,81,43,22,14,57,41,31
E02001685,Gateshead 004,Middle Super Output Areas and Intermediate Zones,MSOAIZ,NE,8247,3612,4237,1811,1178,627,3059,1184,68,28,3274,1463,2892,1258,382,205,205,,,,614,282,568,254,1,1,39,22,6,5,28,54,28
E02001686,Gateshead 005,Middle Super Output Areas and Intermediate Zones,MSOAIZ,NE,6949,3168,5410,2392,2159,1141,3251,1251,23,8,933,477,862,430,71,47,47,,,,540,263,484,234,9,3,43,24,4,2,29,43,28
E02001688,Gateshead 007,Middle Super Output Areas and Intermediate Zones,MSOAIZ,NE,7672,3799,3099,1381,769,410,2330,971,82,32,3081,1703,2470,1401,611,302,302,,,,1351,646,1238,588,1,1,94,50,18,7,58,59,37
E02001689,Gateshead 008,Middle Super Output Areas and Intermediate Zones,MSOAIZ,NE,7718,3351,3263,1255,1168,500,2095,755,37,17,1850,985,1063,583,787,402,402,,,,2488,1058,2315,991,9,5,139,54,25,8,67,80,36
E02001690,Gateshead 009,Middle Super Output Areas and Intermediate Zones,MSOAIZ,NE,7511,3325,5047,2136,1878,974,3169,1162,17,7,1415,714,1169,539,246,175,175,,,,956,430,869,395,13,4,68,28,6,3,35,76,38
E02001691,Gateshead 010,Middle Super Output Areas and Intermediate Zones,MSOAIZ,NE,8268,3876,3876,1737,1404,730,2472,1007,14,7,1132,591,722,349,410,242,242,,,,3177,1502,2969,1417,24,9,169,72,15,4,85,69,39
E02001692,Gateshead 011,Middle Super Output Areas and Intermediate Zones,MSOAIZ,NE,6414,2765,2429,1021,705,355,1724,666,29,14,3423,1442,1999,759,1424,683,683,,,,508,273,440,237,7,2,46,27,15,7,36,25,15
E02001693,Gateshead 012,Middle Super Output Areas and Intermediate Zones,MSOAIZ,NE,5570,2633,2656,1131,871,466,1785,665,16,5,2425,1274,2063,1019,362,255,255,,,,449,205,396,174,3,2,44,25,6,4,31,24,18
E02001694,Gateshead 013,Middle Super Output Areas and Intermediate Zones,MSOAIZ,NE,6562,2814,4822,2017,1746,902,3076,1115,13,7,1036,483,870,397,166,86,86,,,,649,284,553,243,0,0,92,40,4,1,41,42,23
E02001695,Gateshead 014,Middle Super Output Areas and Intermediate Zones,MSOAIZ,NE,6345,2702,5018,2041,1576,809,3442,1232,7,3,958,481,845,395,113,86,86,,,,344,165,314,150,0,0,29,14,1,1,15,18,12
E02001696,Gateshead 015,Middle Super Output Areas and Intermediate Zones,MSOAIZ,NE,9399,4065,5008,2082,1652,875,3356,1207,3,3,3844,1749,3224,1425,620,324,324,,,,462,191,424,170,3,1,28,15,7,5,21,82,40
E02001697,Gateshead 016,Middle Super Output Areas and Intermediate Zones,MSOAIZ,NE,7709,3386,6204,2589,2198,1120,4006,1469,28,26,746,402,670,347,76,55,55,,,,688,343,628,315,0,0,58,27,2,1,28,43,26
E02001698,Gateshead 017,Middle Super Output Areas and Intermediate Zones,MSOAIZ,NE,7203,3202,6461,2839,3255,1724,3206,1115,12,4,310,162,261,133,49,29,29,,,,346,166,304,147,0,0,37,18,5,1,19,74,31
E02001699,Gateshead 018,Middle Super Output Areas and Intermediate Zones,MSOAIZ,NE,6942,3124,4301,1828,1446,771,2855,1057,33,14,2088,1039,1664,826,424,213,213,,,,479,218,416,185,2,1,50,28,11,4,33,41,25
E02001700,Gateshead 019,Middle Super Output Areas and Intermediate Zones,MSOAIZ,NE,10579,4585,8056,3422,2893,1501,5163,1921,21,9,1643,794,1497,694,146,100,100,,,,771,313,705,281,2,1,62,30,2,1,32,88,47
E02001701,Gateshead 020,Middle Super Output Areas and Intermediate Zones,MSOAIZ,NE,6152,2763,5413,2323,2303,1201,3110,1122,27,19,248,163,140,79,108,84,84,,,,421,230,373,200,3,1,39,27,6,2,30,43,28
E02001702,Gateshead 021,Middle Super Output Areas and Intermediate Zones,MSOAIZ,NE,7997,3522,3289,1361,1137,587,2152,774,14,6,4205,1951,3705,1659,500,292,292,,,,442,179,384,153,0,0,40,19,18,7,26,47,25
E02001703,Gateshead 022,Middle Super Output Areas and Intermediate Zones,MSOAIZ,NE,5699,2435,4398,1818,1830,947,2568,871,40,23,971,459,914,419,57,40,40,,,,273,125,233,103,6,3,28,15,6,4,22,17,10
E02001704,Gateshead 023,Middle Super Output Areas and Intermediate Zones,MSOAIZ,NE,7150,3380,4040,1755,1434,805,2606,950,4,4,2629,1397,2516,1334,113,63,63,,,,421,184,348,154,0,0,72,29,1,1,30,56,40
E02001705,Gateshead 024,Middle Super Output Areas and Intermediate Zones,MSOAIZ,NE,6979,3200,4647,2048,2017,1051,2630,997,7,6,1230,619,1150,568,80,51,51,,,,1040,492,969,464,7,3,59,22,5,3,28,55,35
E02001706,Gateshead 025,Middle Super Output Areas and Intermediate Zones,MSOAIZ,NE,6597,2924,3780,1579,1322,697,2458,882,9,4,2353,1123,2065,981,288,142,142,,,,389,184,341,159,0,0,46,24,2,1,25,66,34
E02001707,Gateshead 026,Middle Super Output Areas and Intermediate Zones,MSOAIZ,NE,8248,3599,5463,2251,1911,980,3552,1271,61,38,1712,886,1493,738,219,148,148,,,,953,386,890,356,2,1,61,29,0,0,30,59,38
E02001708,Newcastle upon Tyne 001,Middle Super Output Areas and Intermediate Zones,MSOAIZ,NE,9684,4122,7112,2980,2499,1286,4613,1694,9,4,1347,643,1123,512,224,131,131,,,,1169,470,1084,430,4,2,68,33,13,5,40,47,25
E02001709,Newcastle upon Tyne 002,Middle Super Output Areas and Intermediate Zones,MSOAIZ,NE,10207,4218,8095,3215,3037,1539,5058,1676,11,7,428,179,403,161,25,18,18,,,,1622,792,1556,756,13,5,53,31,0,0,36,51,25
E02001710,Newcastle upon Tyne 003,Middle Super Output Areas and Intermediate Zones,MSOAIZ,NE,9726,4381,4692,2138,1725,989,2967,1149,55,25,3933,1732,3584,1538,349,194,194,,,,938,425,847,383,4,1,82,38,5,3,42,108,61
E02001711,Newcastle upon Tyne 004,Middle Super Output Areas and Intermediate Zones,MSOAIZ,NE,9559,4129,4848,2076,1673,874,3175,1202,82,27,3790,1648,3562,1492,228,156,156,,,,743,325,668,292,10,4,54,25,11,4,33,96,53
E02001712,Newcastle upon Tyne 005,Middle Super Output Areas and Intermediate Zones,MSOAIZ,NE,9588,4214,6643,2882,2636,1367,4007,1515,38,23,829,453,654,367,175,86,86,,,,2006,813,1755,717,7,5,91,49,153,42,96,72,43
E02001713,Newcastle upon Tyne 006,Middle Super Output Areas and Intermediate Zones,MSOAIZ,NE,10266,4389,7928,3270,3149,1607,4779,1663,18,15,861,462,645,322,216,140,140,,,,1384,602,1315,564,16,8,49,27,4,3,38,75,40
E02001714,Newcastle upon Tyne 007,Middle Super Output Areas and Intermediate Zones,MSOAIZ,NE,9526,3901,7887,3168,2918,1443,4969,1725,19,10,415,173,386,156,29,17,17,,,,1125,504,1008,441,13,6,100,53,4,4,63,80,46
E02001715,Newcastle upon Tyne 008,Middle Super Output Areas and Intermediate Zones,MSOAIZ,NE,11271,4712,5503,2248,1671,893,3832,1355,125,53,4399,1888,3944,1648,455,240,240,,,,1106,462,1009,412,2,1,92,46,3,3,50,138,61
E02001718,Newcastle upon Tyne 011,Middle Super Output Areas and Intermediate Zones,MSOAIZ,NE,5638,2427,2928,1204,886,467,2042,737,10,4,2073,979,1899,849,174,130,130,,,,558,201,406,156,83,19,56,22,13,4,45,69,39
E02001719,Newcastle upon Tyne 012,Middle Super Output Areas and Intermediate Zones,MSOAIZ,NE,8921,3759,6490,2707,2521,1300,3969,1407,18,7,1041,463,987,433,54,30,30,,,,1276,527,1169,479,8,3,96,42,3,3,48,96,55
E02001720,Newcastle upon Tyne 013,Middle Super Output Areas and Intermediate Zones,MSOAIZ,NE,9669,3343,2802,1251,1286,663,1516,588,62,22,248,165,78,48,170,117,117,,,,6482,1863,6256,1784,4,2,160,60,62,17,79,75,42
E02001721,Newcastle upon Tyne 014,Middle Super Output Areas and Intermediate Zones,MSOAIZ,NE,10171,4647,6459,2810,2417,1288,4042,1522,14,6,2666,1352,2122,1057,544,295,295,,,,939,424,848,380,7,4,78,38,6,2,44,93,55
E02001722,Newcastle upon Tyne 015,Middle Super Output Areas and Intermediate Zones,MSOAIZ,NE,9595,4195,5724,2455,2032,1122,3692,1333,26,14,2960,1364,2674,1202,286,162,162,,,,771,301,663,250,0,0,95,47,13,4,51,114,61
E02001723,Newcastle upon Tyne 016,Middle Super Output Areas and Intermediate Zones,MSOAIZ,NE,6304,2575,3533,1413,1099,556,2434,857,8,4,1777,721,1681,669,96,52,52,,,,932,410,847,371,6,1,69,35,10,3,39,54,27
E02001724,Newcastle upon Tyne 017,Middle Super Output Areas and Intermediate Zones,MSOAIZ,NE,8935,3575,2492,1236,1144,632,1348,604,102,60,505,363,120,73,385,290,290,,,,5763,1879,5546,1788,7,2,158,70,52,19,91,73,37
E02001725,Newcastle upon Tyne 018,Middle Super Output Areas and Intermediate Zones,MSOAIZ,NE,10141,4536,2361,1168,761,411,1600,757,45,20,2236,1362,1594,927,642,435,435,,,,5401,1936,5141,1827,6,3,201,85,53,21,109,98,50
E02001726,Newcastle upon Tyne 019,Middle Super Output Areas and Intermediate Zones,MSOAIZ,NE,11494,4687,6884,2710,2303,1154,4581,1556,41,17,2783,1290,2521,1127,262,163,163,,,,1671,607,1265,479,0,0,170,74,236,54,128,115,63
E02001727,Newcastle upon Tyne 020,Middle Super Output Areas and Intermediate Zones,MSOAIZ,NE,8520,3877,5663,2378,2148,1141,3515,1237,39,27,2030,1098,1798,938,232,160,160,,,,683,324,574,273,6,2,85,41,18,8,51,105,50
E02001728,Newcastle upon Tyne 021,Middle Super Output Areas and Intermediate Zones,MSOAIZ,NE,9669,4248,6161,2705,2117,1137,4044,1568,25,8,2303,987,2068,849,235,138,138,,,,1088,488,953,429,40,13,82,41,13,5,59,92,60
E02001729,Newcastle upon Tyne 022,Middle Super Output Areas and Intermediate Zones,MSOAIZ,NE,10974,4145,3544,1227,1563,609,1981,618,34,14,2751,1416,1100,686,1651,730,730,,,,4505,1430,4314,1366,11,3,122,41,58,20,64,140,58
E02001730,Newcastle upon Tyne 023,Middle Super Output Areas and Intermediate Zones,MSOAIZ,NE,10461,4835,2081,1060,773,443,1308,617,46,16,2904,1788,2406,1486,498,302,302,,,,5298,1889,5098,1803,15,6,148,64,37,16,86,132,82
E02001731,Newcastle upon Tyne 024,Middle Super Output Areas and Intermediate Zones,MSOAIZ,NE,10850,5587,1665,873,586,339,1079,534,66,25,4535,2520,2576,1187,1959,1333,1333,,,,4437,2089,3595,1832,31,13,99,51,712,193,257,147,80
E02001732,Newcastle upon Tyne 025,Middle Super Output Areas and Intermediate Zones,MSOAIZ,NE,5000,2193,2445,1058,885,468,1560,590,10,5,1942,859,1667,675,275,184,184,,,,568,249,527,223,0,0,27,16,14,10,26,35,22
E02001733,Newcastle upon Tyne 026,Middle Super Output Areas and Intermediate Zones,MSOAIZ,NE,11685,5675,3837,1784,1364,737,2473,1047,14,7,5699,2871,5176,2523,523,348,348,,,,1988,945,1877,886,0,0,86,47,25,12,59,147,68
E02001734,Newcastle upon Tyne 027,Middle Super Output Areas and Intermediate Zones,MSOAIZ,NE,7576,3233,3344,1391,1171,614,2173,777,19,10,2907,1331,1975,819,932,512,512,,,,1196,446,1122,411,3,2,52,24,19,9,35,110,55
E02001735,Newcastle upon Tyne 028,Middle Super Output Areas and Intermediate Zones,MSOAIZ,NE,6568,2884,1776,696,513,250,1263,446,3,2,4273,1960,4081,1824,192,136,136,,,,457,192,414,174,6,2,37,16,0,0,18,59,34
E02001736,Newcastle upon Tyne 029,Middle Super Output Areas and Intermediate Zones,MSOAIZ,NE,12628,4959,4070,1322,1390,559,2680,763,53,21,4720,2241,3669,1758,1051,483,483,,,,3485,1264,3261,1176,26,6,126,55,72,27,88,300,111
E02001737,Newcastle upon Tyne 030,Middle Super Output Areas and Intermediate Zones,MSOAIZ,NE,5931,2968,1500,644,493,272,1007,372,67,29,3865,2032,3091,1666,774,366,366,,,,363,171,320,144,0,0,27,15,16,12,27,136,92
E02001738,North Tyneside 001,Middle Super Output Areas and Intermediate Zones,MSOAIZ,NE,5622,2471,5292,2306,2598,1427,2694,879,2,2,52,27,31,15,21,12,12,,,,242,114,206,95,0,0,36,19,0,0,19,34,22
E02001739,North Tyneside 002,Middle Super Output Areas and Intermediate Zones,MSOAIZ,NE,7454,3355,4845,2034,1464,772,3381,1262,57,35,2040,1034,1573,774,467,260,260,,,,485,236,440,212,0,0,37,19,8,5,24,27,16
E02001740,North Tyneside 003,Middle Super Output Areas and Intermediate Zones,MSOAIZ,NE,5779,2294,5289,2035,1937,958,3352,1077,12,5,93,62,75,52,18,10,10,,,,359,174,326,155,3,2,28,15,2,2,19,26,18
E02001741,North Tyneside 004,Middle Super Output Areas and Intermediate Zones,MSOAIZ,NE,6922,3283,5543,2604,2484,1423,3059,1181,5,2,725,367,644,319,81,48,48,,,,602,277,432,208,55,17,71,37,44,15,69,47,33
E02001742,North Tyneside 005,Middle Super Output Areas and Intermediate Zones,MSOAIZ,NE,5997,2604,5199,2183,1912,1025,3287,1158,22,17,325,172,118,48,207,124,124,,,,432,221,394,199,5,2,29,17,4,3,22,19,11
E02001743,North Tyneside 006,Middle Super Output Areas and Intermediate Zones,MSOAIZ,NE,7281,3195,5483,2262,1714,902,3769,1360,53,26,349,200,187,87,162,113,113,,,,1334,672,1208,612,15,7,88,45,23,8,60,62,35
E02001744,North Tyneside 007,Middle Super Output Areas and Intermediate Zones,MSOAIZ,NE,6442,2877,4644,2012,1529,842,3115,1170,14,8,1174,568,970,453,204,115,115,,,,561,260,508,234,5,2,44,22,4,2,26,49,29
E02001745,North Tyneside 008,Middle Super Output Areas and Intermediate Zones,MSOAIZ,NE,6352,2786,4305,1854,1241,662,3064,1192,8,6,1592,691,1461,601,131,90,90,,,,425,219,353,176,0,0,65,37,7,6,43,22,16
E02001746,North Tyneside 009,Middle Super Output Areas and Intermediate Zones,MSOAIZ,NE,8260,3598,6074,2528,1991,1086,4083,1442,22,8,1106,531,1033,480,73,51,51,,,,997,497,910,462,0,0,84,34,3,1,35,61,34
E02001747,North Tyneside 010,Middle Super Output Areas and Intermediate Zones,MSOAIZ,NE,6166,2880,5380,2441,2493,1425,2887,1016,6,2,308,197,281,185,27,12,12,,,,419,214,358,181,0,0,52,26,9,7,33,53,26
E02001748,North Tyneside 011,Middle Super Output Areas and Intermediate Zones,MSOAIZ,NE,7525,3253,4849,2039,1182,644,3667,1395,44,22,1782,792,1643,732,139,60,60,,,,785,370,705,331,4,3,61,30,15,6,39,65,30
E02001749,North Tyneside 012,Middle Super Output Areas and Intermediate Zones,MSOAIZ,NE,6115,2772,4562,1933,1458,760,3104,1173,17,9,1003,576,636,348,367,228,228,,,,494,233,436,209,1,1,56,22,1,1,24,39,21
E02001750,North Tyneside 013,Middle Super Output Areas and Intermediate Zones,MSOAIZ,NE,6576,2841,5570,2330,2240,1198,3330,1132,16,6,518,288,407,219,111,69,69,,,,430,187,358,159,8,3,61,23,3,2,28,42,30
E02001751,North Tyneside 014,Middle Super Output Areas and Intermediate Zones,MSOAIZ,NE,5971,2716,4142,1825,1493,825,2649,1000,15,7,1363,660,1059,484,304,176,176,,,,405,198,338,168,0,0,67,30,0,0,30,46,26
E02001752,North Tyneside 015,Middle Super Output Areas and Intermediate Zones,MSOAIZ,NE,6281,2789,3534,1521,1175,642,2359,879,13,5,2162,988,1994,906,168,82,82,,,,537,253,496,230,0,0,41,23,0,0,23,35,22
E02001753,North Tyneside 016,Middle Super Output Areas and Intermediate Zones,MSOAIZ,NE,6250,3230,4161,1986,1762,1003,2399,983,18,11,899,551,315,175,584,376,376,,,,1083,624,986,568,18,10,72,41,7,5,56,89,58
E02001754,North Tyneside 017,Middle Super Output Areas and Intermediate Zones,MSOAIZ,NE,5914,2849,4716,2147,1851,1008,2865,1139,15,13,198,138,110,66,88,72,72,,,,944,531,837,475,26,8,78,47,3,1,56,41,20
E02001755,North Tyneside 018,Middle Super Output Areas and Intermediate Zones,MSOAIZ,NE,7865,3500,6182,2596,2054,1108,4128,1488,6,4,968,515,844,421,124,94,94,,,,670,363,594,322,3,2,69,37,4,2,41,39,22
E02001756,North Tyneside 019,Middle Super Output Areas and Intermediate Zones,MSOAIZ,NE,9258,4391,4731,2072,1271,682,3460,1390,51,21,3480,1831,2704,1429,776,402,402,,,,949,440,888,407,2,1,52,28,7,4,33,47,27
E02001757,North Tyneside 020,Middle Super Output Areas and Intermediate Zones,MSOAIZ,NE,5883,2753,4436,1998,1917,1044,2519,954,3,2,988,524,888,461,100,63,63,,,,420,209,367,179,5,3,44,24,4,3,30,36,20
E02001758,North Tyneside 021,Middle Super Output Areas and Intermediate Zones,MSOAIZ,NE,5599,2450,4026,1719,1306,676,2720,1043,86,39,1128,523,1086,500,42,23,23,,,,332,152,283,125,3,1,43,24,3,2,27,27,17
E02001759,North Tyneside 022,Middle Super Output Areas and Intermediate Zones,MSOAIZ,NE,6182,3261,4062,1941,1349,770,2713,1171,25,10,605,419,245,148,360,271,271,,,,1440,857,1340,794,2,1,95,59,3,3,63,50,34
E02001760,North Tyneside 023,Middle Super Output Areas and Intermediate Zones,MSOAIZ,NE,7706,3471,3082,1358,1002,549,2080,809,18,9,3470,1477,2928,1223,542,254,254,,,,1073,580,979,540,1,1,81,32,12,7,40,63,47
E02001761,North Tyneside 024,Middle Super Output Areas and Intermediate Zones,MSOAIZ,NE,5342,2448,3761,1628,1354,738,2407,890,13,7,1134,612,1030,550,104,62,62,,,,395,178,338,150,0,0,56,27,1,1,28,39,23
E02001762,North Tyneside 025,Middle Super Output Areas and Intermediate Zones,MSOAIZ,NE,5588,2471,4645,1997,1628,846,3017,1151,62,31,461,226,439,217,22,9,9,,,,392,202,320,163,0,0,72,39,0,0,39,28,15
E02001763,North Tyneside 026,Middle Super Output Areas and Intermediate Zones,MSOAIZ,NE,6262,2882,3314,1385,931,498,2383,887,16,6,2411,1205,1838,889,573,316,316,,,,478,254,424,225,0,0,49,26,5,3,29,43,32
E02001764,North Tyneside 027,Middle Super Output Areas and Intermediate Zones,MSOAIZ,NE,7488,3883,2888,1346,654,389,2234,957,75,30,3136,1693,1769,874,1367,819,819,,,,1334,785,1231,729,4,1,85,50,14,5,56,55,29
E02001765,North Tyneside 028,Middle Super Output Areas and Intermediate Zones,MSOAIZ,NE,7137,3312,3321,1404,735,404,2586,1000,39,21,2626,1297,1878,894,748,403,403,,,,1111,564,1056,532,3,3,49,27,3,2,32,40,26
E02001766,North Tyneside 029,Middle Super Output Areas and Intermediate Zones,MSOAIZ,NE,6927,3295,3860,1717,1053,579,2807,1138,4,3,1330,626,1024,438,306,188,188,,,,1687,918,1595,856,2,1,85,58,5,3,62,46,31
E02001767,North Tyneside 030,Middle Super Output Areas and Intermediate Zones,MSOAIZ,NE,6998,3385,4306,1935,1245,726,3061,1209,13,7,1603,887,1168,622,435,265,265,,,,1016,518,881,450,19,8,104,51,12,9,68,60,38
E02001768,South Tyneside 001,Middle Super Output Areas and Intermediate Zones,MSOAIZ,NE,8251,3812,5189,2256,1684,910,3505,1346,140,69,1467,721,1174,515,293,206,206,,,,1393,735,1256,653,6,4,126,74,5,4,82,62,31
E02001769,South Tyneside 002,Middle Super Output Areas and Intermediate Zones,MSOAIZ,NE,7342,3973,2765,1322,1143,616,1622,706,39,23,3014,1778,1879,1122,1135,656,656,,,,1439,798,1331,737,13,5,72,45,23,11,61,85,52
E02001770,South Tyneside 003,Middle Super Output Areas and Intermediate Zones,MSOAIZ,NE,6272,3035,4677,2102,1664,917,3013,1185,37,27,362,240,82,45,280,195,195,,,,1139,633,1025,566,10,5,97,57,7,5,67,57,33
E02001771,South Tyneside 004,Middle Super Output Areas and Intermediate Zones,MSOAIZ,NE,6305,2806,3625,1566,1487,812,2138,754,74,46,2282,1037,2110,905,172,132,132,,,,282,131,255,117,5,2,21,11,1,1,14,42,26
E02001772,South Tyneside 005,Middle Super Output Areas and Intermediate Zones,MSOAIZ,NE,5375,2467,3621,1608,1426,764,2195,844,30,12,953,451,732,332,221,119,119,,,,744,381,669,336,2,1,69,40,4,4,45,27,15
E02001773,South Tyneside 006,Middle Super Output Areas and Intermediate Zones,MSOAIZ,NE,5457,2381,4690,2038,2168,1155,2522,883,15,12,444,182,176,75,268,107,107,,,,250,117,218,100,0,0,32,17,0,0,17,58,32
E02001774,South Tyneside 007,Middle Super Output Areas and Intermediate Zones,MSOAIZ,NE,5368,2559,2828,1214,895,470,1933,744,11,7,1912,998,1793,925,119,73,73,,,,573,317,529,296,0,0,42,19,2,2,21,44,23
E02001775,South Tyneside 008,Middle Super Output Areas and Intermediate Zones,MSOAIZ,NE,5621,2450,3039,1202,854,456,2185,746,8,3,2215,1081,1542,721,673,360,360,,,,319,138,293,126,0,0,22,9,4,3,12,40,26
E02001776,South Tyneside 009,Middle Super Output Areas and Intermediate Zones,MSOAIZ,NE,8289,3729,4621,1938,1406,718,3215,1220,13,8,2797,1310,1668,832,1129,478,478,,,,791,437,692,385,9,3,81,43,9,6,52,67,36
E02001777,South Tyneside 010,Middle Super Output Areas and Intermediate Zones,MSOAIZ,NE,6244,2897,4367,1848,1165,620,3202,1228,15,7,1196,672,1104,622,92,50,50,,,,640,355,586,326,2,2,42,24,10,3,29,26,15
E02001778,South Tyneside 011,Middle Super Output Areas and Intermediate Zones,MSOAIZ,NE,6013,2939,3307,1447,985,544,2322,903,16,5,1361,738,1036,559,325,179,179,,,,1289,722,1197,667,15,8,69,41,8,6,55,40,27
E02001779,South Tyneside 012,Middle Super Output Areas and Intermediate Zones,MSOAIZ,NE,5369,2519,2629,1119,916,492,1713,627,17,10,2308,1156,1892,879,416,277,277,,,,396,220,344,193,4,4,29,15,19,8,27,19,14
E02001780,South Tyneside 013,Middle Super Output Areas and Intermediate Zones,MSOAIZ,NE,5190,2318,2814,1231,1222,632,1592,599,27,9,2074,959,1077,550,997,409,409,,,,253,104,208,87,0,0,32,13,13,4,17,22,15
E02001781,South Tyneside 014,Middle Super Output Areas and Intermediate Zones,MSOAIZ,NE,5404,2567,2506,1110,793,463,1713,647,6,1,2606,1305,2505,1254,101,51,51,,,,262,133,236,117,0,0,23,13,3,3,16,24,18
E02001782,South Tyneside 015,Middle Super Output Areas and Intermediate Zones,MSOAIZ,NE,8569,3835,4967,2106,1706,926,3261,1180,8,4,3143,1508,3085,1476,58,32,32,,,,399,182,339,150,0,0,55,28,5,4,32,52,35
E02001783,South Tyneside 016,Middle Super Output Areas and Intermediate Zones,MSOAIZ,NE,6679,2980,3071,1310,922,502,2149,808,5,2,3105,1446,2819,1303,286,143,143,,,,454,197,419,178,0,0,33,17,2,2,19,44,25
E02001784,South Tyneside 017,Middle Super Output Areas and Intermediate Zones,MSOAIZ,NE,6810,2970,3738,1512,1175,625,2563,887,13,7,2746,1297,2532,1182,214,115,115,,,,270,132,224,109,0,0,44,22,2,1,23,43,22
E02001785,South Tyneside 018,Middle Super Output Areas and Intermediate Zones,MSOAIZ,SR,7891,3555,5371,2253,2047,1086,3324,1167,31,18,1996,1069,1515,865,481,204,204,,,,461,187,395,161,0,0,43,20,23,6,26,32,28
E02001786,South Tyneside 019,Middle Super Output Areas and Intermediate Zones,MSOAIZ,NE,6973,3178,4204,1739,1409,735,2795,1004,17,11,2336,1248,2230,1193,106,55,55,,,,389,163,328,136,3,1,58,26,0,0,27,27,17
E02001787,South Tyneside 020,Middle Super Output Areas and Intermediate Zones,MSOAIZ,NE,5623,2457,3493,1495,1278,662,2215,833,16,9,1794,799,1498,679,296,120,120,,,,307,146,266,131,1,1,29,11,11,3,15,13,8
E02001788,South Tyneside 021,Middle Super Output Areas and Intermediate Zones,MSOAIZ,NE,5899,2636,3900,1622,1193,622,2707,1000,4,3,1439,737,1054,523,385,214,214,,,,509,247,481,230,3,2,25,15,0,0,17,47,27
E02001789,South Tyneside 022,Middle Super Output Areas and Intermediate Zones,MSOAIZ,SR,5829,2471,5443,2303,2489,1288,2954,1015,4,2,71,30,60,21,11,9,9,,,,283,118,250,100,0,0,30,17,3,1,18,28,18
E02001790,South Tyneside 023,Middle Super Output Areas and Intermediate Zones,MSOAIZ,SR,5956,2633,4691,1992,1857,988,2834,1004,2,2,853,442,764,389,89,53,53,,,,357,165,301,139,9,3,41,20,6,3,26,53,32
E02001791,Sunderland 001,Middle Super Output Areas and Intermediate Zones,MSOAIZ,SR,5783,2427,5325,2196,2250,1158,3075,1038,13,10,93,45,33,12,60,33,33,,,,310,153,290,144,3,1,17,8,0,0,9,42,23
E02001792,Sunderland 002,Middle Super Output Areas and Intermediate Zones,MSOAIZ,SR,6951,3048,6268,2711,2742,1472,3526,1239,15,7,150,78,66,30,84,48,48,,,,486,232,412,192,2,1,56,34,16,5,40,32,20
E02001793,Sunderland 003,Middle Super Output Areas and Intermediate Zones,MSOAIZ,SR,8357,3822,3648,1508,990,542,2658,966,12,5,3804,1912,2123,1046,1681,866,866,,,,862,384,776,346,6,3,35,15,45,20,38,31,13
E02001794,Sunderland 004,Middle Super Output Areas and Intermediate Zones,MSOAIZ,SR,8502,3732,4118,1717,1515,788,2603,929,11,4,3604,1700,2221,1024,1383,676,676,,,,732,289,644,250,1,1,48,20,39,18,39,37,22
E02001795,Sunderland 005,Middle Super Output Areas and Intermediate Zones,MSOAIZ,SR,7521,3577,3860,1711,1459,799,2401,912,4,2,2306,1183,1022,517,1284,666,666,,,,1314,656,1191,598,10,4,107,49,6,5,58,37,25
E02001796,Sunderland 006,Middle Super Output Areas and Intermediate Zones,MSOAIZ,SR,9144,4426,6094,2725,2529,1345,3565,1380,37,23,1106,683,446,271,660,412,412,,,,1788,940,1643,864,15,7,104,54,26,15,76,119,55
E02001797,Sunderland 007,Middle Super Output Areas and Intermediate Zones,MSOAIZ,SR,5766,2486,4792,1999,1837,928,2955,1071,17,6,514,299,286,170,228,129,129,,,,411,164,359,144,0,0,45,16,7,4,20,32,18
E02001798,Sunderland 008,Middle Super Output Areas and Intermediate Zones,MSOAIZ,SR,8156,3445,4738,1896,1551,785,3187,1111,8,4,2716,1256,1509,693,1207,563,563,,,,647,259,541,205,7,7,68,32,31,15,54,47,30
E02001799,Sunderland 009,Middle Super Output Areas and Intermediate Zones,MSOAIZ,NE,9948,4424,4701,2033,1435,789,3266,1244,6,4,3992,1780,2482,1077,1510,703,703,,,,1205,582,1121,542,5,2,66,29,13,9,40,44,25
E02001800,Sunderland 010,Middle Super Output Areas and Intermediate Zones,MSOAIZ,NE,7267,3014,4377,1798,1278,654,3099,1144,22,12,2259,947,1270,530,989,417,417,,,,577,241,512,212,0,0,49,23,16,6,29,32,16
E02001801,Sunderland 011,Middle Super Output Areas and Intermediate Zones,MSOAIZ,SR,5890,2515,3493,1451,1121,594,2372,857,24,9,435,247,120,67,315,180,180,,,,1891,779,1718,706,17,6,93,50,63,17,73,47,29
E02001802,Sunderland 012,Middle Super Output Areas and Intermediate Zones,MSOAIZ,SR,6302,2638,2622,1068,780,403,1842,665,6,2,3072,1308,1681,681,1391,627,627,,,,585,249,525,219,0,0,38,17,22,13,30,17,11
E02001803,Sunderland 013,Middle Super Output Areas and Intermediate Zones,MSOAIZ,SR,7897,4188,2570,1187,989,530,1581,657,40,16,1611,1136,652,465,959,671,671,,,,3594,1809,3408,1720,13,7,106,47,67,35,89,82,40
E02001804,Sunderland 014,Middle Super Output Areas and Intermediate Zones,MSOAIZ,SR,6317,2706,3907,1624,1250,658,2657,966,11,3,1819,839,1160,521,659,318,318,,,,562,225,484,191,10,4,56,24,12,6,34,18,15
E02001805,Sunderland 015,Middle Super Output Areas and Intermediate Zones,MSOAIZ,SR,5711,2501,4480,1952,2029,1085,2451,867,19,10,396,178,117,57,279,121,121,,,,779,342,705,307,11,6,53,26,10,3,35,37,19
E02001806,Sunderland 016,Middle Super Output Areas and Intermediate Zones,MSOAIZ,SR,8335,4143,3233,1432,1208,637,2025,795,13,7,2537,1451,937,523,1600,928,928,,,,2487,1223,2364,1160,10,3,93,45,20,15,63,65,30
E02001807,Sunderland 017,Middle Super Output Areas and Intermediate Zones,MSOAIZ,SR,7260,3027,4477,1791,1307,657,3170,1134,14,9,2058,907,1270,534,788,373,373,,,,682,304,638,281,4,2,36,19,4,2,23,29,16
E02001808,Sunderland 018,Middle Super Output Areas and Intermediate Zones,MSOAIZ,SR,6055,2468,4392,1797,1568,851,2824,946,8,3,136,64,72,27,64,37,37,,,,1473,574,1309,508,21,8,117,52,26,6,66,46,30
E02001809,Sunderland 019,Middle Super Output Areas and Intermediate Zones,MSOAIZ,NE,6547,2881,4644,1954,1826,926,2818,1028,3,2,1385,694,796,390,589,304,304,,,,478,208,418,181,3,1,47,21,10,5,27,37,23
E02001810,Sunderland 020,Middle Super Output Areas and Intermediate Zones,MSOAIZ,NE,8577,3699,5902,2401,1664,818,4238,1583,66,29,1902,969,1154,577,748,392,392,,,,685,287,595,248,7,3,65,28,18,8,39,22,13
E02001811,Sunderland 021,Middle Super Output Areas and Intermediate Zones,MSOAIZ,SR,9174,4087,4996,2095,1882,992,3114,1103,12,6,3541,1698,2098,959,1443,739,739,,,,585,258,483,209,3,1,61,30,38,18,49,40,30
E02001812,Sunderland 022,Middle Super Output Areas and Intermediate Zones,MSOAIZ,SR,10316,4354,9128,3815,4135,2142,4993,1673,17,7,165,70,67,18,98,52,52,,,,937,425,831,380,7,4,81,35,18,6,45,69,37
E02001813,Sunderland 023,Middle Super Output Areas and Intermediate Zones,MSOAIZ,SR,10054,4318,4266,1693,1286,655,2980,1038,16,12,4933,2261,2252,1044,2681,1217,1217,,,,774,310,664,262,3,1,77,35,30,12,48,65,42
E02001814,Sunderland 024,Middle Super Output Areas and Intermediate Zones,MSOAIZ,SR,6366,2762,4088,1683,1469,753,2619,930,1,1,1570,755,831,397,739,358,358,,,,664,297,624,276,0,0,37,20,3,1,21,43,26
E02001815,Sunderland 025,Middle Super Output Areas and Intermediate Zones,MSOAIZ,NE,10326,4244,7981,3154,2748,1328,5233,1826,34,12,1672,808,887,415,785,393,393,,,,596,239,520,210,2,1,66,24,8,4,29,43,31
E02001816,Sunderland 026,Middle Super Output Areas and Intermediate Zones,MSOAIZ,SR,6839,3357,3636,1575,1288,697,2348,878,13,9,2542,1466,1369,728,1173,738,738,,,,606,282,533,244,2,1,59,28,12,9,38,42,25
E02001817,Sunderland 027,Middle Super Output Areas and Intermediate Zones,MSOAIZ,SR,6235,2714,3747,1517,1271,642,2476,875,51,28,1743,855,766,373,977,482,482,,,,664,290,590,255,2,2,46,23,26,10,35,30,24
E02001818,Sunderland 028,Middle Super Output Areas and Intermediate Zones,MSOAIZ,SR,8335,3530,5359,2126,1616,832,3743,1294,11,5,2176,1028,1319,609,857,419,419,,,,741,345,637,295,14,5,60,32,30,13,50,48,26
E02001819,Sunderland 029,Middle Super Output Areas and Intermediate Zones,MSOAIZ,SR,6941,3054,5926,2500,2632,1339,3294,1161,62,40,505,277,256,129,249,148,148,,,,418,218,350,181,4,3,49,27,15,7,37,30,19
E02001820,Sunderland 030,Middle Super Output Areas and Intermediate Zones,MSOAIZ,DH,8521,3618,5692,2313,1871,985,3821,1328,0,0,2185,1016,1227,551,958,465,465,,,,598,261,503,219,4,1,74,32,17,9,42,46,28
E02001821,Sunderland 031,Middle Super Output Areas and Intermediate Zones,MSOAIZ,SR,5942,2453,4637,1790,1394,674,3243,1116,43,22,890,494,393,222,497,272,272,,,,357,136,296,107,3,1,51,23,7,5,29,15,11
E02001822,Sunderland 032,Middle Super Output Areas and Intermediate Zones,MSOAIZ,SR,7497,3165,5730,2370,1983,1007,3747,1363,3,2,827,379,456,195,371,184,184,,,,894,389,818,346,2,2,70,37,4,4,43,43,25
E02001823,Sunderland 033,Middle Super Output Areas and Intermediate Zones,MSOAIZ,DH,7090,3064,4638,1915,1526,802,3112,1113,16,6,1679,829,893,443,786,386,386,,,,729,294,667,265,2,1,55,26,5,2,29,28,20
E02001824,Sunderland 034,Middle Super Output Areas and Intermediate Zones,MSOAIZ,DH,8367,3722,5696,2457,2459,1289,3237,1168,26,11,1939,939,998,468,941,471,471,,,,667,289,614,259,2,1,39,22,12,7,30,39,26
E02001825,Sunderland 035,Middle Super Output Areas and Intermediate Zones,MSOAIZ,SR,7003,3232,4809,2084,2078,1098,2731,986,30,13,1434,794,713,395,721,399,399,,,,688,311,613,269,1,1,63,33,11,8,42,42,30
E02001826,Sunderland 036,Middle Super Output Areas and Intermediate Zones,MSOAIZ,SR,6592,2917,3619,1528,1453,765,2166,763,15,11,2162,1054,1193,567,969,487,487,,,,769,308,700,282,0,0,50,17,19,9,26,27,16
E02001827,Birmingham 001,Middle Super Output Areas and Intermediate Zones,MSOAIZ,B,6044,2578,4986,2033,2113,1087,2873,946,14,6,552,306,268,126,284,180,180,,,,437,207,386,187,14,4,37,16,0,0,20,55,26
E02001828,Birmingham 002,Middle Super Output Areas and Intermediate Zones,MSOAIZ,B,6877,3141,5625,2458,2534,1398,3091,1060,12,5,501,278,414,231,87,47,47,,,,675,359,619,331,11,5,40,21,5,2,28,64,41
E02001829,Birmingham 003,Middle Super Output Areas and Intermediate Zones,MSOAIZ,B,8731,3446,7802,3063,2992,1534,4810,1529,26,13,230,96,66,43,164,53,53,,,,637,255,594,234,3,2,34,18,6,1,21,36,19
E02001830,Birmingham 004,Middle Super Output Areas and Intermediate Zones,MSOAIZ,B,9311,3954,8169,3360,3904,1937,4265,1423,6,5,254,149,81,33,173,116,116,,,,832,406,802,388,0,0,28,17,2,1,18,50,34
E02001831,Birmingham 005,Middle Super Output Areas and Intermediate Zones,MSOAIZ,B,10285,4399,6651,2714,2172,1146,4479,1568,137,55,2496,1177,1578,666,918,511,511,,,,905,399,822,357,14,7,62,30,7,5,42,96,54
E02001832,Birmingham 006,Middle Super Output Areas and Intermediate Zones,MSOAIZ,B,8163,3437,6829,2751,2605,1329,4224,1422,54,25,509,274,312,155,197,119,119,,,,708,345,660,317,20,9,24,18,4,1,28,63,42
E02001833,Birmingham 007,Middle Super Output Areas and Intermediate Zones,MSOAIZ,B,5805,2288,5000,1944,1959,975,3041,969,7,5,398,176,167,66,231,110,110,,,,365,146,334,135,5,2,20,7,6,2,11,35,17
E02001834,Birmingham 008,Middle Super Output Areas and Intermediate Zones,MSOAIZ,B,6139,2480,3845,1597,1251,685,2594,912,15,6,1398,527,1237,470,161,57,57,,,,780,304,700,273,7,3,73,28,0,0,31,101,46
E02001835,Birmingham 009,Middle Super Output Areas and Intermediate Zones,MSOAIZ,B,8002,3496,6140,2575,2405,1260,3735,1315,29,13,318,156,301,142,17,14,14,,,,1431,708,1341,668,6,3,74,34,10,3,40,84,44
E02001836,Birmingham 010,Middle Super Output Areas and Intermediate Zones,MSOAIZ,B,9142,3672,7905,3083,3153,1549,4752,1534,11,6,342,216,225,137,117,79,79,,,,839,344,787,323,3,2,42,17,7,2,21,45,23
E02001837,Birmingham 011,Middle Super Output Areas and Intermediate Zones,MSOAIZ,B,10556,4098,5077,1976,1398,734,3679,1242,58,25,3888,1534,3643,1431,245,103,103,,,,1402,493,1319,457,2,1,76,32,5,3,36,131,70
E02001838,Birmingham 012,Middle Super Output Areas and Intermediate Zones,MSOAIZ,B,7618,3082,6857,2740,2600,1319,4257,1421,26,9,158,60,67,27,91,33,33,,,,516,238,472,221,0,0,36,15,8,2,17,61,35
E02001839,Birmingham 013,Middle Super Output Areas and Intermediate Zones,MSOAIZ,B,6408,2810,4760,2005,1776,940,2984,1065,7,4,674,393,428,231,246,162,162,,,,911,376,838,342,0,0,72,33,1,1,34,56,32
E02001840,Birmingham 014,Middle Super Output Areas and Intermediate Zones,MSOAIZ,B,8678,3586,3895,1549,1050,572,2845,977,126,62,3307,1462,2498,1085,809,377,377,,,,1203,435,1109,397,14,4,69,29,11,5,38,147,78
E02001841,Birmingham 015,Middle Super Output Areas and Intermediate Zones,MSOAIZ,B,5945,2414,5430,2186,2639,1282,2791,904,5,4,70,26,28,11,42,15,15,,,,396,177,362,163,4,1,24,11,6,2,14,44,21
E02001842,Birmingham 016,Middle Super Output Areas and Intermediate Zones,MSOAIZ,B,7655,3024,6178,2464,2456,1216,3722,1248,25,11,290,124,229,105,61,19,19,,,,1107,397,1051,371,0,0,51,24,5,2,26,55,28
E02001843,Birmingham 017,Middle Super Output Areas and Intermediate Zones,MSOAIZ,B,6423,2713,5202,2207,2065,1088,3137,1119,29,15,104,44,39,15,65,29,29,,,,1023,420,931,382,3,2,84,34,5,2,38,65,27
E02001844,Birmingham 018,Middle Super Output Areas and Intermediate Zones,MSOAIZ,B,9533,4459,6759,2826,2502,1314,4257,1512,255,159,884,600,442,288,442,312,312,,,,1575,826,1458,773,11,4,96,44,10,5,53,60,48
E02001845,Birmingham 019,Middle Super Output Areas and Intermediate Zones,MSOAIZ,B,6274,2575,4902,1977,1418,727,3484,1250,27,12,270,161,64,23,206,138,138,,,,1038,409,957,378,0,0,77,28,4,3,31,37,16
E02001846,Birmingham 020,Middle Super Output Areas and Intermediate Zones,MSOAIZ,B,7802,3359,4361,1810,1362,712,2999,1098,66,42,2101,970,1806,824,295,146,146,,,,1179,475,1114,448,3,1,53,22,9,4,27,95,62
E02001847,Birmingham 021,Middle Super Output Areas and Intermediate Zones,MSOAIZ,B,5521,2399,4538,1931,1752,942,2786,989,18,7,307,156,193,104,114,52,52,,,,626,283,547,250,22,10,39,15,18,8,33,32,22
E02001848,Birmingham 022,Middle Super Output Areas and Intermediate Zones,MSOAIZ,B,6291,2545,3414,1411,1185,618,2229,793,32,14,1883,739,1592,619,291,120,120,,,,873,336,833,316,2,2,29,13,9,5,20,89,45
E02001849,Birmingham 023,Middle Super Output Areas and Intermediate Zones,MSOAIZ,B,6838,3211,3184,1446,1103,614,2081,832,39,21,1896,937,1648,774,248,163,163,,,,1616,753,1546,719,11,4,56,27,3,3,34,103,54
E02001850,Birmingham 024,Middle Super Output Areas and Intermediate Zones,MSOAIZ,B,8167,3059,6080,2256,2211,1057,3869,1199,30,11,295,173,198,110,97,63,63,,,,1668,578,1566,531,0,0,98,45,4,2,47,94,41
E02001851,Birmingham 025,Middle Super Output Areas and Intermediate Zones,MSOAIZ,B,8489,3705,5440,2258,1643,864,3797,1394,61,32,1841,929,1016,555,825,374,374,,,,1039,417,962,376,0,0,63,36,14,5,41,108,69
E02001852,Birmingham 026,Middle Super Output Areas and Intermediate Zones,MSOAIZ,B,6512,2687,4115,1676,1429,741,2686,935,66,40,842,408,566,233,276,175,175,,,,1423,519,1345,488,0,0,71,27,7,4,31,66,44
E02001854,Birmingham 028,Middle Super Output Areas and Intermediate Zones,MSOAIZ,B,7733,3252,4951,2007,1723,872,3228,1135,57,28,1411,668,1023,456,388,212,212,,,,1223,491,1146,460,12,4,61,26,4,1,31,91,58
E02001855,Birmingham 029,Middle Super Output Areas and Intermediate Zones,MSOAIZ,B,9826,4247,3586,1568,1333,722,2253,846,48,20,5584,2368,442,207,5142,2161,2161,,,,504,229,459,208,4,2,31,13,10,6,21,104,62
E02001856,Birmingham 030,Middle Super Output Areas and Intermediate Zones,MSOAIZ,B,8459,3451,5163,2074,1809,816,3354,1258,89,33,646,296,299,136,347,160,160,,,,2450,1001,2308,948,19,4,120,46,3,3,53,111,47
E02001857,Birmingham 031,Middle Super Output Areas and Intermediate Zones,MSOAIZ,B,12583,5340,5942,2259,2091,937,3851,1322,224,110,2728,1306,1507,621,1221,685,685,,,,3515,1579,3376,1516,10,4,114,54,15,5,63,174,86
E02001858,Birmingham 032,Middle Super Output Areas and Intermediate Zones,MSOAIZ,B,7975,3126,4372,1373,1821,660,2551,713,48,19,1425,780,405,214,1020,566,566,,,,1967,900,1900,875,8,2,39,16,20,7,25,163,54
E02001859,Birmingham 033,Middle Super Output Areas and Intermediate Zones,MSOAIZ,B,9407,2722,5592,1469,2842,818,2750,651,39,13,1338,470,541,189,797,281,281,,,,2186,694,2037,650,13,5,91,23,45,16,44,252,76
E02001860,Birmingham 034,Middle Super Output Areas and Intermediate Zones,MSOAIZ,B,8337,2852,4387,1445,1996,763,2391,682,37,13,1497,596,433,169,1064,427,427,,,,2234,737,2053,669,2,1,85,31,94,36,68,182,61
E02001861,Birmingham 035,Middle Super Output Areas and Intermediate Zones,MSOAIZ,B,10114,3160,4742,1193,2527,704,2215,489,80,28,3047,1203,642,251,2405,952,952,,,,1982,652,1841,609,11,2,94,26,36,15,43,263,84
E02001862,Birmingham 036,Middle Super Output Areas and Intermediate Zones,MSOAIZ,B,9897,3337,5124,1571,2419,834,2705,737,82,31,2399,945,923,359,1476,586,586,,,,2041,716,1858,657,15,3,112,41,56,15,59,251,74
E02001863,Birmingham 037,Middle Super Output Areas and Intermediate Zones,MSOAIZ,B,7806,2350,4269,1083,2124,583,2145,500,24,10,1901,754,1074,447,827,307,307,,,,1406,436,1311,408,5,2,62,16,28,10,28,206,67
E02001864,Birmingham 038,Middle Super Output Areas and Intermediate Zones,MSOAIZ,B,5531,2248,2023,793,602,308,1421,485,64,43,2754,1156,2499,1037,255,119,119,,,,562,199,524,185,3,1,29,11,6,2,14,128,57
E02001865,Birmingham 039,Middle Super Output Areas and Intermediate Zones,MSOAIZ,B,10912,3324,6094,1653,3311,968,2783,685,67,24,2260,835,485,185,1775,650,650,,,,2234,721,1988,653,27,6,143,42,76,20,68,257,91
E02001866,Birmingham 040,Middle Super Output Areas and Intermediate Zones,MSOAIZ,B,8561,2576,4268,955,2038,493,2230,462,60,18,2909,1140,744,271,2165,869,869,,,,1142,406,1069,384,0,0,32,9,41,13,22,182,57
E02001867,Birmingham 041,Middle Super Output Areas and Intermediate Zones,MSOAIZ,B,6875,2076,3030,761,1299,331,1731,430,70,27,2843,1020,1717,631,1126,389,389,,,,728,212,664,195,0,0,52,14,12,3,17,204,56
E02001868,Birmingham 042,Middle Super Output Areas and Intermediate Zones,MSOAIZ,B,8557,2637,6942,2120,2680,1087,4262,1033,19,7,248,109,200,86,48,23,23,,,,1243,367,1161,341,6,3,69,19,7,4,26,105,34
E02001869,Birmingham 043,Middle Super Output Areas and Intermediate Zones,MSOAIZ,B,6056,2433,1269,459,469,198,800,261,85,27,4105,1721,2999,1276,1106,445,445,,,,467,170,416,149,3,1,28,10,20,10,21,130,56
E02001870,Birmingham 044,Middle Super Output Areas and Intermediate Zones,MSOAIZ,B,11471,3575,7828,2349,2962,1082,4866,1267,64,16,1303,469,1098,392,205,77,77,,,,2102,683,1957,630,3,2,112,42,30,9,53,174,58
E02001871,Birmingham 045,Middle Super Output Areas and Intermediate Zones,MSOAIZ,B,7640,3543,3620,1582,1372,773,2248,809,334,131,2861,1470,2184,1133,677,337,337,,,,692,275,647,252,2,1,37,17,6,5,23,133,85
E02001872,Birmingham 046,Middle Super Output Areas and Intermediate Zones,MSOAIZ,B,7158,3128,3585,1553,1207,679,2378,874,206,77,2603,1164,2033,935,570,229,229,,,,614,245,550,216,2,1,50,24,12,4,29,150,89
E02001873,Birmingham 047,Middle Super Output Areas and Intermediate Zones,MSOAIZ,B,10442,3949,4049,1417,1935,719,2114,698,51,21,3239,1331,1400,570,1839,761,761,,,,2787,1059,2626,1000,3,3,103,36,55,20,59,316,121
E02001874,Birmingham 048,Middle Super Output Areas and Intermediate Zones,MSOAIZ,B,9296,2737,4913,1249,2387,675,2526,574,52,20,2705,956,1502,527,1203,429,429,,,,1399,433,1291,402,0,0,89,25,19,6,31,227,79
E02001875,Birmingham 049,Middle Super Output Areas and Intermediate Zones,MSOAIZ,B,8133,3264,2120,717,743,272,1377,445,27,19,4127,1697,3037,1239,1090,458,458,,,,1557,734,1450,698,0,0,50,20,57,16,36,302,97
E02001876,Birmingham 050,Middle Super Output Areas and Intermediate Zones,MSOAIZ,B,7300,3136,1275,445,375,165,900,280,28,12,4195,1882,3506,1581,689,301,301,,,,1524,684,1416,633,12,9,22,15,74,27,51,278,113
E02001877,Birmingham 051,Middle Super Output Areas and Intermediate Zones,MSOAIZ,B,10615,2867,6052,1379,3108,758,2944,621,65,14,2360,852,866,303,1494,549,549,,,,1888,546,1730,507,2,2,128,30,28,7,39,250,76
E02001878,Birmingham 052,Middle Super Output Areas and Intermediate Zones,MSOAIZ,B,8949,2707,4460,1073,2441,585,2019,488,63,25,2674,1008,1298,543,1376,465,465,,,,1539,525,1443,494,0,0,74,21,22,10,31,213,76
E02001879,Birmingham 053,Middle Super Output Areas and Intermediate Zones,MSOAIZ,B,9490,3155,4496,1228,2180,634,2316,594,72,25,2467,1008,1452,569,1015,439,439,,,,2269,826,2161,789,16,7,58,19,34,11,37,186,68
E02001880,Birmingham 054,Middle Super Output Areas and Intermediate Zones,MSOAIZ,B,9429,3479,4147,1550,1006,501,3141,1049,100,39,3944,1396,3309,1168,635,228,228,,,,1104,427,1011,387,2,1,79,35,12,4,40,134,67
E02001881,Birmingham 055,Middle Super Output Areas and Intermediate Zones,MSOAIZ,B,9334,2943,4955,1428,1917,655,3038,773,27,8,2554,945,2340,878,214,67,67,,,,1584,476,1505,452,5,3,50,14,24,7,24,214,86
E02001882,Birmingham 056,Middle Super Output Areas and Intermediate Zones,MSOAIZ,B,8028,3144,4911,1710,1884,828,3027,882,43,18,1592,827,1086,489,506,338,338,,,,1411,556,1341,526,0,0,57,25,13,5,30,71,33
E02001883,Birmingham 057,Middle Super Output Areas and Intermediate Zones,MSOAIZ,B,8129,3615,3895,1663,1220,667,2675,996,32,13,3155,1437,2840,1264,315,173,173,,,,896,423,836,389,4,2,52,29,4,3,34,151,79
E02001884,Birmingham 058,Middle Super Output Areas and Intermediate Zones,MSOAIZ,B,9233,2447,5349,1307,2221,582,3128,725,111,32,1698,514,795,283,903,231,231,,,,1885,534,1745,498,4,1,112,25,24,10,36,190,60
E02001886,Birmingham 060,Middle Super Output Areas and Intermediate Zones,MSOAIZ,B,8657,3231,4782,1594,2149,798,2633,796,93,38,819,377,368,157,451,220,220,,,,2854,1176,2764,1136,17,9,55,23,18,8,40,109,46
E02001888,Birmingham 062,Middle Super Output Areas and Intermediate Zones,MSOAIZ,B,6161,2400,3621,1359,1144,557,2477,802,14,7,1703,726,1511,622,192,104,104,,,,748,271,665,237,0,0,74,30,9,4,34,75,37
E02001889,Birmingham 063,Middle Super Output Areas and Intermediate Zones,MSOAIZ,B,8246,2276,4973,1274,2042,611,2931,663,19,8,1181,415,718,257,463,158,158,,,,1925,529,1824,496,0,0,69,21,32,12,33,148,50
E02001890,Birmingham 064,Middle Super Output Areas and Intermediate Zones,MSOAIZ,B,9389,4450,4045,1696,1855,890,2190,806,54,22,1347,754,655,330,692,424,424,,,,3792,1901,3675,1837,9,4,69,34,39,26,64,151,77
E02001892,Birmingham 066,Middle Super Output Areas and Intermediate Zones,MSOAIZ,B,10189,3534,5071,1631,1627,656,3444,975,45,23,3343,1304,2996,1158,347,146,146,,,,1529,500,1420,458,0,0,88,31,21,11,42,201,76
E02001893,Birmingham 067,Middle Super Output Areas and Intermediate Zones,MSOAIZ,B,8035,3168,5879,2221,2157,1064,3722,1157,24,13,1078,515,773,356,305,159,159,,,,962,379,867,335,0,0,85,38,10,6,44,92,40
E02001895,Birmingham 069,Middle Super Output Areas and Intermediate Zones,MSOAIZ,B,7680,3259,4184,1739,1544,822,2640,917,62,23,2611,1138,2172,965,439,173,173,,,,694,282,620,250,13,4,58,26,3,2,32,129,77
E02001896,Birmingham 070,Middle Super Output Areas and Intermediate Zones,MSOAIZ,B,9269,2422,5806,1293,2919,715,2887,578,19,12,981,393,221,74,760,319,319,,,,2239,661,2107,615,2,1,88,28,42,17,46,224,63
E02001897,Birmingham 071,Middle Super Output Areas and Intermediate Zones,MSOAIZ,B,7521,2818,2571,696,1257,359,1314,337,44,21,3703,1671,2300,1060,1403,611,611,,,,974,331,904,302,5,4,40,13,25,12,29,229,99
E02001898,Birmingham 072,Middle Super Output Areas and Intermediate Zones,MSOAIZ,B,6488,2664,5610,2280,2008,1071,3602,1209,21,14,249,119,190,83,59,36,36,,,,569,224,515,201,3,1,46,20,5,2,23,39,27
E02001899,Birmingham 073,Middle Super Output Areas and Intermediate Zones,MSOAIZ,B,7755,3216,6229,2472,2789,1334,3440,1138,66,34,264,190,69,33,195,157,157,,,,1102,472,1019,437,13,5,64,28,6,2,35,94,48
E02001900,Birmingham 074,Middle Super Output Areas and Intermediate Zones,MSOAIZ,B,6219,2625,2513,1015,1192,546,1321,469,42,15,1828,944,831,458,997,486,486,,,,1678,583,1572,545,12,4,46,20,48,14,38,158,68
E02001901,Birmingham 075,Middle Super Output Areas and Intermediate Zones,MSOAIZ,B,7752,3677,4567,2067,1788,980,2779,1087,64,50,617,369,241,132,376,237,237,,,,2379,1124,2263,1067,12,5,83,41,21,11,57,125,67
E02001902,Birmingham 076,Middle Super Output Areas and Intermediate Zones,MSOAIZ,B,6101,2487,4622,1806,1578,790,3044,1016,48,25,539,297,495,269,44,28,28,,,,859,337,792,311,6,2,55,21,6,3,26,33,22
E02001903,Birmingham 077,Middle Super Output Areas and Intermediate Zones,MSOAIZ,B,7597,2016,3929,875,2220,519,1709,356,41,12,2167,684,564,211,1603,473,473,,,,1221,379,1123,348,3,2,55,16,40,13,31,239,66
E02001904,Birmingham 078,Middle Super Output Areas and Intermediate Zones,MSOAIZ,B,6808,2618,3957,1422,1218,563,2739,859,22,12,995,453,736,355,259,98,98,,,,1743,687,1631,647,16,5,63,20,33,15,40,91,44
E02001905,Birmingham 079,Middle Super Output Areas and Intermediate Zones,MSOAIZ,B,6065,2578,3641,1522,1614,795,2027,727,13,5,354,156,71,35,283,121,121,,,,1863,814,1641,729,68,23,47,20,107,42,85,194,81
E02001906,Birmingham 080,Middle Super Output Areas and Intermediate Zones,MSOAIZ,B,9315,3798,6722,2791,2679,1360,4043,1431,44,17,1341,507,1123,423,218,84,84,,,,1118,441,1034,406,6,2,68,30,10,3,35,90,42
E02001907,Birmingham 081,Middle Super Output Areas and Intermediate Zones,MSOAIZ,B,9608,4115,7215,3037,2933,1526,4282,1511,27,14,978,479,903,442,75,37,37,,,,1261,533,1146,481,9,3,89,44,17,5,52,127,52
E02001908,Birmingham 082,Middle Super Output Areas and Intermediate Zones,MSOAIZ,B,8896,2178,5745,1256,3126,715,2619,541,17,6,1305,387,543,151,762,236,236,,,,1620,474,1482,432,7,2,105,30,26,10,42,209,55
E02001909,Birmingham 083,Middle Super Output Areas and Intermediate Zones,MSOAIZ,B,7941,2298,4067,995,2034,527,2033,468,19,7,1982,728,524,224,1458,504,504,,,,1672,510,1581,482,0,0,67,20,24,8,28,201,58
E02001910,Birmingham 084,Middle Super Output Areas and Intermediate Zones,MSOAIZ,B,7105,2330,3282,854,1805,477,1477,377,28,12,2219,905,879,367,1340,538,538,,,,1415,511,1318,478,6,2,68,21,23,10,33,161,48
E02001911,Birmingham 085,Middle Super Output Areas and Intermediate Zones,MSOAIZ,B,7935,3317,3344,1405,1111,601,2233,804,19,9,3413,1446,3234,1363,179,83,83,,,,989,376,929,352,6,3,43,17,11,4,24,170,81
E02001913,Birmingham 087,Middle Super Output Areas and Intermediate Zones,MSOAIZ,B,7095,3289,2768,1277,1340,719,1428,558,47,20,1715,969,1423,736,292,233,233,,,,2454,955,2338,909,0,0,100,40,16,6,46,111,68
E02001914,Birmingham 088,Middle Super Output Areas and Intermediate Zones,MSOAIZ,B,6686,2195,4348,1310,2042,677,2306,633,45,16,808,321,281,144,527,177,177,,,,1396,507,1326,489,8,3,37,10,25,5,18,89,41
E02001915,Birmingham 089,Middle Super Output Areas and Intermediate Zones,MSOAIZ,B,11339,4852,6744,2634,2102,1015,4642,1619,266,117,1629,857,845,450,784,407,407,,,,2565,1173,2407,1106,7,3,132,55,19,9,67,135,71
E02001916,Birmingham 090,Middle Super Output Areas and Intermediate Zones,MSOAIZ,B,8499,3085,4873,1703,1637,754,3236,949,51,16,1851,707,1700,638,151,69,69,,,,1612,612,1521,576,4,2,58,26,29,8,36,112,47
E02001918,Birmingham 092,Middle Super Output Areas and Intermediate Zones,MSOAIZ,B,8682,4081,4506,1689,1963,781,2543,908,50,17,1794,1104,319,157,1475,947,947,,,,2236,1226,2133,1184,3,1,83,32,17,9,42,96,45
E02001919,Birmingham 093,Middle Super Output Areas and Intermediate Zones,MSOAIZ,B,6520,2624,4461,1498,2286,792,2175,706,30,16,427,271,86,47,341,224,224,,,,1503,796,1410,741,1,1,50,30,42,24,55,99,43
E02001920,Birmingham 094,Middle Super Output Areas and Intermediate Zones,MSOAIZ,B,7579,3256,4050,1660,1460,758,2590,902,44,19,2701,1252,2621,1223,80,29,29,,,,671,259,630,237,0,0,28,15,13,7,22,113,66
E02001921,Birmingham 095,Middle Super Output Areas and Intermediate Zones,MSOAIZ,B,7792,3283,4286,1864,1641,876,2645,988,33,12,2206,916,1889,797,317,119,119,,,,1164,433,1090,401,5,1,56,25,13,6,32,103,58
E02001922,Birmingham 096,Middle Super Output Areas and Intermediate Zones,MSOAIZ,B,11409,2994,1080,476,548,298,532,178,62,19,824,328,442,180,382,148,148,,,,9351,2138,9155,2081,11,4,115,30,70,23,57,92,33
E02001923,Birmingham 097,Middle Super Output Areas and Intermediate Zones,MSOAIZ,B,10427,3380,7514,2293,3309,1208,4205,1085,20,7,769,369,387,162,382,207,207,,,,1949,651,1795,599,28,7,98,33,28,12,52,175,60
E02001924,Birmingham 098,Middle Super Output Areas and Intermediate Zones,MSOAIZ,B,6449,2396,4648,1586,1693,723,2955,863,23,8,812,442,749,403,63,39,39,,,,875,301,808,278,0,0,58,19,9,4,23,91,59
E02001925,Birmingham 099,Middle Super Output Areas and Intermediate Zones,MSOAIZ,B,6548,2812,3896,1697,1735,903,2161,794,23,9,1007,530,448,174,559,356,356,,,,1542,532,1443,493,20,7,54,24,25,8,39,80,44
E02001926,Birmingham 100,Middle Super Output Areas and Intermediate Zones,MSOAIZ,B,6830,2829,3560,1559,1611,828,1949,731,27,16,683,329,187,101,496,228,228,,,,2451,881,2214,780,24,22,150,56,63,23,101,109,44
E02001927,Birmingham 101,Middle Super Output Areas and Intermediate Zones,MSOAIZ,B,7634,3205,3927,1610,1229,660,2698,950,132,67,2535,1096,1990,868,545,228,228,,,,933,367,862,334,10,5,47,19,14,9,33,107,65
E02001928,Birmingham 102,Middle Super Output Areas and Intermediate Zones,MSOAIZ,B,6850,3003,3728,1546,1309,663,2419,883,43,21,2403,1150,2031,954,372,196,196,,,,553,219,495,194,0,0,55,23,3,2,25,123,67
E02001929,Birmingham 103,Middle Super Output Areas and Intermediate Zones,MSOAIZ,B,9626,3690,4851,1854,1311,670,3540,1184,10,5,3294,1286,3096,1207,198,79,79,,,,1292,461,1206,425,0,0,76,33,10,3,36,179,84
E02001930,Birmingham 104,Middle Super Output Areas and Intermediate Zones,MSOAIZ,B,7845,3203,5566,2192,2080,960,3486,1232,22,11,471,266,324,174,147,92,92,,,,1675,689,1581,652,11,2,78,33,5,2,37,111,45
E02001931,Birmingham 105,Middle Super Output Areas and Intermediate Zones,MSOAIZ,B,7884,3067,6133,2262,2667,1181,3466,1081,10,5,748,385,564,256,184,129,129,,,,934,384,840,346,0,0,83,34,11,4,38,59,31
E02001932,Birmingham 106,Middle Super Output Areas and Intermediate Zones,MSOAIZ,B,6586,2853,2857,1199,998,524,1859,675,407,159,2549,1192,1687,848,862,344,344,,,,643,239,580,210,7,2,41,19,15,8,29,130,64
E02001933,Birmingham 107,Middle Super Output Areas and Intermediate Zones,MSOAIZ,B,7512,3119,4883,1982,1616,799,3267,1183,40,16,1457,661,1199,515,258,146,146,,,,1066,423,957,376,12,5,92,40,5,2,47,66,37
E02001934,Birmingham 108,Middle Super Output Areas and Intermediate Zones,MSOAIZ,B,6782,2297,5571,1858,2271,948,3300,910,17,6,276,103,253,97,23,6,6,,,,863,304,792,279,2,1,62,22,7,2,25,55,26
E02001935,Birmingham 109,Middle Super Output Areas and Intermediate Zones,MSOAIZ,B,7811,3238,4627,1938,2096,1086,2531,852,96,44,2280,939,416,174,1864,765,765,,,,731,286,652,250,6,3,38,18,35,15,36,77,31
E02001936,Birmingham 110,Middle Super Output Areas and Intermediate Zones,MSOAIZ,B,6438,2570,5032,1931,2111,1038,2921,893,17,10,765,359,596,284,169,75,75,,,,559,236,491,209,22,7,25,12,21,8,27,65,34
E02001937,Birmingham 111,Middle Super Output Areas and Intermediate Zones,MSOAIZ,B,7871,3249,4317,1696,1581,773,2736,923,114,61,2442,1083,2202,955,240,128,128,,,,880,346,805,312,0,0,66,30,9,4,34,118,63
E02001938,Birmingham 112,Middle Super Output Areas and Intermediate Zones,MSOAIZ,B,7560,3286,4896,2022,1416,718,3480,1304,96,48,921,473,256,87,665,386,386,,,,1592,711,1485,661,2,2,91,41,14,7,50,55,32
E02001939,Birmingham 113,Middle Super Output Areas and Intermediate Zones,MSOAIZ,B,5807,2882,2219,939,995,517,1224,422,62,37,2814,1572,660,429,2154,1143,1143,,,,655,299,601,273,17,5,12,7,25,14,26,57,35
E02001941,Birmingham 115,Middle Super Output Areas and Intermediate Zones,MSOAIZ,B,6098,2519,3328,1348,1185,598,2143,750,50,26,1892,802,1764,724,128,78,78,,,,720,285,671,259,2,1,42,22,5,3,26,108,58
E02001942,Birmingham 116,Middle Super Output Areas and Intermediate Zones,MSOAIZ,B,6673,2971,4051,1700,1519,807,2532,893,170,84,1408,613,969,399,439,214,214,,,,996,549,933,519,13,5,44,22,6,3,30,48,25
E02001943,Birmingham 117,Middle Super Output Areas and Intermediate Zones,MSOAIZ,B,6363,2593,4020,1645,1345,692,2675,953,197,86,1376,544,963,369,413,175,175,,,,708,285,669,270,13,4,26,11,0,0,15,62,33
E02001944,Birmingham 118,Middle Super Output Areas and Intermediate Zones,MSOAIZ,B,8051,3411,5283,2181,1722,908,3561,1273,364,178,1238,562,792,362,446,200,200,,,,1085,446,1013,413,3,2,60,27,9,4,33,81,44
E02001945,Birmingham 119,Middle Super Output Areas and Intermediate Zones,MSOAIZ,B,7777,3098,3839,1530,998,522,2841,1008,82,40,2953,1178,2762,1113,191,65,65,,,,808,300,739,270,0,0,65,27,4,3,30,95,50
E02001946,Birmingham 120,Middle Super Output Areas and Intermediate Zones,MSOAIZ,B,7619,3193,6092,2508,2394,1238,3698,1270,55,24,661,315,295,139,366,176,176,,,,774,321,705,296,9,2,56,22,4,1,25,37,25
E02001947,Birmingham 121,Middle Super Output Areas and Intermediate Zones,MSOAIZ,B,6115,2869,2473,1067,840,466,1633,601,15,7,3127,1567,3002,1485,125,82,82,,,,367,138,327,122,5,1,33,13,2,2,16,133,90
E02001948,Birmingham 122,Middle Super Output Areas and Intermediate Zones,MSOAIZ,B,7387,3073,5560,2305,1939,1028,3621,1277,71,31,810,347,704,289,106,58,58,,,,905,364,819,334,0,0,86,30,0,0,30,41,26
E02001949,Birmingham 123,Middle Super Output Areas and Intermediate Zones,MSOAIZ,B,5695,2483,3210,1452,1070,600,2140,852,23,8,1778,695,1330,524,448,171,171,,,,638,306,607,288,1,1,28,16,2,1,18,46,22
E02001950,Birmingham 124,Middle Super Output Areas and Intermediate Zones,MSOAIZ,B,8363,3608,6161,2602,2399,1273,3762,1329,126,54,924,435,509,249,415,186,186,,,,1101,485,1031,457,2,1,68,27,0,0,28,51,32
E02001951,Birmingham 125,Middle Super Output Areas and Intermediate Zones,MSOAIZ,B,8200,3573,3425,1409,945,465,2480,944,103,47,4051,1850,3546,1640,505,210,210,,,,493,189,467,176,2,1,24,12,0,0,13,128,78
E02001952,Birmingham 126,Middle Super Output Areas and Intermediate Zones,MSOAIZ,B,8890,4055,3567,1535,1156,651,2411,884,238,110,4059,1923,2745,1454,1314,469,469,,,,855,380,768,344,13,5,59,24,15,7,36,171,107
E02001953,Birmingham 127,Middle Super Output Areas and Intermediate Zones,MSOAIZ,B,7008,2963,5384,2220,2161,1124,3223,1096,48,21,1043,484,990,464,53,20,20,,,,473,205,408,179,4,2,57,23,4,1,26,60,33
E02001954,Birmingham 128,Middle Super Output Areas and Intermediate Zones,MSOAIZ,B,7784,3400,3135,1338,964,499,2171,839,62,26,3813,1705,3566,1604,247,101,101,,,,623,250,569,223,9,3,41,22,4,2,27,151,81
E02001955,Birmingham 129,Middle Super Output Areas and Intermediate Zones,MSOAIZ,B,6307,2738,3625,1573,1051,580,2574,993,138,56,1666,700,931,401,735,299,299,,,,829,385,757,353,4,1,55,26,13,5,32,49,24
E02001956,Birmingham 130,Middle Super Output Areas and Intermediate Zones,MSOAIZ,B,6367,2684,4566,1904,1409,744,3157,1160,50,21,949,382,826,339,123,43,43,,,,738,337,664,303,1,1,73,33,0,0,34,64,40
E02001957,Birmingham 131,Middle Super Output Areas and Intermediate Zones,MSOAIZ,B,7889,3283,6074,2562,2187,1179,3887,1383,62,27,866,341,572,229,294,112,112,,,,823,325,737,288,2,1,75,32,9,4,37,64,28
E02001958,Coventry 001,Middle Super Output Areas and Intermediate Zones,MSOAIZ,CV,7422,3268,4699,1997,1744,892,2955,1105,44,19,916,420,161,75,755,345,345,,,,1683,791,1573,743,11,3,81,38,18,7,48,80,41
E02001959,Coventry 002,Middle Super Output Areas and Intermediate Zones,MSOAIZ,CV,6110,2378,4754,1900,2020,984,2734,916,22,11,234,78,60,18,174,60,60,,,,1074,374,973,336,1,1,98,36,2,1,38,26,15
E02001961,Coventry 004,Middle Super Output Areas and Intermediate Zones,MSOAIZ,CV,7484,3277,3760,1546,1382,719,2378,827,35,15,2247,1160,950,491,1297,669,669,,,,1386,524,1261,476,2,1,113,42,10,5,48,56,32
E02001962,Coventry 005,Middle Super Output Areas and Intermediate Zones,MSOAIZ,CV,6017,2215,3411,1259,1312,592,2099,667,18,5,981,335,227,80,754,255,255,,,,1507,577,1384,537,21,4,85,28,17,8,40,100,39
E02001963,Coventry 006,Middle Super Output Areas and Intermediate Zones,MSOAIZ,CV,5908,2441,4718,1898,1877,956,2841,942,9,4,415,259,132,91,283,168,168,,,,724,260,636,226,16,5,71,28,1,1,34,42,20
E02001964,Coventry 007,Middle Super Output Areas and Intermediate Zones,MSOAIZ,CV,8019,3282,2317,984,888,463,1429,521,42,21,4831,1924,2167,864,2664,1060,1060,,,,741,312,659,280,6,1,66,26,10,5,32,88,41
E02001965,Coventry 008,Middle Super Output Areas and Intermediate Zones,MSOAIZ,CV,7977,3309,5697,2286,2024,1020,3673,1266,154,68,901,440,120,60,781,380,380,,,,1153,475,1087,450,6,1,56,20,4,4,25,72,40
E02001966,Coventry 009,Middle Super Output Areas and Intermediate Zones,MSOAIZ,CV,6888,2228,3691,1061,1659,558,2032,503,48,14,980,364,170,62,810,302,302,,,,2017,734,1894,686,4,2,90,35,29,11,48,152,55
E02001967,Coventry 010,Middle Super Output Areas and Intermediate Zones,MSOAIZ,CV,6147,2648,5168,2195,2355,1230,2813,965,18,10,278,143,109,53,169,90,90,,,,630,274,561,242,4,2,55,24,10,6,32,53,26
E02001968,Coventry 011,Middle Super Output Areas and Intermediate Zones,MSOAIZ,CV,7147,2693,4711,1793,1651,763,3060,1030,19,8,308,124,129,59,179,65,65,,,,2045,741,1882,674,7,2,142,56,14,9,67,64,27
E02001969,Coventry 012,Middle Super Output Areas and Intermediate Zones,MSOAIZ,CV,6332,2677,3596,1530,1257,674,2339,856,16,10,1169,548,550,246,619,302,302,,,,1495,554,1378,509,5,2,93,36,19,7,45,56,35
E02001970,Coventry 013,Middle Super Output Areas and Intermediate Zones,MSOAIZ,CV,5436,2474,3952,1816,1960,1105,1992,711,23,8,220,112,77,46,143,66,66,,,,1171,507,1096,470,4,1,67,34,4,2,37,70,31
E02001971,Coventry 014,Middle Super Output Areas and Intermediate Zones,MSOAIZ,CV,5834,2401,4578,1853,1735,879,2843,974,1,1,375,224,141,72,234,152,152,,,,838,303,767,275,5,2,63,25,3,1,28,42,20
E02001972,Coventry 015,Middle Super Output Areas and Intermediate Zones,MSOAIZ,CV,9935,3644,3638,1149,1700,617,1938,532,71,24,3026,1283,464,221,2562,1062,1062,,,,2997,1110,2823,1042,14,5,90,35,70,28,68,203,78
E02001973,Coventry 016,Middle Super Output Areas and Intermediate Zones,MSOAIZ,CV,8111,3414,4204,1667,1373,646,2831,1021,45,15,1675,867,652,345,1023,522,522,,,,2129,832,1949,760,9,3,138,51,33,18,72,58,33
E02001974,Coventry 017,Middle Super Output Areas and Intermediate Zones,MSOAIZ,CV,9436,3906,7588,3127,2901,1512,4687,1615,30,24,145,69,44,15,101,54,54,,,,1618,655,1485,601,10,3,111,45,12,6,54,55,31
E02001975,Coventry 018,Middle Super Output Areas and Intermediate Zones,MSOAIZ,CV,7854,2974,6181,2392,2212,1087,3969,1305,23,8,126,51,47,17,79,34,34,,,,1483,500,1385,464,0,0,80,32,18,4,36,41,23
E02001976,Coventry 019,Middle Super Output Areas and Intermediate Zones,MSOAIZ,CV,7085,3126,4499,1830,1761,904,2738,926,39,23,1035,644,335,209,700,435,435,,,,1462,600,1323,545,37,16,84,31,18,8,55,50,29
E02001977,Coventry 020,Middle Super Output Areas and Intermediate Zones,MSOAIZ,CV,8818,4097,3096,1350,1019,527,2077,823,97,39,1933,996,639,329,1294,667,667,,,,3552,1637,3351,1518,7,4,112,51,82,64,119,140,75
E02001978,Coventry 021,Middle Super Output Areas and Intermediate Zones,MSOAIZ,CV,6471,2538,4723,1845,1732,830,2991,1015,20,7,131,57,42,17,89,40,40,,,,1529,596,1433,559,0,0,89,35,7,2,37,68,33
E02001979,Coventry 022,Middle Super Output Areas and Intermediate Zones,MSOAIZ,CV,5678,2465,4910,2140,2161,1170,2749,970,9,4,60,19,28,7,32,12,12,,,,659,279,620,260,3,1,31,16,5,2,19,40,23
E02001980,Coventry 023,Middle Super Output Areas and Intermediate Zones,MSOAIZ,CV,5972,2568,5398,2291,2484,1292,2914,999,7,2,26,12,8,4,18,8,8,,,,512,245,479,229,0,0,33,16,0,0,16,29,18
E02001981,Coventry 024,Middle Super Output Areas and Intermediate Zones,MSOAIZ,CV,10927,4334,3149,1079,1459,555,1690,524,82,33,3334,1510,653,324,2681,1186,1186,,,,4125,1603,3953,1525,9,3,88,37,75,38,78,237,109
E02001982,Coventry 025,Middle Super Output Areas and Intermediate Zones,MSOAIZ,CV,7062,3068,5275,2223,1889,981,3386,1242,114,59,883,410,39,24,844,386,386,,,,741,349,686,322,2,1,51,24,2,2,27,49,27
E02001983,Coventry 026,Middle Super Output Areas and Intermediate Zones,MSOAIZ,CV,7492,3268,5618,2453,2039,1085,3579,1368,13,10,424,228,160,94,264,134,134,,,,1390,551,1285,508,0,0,85,32,20,11,43,47,26
E02001984,Coventry 027,Middle Super Output Areas and Intermediate Zones,MSOAIZ,CV,8829,3515,6135,2479,2189,1100,3946,1379,39,15,484,211,150,59,334,152,152,,,,2097,776,1970,726,7,3,89,37,31,10,50,74,34
E02001985,Coventry 028,Middle Super Output Areas and Intermediate Zones,MSOAIZ,CV,7370,3071,1968,931,872,460,1096,471,37,19,1022,440,306,114,716,326,326,,,,4265,1642,4073,1553,30,10,106,52,56,27,89,78,39
E02001986,Coventry 029,Middle Super Output Areas and Intermediate Zones,MSOAIZ,CV,7503,3587,3944,1741,1365,775,2579,966,40,19,2528,1382,960,529,1568,853,853,,,,894,378,782,333,4,1,82,34,26,10,45,97,67
E02001987,Coventry 030,Middle Super Output Areas and Intermediate Zones,MSOAIZ,CV,5775,2609,2464,1233,929,526,1535,707,40,19,260,125,36,17,224,108,108,,,,2968,1210,2705,1108,3,2,119,55,141,45,102,43,22
E02001988,Coventry 031,Middle Super Output Areas and Intermediate Zones,MSOAIZ,CV,6903,3562,1797,883,715,419,1082,464,86,54,1767,1035,368,208,1399,827,827,,,,3176,1537,2991,1431,21,8,60,31,104,67,106,77,53
E02001989,Coventry 032,Middle Super Output Areas and Intermediate Zones,MSOAIZ,CV,5626,2296,4046,1718,1422,747,2624,971,6,5,358,109,146,47,212,62,62,,,,1176,444,1081,403,11,4,73,34,11,3,41,40,20
E02001990,Coventry 033,Middle Super Output Areas and Intermediate Zones,MSOAIZ,CV,9184,3661,7789,3108,3156,1542,4633,1566,38,16,314,133,85,44,229,89,89,,,,1006,377,905,338,5,3,91,34,5,2,39,37,27
E02001991,Coventry 034,Middle Super Output Areas and Intermediate Zones,MSOAIZ,CV,8379,3732,6361,2714,2810,1451,3551,1263,35,30,250,160,22,16,228,144,144,,,,1686,800,1518,706,6,2,56,28,106,64,94,47,28
E02001992,Coventry 035,Middle Super Output Areas and Intermediate Zones,MSOAIZ,CV,9526,3879,4482,1889,1498,806,2984,1083,87,40,3919,1514,1418,529,2501,985,985,,,,962,393,855,348,7,3,78,32,22,10,45,76,43
E02001993,Coventry 036,Middle Super Output Areas and Intermediate Zones,MSOAIZ,CV,7202,2937,4091,1583,1379,676,2712,907,20,9,2013,961,800,368,1213,593,593,,,,988,336,895,304,4,1,58,21,31,10,32,90,48
E02001994,Coventry 037,Middle Super Output Areas and Intermediate Zones,MSOAIZ,CV,8099,3398,5753,2399,2336,1215,3417,1184,16,9,741,398,252,129,489,269,269,,,,1495,553,1386,515,5,2,89,30,15,6,38,94,39
E02001995,Coventry 038,Middle Super Output Areas and Intermediate Zones,MSOAIZ,CV,6368,3090,3854,1856,1482,835,2372,1021,17,10,501,307,106,56,395,251,251,,,,1922,873,1800,820,9,4,88,40,25,9,53,74,44
E02001996,Coventry 039,Middle Super Output Areas and Intermediate Zones,MSOAIZ,CV,6781,3262,2331,1072,883,500,1448,572,57,24,3526,1764,1308,682,2218,1082,1082,,,,796,357,737,326,3,1,38,22,18,8,31,71,45
E02001997,Coventry 040,Middle Super Output Areas and Intermediate Zones,MSOAIZ,CV,8510,3464,7399,2949,3536,1757,3863,1192,5,4,354,202,87,56,267,146,146,,,,684,276,615,250,7,3,40,15,22,8,26,68,33
E02001998,Coventry 041,Middle Super Output Areas and Intermediate Zones,MSOAIZ,CV,5973,2381,5343,2137,2145,1115,3198,1022,13,6,88,38,30,12,58,26,26,,,,494,180,440,161,2,1,51,17,1,1,19,35,20
E02001999,Coventry 042,Middle Super Output Areas and Intermediate Zones,MSOAIZ,CV,5935,2258,4488,1724,2061,962,2427,762,20,12,418,190,138,68,280,122,122,,,,976,313,876,280,23,6,29,14,48,13,33,33,19
E02002000,Dudley 001,Middle Super Output Areas and Intermediate Zones,MSOAIZ,WV,7778,3218,4717,1907,1882,933,2835,974,10,5,2418,1032,1974,886,444,146,146,,,,516,207,458,183,0,0,46,18,12,6,24,117,67
E02002001,Dudley 002,Middle Super Output Areas and Intermediate Zones,MSOAIZ,WV,5944,2509,4015,1632,1531,793,2484,839,11,6,1417,624,1284,548,133,76,76,,,,433,202,414,191,3,1,14,8,2,2,11,68,45
E02002002,Dudley 003,Middle Super Output Areas and Intermediate Zones,MSOAIZ,WV,7016,2982,6323,2628,3346,1664,2977,964,21,13,349,189,299,146,50,43,43,,,,266,117,232,99,0,0,32,16,2,2,18,57,35
E02002003,Dudley 004,Middle Super Output Areas and Intermediate Zones,MSOAIZ,WV,9034,3766,6981,2839,2987,1524,3994,1315,13,6,1349,603,1232,514,117,89,89,,,,609,269,564,249,4,1,35,16,6,3,20,82,49
E02002004,Dudley 005,Middle Super Output Areas and Intermediate Zones,MSOAIZ,DY,7431,2979,4293,1701,1593,806,2700,895,180,75,2249,900,1588,673,661,227,227,,,,573,229,533,210,7,2,29,15,4,2,19,136,74
E02002005,Dudley 006,Middle Super Output Areas and Intermediate Zones,MSOAIZ,DY,8047,3024,3789,1471,1464,706,2325,765,30,13,3523,1249,3433,1203,90,46,46,,,,546,216,486,191,13,5,40,16,7,4,25,159,75
E02002006,Dudley 007,Middle Super Output Areas and Intermediate Zones,MSOAIZ,DY,6400,2826,3819,1586,1405,726,2414,860,117,51,1948,934,1409,681,539,253,253,,,,442,207,401,186,6,2,31,16,4,3,21,74,48
E02002007,Dudley 008,Middle Super Output Areas and Intermediate Zones,MSOAIZ,DY,8725,3796,6652,2878,3317,1718,3335,1160,13,7,1516,643,1426,584,90,59,59,,,,450,206,407,183,1,1,41,21,1,1,23,94,62
E02002008,Dudley 009,Middle Super Output Areas and Intermediate Zones,MSOAIZ,DY,8220,3066,7375,2720,2161,965,5214,1755,52,21,217,85,100,43,117,42,42,,,,538,222,506,207,2,1,30,14,0,0,15,38,18
E02002009,Dudley 010,Middle Super Output Areas and Intermediate Zones,MSOAIZ,DY,6707,2550,3300,1143,1232,502,2068,641,14,5,2499,1027,2298,931,201,96,96,,,,736,292,676,268,0,0,54,20,6,4,24,158,83
E02002010,Dudley 011,Middle Super Output Areas and Intermediate Zones,MSOAIZ,DY,7020,3223,3612,1373,1601,709,2011,664,110,49,1798,1100,1145,705,653,395,395,,,,1369,622,1299,588,11,3,35,16,24,15,34,131,79
E02002011,Dudley 012,Middle Super Output Areas and Intermediate Zones,MSOAIZ,DY,5789,2457,5253,2213,2341,1210,2912,1003,11,7,137,67,85,47,52,20,20,,,,348,146,310,130,8,2,23,12,7,2,16,40,24
E02002012,Dudley 013,Middle Super Output Areas and Intermediate Zones,MSOAIZ,DY,7678,3278,3661,1460,1472,744,2189,716,38,18,2994,1400,2608,1242,386,158,158,,,,851,320,677,252,82,30,30,17,62,21,68,134,80
E02002013,Dudley 014,Middle Super Output Areas and Intermediate Zones,MSOAIZ,DY,6589,2783,5860,2419,2835,1445,3025,974,8,4,352,186,340,182,12,4,4,,,,339,152,316,141,0,0,14,8,9,3,11,30,22
E02002014,Dudley 015,Middle Super Output Areas and Intermediate Zones,MSOAIZ,DY,6865,2643,4125,1529,1733,753,2392,776,24,8,1553,637,1357,542,196,95,95,,,,1030,409,950,378,13,5,55,21,12,5,31,133,60
E02002015,Dudley 016,Middle Super Output Areas and Intermediate Zones,MSOAIZ,DY,5982,2429,4567,1848,1872,920,2695,928,7,3,971,389,916,377,55,12,12,,,,378,152,333,133,3,2,35,14,7,3,19,59,37
E02002016,Dudley 017,Middle Super Output Areas and Intermediate Zones,MSOAIZ,DY,7795,3132,3781,1540,1417,707,2364,833,18,8,3091,1184,2881,1114,210,70,70,,,,733,310,683,286,5,2,41,20,4,2,24,172,90
E02002017,Dudley 018,Middle Super Output Areas and Intermediate Zones,MSOAIZ,DY,8146,3550,5127,2042,2192,1001,2935,1041,47,14,1953,1011,1627,861,326,150,150,,,,923,432,857,404,14,4,46,20,6,4,28,96,51
E02002018,Dudley 019,Middle Super Output Areas and Intermediate Zones,MSOAIZ,DY,9004,3707,7922,3252,3738,1913,4184,1339,6,2,528,220,517,217,11,3,3,,,,474,190,443,175,0,0,31,15,0,0,15,74,43
E02002019,Dudley 020,Middle Super Output Areas and Intermediate Zones,MSOAIZ,DY,7857,3102,4637,1799,1912,893,2725,906,16,6,2520,988,2398,947,122,41,41,,,,562,240,524,221,0,0,33,17,5,2,19,122,69
E02002020,Dudley 021,Middle Super Output Areas and Intermediate Zones,MSOAIZ,DY,9309,3980,7844,3306,3271,1669,4573,1637,35,21,655,268,476,216,179,52,52,,,,719,345,671,319,2,2,35,19,11,5,26,56,40
E02002021,Dudley 022,Middle Super Output Areas and Intermediate Zones,MSOAIZ,DY,7249,3400,3343,1343,1164,528,2179,815,32,19,2408,1310,2034,1125,374,185,185,,,,1329,653,1260,618,11,4,42,25,16,6,35,137,75
E02002022,Dudley 023,Middle Super Output Areas and Intermediate Zones,MSOAIZ,DY,8280,3418,4975,2032,1571,804,3404,1228,28,16,2304,922,2087,826,217,96,96,,,,872,385,778,341,10,3,76,37,8,4,44,101,63
E02002023,Dudley 024,Middle Super Output Areas and Intermediate Zones,MSOAIZ,DY,5339,2221,4265,1779,1758,891,2507,888,4,2,700,273,463,181,237,92,92,,,,358,156,317,136,5,1,29,16,7,3,20,12,11
E02002024,Dudley 025,Middle Super Output Areas and Intermediate Zones,MSOAIZ,DY,8488,3434,6032,2365,2327,1142,3705,1223,60,25,1430,625,1326,592,104,33,33,,,,861,351,783,319,20,7,54,23,4,2,32,105,68
E02002025,Dudley 026,Middle Super Output Areas and Intermediate Zones,MSOAIZ,B,7943,3319,5752,2331,2219,1074,3533,1257,38,18,1124,533,860,406,264,127,127,,,,941,396,873,367,4,2,62,25,2,2,29,88,41
E02002026,Dudley 027,Middle Super Output Areas and Intermediate Zones,MSOAIZ,DY,7087,2800,5997,2340,2365,1141,3632,1199,121,78,375,148,345,134,30,14,14,,,,556,213,465,179,5,2,83,30,3,2,34,38,21
E02002027,Dudley 028,Middle Super Output Areas and Intermediate Zones,MSOAIZ,DY,5659,2223,5201,2004,1594,738,3607,1266,66,30,26,17,20,14,6,3,3,,,,349,163,324,151,0,0,25,12,0,0,12,17,9
E02002028,Dudley 029,Middle Super Output Areas and Intermediate Zones,MSOAIZ,DY,5781,2587,4565,1979,2096,1127,2469,852,9,5,796,406,764,389,32,17,17,,,,359,153,332,140,0,0,21,10,6,3,13,52,44
E02002029,Dudley 030,Middle Super Output Areas and Intermediate Zones,MSOAIZ,B,5846,2468,5015,2074,2348,1195,2667,879,18,8,327,176,202,95,125,81,81,,,,452,189,404,166,0,0,45,22,3,1,23,34,21
E02002030,Dudley 031,Middle Super Output Areas and Intermediate Zones,MSOAIZ,DY,6220,2690,3997,1680,1523,786,2474,894,89,54,1483,675,887,436,596,239,239,,,,548,223,486,198,0,0,55,22,7,3,25,103,58
E02002031,Dudley 032,Middle Super Output Areas and Intermediate Zones,MSOAIZ,DY,5914,2339,4637,1782,1786,817,2851,965,30,13,239,94,138,62,101,32,32,,,,974,434,915,406,0,0,57,26,2,2,28,34,16
E02002032,Dudley 033,Middle Super Output Areas and Intermediate Zones,MSOAIZ,DY,9910,4050,6031,2474,2121,1045,3910,1429,48,19,2557,1014,2070,859,487,155,155,,,,1127,462,1044,422,5,3,68,33,10,4,40,147,81
E02002033,Dudley 034,Middle Super Output Areas and Intermediate Zones,MSOAIZ,B,7446,3190,5766,2403,2390,1240,3376,1163,32,21,916,414,662,269,254,145,145,,,,678,311,610,279,1,1,61,29,6,2,32,54,41
E02002034,Dudley 035,Middle Super Output Areas and Intermediate Zones,MSOAIZ,DY,8053,3724,5370,2298,2035,1074,3335,1224,32,16,1423,764,1325,713,98,51,51,,,,1101,571,1013,530,13,6,71,32,4,3,41,127,75
E02002035,Dudley 036,Middle Super Output Areas and Intermediate Zones,MSOAIZ,B,6065,2490,5326,2131,2416,1188,2910,943,0,0,421,208,380,194,41,14,14,,,,251,114,222,100,2,2,27,12,0,0,14,67,37
E02002036,Dudley 037,Middle Super Output Areas and Intermediate Zones,MSOAIZ,DY,6560,2773,3601,1375,1453,673,2148,702,9,4,1957,943,1769,820,188,123,123,,,,877,391,826,361,1,1,42,23,8,6,30,116,60
E02002037,Dudley 038,Middle Super Output Areas and Intermediate Zones,MSOAIZ,DY,5859,2507,4554,1884,1885,966,2669,918,10,5,871,424,860,418,11,6,6,,,,359,149,311,129,2,1,44,18,2,1,20,65,45
E02002038,Dudley 039,Middle Super Output Areas and Intermediate Zones,MSOAIZ,B,9377,4231,6198,2671,2585,1369,3613,1302,30,17,2049,1014,1747,842,302,172,172,,,,964,446,907,412,5,2,50,30,2,2,34,136,83
E02002039,Dudley 040,Middle Super Output Areas and Intermediate Zones,MSOAIZ,DY,5855,2562,4523,1906,2033,1049,2490,857,9,6,642,305,565,262,77,43,43,,,,603,304,561,277,6,3,26,19,10,5,27,78,41
E02002040,Dudley 041,Middle Super Output Areas and Intermediate Zones,MSOAIZ,DY,5927,2510,5291,2187,2612,1303,2679,884,0,0,247,144,193,99,54,45,45,,,,344,151,308,136,6,4,30,11,0,0,15,45,28
E02002041,Dudley 042,Middle Super Output Areas and Intermediate Zones,MSOAIZ,DY,6167,2570,4937,2080,2537,1292,2400,788,13,5,859,341,853,339,6,2,2,,,,302,114,286,104,0,0,15,9,1,1,10,56,30
E02002042,Dudley 043,Middle Super Output Areas and Intermediate Zones,MSOAIZ,B,8037,3361,7005,2900,3204,1640,3801,1260,8,4,532,233,333,140,199,93,93,,,,439,190,397,173,0,0,36,15,6,2,17,53,34
E02002043,Sandwell 001,Middle Super Output Areas and Intermediate Zones,MSOAIZ,WS,8347,3165,4989,1827,1697,781,3292,1046,11,4,2370,927,2242,852,128,75,75,,,,852,323,775,290,2,1,72,30,3,2,33,125,84
E02002044,Sandwell 002,Middle Super Output Areas and Intermediate Zones,MSOAIZ,WS,7498,2834,4802,1701,1406,631,3396,1070,29,10,1793,755,1311,556,482,199,199,,,,798,324,756,306,0,0,38,16,4,2,18,76,44
E02002045,Sandwell 003,Middle Super Output Areas and Intermediate Zones,MSOAIZ,WS,7754,3201,4939,1969,1933,955,3006,1014,17,9,2026,900,1815,821,211,79,79,,,,671,254,619,233,2,1,46,19,4,1,21,101,69
E02002046,Sandwell 004,Middle Super Output Areas and Intermediate Zones,MSOAIZ,WS,5626,2031,2243,823,682,317,1561,506,12,5,2938,1033,2911,1025,27,8,8,,,,330,112,311,102,1,1,14,6,4,3,10,103,58
E02002047,Sandwell 005,Middle Super Output Areas and Intermediate Zones,MSOAIZ,WS,6331,2787,3835,1547,1644,818,2191,729,56,25,1614,831,1328,648,286,183,183,,,,720,312,670,290,3,1,38,16,9,5,22,106,72
E02002048,Sandwell 006,Middle Super Output Areas and Intermediate Zones,MSOAIZ,B,6420,2635,5604,2239,2526,1258,3078,981,24,9,250,121,194,83,56,38,38,,,,500,239,457,220,8,3,34,15,1,1,19,42,27
E02002049,Sandwell 007,Middle Super Output Areas and Intermediate Zones,MSOAIZ,WV,5920,2365,3975,1555,1469,688,2506,867,41,14,1395,573,1100,458,295,115,115,,,,472,200,432,185,0,0,39,14,1,1,15,37,23
E02002051,Sandwell 009,Middle Super Output Areas and Intermediate Zones,MSOAIZ,DY,5467,2041,2204,830,733,361,1471,469,7,3,2738,1003,2117,792,621,211,211,,,,413,149,398,142,2,1,12,5,1,1,7,105,56
E02002052,Sandwell 010,Middle Super Output Areas and Intermediate Zones,MSOAIZ,B,10467,4082,5355,1995,1809,878,3546,1117,54,18,3567,1503,2911,1219,656,284,284,,,,1328,474,1275,452,7,3,40,15,6,4,22,163,92
E02002053,Sandwell 011,Middle Super Output Areas and Intermediate Zones,MSOAIZ,B,5970,2477,4401,1792,1841,950,2560,842,13,6,791,378,683,318,108,60,60,,,,722,276,681,259,3,1,34,14,4,2,17,43,25
E02002054,Sandwell 012,Middle Super Output Areas and Intermediate Zones,MSOAIZ,B,5579,2274,4275,1734,1941,958,2334,776,12,7,599,247,553,229,46,18,18,,,,643,260,593,237,0,0,45,20,5,3,23,50,26
E02002055,Sandwell 013,Middle Super Output Areas and Intermediate Zones,MSOAIZ,WS,9050,3519,5274,1939,2018,899,3256,1040,79,36,2507,1094,1954,854,553,240,240,,,,1085,375,1014,348,3,3,60,22,8,2,27,105,75
E02002056,Sandwell 014,Middle Super Output Areas and Intermediate Zones,MSOAIZ,DY,8547,3532,3764,1508,1312,644,2452,864,20,10,3931,1628,3672,1486,259,142,142,,,,721,318,688,302,6,2,24,12,3,2,16,111,68
E02002057,Sandwell 015,Middle Super Output Areas and Intermediate Zones,MSOAIZ,DY,8917,3655,5258,1910,1821,795,3437,1115,166,69,2287,1139,1775,879,512,260,260,,,,1065,448,1007,426,2,2,45,17,11,3,22,141,89
E02002058,Sandwell 016,Middle Super Output Areas and Intermediate Zones,MSOAIZ,DY,11579,4622,6897,2482,1972,838,4925,1644,55,23,2674,1316,2411,1175,263,141,141,,,,1777,705,1673,667,9,3,72,27,23,8,38,176,96
E02002059,Sandwell 017,Middle Super Output Areas and Intermediate Zones,MSOAIZ,B,10380,4244,5990,2264,2602,1160,3388,1104,63,27,2331,1201,2012,1039,319,162,162,,,,1831,661,1714,608,26,12,60,27,31,14,53,165,91
E02002060,Sandwell 018,Middle Super Output Areas and Intermediate Zones,MSOAIZ,DY,6250,2369,3166,1077,1354,557,1812,520,42,24,2086,918,1906,821,180,97,97,,,,849,282,775,253,5,2,62,24,7,3,29,107,68
E02002061,Sandwell 019,Middle Super Output Areas and Intermediate Zones,MSOAIZ,B,5731,2052,3261,1060,1560,595,1701,465,58,25,1165,536,891,389,274,147,147,,,,1139,384,1083,360,0,0,44,17,12,7,24,108,47
E02002062,Sandwell 020,Middle Super Output Areas and Intermediate Zones,MSOAIZ,B,7080,2952,3211,1064,1473,599,1738,465,40,19,2579,1389,1647,886,932,503,503,,,,1096,378,1004,346,21,7,58,20,13,5,32,154,102
E02002063,Sandwell 021,Middle Super Output Areas and Intermediate Zones,MSOAIZ,DY,9129,3583,5829,2205,1961,844,3868,1361,42,20,1401,597,916,404,485,193,193,,,,1720,701,1648,665,10,3,54,28,8,5,36,137,60
E02002064,Sandwell 022,Middle Super Output Areas and Intermediate Zones,MSOAIZ,B,11869,4656,7586,2905,2546,1204,5040,1701,28,13,3064,1248,2933,1200,131,48,48,,,,1048,413,982,379,2,1,53,28,11,5,34,143,77
E02002065,Sandwell 023,Middle Super Output Areas and Intermediate Zones,MSOAIZ,B,12067,3774,7059,2056,3061,1027,3998,1029,56,25,2034,784,1199,458,835,326,326,,,,2667,815,2392,734,0,0,190,54,85,27,81,251,94
E02002066,Sandwell 024,Middle Super Output Areas and Intermediate Zones,MSOAIZ,B,7198,2784,4155,1452,1699,673,2456,779,45,18,1467,712,1119,519,348,193,193,,,,1357,534,1298,512,0,0,38,15,21,7,22,174,68
E02002067,Sandwell 025,Middle Super Output Areas and Intermediate Zones,MSOAIZ,B,5468,2190,3921,1585,1689,824,2232,761,27,11,1138,429,1045,399,93,30,30,,,,340,138,310,122,0,0,22,12,8,4,16,42,27
E02002068,Sandwell 026,Middle Super Output Areas and Intermediate Zones,MSOAIZ,B,11930,4097,4859,1445,1735,579,3124,866,50,17,4255,1686,3006,1168,1249,518,518,,,,2384,814,2312,776,0,0,54,29,18,9,38,382,135
E02002069,Sandwell 027,Middle Super Output Areas and Intermediate Zones,MSOAIZ,B,6542,2917,3722,1541,1531,767,2191,774,16,7,2067,1043,1815,930,252,113,113,,,,668,277,618,253,10,4,35,17,5,3,24,69,49
E02002070,Sandwell 028,Middle Super Output Areas and Intermediate Zones,MSOAIZ,B,8993,3487,4765,1587,2050,777,2715,810,71,24,2030,1050,1391,648,639,402,402,,,,1889,714,1812,683,1,1,66,26,10,4,31,238,112
E02002071,Sandwell 029,Middle Super Output Areas and Intermediate Zones,MSOAIZ,B,6507,2610,3769,1485,1358,676,2411,809,36,15,2059,840,1951,781,108,59,59,,,,544,212,493,191,2,2,42,16,7,3,21,99,58
E02002072,Sandwell 030,Middle Super Output Areas and Intermediate Zones,MSOAIZ,B,8266,3415,5877,2240,2196,1026,3681,1214,22,8,1024,560,768,427,256,133,133,,,,1221,534,1113,486,1,1,88,38,19,9,48,122,73
E02002073,Sandwell 031,Middle Super Output Areas and Intermediate Zones,MSOAIZ,B,7508,2867,4204,1532,1496,685,2708,847,31,16,2448,1004,2352,936,96,68,68,,,,706,245,655,229,0,0,51,16,0,0,16,119,70
E02002074,Sandwell 032,Middle Super Output Areas and Intermediate Zones,MSOAIZ,B,7964,3109,5096,1925,1850,892,3246,1033,11,4,1937,817,1881,789,56,28,28,,,,812,301,740,272,10,3,56,24,6,2,29,108,62
E02002075,Sandwell 033,Middle Super Output Areas and Intermediate Zones,MSOAIZ,B,8473,3593,5222,2078,1783,901,3439,1177,44,17,2066,987,1669,736,397,251,251,,,,1000,424,872,370,22,8,96,41,10,5,54,141,87
E02002076,Sandwell 034,Middle Super Output Areas and Intermediate Zones,MSOAIZ,B,10243,4479,6402,2831,2365,1217,4037,1614,22,17,933,401,849,368,84,33,33,,,,2767,1170,2656,1125,9,4,86,36,16,5,45,119,60
E02002077,Sandwell 035,Middle Super Output Areas and Intermediate Zones,MSOAIZ,B,10109,4282,6033,2359,2253,1049,3780,1310,100,50,2587,1221,1891,951,696,270,270,,,,1266,575,1171,534,17,9,58,26,20,6,41,123,77
E02002078,Sandwell 036,Middle Super Output Areas and Intermediate Zones,MSOAIZ,B,6205,2483,4981,1972,2102,1049,2879,923,11,5,594,250,514,191,80,59,59,,,,568,229,513,206,1,1,48,20,6,2,23,51,27
E02002079,Sandwell 037,Middle Super Output Areas and Intermediate Zones,MSOAIZ,B,7958,3375,5246,2146,1961,1032,3285,1114,107,54,1660,771,1531,705,129,66,66,,,,835,330,773,299,4,2,47,23,11,6,31,110,74
E02002080,Sandwell 038,Middle Super Output Areas and Intermediate Zones,MSOAIZ,B,6593,2783,3936,1609,1460,753,2476,856,41,19,1808,770,1636,705,172,65,65,,,,704,324,650,305,3,1,37,13,14,5,19,104,61
E02002081,Solihull 001,Middle Super Output Areas and Intermediate Zones,MSOAIZ,B,5366,2369,4248,1784,1858,956,2390,828,34,19,729,391,147,84,582,307,307,,,,333,162,292,141,0,0,39,19,2,2,21,22,13
E02002082,Solihull 002,Middle Super Output Areas and Intermediate Zones,MSOAIZ,B,5909,2441,2828,1130,929,461,1899,669,44,18,2468,1082,2010,937,458,145,145,,,,538,196,504,181,0,0,29,13,5,2,15,31,15
E02002083,Solihull 003,Middle Super Output Areas and Intermediate Zones,MSOAIZ,B,5825,2339,5370,2152,2312,1205,3058,947,71,29,89,28,57,17,32,11,11,,,,262,117,234,102,4,2,22,11,2,2,15,33,13
E02002084,Solihull 004,Middle Super Output Areas and Intermediate Zones,MSOAIZ,B,6126,2614,3316,1347,1208,615,2108,732,46,21,2420,1107,1977,929,443,178,178,,,,332,131,312,123,0,0,17,6,3,2,8,12,8
E02002085,Solihull 005,Middle Super Output Areas and Intermediate Zones,MSOAIZ,B,6252,2593,3365,1397,1311,677,2054,720,44,19,2309,946,2015,829,294,117,117,,,,501,210,477,197,0,0,20,10,4,3,13,33,21
E02002086,Solihull 006,Middle Super Output Areas and Intermediate Zones,MSOAIZ,B,5347,2462,2349,932,747,385,1602,547,31,10,2585,1357,2112,1168,473,189,189,,,,350,143,333,131,3,1,9,6,5,5,12,32,20
E02002087,Solihull 007,Middle Super Output Areas and Intermediate Zones,MSOAIZ,B,6032,2684,3084,1260,961,535,2123,725,28,17,2308,1172,2181,1108,127,64,64,,,,589,218,530,192,5,3,49,20,5,3,26,23,17
E02002088,Solihull 008,Middle Super Output Areas and Intermediate Zones,MSOAIZ,B,9326,4116,4429,1833,1474,772,2955,1061,64,38,3859,1866,3153,1606,706,260,260,,,,937,353,872,327,0,0,61,23,4,3,26,37,26
E02002089,Solihull 009,Middle Super Output Areas and Intermediate Zones,MSOAIZ,CV,7532,3084,5749,2304,2122,1059,3627,1245,86,40,881,397,470,229,411,168,168,,,,763,316,710,295,1,1,52,20,0,0,21,53,27
E02002090,Solihull 010,Middle Super Output Areas and Intermediate Zones,MSOAIZ,B,5807,2302,4990,1989,1721,892,3269,1097,8,4,205,76,153,56,52,20,20,,,,572,219,528,197,3,2,37,18,4,2,22,32,14
E02002091,Solihull 011,Middle Super Output Areas and Intermediate Zones,MSOAIZ,B,7277,3160,5989,2578,2570,1425,3419,1153,15,4,407,206,289,146,118,60,60,,,,828,347,745,313,8,3,69,30,6,1,34,38,25
E02002092,Solihull 012,Middle Super Output Areas and Intermediate Zones,MSOAIZ,B,7086,3058,5065,2058,1811,958,3254,1100,43,19,1241,672,1118,612,123,60,60,,,,690,280,637,254,0,0,48,25,5,1,26,47,29
E02002093,Solihull 013,Middle Super Output Areas and Intermediate Zones,MSOAIZ,B,6353,2836,4782,1943,1918,988,2864,955,32,20,612,411,413,254,199,157,157,,,,892,440,830,414,0,0,58,24,4,2,26,35,22
E02002094,Solihull 014,Middle Super Output Areas and Intermediate Zones,MSOAIZ,B,5866,2380,5265,2106,2241,1162,3024,944,10,6,45,16,37,13,8,3,3,,,,507,227,477,215,0,0,28,10,2,2,12,39,25
E02002095,Solihull 015,Middle Super Output Areas and Intermediate Zones,MSOAIZ,B,8510,3613,6601,2726,2613,1329,3988,1397,89,51,718,338,505,249,213,89,89,,,,1067,477,982,431,6,3,66,37,13,6,46,35,21
E02002096,Solihull 016,Middle Super Output Areas and Intermediate Zones,MSOAIZ,B,9870,4165,7754,3211,3542,1839,4212,1372,124,57,783,372,618,305,165,67,67,,,,1137,492,1085,462,9,6,33,19,10,5,30,72,33
E02002097,Solihull 017,Middle Super Output Areas and Intermediate Zones,MSOAIZ,CV,6497,2860,5080,2142,2332,1151,2748,991,7,4,668,360,473,227,195,133,133,,,,641,308,542,258,22,7,62,33,15,10,50,101,46
E02002098,Solihull 018,Middle Super Output Areas and Intermediate Zones,MSOAIZ,B,9381,3808,7767,3007,3154,1563,4613,1444,6,3,804,475,601,347,203,128,128,,,,764,300,701,278,1,1,37,17,25,4,22,40,23
E02002099,Solihull 019,Middle Super Output Areas and Intermediate Zones,MSOAIZ,B,6453,2687,5607,2260,2678,1349,2929,911,8,6,116,74,43,14,73,60,60,,,,666,321,621,298,11,6,28,13,6,4,23,56,26
E02002101,Solihull 021,Middle Super Output Areas and Intermediate Zones,MSOAIZ,B,5783,2645,4726,2055,1966,1067,2760,988,25,17,399,263,296,183,103,80,80,,,,601,286,543,258,7,3,49,23,2,2,28,32,24
E02002102,Solihull 022,Middle Super Output Areas and Intermediate Zones,MSOAIZ,B,8407,3474,6813,2756,2756,1420,4057,1336,54,27,563,260,414,183,149,77,77,,,,939,410,846,367,0,0,88,41,5,2,43,38,21
E02002103,Solihull 023,Middle Super Output Areas and Intermediate Zones,MSOAIZ,B,6012,2575,5291,2185,2415,1240,2876,945,9,3,326,214,305,203,21,11,11,,,,352,151,303,129,3,2,42,19,4,1,22,34,22
E02002104,Solihull 024,Middle Super Output Areas and Intermediate Zones,MSOAIZ,B,6166,2399,5527,2139,2156,1025,3371,1114,15,4,51,21,27,12,24,9,9,,,,550,225,522,213,5,1,23,11,0,0,12,23,10
E02002105,Solihull 025,Middle Super Output Areas and Intermediate Zones,MSOAIZ,CV,7811,3101,6923,2683,2867,1380,4056,1303,17,9,232,120,149,72,83,48,48,,,,604,267,554,247,12,5,26,12,12,3,20,35,22
E02002106,Solihull 026,Middle Super Output Areas and Intermediate Zones,MSOAIZ,B,9127,3888,7936,3266,3786,1944,4150,1322,14,9,345,222,201,123,144,99,99,,,,767,359,702,325,11,6,36,19,18,9,34,65,32
E02002107,Solihull 027,Middle Super Output Areas and Intermediate Zones,MSOAIZ,B,5733,2269,4998,1941,1871,871,3127,1070,60,30,93,47,81,42,12,5,5,,,,562,240,538,231,5,1,18,7,1,1,9,20,11
E02002108,Solihull 028,Middle Super Output Areas and Intermediate Zones,MSOAIZ,B,9790,3867,8779,3386,3689,1818,5090,1568,18,10,296,169,230,116,66,53,53,,,,654,281,606,262,4,1,39,16,5,2,19,43,21
E02002109,Solihull 029,Middle Super Output Areas and Intermediate Zones,MSOAIZ,B,9346,3874,7572,2984,2538,1233,5034,1751,47,30,163,83,117,53,46,30,30,,,,1508,743,1404,697,15,6,77,36,12,4,46,56,34
E02002110,Walsall 001,Middle Super Output Areas and Intermediate Zones,MSOAIZ,WS,6692,2689,4795,1871,1552,755,3243,1116,109,46,1048,458,568,226,480,232,232,,,,693,283,609,247,13,8,70,27,1,1,36,47,31
E02002111,Walsall 002,Middle Super Output Areas and Intermediate Zones,MSOAIZ,WS,5864,2484,3769,1546,1570,814,2199,732,22,13,1542,705,693,316,849,389,389,,,,475,185,411,159,5,4,46,16,13,6,26,56,35
E02002112,Walsall 003,Middle Super Output Areas and Intermediate Zones,MSOAIZ,WS,5435,2219,4206,1679,1612,815,2594,864,8,6,864,395,465,204,399,191,191,,,,319,116,279,99,0,0,36,15,4,2,17,38,23
E02002113,Walsall 004,Middle Super Output Areas and Intermediate Zones,MSOAIZ,WS,6392,2683,4221,1724,1594,805,2627,919,82,35,1306,561,667,261,639,300,300,,,,732,333,674,307,5,3,40,18,13,5,26,51,30
E02002114,Walsall 005,Middle Super Output Areas and Intermediate Zones,MSOAIZ,WS,5974,2642,4655,1973,2117,1111,2538,862,17,11,714,397,295,136,419,261,261,,,,534,234,468,207,1,1,56,23,9,3,27,54,27
E02002115,Walsall 006,Middle Super Output Areas and Intermediate Zones,MSOAIZ,WS,6564,2835,3984,1682,1752,918,2232,764,12,5,2014,918,1124,482,890,436,436,,,,479,180,434,162,3,1,23,9,19,8,18,75,50
E02002116,Walsall 007,Middle Super Output Areas and Intermediate Zones,MSOAIZ,WS,6720,2849,5612,2321,2401,1222,3211,1099,14,7,588,309,307,157,281,152,152,,,,453,180,406,161,1,1,39,16,7,2,19,53,32
E02002117,Walsall 008,Middle Super Output Areas and Intermediate Zones,MSOAIZ,WS,5991,2682,3929,1610,1471,745,2458,865,6,4,1441,776,607,285,834,491,491,,,,543,247,482,217,3,2,48,22,10,6,30,72,45
E02002118,Walsall 009,Middle Super Output Areas and Intermediate Zones,MSOAIZ,WV,7194,3019,3906,1589,1405,735,2501,854,30,14,2438,1097,1290,527,1148,570,570,,,,743,274,688,251,1,1,41,16,13,6,23,77,45
E02002119,Walsall 010,Middle Super Output Areas and Intermediate Zones,MSOAIZ,WS,5990,2451,4478,1795,1758,888,2720,907,55,31,954,425,478,214,476,211,211,,,,467,183,420,162,2,1,42,18,3,2,21,36,17
E02002120,Walsall 011,Middle Super Output Areas and Intermediate Zones,MSOAIZ,WV,6261,2386,4897,1840,1645,771,3252,1069,58,36,922,358,489,186,433,172,172,,,,365,138,341,128,0,0,24,10,0,0,10,19,14
E02002121,Walsall 012,Middle Super Output Areas and Intermediate Zones,MSOAIZ,WS,6007,2401,2789,1123,975,498,1814,625,23,13,2290,887,1255,465,1035,422,422,,,,837,341,784,317,3,2,32,15,18,7,24,68,37
E02002122,Walsall 013,Middle Super Output Areas and Intermediate Zones,MSOAIZ,WS,5481,2006,2360,899,791,394,1569,505,35,15,2241,768,1566,510,675,258,258,,,,791,296,747,276,2,1,15,7,27,12,20,54,28
E02002123,Walsall 014,Middle Super Output Areas and Intermediate Zones,MSOAIZ,WV,6387,2694,4369,1769,1852,908,2517,861,24,11,1311,650,580,278,731,372,372,,,,603,220,531,192,0,0,58,20,14,8,28,80,44
E02002124,Walsall 015,Middle Super Output Areas and Intermediate Zones,MSOAIZ,WS,6827,3161,4800,2142,2042,1149,2758,993,18,10,1208,635,629,307,579,328,328,,,,734,334,665,303,8,4,59,26,2,1,31,67,40
E02002125,Walsall 016,Middle Super Output Areas and Intermediate Zones,MSOAIZ,WS,5855,2552,4027,1685,1517,795,2510,890,66,37,1135,566,451,228,684,338,338,,,,565,224,509,201,6,3,40,16,10,4,23,62,40
E02002126,Walsall 017,Middle Super Output Areas and Intermediate Zones,MSOAIZ,WS,6342,2656,2454,989,869,440,1585,549,5,3,3035,1298,774,323,2261,975,975,,,,795,327,740,302,0,0,40,17,15,8,25,53,39
E02002127,Walsall 018,Middle Super Output Areas and Intermediate Zones,MSOAIZ,WS,8245,3087,3654,1239,1243,508,2411,731,69,26,3176,1257,1751,660,1425,597,597,,,,1260,519,1183,488,0,0,39,15,38,16,31,86,46
E02002128,Walsall 019,Middle Super Output Areas and Intermediate Zones,MSOAIZ,WV,5542,2386,4061,1659,1815,915,2246,744,21,8,953,506,503,274,450,232,232,,,,475,191,429,176,2,1,41,13,3,1,15,32,22
E02002129,Walsall 020,Middle Super Output Areas and Intermediate Zones,MSOAIZ,WV,5902,2451,4617,1861,2162,1048,2455,813,0,0,710,347,353,174,357,173,173,,,,531,213,474,190,2,1,50,20,5,2,23,44,30
E02002130,Walsall 021,Middle Super Output Areas and Intermediate Zones,MSOAIZ,WS,6586,2540,3516,1264,1226,538,2290,726,43,22,2002,871,154,68,1848,803,803,,,,950,342,893,321,0,0,51,19,6,2,21,75,41
E02002131,Walsall 022,Middle Super Output Areas and Intermediate Zones,MSOAIZ,WS,7842,3182,7029,2822,3097,1574,3932,1248,4,3,331,157,144,66,187,91,91,,,,442,179,381,154,6,2,44,20,11,3,25,36,21
E02002132,Walsall 023,Middle Super Output Areas and Intermediate Zones,MSOAIZ,WS,6320,2559,3350,1348,1201,616,2149,732,10,4,2446,1003,1368,538,1078,465,465,,,,456,165,402,142,0,0,45,19,9,4,23,58,39
E02002133,Walsall 024,Middle Super Output Areas and Intermediate Zones,MSOAIZ,WS,6580,3041,4008,1558,1817,861,2191,697,43,33,1514,917,309,195,1205,722,722,,,,949,496,886,465,4,4,44,18,15,9,31,66,37
E02002134,Walsall 025,Middle Super Output Areas and Intermediate Zones,MSOAIZ,WV,8159,3308,4289,1758,1549,765,2740,993,126,51,2382,915,1316,467,1066,448,448,,,,1267,543,1201,517,0,0,42,18,24,8,26,95,41
E02002135,Walsall 026,Middle Super Output Areas and Intermediate Zones,MSOAIZ,WS,7064,2585,3856,1220,1437,556,2419,664,28,9,1654,750,713,303,941,447,447,,,,1385,545,1296,515,20,7,48,15,21,8,30,141,61
E02002136,Walsall 027,Middle Super Output Areas and Intermediate Zones,MSOAIZ,WV,7530,3093,4670,1726,1598,685,3072,1041,39,20,1535,750,853,397,682,353,353,,,,1237,563,1162,534,4,2,70,26,1,1,29,49,34
E02002137,Walsall 028,Middle Super Output Areas and Intermediate Zones,MSOAIZ,WS,6251,2652,5778,2415,2695,1424,3083,991,6,5,53,22,15,6,38,16,16,,,,384,193,350,174,0,0,32,17,2,2,19,30,17
E02002138,Walsall 029,Middle Super Output Areas and Intermediate Zones,MSOAIZ,WS,6278,2313,4894,1747,2110,923,2784,824,32,11,234,102,22,8,212,94,94,,,,1067,427,997,397,2,1,57,24,11,5,30,51,26
E02002139,Walsall 030,Middle Super Output Areas and Intermediate Zones,MSOAIZ,WS,9027,3905,3922,1234,1695,615,2227,619,73,28,3028,1715,611,361,2417,1354,1354,,,,1860,856,1748,805,7,3,63,28,42,20,51,144,72
E02002140,Walsall 031,Middle Super Output Areas and Intermediate Zones,MSOAIZ,WS,7940,2936,4363,1452,1953,757,2410,695,13,6,1972,872,785,333,1187,539,539,,,,1461,552,1331,496,4,1,111,49,15,6,56,131,54
E02002141,Walsall 032,Middle Super Output Areas and Intermediate Zones,MSOAIZ,B,6690,2666,6095,2391,2377,1185,3718,1206,21,8,89,57,29,20,60,37,37,,,,468,199,426,175,0,0,38,22,4,2,24,17,11
E02002142,Walsall 033,Middle Super Output Areas and Intermediate Zones,MSOAIZ,WS,6694,2443,3901,1247,1570,574,2331,673,11,6,1737,772,625,263,1112,509,509,,,,977,383,894,352,1,1,67,25,15,5,31,68,35
E02002143,Walsall 034,Middle Super Output Areas and Intermediate Zones,MSOAIZ,WS,9991,3150,5730,1549,2453,759,3277,790,35,16,2009,806,566,229,1443,577,577,,,,2034,713,1877,654,4,1,103,43,50,15,59,183,66
E02002144,Walsall 035,Middle Super Output Areas and Intermediate Zones,MSOAIZ,WS,6703,2498,6118,2256,3120,1410,2998,846,3,1,111,61,18,4,93,57,57,,,,438,161,412,151,14,5,12,5,0,0,10,33,19
E02002145,Walsall 036,Middle Super Output Areas and Intermediate Zones,MSOAIZ,WS,6790,2741,3449,1298,1111,521,2338,777,25,12,2385,1042,1072,423,1313,619,619,,,,874,348,833,330,3,1,33,14,5,3,18,57,41
E02002146,Walsall 037,Middle Super Output Areas and Intermediate Zones,MSOAIZ,WS,6439,2257,4227,1413,1484,638,2743,775,14,6,1283,499,548,196,735,303,303,,,,843,302,767,275,5,2,65,21,6,4,27,72,37
E02002147,Walsall 038,Middle Super Output Areas and Intermediate Zones,MSOAIZ,WV,7842,3081,3987,1533,1460,711,2527,822,24,10,2923,1184,1684,632,1239,552,552,,,,807,295,723,263,2,1,76,28,6,3,32,101,59
E02002148,Walsall 039,Middle Super Output Areas and Intermediate Zones,MSOAIZ,WS,11006,4539,9855,4038,4212,2170,5643,1868,36,19,322,159,122,52,200,107,107,,,,728,289,685,268,0,0,42,20,1,1,21,65,34
E02002149,Wolverhampton 001,Middle Super Output Areas and Intermediate Zones,MSOAIZ,WV,9973,4268,6717,2849,2824,1453,3893,1396,32,12,2324,1005,2069,857,255,148,148,,,,791,332,716,299,10,3,57,25,8,5,33,109,70
E02002150,Wolverhampton 002,Middle Super Output Areas and Intermediate Zones,MSOAIZ,WV,5668,2259,3757,1465,1305,643,2452,822,44,18,1242,520,1174,484,68,36,36,,,,554,213,526,199,0,0,28,14,0,0,14,71,43
E02002151,Wolverhampton 003,Middle Super Output Areas and Intermediate Zones,MSOAIZ,WV,5804,2548,2857,1172,744,365,2113,807,73,39,2301,1060,1879,851,422,209,209,,,,503,239,470,221,0,0,30,16,3,2,18,70,38
E02002152,Wolverhampton 004,Middle Super Output Areas and Intermediate Zones,MSOAIZ,WV,6160,2337,2672,1043,965,476,1707,567,15,9,3004,1095,2862,1036,142,59,59,,,,381,138,339,119,0,0,39,16,3,3,19,88,52
E02002153,Wolverhampton 005,Middle Super Output Areas and Intermediate Zones,MSOAIZ,WV,7502,3384,4820,2043,2016,1063,2804,980,3,2,2207,1112,2091,1044,116,68,68,,,,395,171,332,141,0,0,51,24,12,6,30,77,56
E02002154,Wolverhampton 006,Middle Super Output Areas and Intermediate Zones,MSOAIZ,WV,5549,2270,3304,1312,1201,589,2103,723,6,4,1428,617,1096,406,332,211,211,,,,712,289,673,271,0,0,33,15,6,3,18,99,48
E02002155,Wolverhampton 007,Middle Super Output Areas and Intermediate Zones,MSOAIZ,WV,5825,2129,1516,604,617,310,899,294,16,7,3684,1284,2975,1013,709,271,271,,,,549,201,516,186,0,0,23,11,10,4,15,60,33
E02002156,Wolverhampton 008,Middle Super Output Areas and Intermediate Zones,MSOAIZ,WV,8359,3409,6082,2350,2205,1113,3877,1237,39,18,1303,651,1183,566,120,85,85,,,,827,323,759,293,0,0,65,28,3,2,30,108,67
E02002157,Wolverhampton 009,Middle Super Output Areas and Intermediate Zones,MSOAIZ,WV,7660,3170,6254,2515,2537,1262,3717,1253,27,14,463,235,396,186,67,49,49,,,,838,366,774,341,3,2,61,23,0,0,25,78,40
E02002158,Wolverhampton 010,Middle Super Output Areas and Intermediate Zones,MSOAIZ,WV,7601,3437,5304,2219,2377,1222,2927,997,5,3,1769,976,1672,904,97,72,72,,,,410,168,353,142,0,0,55,24,2,2,26,113,71
E02002159,Wolverhampton 011,Middle Super Output Areas and Intermediate Zones,MSOAIZ,WV,5992,2215,2568,978,897,420,1671,558,34,11,2331,805,2088,711,243,94,94,,,,965,370,895,341,3,1,42,16,25,12,29,94,51
E02002160,Wolverhampton 012,Middle Super Output Areas and Intermediate Zones,MSOAIZ,WV,6950,2762,5136,1963,2045,965,3091,998,23,9,736,358,662,314,74,44,44,,,,998,395,976,380,2,2,15,10,5,3,15,57,37
E02002161,Wolverhampton 013,Middle Super Output Areas and Intermediate Zones,MSOAIZ,WV,6279,2426,3029,1074,1121,446,1908,628,71,32,1671,768,947,449,724,319,319,,,,1431,520,1325,484,12,6,52,17,42,13,36,77,32
E02002162,Wolverhampton 014,Middle Super Output Areas and Intermediate Zones,MSOAIZ,WV,7340,3275,5843,2535,2953,1550,2890,985,39,22,681,360,621,317,60,43,43,,,,672,299,607,267,6,4,55,24,4,4,32,105,59
E02002163,Wolverhampton 015,Middle Super Output Areas and Intermediate Zones,MSOAIZ,WV,11211,5059,3984,1610,1506,743,2478,867,65,26,5123,2607,4170,2088,953,519,519,,,,1789,702,1677,630,21,17,62,31,29,24,72,250,114
E02002164,Wolverhampton 016,Middle Super Output Areas and Intermediate Zones,MSOAIZ,WV,6029,2361,1934,605,1042,368,892,237,38,14,2162,1096,1109,559,1053,537,537,,,,1758,587,1627,546,9,3,61,22,61,16,41,137,59
E02002165,Wolverhampton 017,Middle Super Output Areas and Intermediate Zones,MSOAIZ,WV,7499,3611,3642,1494,1542,708,2100,786,9,6,1006,626,477,275,529,351,351,,,,2716,1421,2622,1383,9,3,51,23,34,12,38,126,64
E02002166,Wolverhampton 018,Middle Super Output Areas and Intermediate Zones,MSOAIZ,WV,8996,3839,4303,1763,1753,850,2550,913,12,4,3565,1582,3289,1431,276,151,151,,,,961,410,891,380,0,0,57,23,13,7,30,155,80
E02002167,Wolverhampton 019,Middle Super Output Areas and Intermediate Zones,MSOAIZ,WV,6548,2977,5001,2163,2253,1218,2748,945,10,7,878,483,841,462,37,21,21,,,,579,270,504,237,0,0,62,28,13,5,33,80,54
E02002168,Wolverhampton 020,Middle Super Output Areas and Intermediate Zones,MSOAIZ,WV,9528,4422,4090,1553,1878,793,2212,760,45,25,2380,1434,1312,748,1068,686,686,,,,2830,1326,2701,1270,24,11,81,33,24,12,56,183,84
E02002169,Wolverhampton 021,Middle Super Output Areas and Intermediate Zones,MSOAIZ,WV,8395,3531,7180,2933,3384,1686,3796,1247,10,6,399,223,332,186,67,37,37,,,,744,334,688,308,8,3,45,22,3,1,26,62,35
E02002170,Wolverhampton 022,Middle Super Output Areas and Intermediate Zones,MSOAIZ,WV,6253,2461,3947,1512,1640,760,2307,752,17,8,1590,670,1427,540,163,130,130,,,,626,230,596,217,2,1,26,11,2,1,13,73,41
E02002171,Wolverhampton 023,Middle Super Output Areas and Intermediate Zones,MSOAIZ,WV,7367,3059,4185,1681,1897,884,2288,797,34,12,2249,1023,2088,939,161,84,84,,,,780,279,729,255,2,1,45,22,4,1,24,119,64
E02002174,Wolverhampton 026,Middle Super Output Areas and Intermediate Zones,MSOAIZ,WV,7450,2975,5954,2278,2371,1113,3583,1165,5,3,431,225,275,105,156,120,120,,,,992,440,950,422,4,2,31,14,7,2,18,68,29
E02002175,Wolverhampton 027,Middle Super Output Areas and Intermediate Zones,MSOAIZ,WV,6970,2901,3205,1219,1434,627,1771,592,21,11,2679,1210,2118,902,561,308,308,,,,947,392,885,370,6,1,49,17,7,4,22,118,69
E02002176,Wolverhampton 028,Middle Super Output Areas and Intermediate Zones,MSOAIZ,WV,7673,3338,5269,2070,2026,999,3243,1071,18,7,1738,981,1614,887,124,94,94,,,,581,232,513,205,0,0,66,25,2,2,27,67,48
E02002177,Wolverhampton 029,Middle Super Output Areas and Intermediate Zones,MSOAIZ,WV,8947,3821,4400,1638,1723,723,2677,915,47,22,3129,1541,2657,1270,472,271,271,,,,1246,545,1145,510,3,1,71,26,27,8,35,125,75
E02002178,Wolverhampton 030,Middle Super Output Areas and Intermediate Zones,MSOAIZ,WV,7875,2722,6665,2239,3278,1272,3387,967,20,6,185,95,156,79,29,16,16,,,,941,353,880,334,10,2,50,16,1,1,19,64,29
E02002179,Wolverhampton 031,Middle Super Output Areas and Intermediate Zones,MSOAIZ,WV,6328,2580,5273,2116,2314,1134,2959,982,7,5,378,164,309,109,69,55,55,,,,594,250,543,231,3,1,43,16,5,2,19,76,45
E02002180,Wolverhampton 032,Middle Super Output Areas and Intermediate Zones,MSOAIZ,WV,6367,2666,4570,1847,2125,1065,2445,782,17,7,1212,552,1168,532,44,20,20,,,,499,221,452,201,2,2,39,16,6,2,20,69,39
E02002181,Wolverhampton 033,Middle Super Output Areas and Intermediate Zones,MSOAIZ,WV,7066,2979,3374,1342,1269,636,2105,706,27,13,2928,1293,2724,1180,204,113,113,,,,608,261,568,244,0,0,24,12,16,5,17,129,70
E02002182,Wolverhampton 034,Middle Super Output Areas and Intermediate Zones,MSOAIZ,WV,6550,2515,4360,1574,1733,766,2627,808,10,6,1548,684,1385,596,163,88,88,,,,567,201,528,187,10,2,26,11,3,1,14,65,50
E02002183,Bradford 001,Middle Super Output Areas and Intermediate Zones,MSOAIZ,LS,5530,2579,4686,2083,2168,1186,2518,897,23,17,271,175,98,60,173,115,115,,,,482,265,442,241,6,3,31,19,3,2,24,68,39
E02002184,Bradford 002,Middle Super Output Areas and Intermediate Zones,MSOAIZ,LS,12655,5556,10350,4362,4829,2515,5521,1847,33,21,675,381,192,87,483,294,294,,,,1455,714,1362,663,9,5,74,43,10,3,51,142,78
E02002185,Bradford 003,Middle Super Output Areas and Intermediate Zones,MSOAIZ,LS,5909,2478,4900,1985,1925,973,2975,1012,56,32,383,204,168,80,215,124,124,,,,515,231,460,203,0,0,54,27,1,1,28,55,26
E02002186,Bradford 004,Middle Super Output Areas and Intermediate Zones,MSOAIZ,BD,12336,5450,9896,4274,4090,2157,5806,2117,39,22,439,247,177,96,262,151,151,,,,1851,844,1678,768,9,3,126,60,38,13,76,111,63
E02002187,Bradford 005,Middle Super Output Areas and Intermediate Zones,MSOAIZ,LS,5869,2475,5239,2155,2417,1223,2822,932,13,5,189,98,55,21,134,77,77,,,,383,188,342,166,2,1,32,16,7,5,22,45,29
E02002188,Bradford 006,Middle Super Output Areas and Intermediate Zones,MSOAIZ,BD,7680,3173,6627,2718,2561,1329,4066,1389,101,45,77,32,36,14,41,18,18,,,,819,346,753,316,0,0,60,28,6,2,30,56,32
E02002189,Bradford 007,Middle Super Output Areas and Intermediate Zones,MSOAIZ,BD,6646,2249,5441,1745,2254,872,3187,873,10,5,228,122,88,46,140,76,76,,,,848,335,766,304,7,4,61,22,14,5,31,119,42
E02002190,Bradford 008,Middle Super Output Areas and Intermediate Zones,MSOAIZ,BD,11966,4222,8350,2581,3934,1288,4416,1293,14,8,1072,516,301,120,771,396,396,,,,2344,1055,2137,965,21,8,141,61,45,21,90,186,62
E02002191,Bradford 009,Middle Super Output Areas and Intermediate Zones,MSOAIZ,BD,9353,3523,5815,2021,1965,831,3850,1190,52,22,1858,781,858,358,1000,423,423,,,,1524,643,1338,578,12,4,162,55,12,6,65,104,56
E02002192,Bradford 010,Middle Super Output Areas and Intermediate Zones,MSOAIZ,BD,9145,3910,7951,3278,3237,1642,4714,1636,20,12,343,218,164,99,179,119,119,,,,764,362,707,332,10,4,46,25,1,1,30,67,40
E02002193,Bradford 011,Middle Super Output Areas and Intermediate Zones,MSOAIZ,BD,6009,2828,3391,1406,1183,602,2208,804,9,5,1295,790,592,331,703,459,459,,,,1186,560,1096,517,5,2,71,34,14,7,43,128,67
E02002194,Bradford 012,Middle Super Output Areas and Intermediate Zones,MSOAIZ,BD,7500,3107,5661,2254,1975,1015,3686,1239,33,15,1069,508,604,265,465,243,243,,,,677,288,597,251,6,2,71,34,3,1,37,60,42
E02002195,Bradford 013,Middle Super Output Areas and Intermediate Zones,MSOAIZ,LS,6340,2766,5474,2304,2297,1193,3177,1111,9,6,280,176,104,56,176,120,120,,,,492,233,403,197,21,6,64,26,4,4,36,85,47
E02002196,Bradford 014,Middle Super Output Areas and Intermediate Zones,MSOAIZ,BD,6344,2622,4868,1979,1629,828,3239,1151,100,42,477,185,263,103,214,82,82,,,,866,396,775,350,5,2,84,43,2,1,46,33,20
E02002197,Bradford 015,Middle Super Output Areas and Intermediate Zones,MSOAIZ,BD,8474,4019,5568,2485,1968,1087,3600,1398,36,18,841,492,312,163,529,329,329,,,,1961,979,1791,913,30,9,122,50,18,7,66,68,45
E02002198,Bradford 016,Middle Super Output Areas and Intermediate Zones,MSOAIZ,BD,8106,3766,6243,2749,2251,1210,3992,1539,19,11,846,499,471,264,375,235,235,,,,901,442,815,396,5,2,75,40,6,4,46,97,65
E02002199,Bradford 017,Middle Super Output Areas and Intermediate Zones,MSOAIZ,LS,6380,2804,5176,2163,1843,955,3333,1208,47,22,300,183,83,46,217,137,137,,,,817,412,749,376,5,2,50,28,13,6,36,40,24
E02002200,Bradford 018,Middle Super Output Areas and Intermediate Zones,MSOAIZ,BD,9063,4032,6779,2855,2701,1399,4078,1456,93,58,903,458,448,205,455,253,253,,,,1228,624,1156,586,2,1,63,35,7,2,38,60,37
E02002201,Bradford 019,Middle Super Output Areas and Intermediate Zones,MSOAIZ,BD,11908,5203,8607,3467,2233,1121,6374,2346,141,82,1540,909,662,347,878,562,562,,,,1505,673,1351,606,6,3,128,57,20,7,67,115,72
E02002202,Bradford 020,Middle Super Output Areas and Intermediate Zones,MSOAIZ,BD,6984,3408,4012,1707,1463,759,2549,948,35,15,922,552,488,272,434,280,280,,,,1915,1070,1823,1031,19,7,54,23,19,9,39,100,64
E02002203,Bradford 021,Middle Super Output Areas and Intermediate Zones,MSOAIZ,BD,7655,3285,4820,1939,1518,760,3302,1179,49,26,1741,869,993,473,748,396,396,,,,966,391,869,352,3,2,86,35,8,2,39,79,60
E02002204,Bradford 022,Middle Super Output Areas and Intermediate Zones,MSOAIZ,BD,11311,4900,9385,3948,3565,1850,5820,2098,31,21,667,352,306,147,361,205,205,,,,1164,542,1001,472,10,4,144,60,9,6,70,64,37
E02002205,Bradford 023,Middle Super Output Areas and Intermediate Zones,MSOAIZ,BD,10035,4476,7951,3423,3161,1628,4790,1795,75,44,283,164,44,22,239,142,142,,,,1622,790,1481,723,9,4,122,57,10,6,67,104,55
E02002206,Bradford 024,Middle Super Output Areas and Intermediate Zones,MSOAIZ,BD,8720,3427,6616,2534,2183,1087,4433,1447,57,25,859,404,454,199,405,205,205,,,,1129,431,1026,387,0,0,102,43,1,1,44,59,33
E02002207,Bradford 025,Middle Super Output Areas and Intermediate Zones,MSOAIZ,BD,7303,2307,5530,1600,2079,747,3451,853,13,5,318,153,82,46,236,107,107,,,,1357,520,1282,491,6,2,48,20,21,7,29,85,29
E02002208,Bradford 026,Middle Super Output Areas and Intermediate Zones,MSOAIZ,BD,7621,3235,4998,2075,1626,846,3372,1229,94,52,1228,549,594,239,634,310,310,,,,1252,533,1125,478,10,3,106,46,11,6,55,49,26
E02002209,Bradford 027,Middle Super Output Areas and Intermediate Zones,MSOAIZ,BD,5908,2283,2691,1058,764,386,1927,672,17,6,2331,870,1488,529,843,341,341,,,,822,314,744,288,12,1,63,24,3,1,26,47,35
E02002210,Bradford 028,Middle Super Output Areas and Intermediate Zones,MSOAIZ,BD,7579,2824,6066,2218,2219,1030,3847,1188,31,12,222,113,59,29,163,84,84,,,,1195,448,1091,403,1,1,97,42,6,2,45,65,33
E02002211,Bradford 029,Middle Super Output Areas and Intermediate Zones,MSOAIZ,BD,6952,2064,5540,1513,2108,674,3432,839,25,18,181,95,50,15,131,80,80,,,,1114,404,1002,365,9,3,97,32,6,4,39,92,34
E02002212,Bradford 030,Middle Super Output Areas and Intermediate Zones,MSOAIZ,BD,7235,2260,4972,1490,1391,567,3581,923,36,13,1014,328,532,178,482,150,150,,,,1117,390,1027,360,5,4,55,18,30,8,30,96,39
E02002213,Bradford 031,Middle Super Output Areas and Intermediate Zones,MSOAIZ,BD,6745,2917,5154,2120,1949,970,3205,1150,23,11,655,339,199,113,456,226,226,,,,813,394,715,350,3,2,92,40,3,2,44,100,53
E02002214,Bradford 032,Middle Super Output Areas and Intermediate Zones,MSOAIZ,BD,5911,2404,4825,1936,1622,832,3203,1104,52,30,86,37,48,18,38,19,19,,,,909,382,816,345,5,2,77,32,11,3,37,39,19
E02002215,Bradford 033,Middle Super Output Areas and Intermediate Zones,MSOAIZ,BD,10499,2733,8087,1728,3417,789,4670,939,15,5,445,300,110,67,335,233,233,,,,1790,646,1623,597,13,4,113,28,41,17,49,162,54
E02002216,Bradford 034,Middle Super Output Areas and Intermediate Zones,MSOAIZ,BD,9109,2700,5930,1205,3347,685,2583,520,45,11,1607,843,208,103,1399,740,740,,,,1323,573,1181,527,4,2,106,28,32,16,46,204,68
E02002217,Bradford 035,Middle Super Output Areas and Intermediate Zones,MSOAIZ,BD,8779,2995,5790,1694,2269,732,3521,962,20,6,772,396,158,101,614,295,295,,,,2052,849,1865,776,3,3,154,60,30,10,73,145,50
E02002218,Bradford 036,Middle Super Output Areas and Intermediate Zones,MSOAIZ,BD,9346,3685,6066,2281,1922,944,4144,1337,23,12,1882,827,937,411,945,416,416,,,,1296,519,1189,472,3,2,69,32,35,13,47,79,46
E02002219,Bradford 037,Middle Super Output Areas and Intermediate Zones,MSOAIZ,BD,7836,2152,5574,1355,2238,593,3336,762,68,26,464,194,194,74,270,120,120,,,,1619,538,1444,485,3,1,147,42,25,10,53,111,39
E02002220,Bradford 038,Middle Super Output Areas and Intermediate Zones,MSOAIZ,BD,9199,2561,6302,1592,2473,678,3829,914,23,6,1332,447,764,255,568,192,192,,,,1393,461,1265,420,1,1,103,31,24,9,41,149,55
E02002221,Bradford 039,Middle Super Output Areas and Intermediate Zones,MSOAIZ,BD,13430,4961,5506,1279,2750,656,2756,623,187,51,3519,1606,821,423,2698,1183,1183,,,,3870,1909,3582,1805,16,6,153,48,119,50,104,348,116
E02002222,Bradford 040,Middle Super Output Areas and Intermediate Zones,MSOAIZ,BD,7979,2944,5117,1824,1588,736,3529,1088,26,16,1386,568,623,248,763,320,320,,,,1355,500,1261,463,9,3,77,30,8,4,37,95,36
E02002223,Bradford 041,Middle Super Output Areas and Intermediate Zones,MSOAIZ,BD,7817,2216,4526,1115,2109,547,2417,568,29,9,1222,391,194,79,1028,312,312,,,,1906,662,1758,616,5,1,101,32,42,13,46,134,39
E02002224,Bradford 042,Middle Super Output Areas and Intermediate Zones,MSOAIZ,BD,10487,2803,7112,1587,3695,842,3417,745,36,8,1035,412,169,104,866,308,308,,,,2056,721,1889,674,8,2,147,41,12,4,47,248,75
E02002225,Bradford 043,Middle Super Output Areas and Intermediate Zones,MSOAIZ,BD,8143,3448,6148,2508,2048,1039,4100,1469,21,13,734,355,341,150,393,205,205,,,,1156,535,1038,478,8,3,99,47,11,7,57,84,37
E02002226,Bradford 044,Middle Super Output Areas and Intermediate Zones,MSOAIZ,BD,12494,3478,7989,1703,4576,1026,3413,677,39,9,309,145,42,13,267,132,132,,,,3897,1543,3694,1481,7,3,119,37,77,22,62,260,78
E02002227,Bradford 045,Middle Super Output Areas and Intermediate Zones,MSOAIZ,BD,6503,2444,2981,908,1204,392,1777,516,12,6,1642,853,484,274,1158,579,579,,,,1765,631,1534,549,15,5,85,30,131,47,82,103,46
E02002228,Bradford 046,Middle Super Output Areas and Intermediate Zones,MSOAIZ,BD,6670,2824,3077,1228,1109,520,1968,708,22,7,2160,998,427,192,1733,806,806,,,,1303,536,1195,490,7,3,73,32,28,11,46,108,55
E02002229,Bradford 047,Middle Super Output Areas and Intermediate Zones,MSOAIZ,BD,7564,3152,5622,2173,1978,949,3644,1224,33,21,723,410,347,163,376,247,247,,,,1115,510,1004,456,1,1,91,47,19,6,54,71,38
E02002230,Bradford 048,Middle Super Output Areas and Intermediate Zones,MSOAIZ,BD,9364,3332,3779,941,2103,509,1676,432,129,50,2576,1154,712,340,1864,814,814,,,,2643,1100,2503,1054,4,2,48,16,88,28,46,237,87
E02002231,Bradford 049,Middle Super Output Areas and Intermediate Zones,MSOAIZ,BD,12708,4442,9115,3064,3081,1247,6034,1817,75,21,1332,492,623,207,709,285,285,,,,2026,798,1871,733,2,1,132,55,21,9,65,160,67
E02002232,Bradford 050,Middle Super Output Areas and Intermediate Zones,MSOAIZ,BD,6382,2516,3767,1379,1357,606,2410,773,23,8,791,371,118,66,673,305,305,,,,1733,722,1635,680,4,2,74,35,20,5,42,68,36
E02002233,Bradford 051,Middle Super Output Areas and Intermediate Zones,MSOAIZ,BD,9238,2695,5468,1416,2276,619,3192,797,47,12,2067,689,1157,377,910,312,312,,,,1504,525,1430,495,2,1,54,20,18,9,30,152,53
E02002234,Bradford 052,Middle Super Output Areas and Intermediate Zones,MSOAIZ,BD,7814,3192,2441,965,572,296,1869,669,11,3,4285,1795,2567,1058,1718,737,737,,,,951,353,882,328,2,1,45,18,22,6,25,126,76
E02002235,Bradford 053,Middle Super Output Areas and Intermediate Zones,MSOAIZ,BD,7080,2438,4640,1387,2046,643,2594,744,30,12,980,493,322,145,658,348,348,,,,1243,471,1142,435,0,0,87,31,14,5,36,187,75
E02002236,Bradford 054,Middle Super Output Areas and Intermediate Zones,MSOAIZ,BD,5993,2493,4733,1918,1657,869,3076,1049,41,26,128,85,43,30,85,55,55,,,,1047,438,947,389,8,3,89,44,3,2,49,44,26
E02002237,Bradford 055,Middle Super Output Areas and Intermediate Zones,MSOAIZ,BD,8252,3258,5857,2288,1836,910,4021,1378,34,13,805,298,462,171,343,127,127,,,,1514,634,1429,591,2,2,78,38,5,3,43,42,25
E02002238,Bradford 056,Middle Super Output Areas and Intermediate Zones,MSOAIZ,BD,6122,2546,3636,1414,1124,556,2512,858,24,7,1252,605,613,258,639,347,347,,,,1135,476,1046,439,3,1,77,30,9,6,37,75,44
E02002239,Bradford 057,Middle Super Output Areas and Intermediate Zones,MSOAIZ,BD,9868,4000,6347,2496,1821,872,4526,1624,55,19,1522,670,649,271,873,399,399,,,,1839,768,1724,714,4,1,90,42,21,11,54,105,47
E02002240,Bradford 058,Middle Super Output Areas and Intermediate Zones,MSOAIZ,HX,10621,4423,8540,3389,2557,1280,5983,2109,45,26,563,279,262,124,301,155,155,,,,1391,681,1270,622,7,3,105,52,9,4,59,82,48
E02002241,Bradford 059,Middle Super Output Areas and Intermediate Zones,MSOAIZ,BD,11815,4897,7516,3052,2046,1068,5470,1984,17,11,2476,1055,1396,532,1080,523,523,,,,1676,705,1507,631,4,1,146,65,19,8,74,130,74
E02002242,Bradford 060,Middle Super Output Areas and Intermediate Zones,MSOAIZ,BD,7712,3369,6110,2578,2251,1167,3859,1411,22,10,493,278,128,61,365,217,217,,,,991,448,894,408,10,3,76,32,11,5,40,96,55
E02002243,Bradford 061,Middle Super Output Areas and Intermediate Zones,MSOAIZ,BD,9319,4047,6249,2658,2217,1155,4032,1503,39,15,1517,705,930,391,587,314,314,,,,1426,619,1305,554,13,5,102,55,6,5,65,88,50
E02002244,Calderdale 001,Middle Super Output Areas and Intermediate Zones,MSOAIZ,HX,5948,2525,4693,1935,1719,899,2974,1036,69,24,628,323,315,156,313,167,167,,,,508,214,406,170,21,6,76,36,5,2,44,50,29
E02002245,Calderdale 002,Middle Super Output Areas and Intermediate Zones,MSOAIZ,HX,5627,2441,2555,1062,783,419,1772,643,12,6,2227,1020,1183,533,1044,487,487,,,,757,316,676,284,3,1,56,22,22,9,32,76,37
E02002246,Calderdale 003,Middle Super Output Areas and Intermediate Zones,MSOAIZ,HX,9640,4183,8273,3429,3282,1708,4991,1721,11,6,341,222,74,46,267,176,176,,,,967,495,876,443,7,5,79,43,5,4,52,48,31
E02002247,Calderdale 004,Middle Super Output Areas and Intermediate Zones,MSOAIZ,OL,9360,4310,7124,3096,3004,1566,4120,1530,90,44,714,413,192,94,522,319,319,,,,1355,713,1246,658,6,3,88,44,15,8,55,77,44
E02002248,Calderdale 005,Middle Super Output Areas and Intermediate Zones,MSOAIZ,HX,7494,3180,4552,1870,1386,749,3166,1121,8,4,1891,821,840,371,1051,450,450,,,,980,441,849,376,7,3,120,59,4,3,65,63,44
E02002249,Calderdale 006,Middle Super Output Areas and Intermediate Zones,MSOAIZ,HX,5475,2385,2850,1222,860,460,1990,762,29,15,1711,744,771,344,940,400,400,,,,843,380,728,327,7,3,95,45,13,5,53,42,24
E02002250,Calderdale 007,Middle Super Output Areas and Intermediate Zones,MSOAIZ,HX,8408,3805,6325,2710,2734,1416,3591,1294,16,5,857,491,249,122,608,369,369,,,,1128,551,993,485,8,2,118,57,9,7,66,82,48
E02002251,Calderdale 008,Middle Super Output Areas and Intermediate Zones,MSOAIZ,HX,7357,3869,3761,1676,1351,725,2410,951,37,21,1541,1054,536,345,1005,709,709,,,,1932,1061,1751,978,17,6,141,64,23,13,83,86,57
E02002252,Calderdale 009,Middle Super Output Areas and Intermediate Zones,MSOAIZ,HX,5993,2570,4653,1976,1965,1037,2688,939,12,8,732,322,150,65,582,257,257,,,,539,236,471,204,2,1,59,26,7,5,32,57,28
E02002253,Calderdale 010,Middle Super Output Areas and Intermediate Zones,MSOAIZ,HX,7607,2957,4959,1847,1557,770,3402,1077,6,3,826,374,276,112,550,262,262,,,,1679,675,1527,608,5,3,110,50,37,14,67,137,58
E02002254,Calderdale 011,Middle Super Output Areas and Intermediate Zones,MSOAIZ,HX,5709,2497,4845,2024,2043,1022,2802,1002,15,5,187,138,40,29,147,109,109,,,,637,313,578,284,4,2,53,26,2,1,29,25,17
E02002255,Calderdale 012,Middle Super Output Areas and Intermediate Zones,MSOAIZ,HX,7735,2485,4331,1037,2416,601,1915,436,15,5,1685,809,388,207,1297,602,602,,,,1476,558,1303,506,3,2,121,34,49,16,52,228,76
E02002256,Calderdale 013,Middle Super Output Areas and Intermediate Zones,MSOAIZ,OL,9165,4156,6113,2637,2433,1283,3680,1354,105,50,1296,658,490,223,806,435,435,,,,1560,752,1410,681,25,8,104,54,21,9,71,91,59
E02002257,Calderdale 014,Middle Super Output Areas and Intermediate Zones,MSOAIZ,HX,6202,2074,4338,1339,1901,647,2437,692,25,10,339,132,33,11,306,121,121,,,,1354,541,1193,484,3,3,107,38,51,16,57,146,52
E02002258,Calderdale 015,Middle Super Output Areas and Intermediate Zones,MSOAIZ,WF,8767,4005,6458,2720,2329,1228,4129,1492,25,12,795,508,359,204,436,304,304,,,,1403,713,1295,653,24,8,60,37,24,15,60,86,52
E02002259,Calderdale 016,Middle Super Output Areas and Intermediate Zones,MSOAIZ,HX,6550,2902,5029,2096,2081,1035,2948,1061,11,4,338,212,14,10,324,202,202,,,,1097,553,967,497,4,2,106,44,20,10,56,75,37
E02002260,Calderdale 017,Middle Super Output Areas and Intermediate Zones,MSOAIZ,HX,9078,4301,5853,2554,2193,1159,3660,1395,105,47,1282,776,389,236,893,540,540,,,,1750,866,1620,800,6,2,109,56,15,8,66,88,58
E02002261,Calderdale 018,Middle Super Output Areas and Intermediate Zones,MSOAIZ,HX,8088,3655,5757,2466,2108,1104,3649,1362,12,5,842,469,410,213,432,256,256,,,,1410,679,1300,620,8,3,99,53,3,3,59,67,36
E02002262,Calderdale 019,Middle Super Output Areas and Intermediate Zones,MSOAIZ,HX,7878,3689,5691,2507,2313,1284,3378,1223,11,9,942,521,429,217,513,304,304,,,,1159,605,1088,564,12,4,53,34,6,3,41,75,47
E02002263,Calderdale 020,Middle Super Output Areas and Intermediate Zones,MSOAIZ,HX,6661,2881,4510,1854,1572,785,2938,1069,5,3,1252,601,531,222,721,379,379,,,,795,371,722,332,0,0,65,34,8,5,39,99,52
E02002264,Calderdale 021,Middle Super Output Areas and Intermediate Zones,MSOAIZ,HX,6898,3030,5558,2343,2258,1186,3300,1157,1,1,258,182,14,5,244,177,177,,,,1014,466,913,418,22,8,60,33,19,7,48,67,38
E02002265,Calderdale 022,Middle Super Output Areas and Intermediate Zones,MSOAIZ,OL,5385,2512,3945,1736,1563,825,2382,911,25,11,461,298,111,65,350,233,233,,,,890,426,792,379,20,8,73,36,5,3,47,64,41
E02002266,Calderdale 023,Middle Super Output Areas and Intermediate Zones,MSOAIZ,HD,5722,2556,4581,1937,1781,929,2800,1008,27,11,317,200,103,60,214,140,140,,,,730,375,661,344,3,2,59,26,7,3,31,67,33
E02002267,Calderdale 024,Middle Super Output Areas and Intermediate Zones,MSOAIZ,HX,8017,3510,5826,2389,2020,1040,3806,1349,10,5,1374,756,704,382,670,374,374,,,,731,310,652,275,9,4,58,28,12,3,35,76,50
E02002268,Calderdale 025,Middle Super Output Areas and Intermediate Zones,MSOAIZ,HX,9820,4519,6277,2698,2386,1257,3891,1441,49,26,1584,841,630,296,954,545,545,,,,1791,890,1640,816,8,4,131,63,12,7,74,119,64
E02002269,Calderdale 026,Middle Super Output Areas and Intermediate Zones,MSOAIZ,HX,9517,4106,7374,3043,2599,1297,4775,1746,91,50,783,395,240,123,543,272,272,,,,1203,571,1069,508,5,3,115,54,14,6,63,66,47
E02002270,Calderdale 027,Middle Super Output Areas and Intermediate Zones,MSOAIZ,HX,8275,3518,6835,2778,2525,1240,4310,1538,13,7,404,214,117,62,287,152,152,,,,921,474,818,420,3,2,90,45,10,7,54,102,45
E02002271,Kirklees 001,Middle Super Output Areas and Intermediate Zones,MSOAIZ,WF,7033,3040,5820,2423,2153,1111,3667,1312,6,3,348,193,174,63,174,130,130,,,,804,386,678,331,1,1,120,52,5,2,55,55,35
E02002272,Kirklees 002,Middle Super Output Areas and Intermediate Zones,MSOAIZ,WF,9405,4107,6376,2641,2173,1118,4203,1523,22,10,1923,937,1754,870,169,67,67,,,,954,430,840,378,2,1,101,45,11,6,52,130,89
E02002273,Kirklees 003,Middle Super Output Areas and Intermediate Zones,MSOAIZ,BD,6136,2702,4781,2049,1750,959,3031,1090,8,4,555,253,495,227,60,26,26,,,,704,347,643,314,2,2,50,27,9,4,33,88,49
E02002274,Kirklees 004,Middle Super Output Areas and Intermediate Zones,MSOAIZ,WF,6942,2879,5466,2168,1766,899,3700,1269,15,8,668,328,560,279,108,49,49,,,,728,334,628,293,7,3,82,34,11,4,41,65,41
E02002275,Kirklees 005,Middle Super Output Areas and Intermediate Zones,MSOAIZ,WF,8479,3942,5960,2514,2019,1057,3941,1457,24,12,973,643,759,526,214,117,117,,,,1417,706,1291,640,0,0,121,61,5,5,66,105,67
E02002276,Kirklees 006,Middle Super Output Areas and Intermediate Zones,MSOAIZ,WF,7199,2976,5090,2099,1892,958,3198,1141,13,6,1062,426,832,340,230,86,86,,,,953,403,843,352,2,1,97,44,11,6,51,81,42
E02002277,Kirklees 007,Middle Super Output Areas and Intermediate Zones,MSOAIZ,WF,6448,2527,4666,1778,2106,925,2560,853,5,3,731,273,267,144,464,129,129,,,,954,430,892,400,5,3,51,23,6,4,30,92,43
E02002278,Kirklees 008,Middle Super Output Areas and Intermediate Zones,MSOAIZ,WF,6335,2680,4201,1689,1420,715,2781,974,10,4,1371,628,1077,466,294,162,162,,,,675,311,622,287,13,3,37,19,3,2,24,78,48
E02002279,Kirklees 009,Middle Super Output Areas and Intermediate Zones,MSOAIZ,WF,6140,2780,3630,1521,1095,584,2535,937,8,2,1455,749,1182,560,273,189,189,,,,947,444,858,405,6,3,67,31,16,5,39,100,64
E02002280,Kirklees 010,Middle Super Output Areas and Intermediate Zones,MSOAIZ,WF,6219,2274,3399,963,1792,537,1607,426,141,38,1900,930,1188,597,712,333,333,,,,627,265,566,247,4,2,40,11,17,5,18,152,78
E02002281,Kirklees 011,Middle Super Output Areas and Intermediate Zones,MSOAIZ,WF,11318,4340,8444,3008,2736,1200,5708,1808,39,17,1206,627,826,449,380,178,178,,,,1494,614,1367,556,5,3,111,46,11,9,58,135,74
E02002282,Kirklees 012,Middle Super Output Areas and Intermediate Zones,MSOAIZ,WF,7195,2536,5218,1668,1925,704,3293,964,43,14,805,372,719,328,86,44,44,,,,1027,435,939,400,3,1,67,29,18,5,35,102,47
E02002283,Kirklees 013,Middle Super Output Areas and Intermediate Zones,MSOAIZ,WF,7822,2413,5746,1540,3522,940,2224,600,59,20,980,436,647,328,333,108,108,,,,913,363,806,323,4,1,88,35,15,4,40,124,54
E02002284,Kirklees 014,Middle Super Output Areas and Intermediate Zones,MSOAIZ,WF,6049,2648,4778,1996,1937,1005,2841,991,8,4,496,299,470,289,26,10,10,,,,696,306,633,275,3,1,56,27,4,3,31,71,43
E02002285,Kirklees 015,Middle Super Output Areas and Intermediate Zones,MSOAIZ,WF,7898,3356,6501,2651,2524,1306,3977,1345,5,4,349,217,251,160,98,57,57,,,,973,442,878,404,4,3,78,29,13,6,38,70,42
E02002286,Kirklees 016,Middle Super Output Areas and Intermediate Zones,MSOAIZ,WF,6059,2372,3671,1318,1231,526,2440,792,14,7,1388,612,1261,532,127,80,80,,,,902,383,816,341,22,12,48,20,16,10,42,84,52
E02002287,Kirklees 017,Middle Super Output Areas and Intermediate Zones,MSOAIZ,WF,6725,2732,4121,1260,1793,592,2328,668,19,7,946,600,638,398,308,202,202,,,,1497,795,1399,751,7,2,75,30,16,12,44,142,70
E02002288,Kirklees 018,Middle Super Output Areas and Intermediate Zones,MSOAIZ,WF,9201,3831,5746,2283,1704,861,4042,1422,89,45,2272,989,2061,859,211,130,130,,,,1001,455,898,406,3,2,97,44,3,3,49,93,59
E02002289,Kirklees 019,Middle Super Output Areas and Intermediate Zones,MSOAIZ,WF,6499,2126,4025,1165,1338,463,2687,702,23,5,1612,637,1294,508,318,129,129,,,,693,261,633,239,3,1,49,18,8,3,22,146,58
E02002290,Kirklees 020,Middle Super Output Areas and Intermediate Zones,MSOAIZ,WF,6218,2697,5185,2171,2251,1168,2934,1003,17,8,318,191,301,183,17,8,8,,,,628,283,575,257,2,1,42,22,9,3,26,70,44
E02002291,Kirklees 021,Middle Super Output Areas and Intermediate Zones,MSOAIZ,WF,6446,2709,4992,2053,1919,1005,3073,1048,15,7,726,316,687,292,39,24,24,,,,665,304,571,265,8,3,73,31,13,5,39,48,29
E02002292,Kirklees 022,Middle Super Output Areas and Intermediate Zones,MSOAIZ,HD,5686,2391,4621,1840,1783,871,2838,969,9,3,411,250,345,196,66,54,54,,,,595,271,548,248,0,0,39,19,8,4,23,50,27
E02002293,Kirklees 023,Middle Super Output Areas and Intermediate Zones,MSOAIZ,WF,7899,2624,4964,1353,2065,598,2899,755,17,6,1409,656,907,459,502,197,197,,,,1310,529,1174,484,5,2,106,38,25,5,45,199,80
E02002294,Kirklees 024,Middle Super Output Areas and Intermediate Zones,MSOAIZ,WF,10492,3102,7853,2050,4364,1162,3489,888,24,7,1327,604,921,479,406,125,125,,,,1075,363,928,318,2,2,108,35,37,8,45,213,78
E02002295,Kirklees 025,Middle Super Output Areas and Intermediate Zones,MSOAIZ,HD,6672,2951,2901,1230,864,464,2037,766,38,18,2801,1285,2279,1070,522,215,215,,,,734,321,664,282,2,1,57,31,11,7,39,198,97
E02002296,Kirklees 026,Middle Super Output Areas and Intermediate Zones,MSOAIZ,WF,6708,3114,4908,2065,1950,1035,2958,1030,17,9,711,429,565,344,146,85,85,,,,988,551,880,502,13,5,76,37,19,7,49,84,60
E02002297,Kirklees 027,Middle Super Output Areas and Intermediate Zones,MSOAIZ,HD,6899,2773,5675,2204,2542,1174,3133,1030,2,2,145,88,117,73,28,15,15,,,,1032,447,942,403,0,0,85,40,5,4,44,45,32
E02002298,Kirklees 028,Middle Super Output Areas and Intermediate Zones,MSOAIZ,WF,6706,2878,4315,1804,1747,890,2568,914,10,4,1741,795,1720,784,21,11,11,,,,562,224,456,177,5,3,89,37,12,7,47,78,51
E02002299,Kirklees 029,Middle Super Output Areas and Intermediate Zones,MSOAIZ,HD,6410,2852,2486,1033,959,478,1527,555,31,21,2046,906,1526,654,520,252,252,,,,1685,807,1571,754,13,6,80,39,21,8,53,162,85
E02002300,Kirklees 030,Middle Super Output Areas and Intermediate Zones,MSOAIZ,WF,6652,2931,5423,2293,2341,1255,3082,1038,11,5,355,224,227,158,128,66,66,,,,814,375,740,340,3,2,64,30,7,3,35,49,34
E02002301,Kirklees 031,Middle Super Output Areas and Intermediate Zones,MSOAIZ,HD,7644,2839,4855,1582,2049,717,2806,865,43,16,445,294,235,157,210,137,137,,,,2169,886,2027,829,3,3,102,45,37,9,57,132,61
E02002302,Kirklees 032,Middle Super Output Areas and Intermediate Zones,MSOAIZ,WF,6348,2650,5282,2158,2003,1026,3279,1132,11,7,297,136,225,109,72,27,27,,,,726,327,646,293,4,1,71,32,5,1,34,32,22
E02002303,Kirklees 033,Middle Super Output Areas and Intermediate Zones,MSOAIZ,HD,6380,2880,4400,1836,1830,921,2570,915,40,20,540,312,443,243,97,69,69,,,,1342,673,1262,635,13,5,56,29,11,4,38,58,39
E02002304,Kirklees 034,Middle Super Output Areas and Intermediate Zones,MSOAIZ,HD,6405,2972,3654,1472,1717,800,1937,672,6,5,515,315,60,32,455,283,283,,,,2161,1135,2055,1086,8,5,89,41,9,3,49,69,45
E02002305,Kirklees 035,Middle Super Output Areas and Intermediate Zones,MSOAIZ,HD,6061,2639,3259,1332,1187,599,2072,733,23,11,1697,815,1476,724,221,91,91,,,,947,411,853,370,11,3,75,34,8,4,41,135,70
E02002306,Kirklees 036,Middle Super Output Areas and Intermediate Zones,MSOAIZ,HD,6344,2692,5435,2207,2117,1074,3318,1133,7,5,217,142,174,112,43,30,30,,,,628,298,568,263,4,2,51,30,5,3,35,57,40
E02002307,Kirklees 037,Middle Super Output Areas and Intermediate Zones,MSOAIZ,HD,5978,2623,4459,1858,1674,877,2785,981,37,18,784,419,630,336,154,83,83,,,,629,277,534,240,0,0,95,37,0,0,37,69,51
E02002308,Kirklees 038,Middle Super Output Areas and Intermediate Zones,MSOAIZ,HD,6441,2876,4853,2076,1707,902,3146,1174,16,6,520,286,495,274,25,12,12,,,,1007,478,912,427,13,5,78,44,4,2,51,45,30
E02002309,Kirklees 039,Middle Super Output Areas and Intermediate Zones,MSOAIZ,HD,6664,2838,3922,1430,1699,700,2223,730,16,9,802,544,577,384,225,160,160,,,,1785,786,1685,735,14,4,74,41,12,6,51,139,69
E02002310,Kirklees 040,Middle Super Output Areas and Intermediate Zones,MSOAIZ,HD,6028,2713,3713,1592,1266,679,2447,913,9,5,1032,587,895,498,137,89,89,,,,1233,498,1155,469,1,1,69,25,8,3,29,41,31
E02002311,Kirklees 041,Middle Super Output Areas and Intermediate Zones,MSOAIZ,HD,6314,2812,4460,1858,1532,796,2928,1062,9,3,906,463,824,407,82,56,56,,,,872,439,763,387,5,3,98,44,6,5,52,67,49
E02002312,Kirklees 042,Middle Super Output Areas and Intermediate Zones,MSOAIZ,WF,6727,3054,2786,1209,1079,524,1707,685,33,13,1717,823,1297,560,420,263,263,,,,2085,955,1983,907,3,2,79,37,20,9,48,106,54
E02002313,Kirklees 043,Middle Super Output Areas and Intermediate Zones,MSOAIZ,HD,7610,2544,4821,1412,2300,705,2521,707,21,10,711,278,230,124,481,154,154,,,,1862,777,1734,732,8,4,106,33,14,8,45,195,67
E02002314,Kirklees 044,Middle Super Output Areas and Intermediate Zones,MSOAIZ,HD,5967,2624,4424,1965,1984,1078,2440,887,6,4,761,305,674,254,87,51,51,,,,699,310,625,269,4,2,57,32,13,7,41,77,40
E02002315,Kirklees 045,Middle Super Output Areas and Intermediate Zones,MSOAIZ,HD,6745,3028,4432,1908,1416,728,3016,1180,38,21,695,352,427,187,268,165,165,,,,1502,710,1408,664,1,1,86,41,7,4,46,78,37
E02002316,Kirklees 046,Middle Super Output Areas and Intermediate Zones,MSOAIZ,WF,6435,2758,5168,2187,2197,1147,2971,1040,45,17,690,297,640,281,50,16,16,,,,457,211,413,189,0,0,41,20,3,2,22,75,46
E02002317,Kirklees 047,Middle Super Output Areas and Intermediate Zones,MSOAIZ,HD,7039,2920,4471,1837,1725,875,2746,962,24,14,1357,515,1055,421,302,94,94,,,,1050,478,960,440,2,1,71,31,17,6,38,137,76
E02002318,Kirklees 048,Middle Super Output Areas and Intermediate Zones,MSOAIZ,HD,6308,2883,3935,1673,1642,837,2293,836,55,24,1476,802,1046,640,430,162,162,,,,729,313,655,282,2,1,62,28,10,2,31,113,71
E02002319,Kirklees 049,Middle Super Output Areas and Intermediate Zones,MSOAIZ,HD,6508,2876,5039,2126,1772,957,3267,1169,18,6,420,218,346,183,74,35,35,,,,996,501,918,456,5,3,68,39,5,3,45,35,25
E02002320,Kirklees 050,Middle Super Output Areas and Intermediate Zones,MSOAIZ,HD,6385,3097,4862,2161,2214,1193,2648,968,20,9,732,503,667,453,65,50,50,,,,693,364,609,320,6,3,59,31,19,10,44,78,60
E02002321,Kirklees 051,Middle Super Output Areas and Intermediate Zones,MSOAIZ,WF,6027,2569,5031,2058,2140,1066,2891,992,27,18,281,144,230,127,51,17,17,,,,624,314,553,281,3,2,64,28,4,3,33,64,35
E02002322,Kirklees 052,Middle Super Output Areas and Intermediate Zones,MSOAIZ,HX,6398,2781,4966,2117,2056,1067,2910,1050,5,2,554,238,488,213,66,25,25,,,,782,374,720,344,3,1,52,25,7,4,30,91,50
E02002323,Kirklees 053,Middle Super Output Areas and Intermediate Zones,MSOAIZ,HD,8426,3612,6846,2846,2837,1463,4009,1383,17,7,606,324,548,282,58,42,42,,,,879,383,797,346,2,1,76,35,4,1,37,78,52
E02002324,Kirklees 054,Middle Super Output Areas and Intermediate Zones,MSOAIZ,WF,6477,2811,5108,2135,2140,1088,2968,1047,10,4,582,308,473,250,109,58,58,,,,715,322,675,297,2,1,37,23,1,1,25,62,42
E02002325,Kirklees 055,Middle Super Output Areas and Intermediate Zones,MSOAIZ,HD,8419,3567,6510,2660,2554,1307,3956,1353,29,21,845,392,750,329,95,63,63,,,,949,440,849,396,7,3,79,34,14,7,44,86,54
E02002326,Kirklees 056,Middle Super Output Areas and Intermediate Zones,MSOAIZ,HD,6264,2509,5437,2130,2022,993,3415,1137,26,13,238,104,170,78,68,26,26,,,,516,232,475,207,10,5,22,14,9,6,25,47,30
E02002327,Kirklees 057,Middle Super Output Areas and Intermediate Zones,MSOAIZ,HD,9776,4086,8187,3309,3292,1639,4895,1670,16,7,439,215,361,183,78,32,32,,,,1019,488,886,433,22,9,96,38,15,8,55,115,67
E02002328,Kirklees 058,Middle Super Output Areas and Intermediate Zones,MSOAIZ,HD,6886,2942,5687,2364,2410,1230,3277,1134,4,3,385,177,330,159,55,18,18,,,,720,348,621,299,12,4,81,40,6,5,49,90,50
E02002329,Kirklees 059,Middle Super Output Areas and Intermediate Zones,MSOAIZ,HD,11946,5047,9703,4033,4059,2021,5644,2012,30,11,785,324,646,271,139,53,53,,,,1346,628,1198,555,29,11,103,56,16,6,73,82,51
E02002330,Leeds 001,Middle Super Output Areas and Intermediate Zones,MSOAIZ,LS,6592,2785,5921,2497,2778,1435,3143,1062,7,4,260,108,246,100,14,8,8,,,,338,147,323,139,4,2,11,6,0,0,8,66,29
E02002331,Leeds 002,Middle Super Output Areas and Intermediate Zones,MSOAIZ,LS,5507,2679,3669,1672,1571,865,2098,807,17,13,1046,598,832,451,214,147,147,,,,691,344,638,319,10,3,35,19,8,3,25,84,52
E02002332,Leeds 003,Middle Super Output Areas and Intermediate Zones,MSOAIZ,LS,5849,2534,4332,1816,1778,957,2554,859,36,15,1065,529,932,448,133,81,81,,,,362,137,305,117,9,2,39,15,9,3,20,54,37
E02002333,Leeds 004,Middle Super Output Areas and Intermediate Zones,MSOAIZ,LS,7729,3625,5969,2641,2453,1324,3516,1317,24,14,639,386,479,265,160,121,121,,,,1011,535,925,492,18,5,60,33,8,5,43,86,49
E02002334,Leeds 005,Middle Super Output Areas and Intermediate Zones,MSOAIZ,LS,7083,3156,5666,2448,2454,1325,3212,1123,8,4,688,337,615,295,73,42,42,,,,627,308,525,258,54,21,39,24,9,5,50,94,59
E02002335,Leeds 006,Middle Super Output Areas and Intermediate Zones,MSOAIZ,LS,7552,3154,6414,2613,2783,1393,3631,1220,10,6,431,204,379,185,52,19,19,,,,593,277,537,244,16,7,33,21,7,5,33,104,54
E02002336,Leeds 007,Middle Super Output Areas and Intermediate Zones,MSOAIZ,LS,6734,2826,5889,2412,2664,1339,3225,1073,26,13,289,143,237,118,52,25,25,,,,467,222,417,199,12,5,25,13,13,5,23,63,36
E02002337,Leeds 008,Middle Super Output Areas and Intermediate Zones,MSOAIZ,LS,6685,2830,5708,2312,2205,1106,3503,1206,72,45,324,182,157,76,167,106,106,,,,525,259,474,229,0,0,37,24,14,6,30,56,32
E02002338,Leeds 009,Middle Super Output Areas and Intermediate Zones,MSOAIZ,LS,6729,2888,5215,2167,2020,1048,3195,1119,17,9,674,329,529,240,145,89,89,,,,760,349,690,318,4,2,58,24,8,5,31,63,34
E02002339,Leeds 010,Middle Super Output Areas and Intermediate Zones,MSOAIZ,LS,5634,2597,3350,1451,1127,606,2223,845,12,6,1589,780,1340,603,249,177,177,,,,612,311,554,280,2,1,51,28,5,2,31,71,49
E02002340,Leeds 011,Middle Super Output Areas and Intermediate Zones,MSOAIZ,LS,5519,2536,4061,1806,1651,900,2410,906,37,16,785,397,645,321,140,76,76,,,,609,298,565,270,4,1,36,24,4,3,28,27,19
E02002341,Leeds 012,Middle Super Output Areas and Intermediate Zones,MSOAIZ,LS,7348,3016,6472,2619,2800,1416,3672,1203,9,5,76,27,63,20,13,7,7,,,,726,325,686,301,4,4,34,18,2,2,24,65,40
E02002342,Leeds 013,Middle Super Output Areas and Intermediate Zones,MSOAIZ,LS,5752,2577,4688,2026,2064,1118,2624,908,3,3,727,393,629,321,98,72,72,,,,303,132,262,110,2,1,36,20,3,1,22,31,23
E02002343,Leeds 014,Middle Super Output Areas and Intermediate Zones,MSOAIZ,LS,5729,2419,4821,1980,1671,866,3150,1114,15,9,295,147,262,129,33,18,18,,,,554,257,491,228,0,0,52,25,11,4,29,44,26
E02002344,Leeds 015,Middle Super Output Areas and Intermediate Zones,MSOAIZ,LS,7653,3427,6076,2634,2483,1337,3593,1297,56,45,275,178,134,71,141,107,107,,,,1162,531,1076,488,10,5,73,35,3,3,43,84,39
E02002345,Leeds 016,Middle Super Output Areas and Intermediate Zones,MSOAIZ,LS,5475,2334,4731,1984,2121,1096,2610,888,8,2,238,115,206,99,32,16,16,,,,464,212,439,199,0,0,24,12,1,1,13,34,21
E02002346,Leeds 017,Middle Super Output Areas and Intermediate Zones,MSOAIZ,LS,5982,2727,3666,1598,1290,718,2376,880,7,3,1753,873,1495,719,258,154,154,,,,502,222,426,190,4,1,59,24,13,7,32,54,31
E02002347,Leeds 018,Middle Super Output Areas and Intermediate Zones,MSOAIZ,LS,5971,2734,2995,1251,1049,539,1946,712,25,16,2349,1199,2074,1021,275,178,178,,,,481,198,416,169,2,1,56,23,7,5,29,121,70
E02002348,Leeds 019,Middle Super Output Areas and Intermediate Zones,MSOAIZ,LS,6054,2727,3955,1695,1516,825,2439,870,19,9,1419,723,1295,639,124,84,84,,,,574,243,520,216,3,2,42,21,9,4,27,87,57
E02002349,Leeds 020,Middle Super Output Areas and Intermediate Zones,MSOAIZ,LS,5554,2540,4039,1738,1728,917,2311,821,21,7,396,228,170,101,226,127,127,,,,1049,536,1002,503,6,6,32,20,9,7,33,49,31
E02002350,Leeds 021,Middle Super Output Areas and Intermediate Zones,MSOAIZ,LS,5973,2563,5129,2128,2326,1226,2803,902,25,17,174,81,72,28,102,53,53,,,,585,304,508,242,0,0,23,12,54,50,62,60,33
E02002351,Leeds 022,Middle Super Output Areas and Intermediate Zones,MSOAIZ,LS,5380,2265,4824,1998,2190,1092,2634,906,1,1,173,91,123,66,50,25,25,,,,345,151,314,138,6,2,25,11,0,0,13,37,24
E02002352,Leeds 023,Middle Super Output Areas and Intermediate Zones,MSOAIZ,LS,7362,3116,5862,2330,2268,1139,3594,1191,9,7,255,151,118,48,137,103,103,,,,1172,585,1113,554,6,4,49,23,4,4,31,64,43
E02002353,Leeds 024,Middle Super Output Areas and Intermediate Zones,MSOAIZ,LS,5781,2225,4807,1763,1611,748,3196,1015,15,7,374,192,224,104,150,88,88,,,,533,239,482,212,1,1,47,25,3,1,27,52,24
E02002354,Leeds 025,Middle Super Output Areas and Intermediate Zones,MSOAIZ,LS,7782,3328,5599,2205,2113,1027,3486,1178,19,11,1176,696,757,427,419,269,269,,,,904,366,828,324,4,2,63,35,9,5,42,84,50
E02002356,Leeds 027,Middle Super Output Areas and Intermediate Zones,MSOAIZ,LS,7361,3217,5987,2461,2325,1193,3662,1268,14,7,380,256,327,211,53,45,45,,,,900,450,834,412,13,6,49,29,4,3,38,80,43
E02002357,Leeds 028,Middle Super Output Areas and Intermediate Zones,MSOAIZ,LS,7755,3585,4997,2220,1729,955,3268,1265,31,12,1467,708,1333,623,134,85,85,,,,1170,591,1086,546,0,0,75,39,9,6,45,90,54
E02002358,Leeds 029,Middle Super Output Areas and Intermediate Zones,MSOAIZ,LS,7341,3159,5190,2066,1635,829,3555,1237,21,6,1568,829,1218,621,350,208,208,,,,465,191,408,163,2,1,49,24,6,3,28,97,67
E02002359,Leeds 030,Middle Super Output Areas and Intermediate Zones,MSOAIZ,LS,6393,2773,5123,2149,2160,1119,2963,1030,19,13,593,295,530,256,63,39,39,,,,571,262,510,235,15,4,32,16,14,7,27,87,54
E02002360,Leeds 031,Middle Super Output Areas and Intermediate Zones,MSOAIZ,LS,6731,2954,4271,1803,1428,732,2843,1071,16,7,1301,624,317,157,984,467,467,,,,1071,477,987,437,5,2,69,31,10,7,40,72,43
E02002361,Leeds 032,Middle Super Output Areas and Intermediate Zones,MSOAIZ,LS,5653,2462,4075,1595,1383,701,2692,894,16,9,849,495,769,455,80,40,40,,,,646,329,617,316,0,0,27,11,2,2,13,67,34
E02002362,Leeds 033,Middle Super Output Areas and Intermediate Zones,MSOAIZ,LS,7658,3562,3508,1562,1147,651,2361,911,25,12,3284,1578,3066,1437,218,141,141,,,,723,340,643,300,0,0,71,34,9,6,40,118,70
E02002363,Leeds 034,Middle Super Output Areas and Intermediate Zones,MSOAIZ,LS,6901,3300,4603,2082,1580,856,3023,1226,22,14,375,238,199,118,176,120,120,,,,1842,939,1782,907,0,0,55,28,5,4,32,59,27
E02002364,Leeds 035,Middle Super Output Areas and Intermediate Zones,MSOAIZ,LS,5706,2699,2170,920,565,323,1605,597,7,5,3114,1564,2940,1481,174,83,83,,,,314,133,263,113,0,0,49,19,2,1,20,101,77
E02002366,Leeds 037,Middle Super Output Areas and Intermediate Zones,MSOAIZ,LS,7577,2844,5712,2065,2382,1075,3330,990,17,4,556,260,118,52,438,208,208,,,,1201,475,1122,438,2,2,72,33,5,2,37,91,40
E02002367,Leeds 038,Middle Super Output Areas and Intermediate Zones,MSOAIZ,LS,5915,2603,2052,859,550,281,1502,578,21,13,3055,1398,2454,1061,601,337,337,,,,710,285,646,260,2,1,56,20,6,4,25,77,48
E02002368,Leeds 039,Middle Super Output Areas and Intermediate Zones,MSOAIZ,LS,7893,3537,6357,2715,2191,1156,4166,1559,33,17,479,265,423,239,56,26,26,,,,953,490,875,450,0,0,62,32,16,8,40,71,50
E02002369,Leeds 040,Middle Super Output Areas and Intermediate Zones,MSOAIZ,LS,6892,2928,3137,1227,933,470,2204,757,26,10,3040,1383,2790,1219,250,164,164,,,,589,252,546,233,0,0,32,14,11,5,19,100,56
E02002370,Leeds 041,Middle Super Output Areas and Intermediate Zones,MSOAIZ,LS,6620,2880,3179,1321,782,419,2397,902,44,18,2855,1284,2344,1016,511,268,268,,,,466,208,392,175,2,1,70,30,2,2,33,76,49
E02002371,Leeds 042,Middle Super Output Areas and Intermediate Zones,MSOAIZ,LS,9594,4149,4555,1779,1964,842,2591,937,17,10,3066,1451,1643,761,1423,690,690,,,,1741,822,1620,768,0,0,114,49,7,5,54,215,87
E02002373,Leeds 044,Middle Super Output Areas and Intermediate Zones,MSOAIZ,LS,8448,2670,1174,531,518,265,656,266,26,7,592,289,204,99,388,190,190,,,,6616,1826,6484,1784,6,1,110,34,16,7,42,40,17
E02002374,Leeds 045,Middle Super Output Areas and Intermediate Zones,MSOAIZ,LS,6542,2979,2828,1279,1150,614,1678,665,89,34,1701,853,1252,641,449,212,212,,,,1845,763,1724,714,15,7,64,30,42,12,49,79,50
E02002375,Leeds 046,Middle Super Output Areas and Intermediate Zones,MSOAIZ,LS,5393,2296,2324,1023,650,352,1674,671,14,11,2455,1026,2229,929,226,97,97,,,,550,207,438,168,3,1,45,21,64,17,39,50,29
E02002376,Leeds 047,Middle Super Output Areas and Intermediate Zones,MSOAIZ,LS,6845,2455,2716,913,918,379,1798,534,40,18,3154,1212,2630,1017,524,195,195,,,,818,262,743,240,2,2,62,17,11,3,22,117,50
E02002377,Leeds 048,Middle Super Output Areas and Intermediate Zones,MSOAIZ,LS,7033,2282,3434,880,1499,423,1935,457,20,6,1486,575,454,196,1032,379,379,,,,1931,769,1800,734,0,0,98,28,33,7,35,162,52
E02002379,Leeds 050,Middle Super Output Areas and Intermediate Zones,MSOAIZ,LS,5243,2044,1905,756,579,286,1326,470,12,4,2899,1120,2550,951,349,169,169,,,,342,122,284,99,1,1,42,14,15,8,23,85,42
E02002380,Leeds 051,Middle Super Output Areas and Intermediate Zones,MSOAIZ,LS,5265,2353,3873,1676,1352,718,2521,958,21,8,900,431,859,405,41,26,26,,,,410,202,365,178,3,1,37,21,5,2,24,61,36
E02002381,Leeds 052,Middle Super Output Areas and Intermediate Zones,MSOAIZ,LS,6095,2891,3857,1771,1082,584,2775,1187,1,1,1178,582,905,443,273,139,139,,,,989,499,915,454,2,1,50,30,22,14,45,70,38
E02002382,Leeds 053,Middle Super Output Areas and Intermediate Zones,MSOAIZ,LS,5990,2302,2560,869,1116,384,1444,485,11,3,970,394,679,267,291,127,127,,,,2308,975,2234,939,10,4,50,26,14,6,36,141,61
E02002383,Leeds 054,Middle Super Output Areas and Intermediate Zones,MSOAIZ,LS,7512,2332,914,307,490,170,424,137,31,9,807,377,284,137,523,240,240,,,,5715,1620,5583,1581,15,4,82,24,35,11,39,45,19
E02002384,Leeds 055,Middle Super Output Areas and Intermediate Zones,MSOAIZ,LS,8538,4306,1119,536,454,228,665,308,42,23,4151,2179,2922,1589,1229,590,590,,,,3055,1470,2895,1399,10,6,67,29,83,36,71,171,98
E02002385,Leeds 056,Middle Super Output Areas and Intermediate Zones,MSOAIZ,LS,7959,3419,2064,982,842,420,1222,562,28,14,1557,820,1092,549,465,271,271,,,,4222,1556,4026,1479,7,2,168,67,21,8,77,88,47
E02002386,Leeds 057,Middle Super Output Areas and Intermediate Zones,MSOAIZ,LS,8307,3853,7115,3283,3219,1824,3896,1459,8,5,256,111,208,82,48,29,29,,,,861,419,811,393,0,0,44,23,6,3,26,67,35
E02002387,Leeds 058,Middle Super Output Areas and Intermediate Zones,MSOAIZ,LS,5450,2435,2668,1189,765,424,1903,765,43,25,1858,820,1643,673,215,147,147,,,,802,355,729,316,1,1,62,32,10,6,39,79,46
E02002388,Leeds 059,Middle Super Output Areas and Intermediate Zones,MSOAIZ,LS,7299,3196,3937,1700,1148,621,2789,1079,40,18,2181,984,1659,773,522,211,211,,,,1097,467,1016,422,0,0,76,43,5,2,45,44,27
E02002389,Leeds 060,Middle Super Output Areas and Intermediate Zones,MSOAIZ,LS,6600,2906,2230,869,564,300,1666,569,17,10,3716,1745,3201,1498,515,247,247,,,,519,211,475,193,0,0,23,9,21,9,18,118,71
E02002390,Leeds 061,Middle Super Output Areas and Intermediate Zones,MSOAIZ,LS,6055,2665,3729,1554,1148,604,2581,950,40,24,1668,794,849,394,819,400,400,,,,561,252,514,230,0,0,45,20,2,2,22,57,41
E02002391,Leeds 062,Middle Super Output Areas and Intermediate Zones,MSOAIZ,LS,7749,3505,5695,2473,1717,925,3978,1548,8,6,949,466,894,437,55,29,29,,,,1019,509,888,449,21,8,108,50,2,2,60,78,51
E02002392,Leeds 063,Middle Super Output Areas and Intermediate Zones,MSOAIZ,LS,5168,2352,642,260,302,132,340,128,14,6,1265,667,677,346,588,321,321,,,,3191,1394,3087,1353,17,7,45,18,42,16,41,56,25
E02002393,Leeds 064,Middle Super Output Areas and Intermediate Zones,MSOAIZ,LS,7519,3870,958,390,396,191,562,199,70,38,4343,2334,3341,1863,1002,471,471,,,,1964,1004,1854,952,40,19,40,19,30,14,52,184,104
E02002394,Leeds 065,Middle Super Output Areas and Intermediate Zones,MSOAIZ,LS,6770,3198,2126,954,667,373,1459,581,29,9,2690,1344,2348,1154,342,190,190,,,,1807,825,1742,791,8,4,50,26,7,4,34,118,66
E02002395,Leeds 066,Middle Super Output Areas and Intermediate Zones,MSOAIZ,LS,6321,2440,5145,1961,2037,975,3108,986,26,13,245,116,172,87,73,29,29,,,,877,331,814,301,0,0,61,28,2,2,30,28,19
E02002396,Leeds 067,Middle Super Output Areas and Intermediate Zones,MSOAIZ,LS,8375,3822,5523,2325,1712,902,3811,1423,25,13,1084,597,648,370,436,227,227,,,,1671,848,1536,786,8,4,114,52,13,6,62,72,39
E02002397,Leeds 068,Middle Super Output Areas and Intermediate Zones,MSOAIZ,LS,7397,3277,4869,2037,1564,825,3305,1212,70,37,1734,840,1539,769,195,71,71,,,,645,308,568,272,0,0,70,33,7,3,36,79,55
E02002398,Leeds 069,Middle Super Output Areas and Intermediate Zones,MSOAIZ,LS,7431,3256,6372,2730,2678,1432,3694,1298,16,10,341,165,253,110,88,55,55,,,,650,316,577,285,4,1,69,30,0,0,31,52,35
E02002399,Leeds 070,Middle Super Output Areas and Intermediate Zones,MSOAIZ,LS,6183,2631,3424,1490,1050,573,2374,917,5,4,1673,670,1619,650,54,20,20,,,,1005,430,910,384,4,1,82,43,9,2,46,76,37
E02002400,Leeds 071,Middle Super Output Areas and Intermediate Zones,MSOAIZ,LS,7644,3641,2534,1095,844,426,1690,669,34,18,2828,1499,2399,1302,429,197,197,,,,2091,953,2023,921,6,2,50,24,12,6,32,157,76
E02002401,Leeds 072,Middle Super Output Areas and Intermediate Zones,MSOAIZ,LS,6203,2541,1856,748,672,351,1184,397,9,4,3884,1581,2934,1136,950,445,445,,,,382,172,348,155,3,2,16,9,15,6,17,72,36
E02002402,Leeds 073,Middle Super Output Areas and Intermediate Zones,MSOAIZ,LS,5755,2396,5164,2118,1931,960,3233,1158,3,2,94,31,74,23,20,8,8,,,,452,221,408,201,3,1,37,17,4,2,20,42,24
E02002403,Leeds 074,Middle Super Output Areas and Intermediate Zones,MSOAIZ,LS,5975,2633,4452,1895,1790,945,2662,950,14,4,573,318,489,259,84,59,59,,,,872,376,823,350,3,3,42,22,4,1,26,64,40
E02002404,Leeds 075,Middle Super Output Areas and Intermediate Zones,MSOAIZ,LS,8225,4432,2058,1005,562,307,1496,698,88,46,2813,1468,1844,942,969,526,526,,,,3150,1837,3056,1789,3,3,71,38,20,7,48,116,76
E02002405,Leeds 076,Middle Super Output Areas and Intermediate Zones,MSOAIZ,LS,7386,3228,5649,2366,2145,1140,3504,1226,13,6,722,380,564,293,158,87,87,,,,913,423,805,371,4,2,96,45,8,5,52,89,53
E02002406,Leeds 077,Middle Super Output Areas and Intermediate Zones,MSOAIZ,LS,7007,2850,6378,2565,2507,1287,3871,1278,14,7,193,107,130,66,63,41,41,,,,392,152,366,139,0,0,26,13,0,0,13,30,19
E02002407,Leeds 078,Middle Super Output Areas and Intermediate Zones,MSOAIZ,LS,6273,2835,2474,1061,649,337,1825,724,33,14,2801,1300,2669,1253,132,47,47,,,,873,403,798,368,4,3,52,27,19,5,35,92,57
E02002408,Leeds 079,Middle Super Output Areas and Intermediate Zones,MSOAIZ,LS,7112,3268,4972,2077,1516,796,3456,1281,64,33,1076,621,987,562,89,59,59,,,,918,477,852,447,0,0,57,27,9,3,30,82,60
E02002409,Leeds 080,Middle Super Output Areas and Intermediate Zones,MSOAIZ,LS,5919,2633,3730,1607,1346,730,2384,877,49,18,1523,760,1434,717,89,43,43,,,,547,213,467,181,2,1,78,31,0,0,32,70,35
E02002410,Leeds 081,Middle Super Output Areas and Intermediate Zones,MSOAIZ,LS,6500,3051,4609,2026,1584,866,3025,1160,55,33,965,559,644,358,321,201,201,,,,822,395,760,360,6,4,49,26,7,5,35,49,38
E02002411,Leeds 082,Middle Super Output Areas and Intermediate Zones,MSOAIZ,LS,6951,3502,2151,924,724,353,1427,571,15,6,1816,887,1388,653,428,234,234,,,,2866,1625,2784,1580,0,0,68,37,14,8,45,103,60
E02002412,Leeds 083,Middle Super Output Areas and Intermediate Zones,MSOAIZ,LS,6791,3051,5090,2202,1578,852,3512,1350,14,8,735,369,565,280,170,89,89,,,,898,440,838,402,0,0,56,34,4,4,38,54,32
E02002414,Leeds 085,Middle Super Output Areas and Intermediate Zones,MSOAIZ,LS,5674,2682,1790,745,503,275,1287,470,40,22,2251,1126,1755,864,496,262,262,,,,1451,707,1401,681,0,0,34,18,16,8,26,142,82
E02002415,Leeds 086,Middle Super Output Areas and Intermediate Zones,MSOAIZ,LS,6482,2599,2488,739,1027,339,1461,400,13,9,1679,701,570,302,1109,399,399,,,,2184,1108,2063,1063,2,1,45,19,74,25,45,118,42
E02002416,Leeds 087,Middle Super Output Areas and Intermediate Zones,MSOAIZ,LS,6302,2794,4660,1983,2165,1121,2495,862,16,9,1119,569,1068,543,51,26,26,,,,446,192,411,173,3,3,28,15,4,1,19,61,41
E02002417,Leeds 088,Middle Super Output Areas and Intermediate Zones,MSOAIZ,WF,6292,2727,4638,1946,1626,842,3012,1104,76,35,801,386,691,324,110,62,62,,,,723,331,673,308,8,3,25,13,17,7,23,54,29
E02002418,Leeds 089,Middle Super Output Areas and Intermediate Zones,MSOAIZ,LS,7234,3038,5810,2375,1768,925,4042,1450,19,7,880,427,718,349,162,78,78,,,,479,201,418,174,4,1,54,25,3,1,27,46,28
E02002419,Leeds 090,Middle Super Output Areas and Intermediate Zones,MSOAIZ,LS,7832,3503,3685,1545,1236,664,2449,881,8,5,3027,1455,2745,1292,282,163,163,,,,993,431,904,391,0,0,82,36,7,4,40,119,67
E02002420,Leeds 091,Middle Super Output Areas and Intermediate Zones,MSOAIZ,LS,7822,3299,5286,2284,1879,1029,3407,1255,55,23,570,230,459,189,111,41,41,,,,1808,711,1698,658,0,0,109,52,1,1,53,103,51
E02002421,Leeds 092,Middle Super Output Areas and Intermediate Zones,MSOAIZ,LS,5897,2609,1845,756,528,274,1317,482,24,14,3497,1591,2449,1127,1048,464,464,,,,440,190,400,171,1,1,16,8,23,10,19,91,58
E02002422,Leeds 093,Middle Super Output Areas and Intermediate Zones,MSOAIZ,LS,6137,2662,5133,2194,1841,951,3292,1243,8,3,312,150,218,112,94,38,38,,,,617,275,563,247,0,0,54,28,0,0,28,67,40
E02002423,Leeds 094,Middle Super Output Areas and Intermediate Zones,MSOAIZ,LS,5606,2482,3077,1323,1016,537,2061,786,24,14,1967,886,1766,793,201,93,93,,,,454,213,392,186,1,1,56,24,5,2,27,84,46
E02002424,Leeds 095,Middle Super Output Areas and Intermediate Zones,MSOAIZ,LS,7565,3271,5743,2364,1765,897,3978,1467,16,8,1008,515,856,420,152,95,95,,,,726,344,672,313,0,0,52,29,2,2,31,72,40
E02002425,Leeds 096,Middle Super Output Areas and Intermediate Zones,MSOAIZ,LS,8367,3685,6579,2818,2440,1297,4139,1521,32,21,752,350,684,310,68,40,40,,,,924,447,857,403,3,2,57,38,7,4,44,80,49
E02002426,Leeds 097,Middle Super Output Areas and Intermediate Zones,MSOAIZ,LS,7639,3240,6024,2460,2119,1101,3905,1359,22,8,897,420,763,350,134,70,70,,,,642,317,580,287,9,3,41,22,12,5,30,54,35
E02002427,Leeds 098,Middle Super Output Areas and Intermediate Zones,MSOAIZ,LS,6805,3021,4678,1994,1831,961,2847,1033,7,4,1522,742,1210,559,312,183,183,,,,527,240,482,218,9,2,29,16,7,4,22,71,41
E02002428,Leeds 099,Middle Super Output Areas and Intermediate Zones,MSOAIZ,LS,6867,3110,4495,1982,1322,725,3173,1257,126,55,1338,628,1183,558,155,70,70,,,,854,407,765,358,4,4,81,43,4,2,49,54,38
E02002429,Leeds 100,Middle Super Output Areas and Intermediate Zones,MSOAIZ,WF,8178,3523,6178,2592,1998,1021,4180,1571,11,7,1071,473,953,417,118,56,56,,,,832,401,774,372,12,5,32,18,14,6,29,86,50
E02002430,Leeds 101,Middle Super Output Areas and Intermediate Zones,MSOAIZ,LS,7141,3017,2649,1099,656,360,1993,739,4,3,3758,1601,3334,1391,424,210,210,,,,631,247,564,217,2,1,57,23,8,6,30,99,67
E02002431,Leeds 102,Middle Super Output Areas and Intermediate Zones,MSOAIZ,WF,7955,3591,5231,2188,1300,670,3931,1518,22,17,1335,632,1187,557,148,75,75,,,,1277,703,1194,663,2,1,75,36,6,3,40,90,51
E02002432,Leeds 103,Middle Super Output Areas and Intermediate Zones,MSOAIZ,WF,7083,2919,5570,2200,1762,896,3808,1304,20,11,904,446,847,414,57,32,32,,,,523,221,483,198,0,0,35,20,5,3,23,66,41
E02002433,Leeds 104,Middle Super Output Areas and Intermediate Zones,MSOAIZ,WF,6145,3182,3645,1657,1051,589,2594,1068,52,26,1104,715,738,441,366,274,274,,,,1282,737,1183,686,2,1,86,44,11,6,51,62,47
E02002434,Leeds 105,Middle Super Output Areas and Intermediate Zones,MSOAIZ,WF,8563,3542,6230,2511,1288,668,4942,1843,114,48,1268,530,936,392,332,138,138,,,,899,423,818,381,2,1,74,38,5,3,42,52,30
E02002435,Leeds 106,Middle Super Output Areas and Intermediate Zones,MSOAIZ,WF,7379,3269,5731,2482,2079,1099,3652,1383,7,5,451,188,323,111,128,77,77,,,,1112,557,1029,516,6,2,72,37,5,2,41,78,37
E02002436,Leeds 107,Middle Super Output Areas and Intermediate Zones,MSOAIZ,WF,6552,2831,4408,1837,1450,739,2958,1098,27,12,1332,586,1064,464,268,122,122,,,,716,343,630,303,9,5,73,34,4,1,40,69,53
E02002437,Leeds 108,Middle Super Output Areas and Intermediate Zones,MSOAIZ,WF,6190,2445,5526,2162,1784,890,3742,1272,15,7,199,81,176,73,23,8,8,,,,422,179,374,162,0,0,36,14,12,3,17,28,16
E02002438,Wakefield 001,Middle Super Output Areas and Intermediate Zones,MSOAIZ,WF,7759,3273,3796,1558,1299,676,2497,882,11,6,3444,1476,2806,1180,638,296,296,,,,454,196,390,166,3,2,54,23,7,5,30,54,37
E02002439,Wakefield 002,Middle Super Output Areas and Intermediate Zones,MSOAIZ,WF,7593,3639,5050,2291,2017,1094,3033,1197,34,16,900,551,696,429,204,122,122,,,,1547,744,1391,675,17,7,129,55,10,7,69,62,37
E02002440,Wakefield 003,Middle Super Output Areas and Intermediate Zones,MSOAIZ,WF,7735,3225,4944,2037,1854,939,3090,1098,24,16,2284,971,1922,804,362,167,167,,,,423,168,359,144,0,0,58,23,6,1,24,60,33
E02002441,Wakefield 004,Middle Super Output Areas and Intermediate Zones,MSOAIZ,WF,8483,3825,5221,2209,1771,932,3450,1277,54,33,2291,1186,1741,855,550,331,331,,,,868,365,793,332,6,2,59,28,10,3,33,49,32
E02002442,Wakefield 005,Middle Super Output Areas and Intermediate Zones,MSOAIZ,WF,6671,2819,5391,2251,1913,957,3478,1294,8,4,372,139,232,86,140,53,53,,,,854,404,792,375,0,0,57,26,5,3,29,46,21
E02002443,Wakefield 006,Middle Super Output Areas and Intermediate Zones,MSOAIZ,WF,5819,2353,5032,1994,1543,752,3489,1242,14,8,304,124,225,91,79,33,33,,,,432,208,378,183,1,1,50,23,3,1,25,37,19
E02002444,Wakefield 007,Middle Super Output Areas and Intermediate Zones,MSOAIZ,WF,5874,2657,4274,1855,1483,781,2791,1074,32,20,910,464,676,336,234,128,128,,,,629,305,526,260,23,6,69,34,11,5,45,29,13
E02002445,Wakefield 008,Middle Super Output Areas and Intermediate Zones,MSOAIZ,WF,6845,3057,5089,2164,1997,1040,3092,1124,15,5,967,552,660,383,307,169,169,,,,713,305,605,260,4,2,101,42,3,1,45,61,31
E02002446,Wakefield 009,Middle Super Output Areas and Intermediate Zones,MSOAIZ,WF,5983,2585,4874,1999,1816,937,3058,1062,6,3,560,328,398,239,162,89,89,,,,515,236,449,209,9,2,57,25,0,0,27,28,19
E02002447,Wakefield 010,Middle Super Output Areas and Intermediate Zones,MSOAIZ,WF,6059,2721,3891,1633,1375,722,2516,911,28,13,1424,735,1066,548,358,187,187,,,,667,314,627,292,0,0,35,19,5,3,22,49,26
E02002448,Wakefield 011,Middle Super Output Areas and Intermediate Zones,MSOAIZ,WF,7528,3352,4071,1736,1605,828,2466,908,88,34,2681,1283,2195,1051,486,232,232,,,,655,281,576,245,7,4,54,25,18,7,36,33,18
E02002449,Wakefield 012,Middle Super Output Areas and Intermediate Zones,MSOAIZ,WF,8063,3230,6350,2557,2058,1028,4292,1529,60,28,900,336,352,129,548,207,207,,,,702,282,656,263,11,4,35,15,0,0,19,51,27
E02002450,Wakefield 013,Middle Super Output Areas and Intermediate Zones,MSOAIZ,WF,6711,2859,5254,2102,1582,793,3672,1309,31,20,741,429,502,290,239,139,139,,,,636,280,571,247,4,2,53,26,8,5,33,49,28
E02002451,Wakefield 014,Middle Super Output Areas and Intermediate Zones,MSOAIZ,WF,7037,3049,5836,2446,2493,1274,3343,1172,6,3,754,400,464,228,290,172,172,,,,391,175,333,148,4,1,47,24,7,2,27,50,25
E02002452,Wakefield 015,Middle Super Output Areas and Intermediate Zones,MSOAIZ,WF,7846,3723,4210,1775,1340,697,2870,1078,37,20,2551,1416,1855,999,696,417,417,,,,973,472,874,422,4,2,69,34,26,14,50,75,40
E02002453,Wakefield 016,Middle Super Output Areas and Intermediate Zones,MSOAIZ,WF,9179,4171,5324,2231,1751,922,3573,1309,26,15,2636,1376,2033,1020,603,356,356,,,,1131,514,1026,460,6,3,81,41,18,10,54,62,35
E02002454,Wakefield 017,Middle Super Output Areas and Intermediate Zones,MSOAIZ,WF,7406,3399,3591,1298,1215,539,2376,759,54,24,1414,994,880,601,534,393,393,,,,2244,1037,2109,980,0,0,93,41,42,16,57,103,46
E02002455,Wakefield 018,Middle Super Output Areas and Intermediate Zones,MSOAIZ,WF,6149,2552,3178,1249,1058,523,2120,726,31,16,2512,1116,2077,901,435,215,215,,,,388,152,314,128,7,2,52,18,15,4,24,40,19
E02002456,Wakefield 019,Middle Super Output Areas and Intermediate Zones,MSOAIZ,WF,6416,2738,3811,1558,1482,718,2329,840,15,7,1186,498,929,380,257,118,118,,,,1329,642,1232,596,8,4,75,36,14,6,46,75,33
E02002457,Wakefield 020,Middle Super Output Areas and Intermediate Zones,MSOAIZ,WF,7569,3252,3453,1371,1129,562,2324,809,11,6,3262,1516,2339,1112,923,404,404,,,,779,320,721,290,3,3,47,21,8,6,30,64,39
E02002458,Wakefield 021,Middle Super Output Areas and Intermediate Zones,MSOAIZ,WF,8746,3757,6426,2642,2323,1185,4103,1457,11,7,1153,565,923,455,230,110,110,,,,1105,514,999,463,9,5,81,38,16,8,51,51,29
E02002459,Wakefield 022,Middle Super Output Areas and Intermediate Zones,MSOAIZ,WF,9292,3934,5856,2335,1723,859,4133,1476,42,22,2293,1080,1727,795,566,285,285,,,,1044,465,950,420,5,2,74,37,15,6,45,57,32
E02002460,Wakefield 023,Middle Super Output Areas and Intermediate Zones,MSOAIZ,WF,7029,3149,5832,2551,2803,1461,3029,1090,39,15,574,308,326,169,248,139,139,,,,536,245,479,218,5,2,49,23,3,2,27,48,30
E02002461,Wakefield 024,Middle Super Output Areas and Intermediate Zones,MSOAIZ,WF,9931,4173,7141,2915,2320,1170,4821,1745,12,7,1869,841,1448,668,421,173,173,,,,866,382,751,327,21,9,84,41,10,5,55,43,28
E02002462,Wakefield 025,Middle Super Output Areas and Intermediate Zones,MSOAIZ,WF,7288,3337,5170,2186,1999,1037,3171,1149,11,8,1297,731,709,397,588,334,334,,,,755,379,700,347,2,1,43,27,10,4,32,55,33
E02002463,Wakefield 026,Middle Super Output Areas and Intermediate Zones,MSOAIZ,WF,9049,3651,2932,1193,971,482,1961,711,33,13,5516,2234,4252,1712,1264,522,522,,,,498,177,428,144,1,1,38,16,31,16,33,70,34
E02002464,Wakefield 027,Middle Super Output Areas and Intermediate Zones,MSOAIZ,WF,7836,3506,4652,1925,1734,873,2918,1052,12,11,2284,1150,1824,917,460,233,233,,,,831,386,714,331,4,1,104,46,9,8,55,57,34
E02002465,Wakefield 028,Middle Super Output Areas and Intermediate Zones,MSOAIZ,WF,5984,2850,4406,1920,2074,1089,2332,831,1,1,714,521,537,398,177,123,123,,,,804,372,751,348,1,1,36,19,16,4,24,59,36
E02002466,Wakefield 029,Middle Super Output Areas and Intermediate Zones,MSOAIZ,WF,8976,4012,6328,2605,2317,1177,4011,1428,38,23,1757,970,1349,720,408,250,250,,,,775,366,697,327,3,2,66,34,9,3,39,78,48
E02002467,Wakefield 030,Middle Super Output Areas and Intermediate Zones,MSOAIZ,WF,8203,3611,3856,1558,1439,671,2417,887,80,59,2194,1042,1538,725,656,317,317,,,,2015,917,1912,864,15,10,72,34,16,9,53,58,35
E02002468,Wakefield 031,Middle Super Output Areas and Intermediate Zones,MSOAIZ,WF,5984,2660,4615,1975,1757,918,2858,1057,5,4,583,276,430,179,153,97,97,,,,737,378,657,336,1,1,64,33,15,8,42,44,27
E02002469,Wakefield 032,Middle Super Output Areas and Intermediate Zones,MSOAIZ,WF,5945,2423,4762,1890,1885,918,2877,972,4,3,753,347,564,270,189,77,77,,,,379,156,330,133,5,3,39,18,5,2,23,47,27
E02002470,Wakefield 033,Middle Super Output Areas and Intermediate Zones,MSOAIZ,WF,6097,2622,5539,2336,2710,1395,2829,941,31,27,153,93,87,52,66,41,41,,,,324,142,291,125,7,3,21,11,5,3,17,50,24
E02002471,Wakefield 034,Middle Super Output Areas and Intermediate Zones,MSOAIZ,WF,10302,4499,8515,3611,3674,1860,4841,1751,24,15,730,394,465,236,265,158,158,,,,951,438,806,376,27,12,108,44,10,6,62,82,41
E02002472,Wakefield 035,Middle Super Output Areas and Intermediate Zones,MSOAIZ,WF,5648,2439,4490,1869,1866,938,2624,931,13,7,634,324,454,226,180,98,98,,,,484,221,428,196,0,0,35,15,21,10,25,27,18
E02002473,Wakefield 036,Middle Super Output Areas and Intermediate Zones,MSOAIZ,WF,6309,2722,5387,2338,2204,1142,3183,1196,4,2,232,84,40,17,192,67,67,,,,647,275,586,247,8,4,45,21,8,3,28,39,23
E02002474,Wakefield 037,Middle Super Output Areas and Intermediate Zones,MSOAIZ,WF,6064,2700,3518,1444,1261,641,2257,803,62,31,2082,1017,1507,728,575,289,289,,,,366,182,311,156,1,1,50,24,4,1,26,36,26
E02002475,Wakefield 038,Middle Super Output Areas and Intermediate Zones,MSOAIZ,WF,5933,2573,4904,2078,2161,1076,2743,1002,66,43,451,222,318,148,133,74,74,,,,464,204,422,177,6,4,29,19,7,4,27,48,26
E02002476,Wakefield 039,Middle Super Output Areas and Intermediate Zones,MSOAIZ,WF,5732,2375,2975,1188,1127,557,1848,631,16,8,2006,873,1518,663,488,210,210,,,,661,270,608,249,11,2,40,17,2,2,21,74,36
E02002477,Wakefield 040,Middle Super Output Areas and Intermediate Zones,MSOAIZ,WF,6294,2699,4162,1722,1530,751,2632,971,2,2,1365,632,886,436,479,196,196,,,,697,307,623,270,2,1,69,34,3,2,37,68,36
E02002478,Wakefield 041,Middle Super Output Areas and Intermediate Zones,MSOAIZ,WF,5818,2459,4348,1748,1515,761,2833,987,6,5,479,295,359,219,120,76,76,,,,941,385,845,348,0,0,92,34,4,3,37,44,26
E02002479,Wakefield 042,Middle Super Output Areas and Intermediate Zones,MSOAIZ,WF,8314,3693,5522,2283,2088,1057,3434,1226,38,21,1816,925,1343,666,473,259,259,,,,881,427,788,381,5,3,70,33,18,10,46,57,37
E02002480,Wakefield 043,Middle Super Output Areas and Intermediate Zones,MSOAIZ,WF,5860,2673,3696,1565,1531,769,2165,796,12,6,1001,602,748,445,253,157,157,,,,1112,476,1022,434,9,4,76,35,5,3,42,39,24
E02002481,Wakefield 044,Middle Super Output Areas and Intermediate Zones,MSOAIZ,WF,6263,2672,4026,1617,1333,677,2693,940,8,4,1478,726,1069,520,409,206,206,,,,712,308,641,273,8,3,57,29,6,3,35,39,17
E02002482,Wakefield 045,Middle Super Output Areas and Intermediate Zones,MSOAIZ,WF,6642,2746,3805,1483,1165,588,2640,895,20,9,2160,987,1554,713,606,274,274,,,,618,245,549,218,0,0,52,20,17,7,27,39,22
E02002483,Hartlepool 001,Middle Super Output Areas and Intermediate Zones,MSOAIZ,TS,9084,3847,7200,2890,2113,1098,5087,1792,74,58,1020,559,418,206,602,353,353,,,,730,308,662,275,4,1,59,30,5,2,33,60,32
E02002484,Hartlepool 002,Middle Super Output Areas and Intermediate Zones,MSOAIZ,TS,10123,4553,4201,1754,1389,734,2812,1020,54,22,4518,2147,2174,918,2344,1229,1229,,,,1243,558,1144,510,6,4,77,34,16,10,48,107,72
E02002485,Hartlepool 003,Middle Super Output Areas and Intermediate Zones,MSOAIZ,TS,7793,3474,4032,1689,1395,730,2637,959,76,35,2465,1244,1324,609,1141,635,635,,,,1136,462,1089,435,0,0,46,26,1,1,27,84,44
E02002487,Hartlepool 005,Middle Super Output Areas and Intermediate Zones,MSOAIZ,TS,5354,2765,2165,1048,791,455,1374,593,56,26,858,445,108,57,750,388,388,,,,2228,1211,2130,1157,13,6,72,42,13,6,54,47,35
E02002488,Hartlepool 006,Middle Super Output Areas and Intermediate Zones,MSOAIZ,TS,6028,2512,5203,2104,1991,1019,3212,1085,2,1,220,139,25,12,195,127,127,,,,551,238,507,218,6,1,31,16,7,3,20,52,30
E02002489,Hartlepool 007,Middle Super Output Areas and Intermediate Zones,MSOAIZ,TS,7777,3532,3985,1627,1240,668,2745,959,21,9,1271,773,516,261,755,512,512,,,,2369,1059,2275,1011,7,2,65,31,22,15,48,131,64
E02002490,Hartlepool 008,Middle Super Output Areas and Intermediate Zones,MSOAIZ,TS,6057,2857,3548,1605,1305,741,2243,864,4,3,1006,496,204,86,802,410,410,,,,1429,720,1355,683,6,3,59,29,9,5,37,70,33
E02002491,Hartlepool 009,Middle Super Output Areas and Intermediate Zones,MSOAIZ,TS,6506,2887,3835,1639,1435,824,2400,815,32,21,1861,918,1058,520,803,398,398,,,,685,246,594,209,8,2,70,28,13,7,37,93,63
E02002492,Hartlepool 010,Middle Super Output Areas and Intermediate Zones,MSOAIZ,TS,6573,2924,4268,1772,1408,754,2860,1018,2,2,1603,833,796,398,807,435,435,,,,626,265,557,229,3,1,60,31,6,4,36,74,52
E02002493,Hartlepool 011,Middle Super Output Areas and Intermediate Zones,MSOAIZ,TS,6326,2698,5393,2240,2223,1152,3170,1088,12,7,378,215,130,56,248,159,159,,,,495,207,452,181,2,1,33,21,8,4,26,48,29
E02002494,Hartlepool 012,Middle Super Output Areas and Intermediate Zones,MSOAIZ,TS,7675,3399,3564,1483,1301,688,2263,795,13,7,3149,1485,1820,818,1329,667,667,,,,864,373,823,350,0,0,34,20,7,3,23,85,51
E02002496,Middlesbrough 001,Middle Super Output Areas and Intermediate Zones,MSOAIZ,TS,10577,4349,3560,1183,1671,610,1889,573,51,25,2235,1278,462,228,1773,1050,1050,,,,4447,1752,4176,1655,18,7,143,54,110,36,97,284,111
E02002497,Middlesbrough 002,Middle Super Output Areas and Intermediate Zones,MSOAIZ,TS,6268,2815,2607,1100,868,465,1739,635,28,16,1871,877,1090,487,781,390,390,,,,1604,744,1522,712,7,3,39,22,36,7,32,158,78
E02002498,Middlesbrough 003,Middle Super Output Areas and Intermediate Zones,MSOAIZ,TS,8583,3820,2730,1223,1279,629,1451,594,32,18,1183,680,440,263,743,417,417,,,,4419,1813,4193,1723,6,2,100,52,120,36,90,219,86
E02002499,Middlesbrough 004,Middle Super Output Areas and Intermediate Zones,MSOAIZ,TS,7432,3005,3348,1343,1050,561,2298,782,35,14,3060,1264,2217,862,843,402,402,,,,854,319,788,290,7,2,39,20,20,7,29,135,65
E02002500,Middlesbrough 005,Middle Super Output Areas and Intermediate Zones,MSOAIZ,TS,5787,2339,3846,1509,1345,650,2501,859,33,14,448,180,150,56,298,124,124,,,,1380,601,1279,558,9,4,88,37,4,2,43,80,35
E02002501,Middlesbrough 006,Middle Super Output Areas and Intermediate Zones,MSOAIZ,TS,5260,2228,2876,1123,852,442,2024,681,17,6,1547,773,773,329,774,444,444,,,,740,283,665,255,0,0,58,21,17,7,28,80,43
E02002502,Middlesbrough 007,Middle Super Output Areas and Intermediate Zones,MSOAIZ,TS,9559,4180,3944,1656,1403,755,2541,901,19,7,4304,1987,2938,1275,1366,712,712,,,,1110,427,965,370,14,4,114,46,17,7,57,182,103
E02002503,Middlesbrough 008,Middle Super Output Areas and Intermediate Zones,MSOAIZ,TS,6503,2567,3689,1431,1123,563,2566,868,61,27,1923,798,860,356,1063,442,442,,,,757,277,670,238,2,1,75,33,10,5,39,73,34
E02002504,Middlesbrough 009,Middle Super Output Areas and Intermediate Zones,MSOAIZ,TS,9625,3719,7173,2733,2503,1191,4670,1542,100,60,351,130,90,24,261,106,106,,,,1859,740,1758,692,0,0,93,43,8,5,48,142,56
E02002505,Middlesbrough 010,Middle Super Output Areas and Intermediate Zones,MSOAIZ,TS,6224,2531,2892,1133,763,420,2129,713,27,13,2475,1053,1650,670,825,383,383,,,,704,274,632,242,4,1,52,20,16,11,32,126,58
E02002506,Middlesbrough 011,Middle Super Output Areas and Intermediate Zones,MSOAIZ,TS,5613,2426,2167,850,582,325,1585,525,10,6,2569,1167,941,381,1628,786,786,,,,806,359,584,223,117,70,41,21,64,45,136,61,44
E02002507,Middlesbrough 012,Middle Super Output Areas and Intermediate Zones,MSOAIZ,TS,6021,2498,5269,2161,2122,1129,3147,1032,9,4,103,41,42,16,61,25,25,,,,583,265,508,230,0,0,68,33,7,2,35,57,27
E02002508,Middlesbrough 013,Middle Super Output Areas and Intermediate Zones,MSOAIZ,TS,5071,2118,4534,1878,2085,1089,2449,789,3,2,106,51,33,10,73,41,41,,,,392,166,335,145,0,0,55,20,2,1,21,36,21
E02002509,Middlesbrough 014,Middle Super Output Areas and Intermediate Zones,MSOAIZ,TS,5543,2343,3737,1564,1365,724,2372,840,13,7,980,453,541,250,439,203,203,,,,747,281,699,260,0,0,43,19,5,2,21,66,38
E02002510,Middlesbrough 015,Middle Super Output Areas and Intermediate Zones,MSOAIZ,TS,5712,2482,5087,2217,2418,1279,2669,938,18,9,87,46,34,11,53,35,35,,,,491,194,437,170,0,0,46,20,8,4,24,29,16
E02002512,Middlesbrough 017,Middle Super Output Areas and Intermediate Zones,MSOAIZ,TS,5265,2205,4649,1929,1791,943,2858,986,55,26,167,75,27,8,140,67,67,,,,361,153,307,131,0,0,48,19,6,3,22,33,22
E02002513,Middlesbrough 018,Middle Super Output Areas and Intermediate Zones,MSOAIZ,TS,8745,3824,4752,1975,1596,848,3156,1127,24,8,3089,1473,1135,498,1954,975,975,,,,771,316,691,282,8,3,62,26,10,5,34,109,52
E02002514,Middlesbrough 019,Middle Super Output Areas and Intermediate Zones,MSOAIZ,TS,8826,3827,5717,2238,1345,683,4372,1555,128,54,2225,1222,544,308,1681,914,914,,,,649,254,556,218,2,1,77,28,14,7,36,107,59
E02002515,Redcar and Cleveland 001,Middle Super Output Areas and Intermediate Zones,MSOAIZ,TS,6655,3270,3955,1817,1455,830,2500,987,21,13,392,230,74,42,318,188,188,,,,2222,1172,2056,1090,4,2,141,71,21,9,82,65,38
E02002516,Redcar and Cleveland 002,Middle Super Output Areas and Intermediate Zones,MSOAIZ,TS,5711,2432,3673,1544,1317,705,2356,839,25,9,1346,634,694,319,652,315,315,,,,632,222,553,189,9,3,63,25,7,5,33,35,23
E02002517,Redcar and Cleveland 003,Middle Super Output Areas and Intermediate Zones,MSOAIZ,TS,5371,2386,3439,1449,1321,685,2118,764,9,4,1388,697,791,364,597,333,333,,,,477,198,425,170,4,1,40,20,8,7,28,58,38
E02002518,Redcar and Cleveland 004,Middle Super Output Areas and Intermediate Zones,MSOAIZ,TS,10679,4510,9165,3828,3356,1777,5809,2051,104,50,296,156,140,70,156,86,86,,,,1022,420,927,375,0,0,79,40,16,5,45,92,56
E02002519,Redcar and Cleveland 005,Middle Super Output Areas and Intermediate Zones,MSOAIZ,TS,6915,3153,3682,1607,1404,748,2278,859,17,9,2664,1301,1276,628,1388,673,673,,,,515,211,446,180,0,0,56,23,13,8,31,37,25
E02002520,Redcar and Cleveland 006,Middle Super Output Areas and Intermediate Zones,MSOAIZ,TS,13146,5772,10970,4664,4733,2474,6237,2190,96,38,790,490,356,192,434,298,298,,,,1197,519,1065,460,5,3,110,48,17,8,59,93,61
E02002521,Redcar and Cleveland 007,Middle Super Output Areas and Intermediate Zones,MSOAIZ,TS,5717,2865,3979,1864,1777,1007,2202,857,3,2,628,385,196,95,432,290,290,,,,1067,585,972,536,19,10,73,37,3,2,49,40,29
E02002523,Redcar and Cleveland 009,Middle Super Output Areas and Intermediate Zones,MSOAIZ,TS,6514,2716,1977,791,547,288,1430,503,27,11,3634,1574,2407,1005,1227,569,569,,,,847,321,792,302,0,0,42,16,13,3,19,29,19
E02002524,Redcar and Cleveland 010,Middle Super Output Areas and Intermediate Zones,MSOAIZ,TS,5374,2291,3991,1670,1635,836,2356,834,16,6,680,316,356,151,324,165,165,,,,657,283,614,261,4,2,32,15,7,5,22,30,16
E02002525,Redcar and Cleveland 011,Middle Super Output Areas and Intermediate Zones,MSOAIZ,TS,8233,3772,5714,2475,2116,1118,3598,1357,39,22,1494,815,888,428,606,387,387,,,,933,431,847,383,3,2,69,37,14,9,48,53,29
E02002526,Redcar and Cleveland 012,Middle Super Output Areas and Intermediate Zones,MSOAIZ,TS,7442,3189,5107,2111,1736,910,3371,1201,56,22,1077,529,624,294,453,235,235,,,,1156,494,1077,455,8,4,63,31,8,4,39,46,33
E02002527,Redcar and Cleveland 013,Middle Super Output Areas and Intermediate Zones,MSOAIZ,TS,5095,2254,2923,1285,1268,680,1655,605,6,4,1042,478,550,227,492,251,251,,,,1091,465,1004,428,3,1,63,26,21,10,37,33,22
E02002529,Redcar and Cleveland 015,Middle Super Output Areas and Intermediate Zones,MSOAIZ,TS,5721,2620,4084,1727,1615,847,2469,880,5,2,1133,651,727,405,406,246,246,,,,453,214,383,186,5,2,59,21,6,5,28,46,26
E02002530,Redcar and Cleveland 016,Middle Super Output Areas and Intermediate Zones,MSOAIZ,TS,6493,2881,4323,1832,2044,1034,2279,798,6,4,1332,640,669,312,663,328,328,,,,757,363,677,325,23,11,41,20,16,7,38,75,42
E02002532,Redcar and Cleveland 018,Middle Super Output Areas and Intermediate Zones,MSOAIZ,TS,6166,2933,3541,1582,1372,740,2169,842,33,17,1398,766,764,401,634,365,365,,,,1104,516,992,460,12,6,89,44,11,6,56,90,52
E02002533,Redcar and Cleveland 019,Middle Super Output Areas and Intermediate Zones,MSOAIZ,TS,5693,2437,4869,2099,2154,1139,2715,960,0,0,292,112,182,68,110,44,44,,,,492,206,446,179,9,3,36,23,1,1,27,40,20
E02002534,Redcar and Cleveland 020,Middle Super Output Areas and Intermediate Zones,MSOAIZ,TS,5664,2469,5179,2249,2546,1338,2633,911,0,0,42,24,19,10,23,14,14,,,,395,166,346,144,10,4,39,18,0,0,22,48,30
E02002535,Stockton-on-Tees 001,Middle Super Output Areas and Intermediate Zones,MSOAIZ,TS,9938,4062,8848,3539,2803,1421,6045,2118,51,20,255,160,77,44,178,116,116,,,,742,319,660,283,0,0,75,34,7,2,36,42,24
E02002536,Stockton-on-Tees 002,Middle Super Output Areas and Intermediate Zones,MSOAIZ,TS,9581,4239,6562,2872,2500,1393,4062,1479,13,11,1453,769,963,479,490,290,290,,,,1500,559,1336,497,2,2,144,51,18,9,62,53,28
E02002537,Stockton-on-Tees 003,Middle Super Output Areas and Intermediate Zones,MSOAIZ,TS,8944,3673,5000,2050,1527,813,3473,1237,16,6,2452,1104,1798,802,654,302,302,,,,1446,494,1328,450,5,1,94,35,19,8,44,30,19
E02002538,Stockton-on-Tees 004,Middle Super Output Areas and Intermediate Zones,MSOAIZ,TS,5896,2429,3899,1520,1145,570,2754,950,5,3,989,524,463,255,526,269,269,,,,973,367,903,332,11,5,45,20,14,10,35,30,15
E02002539,Stockton-on-Tees 005,Middle Super Output Areas and Intermediate Zones,MSOAIZ,TS,8704,3517,7834,3124,3126,1519,4708,1605,5,3,267,124,171,74,96,50,50,,,,522,225,444,192,8,2,69,30,1,1,33,76,41
E02002540,Stockton-on-Tees 006,Middle Super Output Areas and Intermediate Zones,MSOAIZ,TS,6286,2808,5613,2449,2387,1279,3226,1170,35,24,177,121,5,3,172,118,118,,,,417,192,359,167,0,0,58,25,0,0,25,44,22
E02002541,Stockton-on-Tees 007,Middle Super Output Areas and Intermediate Zones,MSOAIZ,TS,6281,2870,4535,2058,1684,947,2851,1111,6,2,619,282,380,147,239,135,135,,,,1053,490,898,428,5,2,143,57,7,3,62,68,38
E02002542,Stockton-on-Tees 008,Middle Super Output Areas and Intermediate Zones,MSOAIZ,TS,8314,3358,4757,1906,1273,696,3484,1210,14,7,2522,1075,1776,721,746,354,354,,,,979,349,881,309,0,0,81,34,17,6,40,42,21
E02002543,Stockton-on-Tees 009,Middle Super Output Areas and Intermediate Zones,MSOAIZ,TS,8169,3356,4168,1576,924,467,3244,1109,64,30,2995,1409,1876,846,1119,563,563,,,,911,327,800,280,7,3,88,34,16,10,47,31,14
E02002544,Stockton-on-Tees 010,Middle Super Output Areas and Intermediate Zones,MSOAIZ,TS,7542,3391,4072,1772,1386,772,2686,1000,10,6,1989,949,1036,461,953,488,488,,,,1396,633,1304,594,3,1,87,37,2,1,39,75,31
E02002545,Stockton-on-Tees 011,Middle Super Output Areas and Intermediate Zones,MSOAIZ,TS,5392,2294,4825,2021,1897,978,2928,1043,15,7,135,76,64,37,71,39,39,,,,390,175,338,152,0,0,51,22,1,1,23,27,15
E02002546,Stockton-on-Tees 012,Middle Super Output Areas and Intermediate Zones,MSOAIZ,TS,7678,3103,4238,1644,1347,674,2891,970,24,9,2026,886,1287,529,739,357,357,,,,1347,543,1219,485,4,2,110,51,14,5,58,43,21
E02002547,Stockton-on-Tees 013,Middle Super Output Areas and Intermediate Zones,MSOAIZ,TS,6320,2765,5370,2263,2278,1210,3092,1053,21,13,496,311,225,125,271,186,186,,,,389,156,329,124,0,0,47,24,13,8,32,44,22
E02002548,Stockton-on-Tees 014,Middle Super Output Areas and Intermediate Zones,MSOAIZ,TS,10635,4986,4296,1669,1262,597,3034,1072,41,18,3240,1815,1844,991,1396,824,824,,,,2909,1413,2730,1332,8,4,118,51,53,26,81,149,71
E02002549,Stockton-on-Tees 015,Middle Super Output Areas and Intermediate Zones,MSOAIZ,TS,7762,3361,6852,2951,3050,1605,3802,1346,24,13,278,153,139,66,139,87,87,,,,546,208,482,183,6,2,55,21,3,2,25,62,36
E02002550,Stockton-on-Tees 016,Middle Super Output Areas and Intermediate Zones,MSOAIZ,TS,6296,2670,4871,1942,1982,983,2889,959,9,5,529,335,147,55,382,280,280,,,,812,357,755,329,3,1,51,25,3,2,28,75,31
E02002551,Stockton-on-Tees 017,Middle Super Output Areas and Intermediate Zones,MSOAIZ,TS,5895,2739,2333,1003,726,373,1607,630,15,8,1384,792,444,257,940,535,535,,,,2062,901,1981,865,12,5,64,27,5,4,36,101,35
E02002552,Stockton-on-Tees 018,Middle Super Output Areas and Intermediate Zones,MSOAIZ,TS,6814,2798,4290,1725,1255,632,3035,1093,30,11,1731,773,903,395,828,378,378,,,,739,277,634,234,0,0,90,36,15,7,43,24,12
E02002553,Stockton-on-Tees 019,Middle Super Output Areas and Intermediate Zones,MSOAIZ,TS,5847,2585,3866,1621,1415,765,2451,856,11,5,1040,563,690,355,350,208,208,,,,891,371,765,320,4,2,91,36,31,13,51,39,25
E02002554,Stockton-on-Tees 020,Middle Super Output Areas and Intermediate Zones,MSOAIZ,TS,5426,2355,2852,1196,1199,610,1653,586,16,11,1851,870,1148,489,703,381,381,,,,645,251,571,219,0,0,61,25,13,7,32,62,27
E02002555,Stockton-on-Tees 021,Middle Super Output Areas and Intermediate Zones,MSOAIZ,TS,9827,4137,8198,3429,3282,1677,4916,1752,17,7,469,206,184,72,285,134,134,,,,1071,459,982,415,2,1,67,33,20,10,44,72,36
E02002556,Stockton-on-Tees 022,Middle Super Output Areas and Intermediate Zones,MSOAIZ,TS,7160,2726,6334,2420,1843,889,4491,1531,28,17,67,20,44,13,23,7,7,,,,672,245,607,225,2,1,60,17,3,2,20,59,24
E02002557,Stockton-on-Tees 023,Middle Super Output Areas and Intermediate Zones,MSOAIZ,TS,13835,4792,12216,4194,1675,748,10541,3446,30,12,96,31,8,3,88,28,28,,,,1461,540,1387,506,5,2,65,30,4,2,34,32,15
E02002558,Stockton-on-Tees 024,Middle Super Output Areas and Intermediate Zones,MSOAIZ,TS,9417,4145,7725,3281,3287,1667,4438,1614,15,7,486,277,113,66,373,211,211,,,,1105,536,1007,496,15,5,78,33,5,2,40,86,44
E02002559,Darlington 001,Middle Super Output Areas and Intermediate Zones,MSOAIZ,TS,8828,3646,6866,2827,2394,1211,4472,1616,29,14,336,162,242,135,94,27,27,,,,1503,596,1060,455,225,64,93,39,125,38,141,94,47
E02002560,Darlington 002,Middle Super Output Areas and Intermediate Zones,MSOAIZ,DL,5994,2511,5067,2107,1753,922,3314,1185,5,2,180,73,152,59,28,14,14,,,,711,311,625,275,2,1,84,35,0,0,36,31,18
E02002561,Darlington 003,Middle Super Output Areas and Intermediate Zones,MSOAIZ,DL,5709,2507,4614,1985,1795,931,2819,1054,14,6,553,286,188,99,365,187,187,,,,502,215,445,188,3,2,47,21,7,4,27,26,15
E02002562,Darlington 004,Middle Super Output Areas and Intermediate Zones,MSOAIZ,DL,5973,2933,3240,1448,993,570,2247,878,4,2,1018,686,685,504,333,182,182,,,,1658,772,1592,737,1,1,57,29,8,5,35,53,25
E02002563,Darlington 005,Middle Super Output Areas and Intermediate Zones,MSOAIZ,DL,5286,2343,3611,1546,1250,669,2361,877,12,8,1125,557,912,469,213,88,88,,,,497,203,448,180,0,0,49,23,0,0,23,41,29
E02002564,Darlington 006,Middle Super Output Areas and Intermediate Zones,MSOAIZ,DL,9489,4137,5872,2484,1824,996,4048,1488,66,38,2650,1233,1995,963,655,270,270,,,,855,355,762,311,1,1,82,39,10,4,44,46,27
E02002565,Darlington 007,Middle Super Output Areas and Intermediate Zones,MSOAIZ,DL,5412,2667,3581,1722,1227,724,2354,998,6,4,55,29,18,10,37,19,19,,,,1716,878,1578,818,12,5,126,55,0,0,60,54,34
E02002566,Darlington 008,Middle Super Output Areas and Intermediate Zones,MSOAIZ,DL,6757,3475,2798,1278,913,511,1885,767,12,6,756,558,283,222,473,336,336,,,,3115,1585,2914,1486,48,21,132,63,21,15,99,76,48
E02002567,Darlington 009,Middle Super Output Areas and Intermediate Zones,MSOAIZ,DL,7157,3209,3921,1761,1588,882,2333,879,18,6,2001,890,1726,719,275,171,171,,,,1155,522,1050,472,0,0,93,45,12,5,50,62,30
E02002568,Darlington 010,Middle Super Output Areas and Intermediate Zones,MSOAIZ,DL,5791,2634,4726,1970,1844,996,2882,974,11,9,257,192,94,71,163,121,121,,,,764,439,705,410,3,2,50,23,6,4,29,33,24
E02002569,Darlington 011,Middle Super Output Areas and Intermediate Zones,MSOAIZ,DL,8968,3912,8143,3475,4011,2089,4132,1386,34,24,210,141,44,17,166,124,124,,,,503,226,439,196,9,3,50,24,5,3,30,78,46
E02002570,Darlington 012,Middle Super Output Areas and Intermediate Zones,MSOAIZ,DL,7945,3723,4408,1944,1531,806,2877,1138,27,10,1384,823,1059,622,325,201,201,,,,2052,906,1922,855,5,3,104,39,21,9,51,74,40
E02002571,Darlington 013,Middle Super Output Areas and Intermediate Zones,MSOAIZ,DL,6478,2758,3913,1625,1194,641,2719,984,28,15,1333,648,1241,605,92,43,43,,,,1159,446,1033,396,4,1,102,43,20,6,50,45,24
E02002572,Darlington 014,Middle Super Output Areas and Intermediate Zones,MSOAIZ,DL,6246,2727,3125,1361,1070,571,2055,790,43,16,1605,699,1297,566,308,133,133,,,,1435,630,1326,584,5,3,96,41,8,2,46,38,21
E02002573,Darlington 015,Middle Super Output Areas and Intermediate Zones,MSOAIZ,DL,8078,3488,6550,2756,2504,1291,4046,1465,27,18,526,251,369,177,157,74,74,,,,906,429,837,395,13,5,53,27,3,2,34,69,34
E02002574,Halton 001,Middle Super Output Areas and Intermediate Zones,MSOAIZ,WA,7094,2986,6411,2660,2512,1308,3899,1352,3,1,146,60,26,9,120,51,51,,,,494,245,466,228,2,1,23,15,3,1,17,40,20
E02002575,Halton 002,Middle Super Output Areas and Intermediate Zones,MSOAIZ,WA,9642,3732,8794,3332,2324,1117,6470,2215,10,7,183,83,15,4,168,79,79,,,,622,292,580,272,0,0,42,20,0,0,20,33,18
E02002576,Halton 003,Middle Super Output Areas and Intermediate Zones,MSOAIZ,WA,7256,3233,5180,2166,1959,997,3221,1169,11,6,1100,627,247,139,853,488,488,,,,902,395,812,358,3,1,80,33,7,3,37,63,39
E02002577,Halton 004,Middle Super Output Areas and Intermediate Zones,MSOAIZ,WA,7415,3287,3674,1507,1321,686,2353,821,31,10,3103,1497,847,397,2256,1100,1100,,,,486,199,443,179,1,1,34,16,8,3,20,121,74
E02002578,Halton 005,Middle Super Output Areas and Intermediate Zones,MSOAIZ,WA,7702,3207,5293,2166,1939,1012,3354,1154,6,3,1672,731,570,243,1102,488,488,,,,666,270,584,232,7,3,62,29,13,6,38,65,37
E02002579,Halton 006,Middle Super Output Areas and Intermediate Zones,MSOAIZ,WA,7711,3193,4719,1943,1662,863,3057,1080,15,6,2298,940,767,311,1531,629,629,,,,624,267,562,242,0,0,50,21,12,4,25,55,37
E02002580,Halton 007,Middle Super Output Areas and Intermediate Zones,MSOAIZ,WA,7452,3426,3171,1439,1101,603,2070,836,36,15,2521,1163,876,372,1645,791,791,,,,1646,766,1512,708,11,4,108,46,15,8,58,78,43
E02002581,Halton 008,Middle Super Output Areas and Intermediate Zones,MSOAIZ,WA,7287,3108,5905,2465,2445,1223,3460,1242,19,12,634,299,194,95,440,204,204,,,,672,296,618,272,0,0,42,20,12,4,24,57,36
E02002582,Halton 009,Middle Super Output Areas and Intermediate Zones,MSOAIZ,WA,8148,3103,7399,2797,1835,906,5564,1891,104,46,209,88,12,5,197,83,83,,,,416,161,379,147,0,0,33,12,4,2,14,20,11
E02002583,Halton 010,Middle Super Output Areas and Intermediate Zones,MSOAIZ,WA,6851,3093,2159,928,866,441,1293,487,122,62,4247,1951,321,142,3926,1809,1809,,,,275,125,220,98,0,0,36,16,19,11,27,48,27
E02002584,Halton 011,Middle Super Output Areas and Intermediate Zones,MSOAIZ,WA,7392,3089,5371,2221,1840,993,3531,1228,27,11,1342,577,329,130,1013,447,447,,,,594,249,518,216,4,1,62,29,10,3,33,58,31
E02002585,Halton 012,Middle Super Output Areas and Intermediate Zones,MSOAIZ,WA,10428,4897,6547,2886,2150,1180,4397,1706,21,8,1724,905,233,124,1491,781,781,,,,2063,1052,1943,998,6,2,94,45,20,7,54,73,46
E02002586,Halton 013,Middle Super Output Areas and Intermediate Zones,MSOAIZ,WA,9699,4060,4258,1767,1371,732,2887,1035,55,24,4542,1943,663,329,3879,1614,1614,,,,746,267,683,240,0,0,53,21,10,6,27,98,59
E02002587,Halton 014,Middle Super Output Areas and Intermediate Zones,MSOAIZ,WA,6914,2919,3585,1508,988,506,2597,1002,157,82,2532,1057,177,86,2355,971,971,,,,606,249,562,231,3,1,29,12,12,5,18,34,23
E02002588,Halton 015,Middle Super Output Areas and Intermediate Zones,MSOAIZ,WA,7439,3245,3655,1465,1123,561,2532,904,17,5,3181,1505,233,116,2948,1389,1389,,,,557,250,480,215,0,0,65,28,12,7,35,29,20
E02002589,Halton 016,Middle Super Output Areas and Intermediate Zones,MSOAIZ,WA,6444,2734,5991,2546,2564,1308,3427,1238,67,24,42,15,0,0,42,15,15,,,,314,129,287,116,0,0,27,13,0,0,13,30,20
E02002590,Warrington 001,Middle Super Output Areas and Intermediate Zones,MSOAIZ,WA,6100,2525,5322,2185,2394,1191,2928,994,7,4,316,137,172,70,144,67,67,,,,412,178,363,152,3,2,36,19,10,5,26,43,21
E02002591,Warrington 002,Middle Super Output Areas and Intermediate Zones,MSOAIZ,WA,6395,2772,5153,2185,2130,1155,3023,1030,16,8,714,335,421,199,293,136,136,,,,485,227,432,201,4,2,45,21,4,3,26,27,17
E02002592,Warrington 003,Middle Super Output Areas and Intermediate Zones,MSOAIZ,WA,6100,2557,5113,2125,2044,1037,3069,1088,12,8,465,209,291,129,174,80,80,,,,460,188,396,165,0,0,51,20,13,3,23,50,27
E02002593,Warrington 004,Middle Super Output Areas and Intermediate Zones,MSOAIZ,WA,5226,2367,3688,1602,1323,687,2365,915,64,37,944,484,162,75,782,409,409,,,,506,226,471,203,0,0,35,23,0,0,23,24,18
E02002594,Warrington 005,Middle Super Output Areas and Intermediate Zones,MSOAIZ,WA,5452,2472,3226,1377,824,447,2402,930,46,21,1721,839,282,133,1439,706,706,,,,438,221,384,194,0,0,46,22,8,5,27,21,14
E02002595,Warrington 006,Middle Super Output Areas and Intermediate Zones,MSOAIZ,WA,7918,3409,3781,1555,1085,589,2696,966,30,15,3420,1581,2682,1216,738,365,365,,,,636,229,555,195,0,0,69,29,12,5,34,51,29
E02002596,Warrington 007,Middle Super Output Areas and Intermediate Zones,MSOAIZ,WA,8189,3538,6546,2789,2464,1273,4082,1516,43,19,842,400,130,53,712,347,347,,,,718,300,652,266,0,0,58,28,8,6,34,40,30
E02002597,Warrington 008,Middle Super Output Areas and Intermediate Zones,MSOAIZ,WA,8994,3837,3973,1645,1332,695,2641,950,40,14,4311,1901,1854,843,2457,1058,1058,,,,585,234,480,192,5,1,79,32,21,9,42,85,43
E02002598,Warrington 009,Middle Super Output Areas and Intermediate Zones,MSOAIZ,WA,7660,2892,6503,2347,1167,522,5336,1825,169,90,204,104,29,7,175,97,97,,,,752,336,702,311,6,2,41,21,3,2,25,32,15
E02002599,Warrington 010,Middle Super Output Areas and Intermediate Zones,MSOAIZ,WA,10774,4129,8891,3232,2135,976,6756,2256,154,79,782,423,98,51,684,372,372,,,,898,362,837,341,10,1,48,17,3,3,21,49,33
E02002600,Warrington 011,Middle Super Output Areas and Intermediate Zones,MSOAIZ,WA,9142,4104,5942,2591,1991,1088,3951,1503,50,33,1827,889,967,433,860,456,456,,,,1258,545,1144,489,10,4,99,48,5,4,56,65,46
E02002601,Warrington 012,Middle Super Output Areas and Intermediate Zones,MSOAIZ,WA,7928,3343,6811,2858,2736,1448,4075,1410,7,4,497,226,175,74,322,152,152,,,,568,229,487,192,0,0,81,37,0,0,37,45,26
E02002602,Warrington 013,Middle Super Output Areas and Intermediate Zones,MSOAIZ,WA,7268,3166,3417,1447,887,500,2530,947,22,9,2384,1058,1512,663,872,395,395,,,,1378,609,1281,566,8,3,77,35,12,5,43,67,43
E02002603,Warrington 014,Middle Super Output Areas and Intermediate Zones,MSOAIZ,WA,7065,2862,6420,2570,2500,1246,3920,1324,2,2,241,129,149,76,92,53,53,,,,371,140,325,120,0,0,46,20,0,0,20,31,21
E02002604,Warrington 015,Middle Super Output Areas and Intermediate Zones,MSOAIZ,WA,7590,3141,6786,2774,2563,1322,4223,1452,45,23,274,136,116,63,158,73,73,,,,448,189,412,171,0,0,31,15,5,3,18,37,19
E02002605,Warrington 016,Middle Super Output Areas and Intermediate Zones,MSOAIZ,WA,9234,3742,7219,2859,2126,1067,5093,1792,95,47,1096,483,189,76,907,407,407,,,,789,335,702,298,6,3,67,28,14,6,37,35,18
E02002606,Warrington 017,Middle Super Output Areas and Intermediate Zones,MSOAIZ,WA,9954,4930,5157,2474,1635,918,3522,1556,99,63,1514,822,605,340,909,482,482,,,,3139,1541,2975,1456,8,5,138,70,18,10,85,45,30
E02002607,Warrington 018,Middle Super Output Areas and Intermediate Zones,MSOAIZ,WA,9914,4868,5856,2669,2274,1261,3582,1408,65,32,1680,977,815,454,865,523,523,,,,2217,1125,2091,1053,7,5,100,57,19,10,72,96,65
E02002608,Warrington 019,Middle Super Output Areas and Intermediate Zones,MSOAIZ,WA,8382,3526,7569,3183,3308,1732,4261,1451,25,9,185,77,104,43,81,34,34,,,,560,228,484,195,0,0,70,31,6,2,33,43,29
E02002609,Warrington 020,Middle Super Output Areas and Intermediate Zones,MSOAIZ,WA,8038,3731,4303,1915,1332,764,2971,1151,25,10,2331,1114,1461,666,870,448,448,,,,1312,656,1216,618,5,2,75,31,16,5,38,67,36
E02002610,Warrington 021,Middle Super Output Areas and Intermediate Zones,MSOAIZ,WA,12261,5171,10009,4076,3891,1992,6118,2084,87,45,753,386,461,235,292,151,151,,,,1340,622,1244,578,13,4,76,37,7,3,44,72,42
E02002611,Warrington 022,Middle Super Output Areas and Intermediate Zones,MSOAIZ,WA,7862,3253,7030,2865,2810,1458,4220,1407,54,22,343,165,53,22,290,143,143,,,,399,174,361,158,0,0,35,14,3,2,16,36,27
E02002612,Warrington 023,Middle Super Output Areas and Intermediate Zones,MSOAIZ,WA,9232,4009,7475,3103,2821,1498,4654,1605,59,40,776,410,435,207,341,203,203,,,,844,414,748,361,20,8,71,44,5,1,53,78,42
E02002613,Warrington 024,Middle Super Output Areas and Intermediate Zones,MSOAIZ,WA,6054,2402,5579,2179,2275,1070,3304,1109,4,2,65,24,34,15,31,9,9,,,,357,174,309,148,17,9,22,13,9,4,26,49,23
E02002614,Warrington 025,Middle Super Output Areas and Intermediate Zones,MSOAIZ,WA,6096,2394,5875,2310,2655,1270,3220,1040,1,1,38,9,19,4,19,5,5,,,,162,67,149,60,3,1,10,6,0,0,7,20,7
E02002615,Blackburn with Darwen 001,Middle Super Output Areas and Intermediate Zones,MSOAIZ,BB,9266,3952,7256,3022,3116,1579,4140,1443,11,5,1016,477,402,168,614,309,309,,,,887,393,775,344,4,2,93,43,15,4,49,96,55
E02002616,Blackburn with Darwen 002,Middle Super Output Areas and Intermediate Zones,MSOAIZ,BB,8527,2941,7465,2552,3272,1332,4193,1220,21,7,64,24,8,2,56,22,22,,,,868,320,788,288,0,0,68,28,12,4,32,109,38
E02002617,Blackburn with Darwen 003,Middle Super Output Areas and Intermediate Zones,MSOAIZ,BB,8893,2668,5796,1539,3402,945,2394,594,52,15,1567,580,260,98,1307,482,482,,,,1365,494,1221,431,0,0,96,36,48,27,63,113,40
E02002618,Blackburn with Darwen 004,Middle Super Output Areas and Intermediate Zones,MSOAIZ,BB,7400,2143,5590,1451,3515,938,2075,513,19,4,855,331,180,85,675,246,246,,,,786,302,674,263,0,0,81,29,31,10,39,150,55
E02002619,Blackburn with Darwen 005,Middle Super Output Areas and Intermediate Zones,MSOAIZ,PR,8582,3057,5829,1775,2829,961,3000,814,84,35,1018,491,265,124,753,367,367,,,,1497,698,1371,654,0,0,76,30,50,14,44,154,58
E02002620,Blackburn with Darwen 006,Middle Super Output Areas and Intermediate Zones,MSOAIZ,BB,8163,3225,4130,1183,2600,729,1530,454,62,20,2578,1332,618,285,1960,1047,1047,,,,1169,597,1037,536,12,7,80,27,40,27,61,224,93
E02002621,Blackburn with Darwen 007,Middle Super Output Areas and Intermediate Zones,MSOAIZ,BB,8381,2610,5244,1324,3841,988,1403,336,140,33,1887,816,416,192,1471,624,624,,,,939,371,848,339,3,2,69,22,19,8,32,171,66
E02002622,Blackburn with Darwen 008,Middle Super Output Areas and Intermediate Zones,MSOAIZ,BB,9866,3903,4378,1580,1677,714,2701,866,6,3,4068,1735,1891,757,2177,978,978,,,,1244,504,1145,459,6,3,66,30,27,12,45,170,81
E02002623,Blackburn with Darwen 009,Middle Super Output Areas and Intermediate Zones,MSOAIZ,BB,10006,4559,5426,2344,1810,943,3616,1401,111,52,1858,933,499,221,1359,712,712,,,,2494,1160,2281,1055,53,32,129,57,31,16,105,117,70
E02002624,Blackburn with Darwen 010,Middle Super Output Areas and Intermediate Zones,MSOAIZ,BB,8056,3346,7252,2961,3187,1577,4065,1384,17,7,190,103,48,21,142,82,82,,,,533,245,493,221,5,3,32,19,3,2,24,64,30
E02002625,Blackburn with Darwen 011,Middle Super Output Areas and Intermediate Zones,MSOAIZ,BB,9783,3935,5438,2112,1600,775,3838,1337,57,21,2939,1208,1184,468,1755,740,740,,,,1265,543,1143,484,17,9,86,40,19,10,59,84,51
E02002626,Blackburn with Darwen 012,Middle Super Output Areas and Intermediate Zones,MSOAIZ,BB,7167,3091,4498,1987,1827,984,2671,1003,19,8,1824,739,849,327,975,412,412,,,,717,299,614,255,0,0,81,35,22,9,44,109,58
E02002627,Blackburn with Darwen 013,Middle Super Output Areas and Intermediate Zones,MSOAIZ,BB,7672,2969,6738,2566,1631,813,5107,1753,6,4,51,17,14,4,37,13,13,,,,850,366,745,319,2,2,102,44,1,1,47,27,16
E02002628,Blackburn with Darwen 014,Middle Super Output Areas and Intermediate Zones,MSOAIZ,BB,6911,3132,4660,2016,1820,962,2840,1054,29,18,755,449,264,152,491,297,297,,,,1391,607,1257,547,7,2,99,42,28,16,60,76,42
E02002629,Blackburn with Darwen 015,Middle Super Output Areas and Intermediate Zones,MSOAIZ,BB,5767,2588,3399,1461,1334,709,2065,752,26,12,941,486,373,179,568,307,307,,,,1342,599,1267,564,4,1,63,27,8,7,35,59,30
E02002630,Blackburn with Darwen 016,Middle Super Output Areas and Intermediate Zones,MSOAIZ,BB,6042,2661,3738,1597,1307,681,2431,916,28,18,560,279,172,67,388,212,212,,,,1635,731,1500,672,11,4,109,46,15,9,59,81,36
E02002631,Blackburn with Darwen 017,Middle Super Output Areas and Intermediate Zones,MSOAIZ,BB,9076,3925,7182,2967,2444,1246,4738,1721,38,28,559,357,137,71,422,286,286,,,,1231,525,1129,479,8,2,85,40,9,4,46,66,48
E02002632,Blackburn with Darwen 018,Middle Super Output Areas and Intermediate Zones,MSOAIZ,PR,6269,2648,5670,2356,2399,1163,3271,1193,0,0,61,34,21,7,40,27,27,,,,503,239,425,203,8,3,46,23,24,10,36,35,19
E02002633,Blackpool 001,Middle Super Output Areas and Intermediate Zones,MSOAIZ,FY,7683,3595,6273,2950,2698,1609,3575,1341,18,9,60,22,35,11,25,11,11,,,,1276,580,1129,515,5,3,140,61,2,1,65,56,34
E02002634,Blackpool 002,Middle Super Output Areas and Intermediate Zones,MSOAIZ,FY,8251,4040,5742,2681,2431,1410,3311,1271,53,29,1310,823,911,652,399,171,171,,,,1068,449,973,404,3,1,84,40,8,4,45,78,58
E02002635,Blackpool 003,Middle Super Output Areas and Intermediate Zones,MSOAIZ,FY,7784,3683,6130,2815,2711,1584,3419,1231,8,5,89,59,25,16,64,43,43,,,,1510,770,1359,698,7,5,128,60,16,7,72,47,34
E02002636,Blackpool 004,Middle Super Output Areas and Intermediate Zones,MSOAIZ,FY,8363,3738,5910,2600,2003,1100,3907,1500,60,32,890,514,589,352,301,162,162,,,,1449,557,1328,506,2,1,116,49,3,1,51,54,35
E02002637,Blackpool 005,Middle Super Output Areas and Intermediate Zones,MSOAIZ,FY,6143,2673,4898,2147,1931,1067,2967,1080,10,6,105,57,79,46,26,11,11,,,,1092,442,1010,405,0,0,80,36,2,1,37,38,21
E02002638,Blackpool 006,Middle Super Output Areas and Intermediate Zones,MSOAIZ,FY,5670,2907,2461,1025,998,507,1463,518,19,12,362,192,25,10,337,182,182,,,,2772,1643,2677,1591,10,4,71,40,14,8,52,56,35
E02002639,Blackpool 007,Middle Super Output Areas and Intermediate Zones,MSOAIZ,FY,5746,2745,2026,907,734,409,1292,498,36,18,2876,1471,2164,1198,712,273,273,,,,715,285,645,252,1,1,65,30,4,2,33,93,64
E02002640,Blackpool 008,Middle Super Output Areas and Intermediate Zones,MSOAIZ,FY,7259,3493,2708,1251,875,512,1833,739,89,31,1694,1021,1091,707,603,314,314,,,,2703,1138,2601,1095,17,4,75,33,10,6,43,65,52
E02002641,Blackpool 009,Middle Super Output Areas and Intermediate Zones,MSOAIZ,FY,8106,3570,5697,2541,2030,1123,3667,1418,25,12,180,85,111,44,69,41,41,,,,2136,903,1905,811,21,7,182,76,28,9,92,68,29
E02002642,Blackpool 010,Middle Super Output Areas and Intermediate Zones,MSOAIZ,FY,6224,3382,2127,1041,942,548,1185,493,19,8,605,363,231,182,374,181,181,,,,3422,1939,3306,1874,15,8,79,45,22,12,65,51,31
E02002643,Blackpool 011,Middle Super Output Areas and Intermediate Zones,MSOAIZ,FY,7422,3358,4090,1847,1404,804,2686,1043,26,13,581,257,331,162,250,95,95,,,,2680,1209,2532,1132,4,2,129,68,15,7,77,45,32
E02002644,Blackpool 012,Middle Super Output Areas and Intermediate Zones,MSOAIZ,FY,7962,3512,6256,2725,2242,1244,4014,1481,11,5,51,36,35,27,16,9,9,,,,1591,713,1397,618,7,3,187,92,0,0,95,53,33
E02002645,Blackpool 013,Middle Super Output Areas and Intermediate Zones,MSOAIZ,FY,4811,2581,1665,758,687,381,978,377,15,6,214,127,82,65,132,62,62,,,,2875,1662,2795,1616,9,6,59,31,12,9,46,42,28
E02002646,Blackpool 014,Middle Super Output Areas and Intermediate Zones,MSOAIZ,FY,7069,3352,4280,2013,1698,993,2582,1020,14,9,1664,829,1394,690,270,139,139,,,,1039,455,930,399,2,1,99,52,8,3,56,72,46
E02002647,Blackpool 015,Middle Super Output Areas and Intermediate Zones,MSOAIZ,FY,8157,3655,5037,2264,1771,1037,3266,1227,22,13,407,244,151,99,256,145,145,,,,2627,1098,2379,981,7,3,223,104,18,10,117,64,36
E02002648,Blackpool 016,Middle Super Output Areas and Intermediate Zones,MSOAIZ,FY,7322,3267,4677,2140,1739,959,2938,1181,13,8,711,340,555,259,156,81,81,,,,1852,741,1707,672,4,2,138,64,3,3,69,69,38
E02002649,Blackpool 017,Middle Super Output Areas and Intermediate Zones,MSOAIZ,FY,8123,3675,5752,2405,2251,1182,3501,1223,10,3,130,76,11,5,119,71,71,,,,2178,1156,2032,1086,7,3,133,62,6,5,70,53,35
E02002650,Blackpool 018,Middle Super Output Areas and Intermediate Zones,MSOAIZ,FY,7960,3610,6279,2825,2728,1460,3551,1365,24,10,327,209,129,96,198,113,113,,,,1281,535,1139,465,15,7,121,60,6,3,70,49,31
E02002651,Blackpool 019,Middle Super Output Areas and Intermediate Zones,MSOAIZ,FY,7905,3531,6214,2715,2521,1389,3693,1326,21,10,433,274,333,202,100,72,72,,,,1190,495,1028,429,4,1,144,59,14,6,66,47,37
E02002652,Kingston upon Hull 001,Middle Super Output Areas and Intermediate Zones,MSOAIZ,HU,10774,4196,6806,2632,962,465,5844,2167,14,8,2564,1004,806,300,1758,704,704,,,,1337,523,1211,470,1,1,89,39,36,13,53,53,29
E02002653,Kingston upon Hull 002,Middle Super Output Areas and Intermediate Zones,MSOAIZ,HU,8293,3431,2944,1158,847,443,2097,715,17,8,4564,1968,4266,1802,298,166,166,,,,674,244,615,218,0,0,43,19,16,7,26,94,53
E02002654,Kingston upon Hull 003,Middle Super Output Areas and Intermediate Zones,MSOAIZ,HU,7640,3123,1820,742,606,308,1214,434,5,2,5134,2092,4574,1860,560,232,232,,,,526,200,486,185,0,0,34,13,6,2,15,155,87
E02002655,Kingston upon Hull 004,Middle Super Output Areas and Intermediate Zones,MSOAIZ,HU,8756,3594,3877,1486,836,435,3041,1051,18,8,3775,1659,3671,1619,104,40,40,,,,984,380,899,345,5,1,77,33,3,1,35,102,61
E02002656,Kingston upon Hull 005,Middle Super Output Areas and Intermediate Zones,MSOAIZ,HU,5329,2562,4613,2191,2126,1187,2487,1004,14,7,46,21,27,10,19,11,11,,,,638,333,576,302,5,2,54,27,3,2,31,18,10
E02002657,Kingston upon Hull 006,Middle Super Output Areas and Intermediate Zones,MSOAIZ,HU,7535,3106,6130,2494,2148,1096,3982,1398,11,6,639,300,546,247,93,53,53,,,,700,272,613,241,3,1,79,29,5,1,31,55,34
E02002658,Kingston upon Hull 007,Middle Super Output Areas and Intermediate Zones,MSOAIZ,HU,6766,2992,5289,2223,1743,898,3546,1325,17,9,666,345,525,259,141,86,86,,,,714,357,632,320,12,4,58,27,12,6,37,80,58
E02002659,Kingston upon Hull 008,Middle Super Output Areas and Intermediate Zones,MSOAIZ,HU,11018,4665,3285,1353,960,519,2325,834,26,9,6445,2756,5144,2044,1301,712,712,,,,1084,444,974,404,0,0,78,28,32,12,40,178,103
E02002660,Kingston upon Hull 009,Middle Super Output Areas and Intermediate Zones,MSOAIZ,HU,6922,3154,3881,1669,1599,854,2282,815,20,6,2389,1193,2318,1140,71,53,53,,,,549,220,484,193,0,0,61,23,4,4,27,83,66
E02002661,Kingston upon Hull 010,Middle Super Output Areas and Intermediate Zones,MSOAIZ,HU,7748,3373,4341,1819,1411,756,2930,1063,8,4,2724,1250,2650,1204,74,46,46,,,,573,231,510,205,10,2,42,20,11,4,26,102,69
E02002662,Kingston upon Hull 011,Middle Super Output Areas and Intermediate Zones,MSOAIZ,HU,7131,3355,4080,1677,1326,706,2754,971,72,31,2301,1345,1758,1000,543,345,345,,,,572,222,499,190,0,0,57,26,16,6,32,106,80
E02002663,Kingston upon Hull 012,Middle Super Output Areas and Intermediate Zones,MSOAIZ,HU,6387,2457,3361,1409,1192,620,2169,789,6,3,433,206,57,22,376,184,184,,,,2564,827,2053,615,1,1,88,32,422,179,212,23,12
E02002664,Kingston upon Hull 013,Middle Super Output Areas and Intermediate Zones,MSOAIZ,HU,7614,3007,6852,2673,2455,1206,4397,1467,16,11,149,63,141,60,8,3,3,,,,565,237,516,212,0,0,44,23,5,2,25,32,23
E02002665,Kingston upon Hull 014,Middle Super Output Areas and Intermediate Zones,MSOAIZ,HU,8241,3384,6176,2475,2166,1086,4010,1389,36,19,792,363,578,212,214,151,151,,,,1171,489,1056,444,5,2,97,38,13,5,45,66,38
E02002666,Kingston upon Hull 015,Middle Super Output Areas and Intermediate Zones,MSOAIZ,HU,8846,3653,1962,909,716,401,1246,508,70,31,974,557,345,196,629,361,361,,,,5780,2119,5607,2037,12,9,119,54,42,19,82,60,37
E02002667,Kingston upon Hull 016,Middle Super Output Areas and Intermediate Zones,MSOAIZ,HU,7079,3295,5031,2240,1720,910,3311,1330,5,3,310,170,248,131,62,39,39,,,,1692,853,1593,812,3,1,79,35,17,5,41,41,29
E02002668,Kingston upon Hull 017,Middle Super Output Areas and Intermediate Zones,MSOAIZ,HU,8864,3928,2029,863,608,320,1421,543,65,39,6090,2695,4380,1830,1710,865,865,,,,536,245,488,220,2,1,44,23,2,1,25,144,86
E02002669,Kingston upon Hull 018,Middle Super Output Areas and Intermediate Zones,MSOAIZ,HU,8416,3699,3942,1674,1360,698,2582,976,46,17,374,175,59,28,315,147,147,,,,4008,1811,3870,1742,6,3,116,55,16,11,69,46,22
E02002670,Kingston upon Hull 019,Middle Super Output Areas and Intermediate Zones,MSOAIZ,HU,7871,3688,4536,1930,1339,730,3197,1200,27,14,2270,1246,1888,970,382,276,276,,,,931,426,858,393,2,1,71,32,0,0,33,107,72
E02002671,Kingston upon Hull 020,Middle Super Output Areas and Intermediate Zones,MSOAIZ,HU,7643,3246,5018,2012,1487,763,3531,1249,56,28,1443,672,1189,536,254,136,136,,,,1077,502,966,453,5,2,103,46,3,1,49,49,32
E02002672,Kingston upon Hull 021,Middle Super Output Areas and Intermediate Zones,MSOAIZ,HU,7279,3003,2667,1097,782,433,1885,664,28,20,3714,1519,3124,1226,590,293,293,,,,788,322,717,294,4,1,62,23,5,4,28,82,45
E02002673,Kingston upon Hull 022,Middle Super Output Areas and Intermediate Zones,MSOAIZ,HU,7730,3431,5213,2186,1615,838,3598,1348,12,7,399,223,250,125,149,98,98,,,,2063,989,1936,930,4,3,106,50,17,6,59,43,26
E02002674,Kingston upon Hull 023,Middle Super Output Areas and Intermediate Zones,MSOAIZ,HU,6905,3251,4945,2265,1627,904,3318,1361,10,6,333,197,297,180,36,17,17,,,,1578,758,1500,720,0,0,75,36,3,2,38,39,25
E02002675,Kingston upon Hull 024,Middle Super Output Areas and Intermediate Zones,MSOAIZ,HU,8357,4105,2095,872,671,337,1424,535,35,19,3295,1742,2506,1267,789,475,475,,,,2796,1380,2686,1315,20,10,63,36,27,19,65,136,92
E02002676,Kingston upon Hull 025,Middle Super Output Areas and Intermediate Zones,MSOAIZ,HU,7503,3523,4318,1987,1478,815,2840,1172,13,6,504,248,431,211,73,37,37,,,,2584,1233,2415,1144,1,1,154,79,14,9,89,84,49
E02002677,Kingston upon Hull 026,Middle Super Output Areas and Intermediate Zones,MSOAIZ,HU,8336,4273,4197,1891,1138,608,3059,1283,28,10,1320,883,835,504,485,379,379,,,,2701,1427,2575,1354,8,3,102,61,16,9,73,90,62
E02002678,Kingston upon Hull 027,Middle Super Output Areas and Intermediate Zones,MSOAIZ,HU,7604,3349,5075,2144,1609,841,3466,1303,36,19,246,127,110,63,136,64,64,,,,2207,1033,2097,987,13,3,90,39,7,4,46,40,26
E02002679,Kingston upon Hull 028,Middle Super Output Areas and Intermediate Zones,MSOAIZ,HU,7346,3227,5455,2198,1868,954,3587,1244,16,7,1085,653,932,523,153,130,130,,,,738,335,666,300,4,1,62,29,6,5,35,52,34
E02002680,Kingston upon Hull 029,Middle Super Output Areas and Intermediate Zones,MSOAIZ,HU,8461,5316,1327,774,473,312,854,462,67,33,4033,2550,2904,1698,1129,852,852,,,,2802,1816,2675,1737,11,5,69,48,47,26,79,232,143
E02002681,Kingston upon Hull 030,Middle Super Output Areas and Intermediate Zones,MSOAIZ,HU,8318,3905,2748,1206,950,515,1798,691,37,21,1616,852,1167,598,449,254,254,,,,3819,1770,3700,1717,11,4,86,39,22,10,53,98,56
E02002682,Kingston upon Hull 031,Middle Super Output Areas and Intermediate Zones,MSOAIZ,HU,7948,3514,3482,1490,964,508,2518,982,29,12,2795,1278,2010,920,785,358,358,,,,1545,675,1469,639,0,0,71,32,5,4,36,97,59
E02002684,East Riding of Yorkshire 001,Middle Super Output Areas and Intermediate Zones,MSOAIZ,YO,9630,4628,7992,3863,4478,2520,3514,1343,43,19,366,159,127,62,239,97,97,,,,1167,549,1042,489,8,2,111,55,6,3,60,62,38
E02002685,East Riding of Yorkshire 002,Middle Super Output Areas and Intermediate Zones,MSOAIZ,YO,8030,3739,6440,3035,3641,2021,2799,1014,16,8,436,179,267,115,169,64,64,,,,1054,472,899,404,9,5,139,59,7,4,68,84,45
E02002686,East Riding of Yorkshire 003,Middle Super Output Areas and Intermediate Zones,MSOAIZ,YO,7758,3571,3443,1498,1362,721,2081,777,23,17,2914,1430,2643,1285,271,145,145,,,,1235,524,1121,466,6,2,99,48,9,8,58,143,102
E02002687,East Riding of Yorkshire 004,Middle Super Output Areas and Intermediate Zones,MSOAIZ,YO,5724,2759,3523,1541,1615,878,1908,663,53,32,302,189,145,71,157,118,118,,,,1781,957,1686,914,9,4,79,34,7,5,43,65,40
E02002688,East Riding of Yorkshire 005,Middle Super Output Areas and Intermediate Zones,MSOAIZ,YO,5343,2523,2913,1235,1446,739,1467,496,17,7,243,128,52,11,191,117,117,,,,2104,1121,2012,1075,14,8,68,32,10,6,46,66,32
E02002689,East Riding of Yorkshire 006,Middle Super Output Areas and Intermediate Zones,MSOAIZ,YO,5789,2511,4202,1812,2168,1089,2034,723,16,9,461,196,356,155,105,41,41,,,,955,424,828,372,26,10,96,40,5,2,52,155,70
E02002691,East Riding of Yorkshire 008,Middle Super Output Areas and Intermediate Zones,MSOAIZ,YO,8024,3485,6173,2687,2790,1464,3383,1223,5,4,516,211,429,178,87,33,33,,,,1150,483,970,405,94,33,63,36,23,9,78,180,100
E02002692,East Riding of Yorkshire 009,Middle Super Output Areas and Intermediate Zones,MSOAIZ,YO,8133,3384,7022,2877,2930,1450,4092,1427,35,16,359,176,283,146,76,30,30,,,,644,274,582,250,14,4,33,13,15,7,24,73,41
E02002693,East Riding of Yorkshire 010,Middle Super Output Areas and Intermediate Zones,MSOAIZ,YO,6818,2954,5380,2298,2441,1237,2939,1061,1,1,484,224,361,170,123,54,54,,,,846,371,747,325,30,13,49,25,20,8,46,107,60
E02002694,East Riding of Yorkshire 011,Middle Super Output Areas and Intermediate Zones,MSOAIZ,YO,10751,4737,7780,3321,3288,1715,4492,1606,17,9,896,452,697,374,199,78,78,,,,1769,800,1656,742,33,19,65,34,15,5,58,289,155
E02002695,East Riding of Yorkshire 012,Middle Super Output Areas and Intermediate Zones,MSOAIZ,HU,7889,3626,5881,2674,2934,1588,2947,1086,14,8,761,375,514,245,247,130,130,,,,1140,518,1040,469,16,7,78,39,6,3,49,93,51
E02002696,East Riding of Yorkshire 013,Middle Super Output Areas and Intermediate Zones,MSOAIZ,YO,5882,2427,4446,1849,1987,984,2459,865,5,2,230,99,152,70,78,29,29,,,,1091,420,805,327,159,49,27,14,100,30,93,110,57
E02002697,East Riding of Yorkshire 014,Middle Super Output Areas and Intermediate Zones,MSOAIZ,HU,7575,3232,6420,2684,2833,1435,3587,1249,19,11,316,156,214,110,102,46,46,,,,747,340,638,292,17,7,58,25,34,16,48,73,41
E02002698,East Riding of Yorkshire 015,Middle Super Output Areas and Intermediate Zones,MSOAIZ,YO,7528,3253,5865,2455,2244,1168,3621,1287,42,13,617,315,461,245,156,70,70,,,,924,424,817,384,21,4,66,27,20,9,40,80,46
E02002699,East Riding of Yorkshire 016,Middle Super Output Areas and Intermediate Zones,MSOAIZ,HU,9323,3977,8436,3570,3529,1846,4907,1724,20,9,195,83,86,38,109,45,45,,,,611,275,548,243,3,3,58,28,2,1,32,61,40
E02002700,East Riding of Yorkshire 017,Middle Super Output Areas and Intermediate Zones,MSOAIZ,HU,6239,2758,3109,1343,1073,589,2036,754,40,23,2360,1045,2185,959,175,86,86,,,,649,288,585,250,10,4,50,31,4,3,38,81,59
E02002701,East Riding of Yorkshire 018,Middle Super Output Areas and Intermediate Zones,MSOAIZ,YO,8491,3456,7104,2850,3052,1443,4052,1407,26,15,497,194,307,121,190,73,73,,,,726,321,623,275,29,10,63,32,11,4,46,138,76
E02002702,East Riding of Yorkshire 019,Middle Super Output Areas and Intermediate Zones,MSOAIZ,HU,9696,4798,6472,3021,2717,1521,3755,1500,51,32,896,563,471,298,425,265,265,,,,2140,1099,1979,1022,11,5,119,58,31,14,77,137,83
E02002703,East Riding of Yorkshire 020,Middle Super Output Areas and Intermediate Zones,MSOAIZ,HU,8841,3663,7680,3093,2812,1426,4868,1667,21,12,367,183,233,125,134,58,58,,,,712,331,606,278,21,11,66,34,19,8,53,61,44
E02002704,East Riding of Yorkshire 021,Middle Super Output Areas and Intermediate Zones,MSOAIZ,HU,7212,3089,6123,2613,2839,1459,3284,1154,10,5,341,150,295,133,46,17,17,,,,615,263,536,226,7,3,58,27,14,7,37,123,58
E02002705,East Riding of Yorkshire 022,Middle Super Output Areas and Intermediate Zones,MSOAIZ,HU,6253,2765,5390,2366,2786,1441,2604,925,3,2,429,195,393,169,36,26,26,,,,376,170,316,147,11,6,38,12,11,5,23,55,32
E02002706,East Riding of Yorkshire 023,Middle Super Output Areas and Intermediate Zones,MSOAIZ,HU,6785,3010,5685,2469,2410,1292,3275,1177,12,5,385,217,363,207,22,10,10,,,,660,299,603,274,3,2,45,20,9,3,25,43,20
E02002707,East Riding of Yorkshire 024,Middle Super Output Areas and Intermediate Zones,MSOAIZ,YO,6839,2881,5935,2471,2525,1278,3410,1193,15,6,266,123,233,110,33,13,13,,,,560,244,475,214,25,6,41,17,19,7,30,63,37
E02002708,East Riding of Yorkshire 025,Middle Super Output Areas and Intermediate Zones,MSOAIZ,HU,5845,2886,4391,2053,2157,1244,2234,809,19,9,676,436,621,404,55,32,32,,,,686,337,616,301,7,3,49,29,14,4,36,73,51
E02002709,East Riding of Yorkshire 026,Middle Super Output Areas and Intermediate Zones,MSOAIZ,YO,7498,3203,6078,2547,2467,1249,3611,1298,29,13,541,261,352,175,189,86,86,,,,768,332,674,285,21,11,70,34,3,2,47,82,50
E02002710,East Riding of Yorkshire 027,Middle Super Output Areas and Intermediate Zones,MSOAIZ,HU,7489,3106,6427,2624,2369,1259,4058,1365,5,2,374,183,346,168,28,15,15,,,,619,263,590,251,4,2,24,9,1,1,12,64,34
E02002711,East Riding of Yorkshire 028,Middle Super Output Areas and Intermediate Zones,MSOAIZ,HU,7443,3172,6989,2957,3344,1714,3645,1243,5,3,53,25,42,20,11,5,5,,,,359,164,316,144,0,0,38,16,5,4,20,37,23
E02002712,East Riding of Yorkshire 029,Middle Super Output Areas and Intermediate Zones,MSOAIZ,HU,7348,3257,6033,2599,2521,1301,3512,1298,13,5,312,172,284,153,28,19,19,,,,925,443,839,398,5,2,70,37,11,6,45,65,38
E02002714,East Riding of Yorkshire 031,Middle Super Output Areas and Intermediate Zones,MSOAIZ,HU,7617,3264,6135,2596,2673,1350,3462,1246,21,6,386,197,341,179,45,18,18,,,,944,397,810,336,16,7,87,40,31,14,61,131,68
E02002715,East Riding of Yorkshire 032,Middle Super Output Areas and Intermediate Zones,MSOAIZ,HU,12403,5106,10538,4205,3234,1634,7304,2571,32,14,373,193,325,176,48,17,17,,,,1360,636,1273,596,9,4,67,33,11,3,40,100,58
E02002716,East Riding of Yorkshire 033,Middle Super Output Areas and Intermediate Zones,MSOAIZ,HU,8534,3604,7006,2900,2579,1320,4427,1580,16,6,601,293,344,193,257,100,100,,,,841,353,750,314,1,1,83,36,7,2,39,70,52
E02002717,East Riding of Yorkshire 034,Middle Super Output Areas and Intermediate Zones,MSOAIZ,HU,7574,3460,5241,2249,1820,995,3421,1254,24,11,971,546,878,470,93,76,76,,,,1291,616,1177,566,12,4,100,45,2,1,50,47,38
E02002718,East Riding of Yorkshire 035,Middle Super Output Areas and Intermediate Zones,MSOAIZ,HU,7772,3283,6968,2905,3102,1576,3866,1329,7,5,187,106,150,76,37,30,30,,,,555,238,533,225,0,0,22,13,0,0,13,55,29
E02002719,East Riding of Yorkshire 036,Middle Super Output Areas and Intermediate Zones,MSOAIZ,HU,5622,2363,4762,1942,1850,946,2912,996,14,5,254,146,233,131,21,15,15,,,,559,252,524,234,10,3,22,13,3,2,18,33,18
E02002720,East Riding of Yorkshire 037,Middle Super Output Areas and Intermediate Zones,MSOAIZ,YO,6876,2900,6005,2496,2380,1228,3625,1268,4,2,129,48,127,47,2,1,1,,,,690,330,625,301,9,4,47,20,9,5,29,48,24
E02002721,East Riding of Yorkshire 038,Middle Super Output Areas and Intermediate Zones,MSOAIZ,HU,6310,2739,4700,1936,1935,956,2765,980,22,17,783,410,525,289,258,121,121,,,,722,322,672,299,3,2,40,18,7,3,23,83,54
E02002722,East Riding of Yorkshire 039,Middle Super Output Areas and Intermediate Zones,MSOAIZ,HU,8513,3766,5365,2319,2480,1290,2885,1029,13,10,1450,681,1322,595,128,86,86,,,,1542,670,1343,592,32,14,140,53,27,11,78,143,86
E02002723,East Riding of Yorkshire 040,Middle Super Output Areas and Intermediate Zones,MSOAIZ,DN,8260,3559,5452,2347,2434,1241,3018,1106,16,9,505,282,390,206,115,76,76,,,,2210,869,2096,822,25,6,75,36,14,5,47,77,52
E02002724,East Riding of Yorkshire 041,Middle Super Output Areas and Intermediate Zones,MSOAIZ,DN,8770,3811,4809,1989,1633,868,3176,1121,19,8,1986,964,1846,893,140,71,71,,,,1849,781,1756,738,7,5,78,34,8,4,43,107,69
E02002725,East Riding of Yorkshire 042,Middle Super Output Areas and Intermediate Zones,MSOAIZ,DN,6513,2740,5330,2142,2074,1023,3256,1119,28,13,578,296,496,255,82,41,41,,,,519,250,478,231,4,2,32,15,5,2,19,58,39
E02002726,North East Lincolnshire 001,Middle Super Output Areas and Intermediate Zones,MSOAIZ,DN,10185,4427,6880,2940,2604,1366,4276,1574,12,5,1941,919,767,329,1174,590,590,,,,1284,526,1153,476,11,2,110,44,10,4,50,68,37
E02002727,North East Lincolnshire 002,Middle Super Output Areas and Intermediate Zones,MSOAIZ,DN,5857,3297,1307,566,428,228,879,338,35,16,3042,1990,1055,610,1987,1380,1380,,,,1397,670,1324,625,2,2,37,19,34,24,45,76,55
E02002728,North East Lincolnshire 003,Middle Super Output Areas and Intermediate Zones,MSOAIZ,DN,7754,3681,3830,1748,1237,693,2593,1055,10,4,884,491,291,143,593,348,348,,,,2961,1396,2833,1329,8,3,106,56,14,8,67,69,42
E02002729,North East Lincolnshire 004,Middle Super Output Areas and Intermediate Zones,MSOAIZ,DN,5911,2578,4303,1734,1353,676,2950,1058,37,15,947,570,410,226,537,344,344,,,,578,235,528,211,2,2,46,20,2,2,24,46,24
E02002730,North East Lincolnshire 005,Middle Super Output Areas and Intermediate Zones,MSOAIZ,DN,7598,3203,3911,1664,1156,626,2755,1038,11,7,326,169,53,25,273,144,144,,,,3309,1342,3153,1275,7,2,142,61,7,4,67,41,21
E02002731,North East Lincolnshire 006,Middle Super Output Areas and Intermediate Zones,MSOAIZ,DN,5941,2497,2901,1209,964,476,1937,733,17,8,711,328,249,98,462,230,230,,,,2281,933,2161,883,6,2,101,44,13,4,50,31,19
E02002732,North East Lincolnshire 007,Middle Super Output Areas and Intermediate Zones,MSOAIZ,DN,7518,3093,6544,2634,2364,1218,4180,1416,8,4,279,160,90,49,189,111,111,,,,619,262,565,237,8,3,42,19,4,3,25,68,33
E02002733,North East Lincolnshire 008,Middle Super Output Areas and Intermediate Zones,MSOAIZ,DN,5934,2802,3959,1776,1394,763,2565,1013,9,3,449,293,104,40,345,253,253,,,,1470,702,1342,644,14,6,112,50,2,2,58,47,28
E02002734,North East Lincolnshire 009,Middle Super Output Areas and Intermediate Zones,MSOAIZ,DN,5038,2233,3651,1630,1348,734,2303,896,33,12,564,258,241,101,323,157,157,,,,763,321,692,288,0,0,64,31,7,2,33,27,12
E02002735,North East Lincolnshire 010,Middle Super Output Areas and Intermediate Zones,MSOAIZ,DN,5185,2281,3441,1489,1101,601,2340,888,1,1,203,81,39,13,164,68,68,,,,1490,681,1375,632,10,4,95,41,10,4,49,50,29
E02002736,North East Lincolnshire 011,Middle Super Output Areas and Intermediate Zones,MSOAIZ,DN,5866,2451,2960,1222,860,460,2100,762,23,8,382,198,62,28,320,170,170,,,,2467,1003,2343,948,5,2,114,49,5,4,55,34,20
E02002737,North East Lincolnshire 012,Middle Super Output Areas and Intermediate Zones,MSOAIZ,DN,7294,3098,5827,2475,2062,1098,3765,1377,34,17,407,184,182,76,225,108,108,,,,981,398,879,356,4,2,87,36,11,4,42,45,24
E02002738,North East Lincolnshire 013,Middle Super Output Areas and Intermediate Zones,MSOAIZ,DN,7161,3024,5619,2406,1943,1018,3676,1388,16,6,700,275,378,143,322,132,132,,,,796,318,718,283,5,3,63,28,10,4,35,30,19
E02002739,North East Lincolnshire 014,Middle Super Output Areas and Intermediate Zones,MSOAIZ,DN,5952,2876,3768,1761,1364,795,2404,966,1,1,660,407,208,115,452,292,292,,,,1459,663,1379,618,2,1,76,42,2,2,45,64,44
E02002740,North East Lincolnshire 015,Middle Super Output Areas and Intermediate Zones,MSOAIZ,DN,5559,2438,3276,1437,1240,694,2036,743,16,10,1539,687,690,268,849,419,419,,,,663,269,585,237,3,1,63,27,12,4,32,65,35
E02002741,North East Lincolnshire 016,Middle Super Output Areas and Intermediate Zones,MSOAIZ,DN,8810,3693,6535,2741,2399,1266,4136,1475,18,7,294,137,94,42,200,95,95,,,,1871,756,1614,646,112,42,85,41,60,27,110,92,52
E02002742,North East Lincolnshire 017,Middle Super Output Areas and Intermediate Zones,MSOAIZ,DN,5597,2494,4535,1938,1971,1062,2564,876,7,5,72,43,18,8,54,35,35,,,,951,489,877,453,4,3,60,30,10,3,36,32,19
E02002743,North East Lincolnshire 018,Middle Super Output Areas and Intermediate Zones,MSOAIZ,DN,5460,2665,3811,1705,1769,959,2042,746,27,17,1129,694,376,204,753,490,490,,,,447,214,402,191,0,0,41,21,4,2,23,46,35
E02002744,North East Lincolnshire 019,Middle Super Output Areas and Intermediate Zones,MSOAIZ,DN,7082,2837,2612,1064,788,420,1824,644,16,9,3634,1442,1602,597,2032,845,845,,,,777,292,747,278,0,0,27,12,3,2,14,43,30
E02002745,North East Lincolnshire 020,Middle Super Output Areas and Intermediate Zones,MSOAIZ,DN,7528,3406,6672,2994,3131,1731,3541,1263,32,14,191,107,60,25,131,82,82,,,,579,261,482,207,14,9,59,30,24,15,54,54,30
E02002746,North East Lincolnshire 021,Middle Super Output Areas and Intermediate Zones,MSOAIZ,DN,8742,3779,7272,3056,2694,1482,4578,1574,63,32,482,312,104,75,378,237,237,,,,866,341,761,289,10,6,92,44,3,2,52,59,38
E02002747,North East Lincolnshire 022,Middle Super Output Areas and Intermediate Zones,MSOAIZ,DN,7945,3409,7194,3041,3000,1604,4194,1437,13,6,184,108,46,21,138,87,87,,,,525,235,460,208,7,3,54,22,4,2,27,29,19
E02002748,North East Lincolnshire 023,Middle Super Output Areas and Intermediate Zones,MSOAIZ,LN,7869,3445,6666,2840,2925,1527,3741,1313,10,6,370,238,95,57,275,181,181,,,,743,320,661,280,19,8,52,25,11,7,40,80,41
E02002749,North Lincolnshire 001,Middle Super Output Areas and Intermediate Zones,MSOAIZ,DN,10963,4816,7828,3377,3083,1629,4745,1748,37,17,1447,669,665,288,782,381,381,,,,1557,697,1414,625,18,7,99,53,26,12,72,94,56
E02002750,North Lincolnshire 002,Middle Super Output Areas and Intermediate Zones,MSOAIZ,DN,6206,2636,5010,2071,1888,957,3122,1114,13,5,403,210,138,75,265,135,135,,,,714,311,674,293,3,1,34,14,3,3,18,66,39
E02002751,North Lincolnshire 003,Middle Super Output Areas and Intermediate Zones,MSOAIZ,DN,6430,2667,4812,1995,1948,988,2864,1007,10,5,799,342,353,139,446,203,203,,,,756,295,643,246,14,6,93,37,6,6,49,53,30
E02002752,North Lincolnshire 004,Middle Super Output Areas and Intermediate Zones,MSOAIZ,DN,6786,2935,5075,2140,1910,974,3165,1166,7,3,702,350,284,134,418,216,216,,,,943,408,803,352,29,14,97,38,14,4,56,59,34
E02002753,North Lincolnshire 005,Middle Super Output Areas and Intermediate Zones,MSOAIZ,DN,8602,3956,6592,2983,2897,1591,3695,1392,21,12,739,347,263,113,476,234,234,,,,1128,553,1035,509,15,8,64,29,14,7,44,122,61
E02002754,North Lincolnshire 006,Middle Super Output Areas and Intermediate Zones,MSOAIZ,DN,8240,3465,6246,2551,2176,1098,4070,1453,27,13,897,457,454,212,443,245,245,,,,994,404,880,358,16,4,73,35,25,7,46,76,40
E02002755,North Lincolnshire 007,Middle Super Output Areas and Intermediate Zones,MSOAIZ,DN,6901,2907,4015,1599,1319,638,2696,961,18,8,1225,695,514,261,711,434,434,,,,1570,568,1481,530,13,3,57,25,19,10,38,73,37
E02002756,North Lincolnshire 008,Middle Super Output Areas and Intermediate Zones,MSOAIZ,DN,8436,3277,3038,1150,1070,499,1968,651,27,14,2571,1011,1442,514,1129,497,497,,,,2681,1042,2565,996,18,6,77,32,21,8,46,119,60
E02002757,North Lincolnshire 009,Middle Super Output Areas and Intermediate Zones,MSOAIZ,DN,6188,2518,4750,1962,1918,990,2832,972,4,2,384,148,179,71,205,77,77,,,,1015,388,915,341,22,14,58,24,20,9,47,35,18
E02002758,North Lincolnshire 010,Middle Super Output Areas and Intermediate Zones,MSOAIZ,DN,6347,2715,3972,1628,1255,657,2717,971,14,8,1166,608,519,238,647,370,370,,,,1129,436,1047,405,10,3,70,26,2,2,31,66,35
E02002759,North Lincolnshire 011,Middle Super Output Areas and Intermediate Zones,MSOAIZ,DN,9437,4151,6790,2890,2850,1502,3940,1388,20,8,1115,579,419,199,696,380,380,,,,1371,602,1232,536,21,12,108,49,10,5,66,141,72
E02002760,North Lincolnshire 012,Middle Super Output Areas and Intermediate Zones,MSOAIZ,DN,5773,2493,4283,1761,1612,822,2671,939,4,3,956,511,480,234,476,277,277,,,,468,185,410,162,6,2,42,16,10,5,23,62,33
E02002761,North Lincolnshire 013,Middle Super Output Areas and Intermediate Zones,MSOAIZ,DN,6610,2834,5214,2175,1970,1000,3244,1175,8,5,353,215,107,67,246,148,148,,,,957,398,862,352,23,8,65,34,7,4,46,78,41
E02002762,North Lincolnshire 014,Middle Super Output Areas and Intermediate Zones,MSOAIZ,DN,6626,2879,4098,1696,1296,706,2802,990,16,6,1539,773,761,369,778,404,404,,,,914,361,814,322,1,1,91,33,8,5,39,59,43
E02002763,North Lincolnshire 015,Middle Super Output Areas and Intermediate Zones,MSOAIZ,DN,7281,3164,3874,1623,1062,569,2812,1054,16,7,2337,1078,1200,521,1137,557,557,,,,951,397,808,340,4,1,129,51,10,5,57,103,59
E02002764,North Lincolnshire 016,Middle Super Output Areas and Intermediate Zones,MSOAIZ,DN,5820,2289,2841,1152,1019,518,1822,634,16,7,2305,894,1435,514,870,380,380,,,,578,199,531,181,5,1,36,15,6,2,18,80,37
E02002765,North Lincolnshire 017,Middle Super Output Areas and Intermediate Zones,MSOAIZ,DN,6307,2711,4084,1746,1483,819,2601,927,0,0,1246,545,660,260,586,285,285,,,,928,392,818,340,8,4,98,46,4,2,52,49,28
E02002766,North Lincolnshire 018,Middle Super Output Areas and Intermediate Zones,MSOAIZ,DN,9105,3804,6996,2967,2683,1418,4313,1549,31,15,951,366,484,183,467,183,183,,,,1052,414,983,383,0,0,67,29,2,2,31,75,42
E02002767,North Lincolnshire 019,Middle Super Output Areas and Intermediate Zones,MSOAIZ,DN,6788,2967,6020,2619,2474,1320,3546,1299,23,8,94,59,32,14,62,45,45,,,,621,260,571,238,0,0,48,21,2,1,22,30,21
E02002768,North Lincolnshire 020,Middle Super Output Areas and Intermediate Zones,MSOAIZ,DN,7243,3095,5918,2454,2422,1224,3496,1230,24,13,543,292,237,129,306,163,163,,,,678,288,601,254,15,5,56,26,6,3,34,80,48
E02002769,North Lincolnshire 021,Middle Super Output Areas and Intermediate Zones,MSOAIZ,DN,5835,2539,4837,2053,2164,1121,2673,932,9,5,313,185,138,74,175,111,111,,,,561,236,482,203,29,11,42,19,8,3,33,115,60
E02002770,North Lincolnshire 022,Middle Super Output Areas and Intermediate Zones,MSOAIZ,LN,6853,2899,5050,2094,2049,1038,3001,1056,18,9,647,308,267,126,380,182,182,,,,1065,443,822,357,163,51,34,19,46,16,86,73,45
E02002771,North Lincolnshire 023,Middle Super Output Areas and Intermediate Zones,MSOAIZ,DN,7094,2967,5963,2451,2597,1277,3366,1174,14,6,522,253,259,117,263,136,136,,,,501,200,424,170,13,7,58,21,6,2,30,94,57
E02002772,York 001,Middle Super Output Areas and Intermediate Zones,MSOAIZ,YO,6772,2673,5429,2145,1900,959,3529,1186,14,8,364,164,50,19,314,145,145,,,,932,338,454,183,267,81,35,15,176,59,155,33,18
E02002773,York 002,Middle Super Output Areas and Intermediate Zones,MSOAIZ,YO,5699,2624,4921,2223,2356,1288,2565,935,21,10,373,211,49,26,324,185,185,,,,337,152,303,134,4,1,28,15,2,2,18,47,28
E02002774,York 003,Middle Super Output Areas and Intermediate Zones,MSOAIZ,YO,6184,2646,5675,2420,2459,1308,3216,1112,16,7,66,27,32,11,34,16,16,,,,384,165,346,145,4,3,34,17,0,0,20,43,27
E02002775,York 004,Middle Super Output Areas and Intermediate Zones,MSOAIZ,YO,5543,2565,3304,1505,1762,956,1542,549,202,106,1736,816,57,29,1679,787,787,,,,272,122,239,108,1,1,24,9,8,4,14,29,16
E02002776,York 005,Middle Super Output Areas and Intermediate Zones,MSOAIZ,YO,6455,2864,5203,2310,2401,1298,2802,1012,82,38,587,260,34,16,553,244,244,,,,561,241,494,213,8,3,54,23,5,2,28,22,15
E02002777,York 006,Middle Super Output Areas and Intermediate Zones,MSOAIZ,YO,8272,3451,6503,2699,2092,1065,4411,1634,38,14,868,360,100,35,768,325,325,,,,810,348,742,320,5,2,56,24,7,2,28,53,30
E02002778,York 007,Middle Super Output Areas and Intermediate Zones,MSOAIZ,YO,7952,3619,6251,2810,2749,1488,3502,1322,31,14,336,179,120,53,216,126,126,,,,1247,579,1185,546,0,0,50,28,12,5,33,87,37
E02002779,York 008,Middle Super Output Areas and Intermediate Zones,MSOAIZ,YO,9440,4177,7366,3228,3617,1897,3749,1331,26,13,799,401,605,310,194,91,91,,,,1152,485,1064,441,5,3,77,37,6,4,44,97,50
E02002780,York 009,Middle Super Output Areas and Intermediate Zones,MSOAIZ,YO,8236,3493,3481,1618,1184,686,2297,932,51,26,2413,998,1987,795,426,203,203,,,,2189,802,2052,743,7,4,102,44,28,11,59,102,49
E02002781,York 010,Middle Super Output Areas and Intermediate Zones,MSOAIZ,YO,9485,4161,3732,1800,1382,809,2350,991,103,57,1902,833,1466,642,436,191,191,,,,3646,1413,3512,1356,9,3,110,46,15,8,57,102,58
E02002782,York 011,Middle Super Output Areas and Intermediate Zones,MSOAIZ,YO,6013,2491,5194,2133,2471,1244,2723,889,28,17,292,125,231,96,61,29,29,,,,434,178,351,148,25,9,51,18,7,3,30,65,38
E02002783,York 012,Middle Super Output Areas and Intermediate Zones,MSOAIZ,YO,10063,4152,7639,3154,2701,1442,4938,1712,88,41,1417,544,1051,383,366,161,161,,,,864,376,776,337,11,3,61,30,16,6,39,55,37
E02002784,York 013,Middle Super Output Areas and Intermediate Zones,MSOAIZ,YO,9834,5511,2798,1576,1367,849,1431,727,82,59,2189,1418,1584,982,605,436,436,,,,4524,2317,4290,2189,28,17,97,51,109,60,128,241,141
E02002785,York 014,Middle Super Output Areas and Intermediate Zones,MSOAIZ,YO,6783,2762,5016,2225,2355,1280,2661,945,22,7,264,125,82,29,182,96,96,,,,1437,382,1359,352,13,5,59,22,6,3,30,44,23
E02002786,York 015,Middle Super Output Areas and Intermediate Zones,MSOAIZ,YO,10650,3996,3718,1653,1392,748,2326,905,71,21,2473,982,2262,896,211,86,86,,,,4307,1294,4078,1219,13,3,214,71,2,1,75,81,46
E02002787,York 016,Middle Super Output Areas and Intermediate Zones,MSOAIZ,YO,8998,4276,5991,2751,2341,1316,3650,1435,62,31,1535,795,1197,632,338,163,163,,,,1330,649,1202,588,17,6,99,47,12,8,61,80,50
E02002788,York 017,Middle Super Output Areas and Intermediate Zones,MSOAIZ,YO,8754,4053,5588,2518,2072,1111,3516,1407,28,13,453,244,186,116,267,128,128,,,,2586,1233,2448,1168,10,9,116,51,12,5,65,99,45
E02002789,York 018,Middle Super Output Areas and Intermediate Zones,MSOAIZ,YO,8766,3830,4555,1979,1491,823,3064,1156,54,18,3382,1496,2796,1254,586,242,242,,,,694,282,612,247,3,1,67,28,12,6,35,81,55
E02002790,York 019,Middle Super Output Areas and Intermediate Zones,MSOAIZ,YO,10798,4743,4898,2280,2162,1201,2736,1079,92,53,948,529,561,312,387,217,217,,,,4701,1786,4119,1581,265,75,140,69,177,61,205,159,95
E02002791,York 020,Middle Super Output Areas and Intermediate Zones,MSOAIZ,YO,6428,2627,5574,2254,2451,1230,3123,1024,19,11,277,136,188,99,89,37,37,,,,499,190,463,174,2,1,21,8,13,7,16,59,36
E02002792,York 021,Middle Super Output Areas and Intermediate Zones,MSOAIZ,YO,6990,3130,5048,2245,2153,1121,2895,1124,11,5,257,126,21,10,236,116,116,,,,1624,727,1539,689,11,4,68,31,6,3,38,50,27
E02002793,York 022,Middle Super Output Areas and Intermediate Zones,MSOAIZ,YO,9164,4072,6983,3121,2927,1585,4056,1536,70,32,1324,578,798,399,526,179,179,,,,722,297,645,258,6,3,56,30,15,6,39,65,44
E02002794,York 023,Middle Super Output Areas and Intermediate Zones,MSOAIZ,YO,5045,2173,3479,1518,1714,896,1765,622,37,20,369,196,235,133,134,63,63,,,,1061,399,932,351,18,6,41,17,70,25,48,99,40
E02002795,York 024,Middle Super Output Areas and Intermediate Zones,MSOAIZ,YO,8068,3463,7188,3062,3373,1751,3815,1311,26,10,280,136,187,104,93,32,32,,,,531,225,477,197,4,2,40,22,10,4,28,43,30
E02002796,Derby 001,Middle Super Output Areas and Intermediate Zones,MSOAIZ,DE,6135,2585,5436,2261,2476,1286,2960,975,36,30,190,88,178,83,12,5,5,,,,452,189,412,168,0,0,36,19,4,2,21,21,17
E02002797,Derby 002,Middle Super Output Areas and Intermediate Zones,MSOAIZ,DE,7486,3371,6772,3044,3500,1944,3272,1100,8,3,83,28,36,11,47,17,17,,,,588,272,537,248,3,2,40,18,8,4,24,35,24
E02002798,Derby 003,Middle Super Output Areas and Intermediate Zones,MSOAIZ,DE,10090,4187,8701,3530,2573,1272,6128,2258,24,10,114,50,45,18,69,32,32,,,,1208,572,1106,525,7,4,86,38,9,5,47,43,25
E02002799,Derby 004,Middle Super Output Areas and Intermediate Zones,MSOAIZ,DE,5992,2451,3396,1434,1139,614,2257,820,50,18,1724,668,1398,547,326,121,121,,,,760,305,696,275,3,1,57,28,4,1,30,62,26
E02002800,Derby 005,Middle Super Output Areas and Intermediate Zones,MSOAIZ,DE,6969,3136,4995,2111,1904,1010,3091,1101,41,25,535,384,166,113,369,271,271,,,,1345,586,1292,558,0,0,43,21,10,7,28,53,30
E02002801,Derby 006,Middle Super Output Areas and Intermediate Zones,MSOAIZ,DE,7602,3160,5715,2340,2127,1108,3588,1232,6,4,1120,486,983,410,137,76,76,,,,690,290,599,253,0,0,85,34,6,3,37,71,40
E02002802,Derby 007,Middle Super Output Areas and Intermediate Zones,MSOAIZ,DE,7921,3256,3389,1434,1138,613,2251,821,20,11,3592,1422,3304,1303,288,119,119,,,,829,335,742,303,0,0,73,27,14,5,32,91,54
E02002803,Derby 008,Middle Super Output Areas and Intermediate Zones,MSOAIZ,DE,6474,3492,2157,1151,724,458,1433,693,181,114,1677,1065,931,588,746,477,477,,,,2409,1126,2303,1070,4,3,81,42,21,11,56,50,36
E02002804,Derby 009,Middle Super Output Areas and Intermediate Zones,MSOAIZ,DE,7628,3243,4669,1992,1803,994,2866,998,11,5,2325,980,2074,878,251,102,102,,,,550,210,451,175,0,0,91,33,8,2,35,73,56
E02002805,Derby 010,Middle Super Output Areas and Intermediate Zones,MSOAIZ,DE,5668,2575,5035,2257,2414,1306,2621,951,22,14,148,93,72,42,76,51,51,,,,424,189,382,167,2,1,40,21,0,0,22,39,22
E02002806,Derby 011,Middle Super Output Areas and Intermediate Zones,MSOAIZ,DE,6189,2839,2043,998,744,422,1299,576,38,21,1414,674,737,332,677,342,342,,,,2630,1109,2510,1056,11,3,100,43,9,7,53,64,37
E02002807,Derby 012,Middle Super Output Areas and Intermediate Zones,MSOAIZ,DE,8978,3737,6540,2671,2417,1262,4123,1409,35,10,1558,710,1416,644,142,66,66,,,,779,304,691,267,5,1,77,34,6,2,37,66,42
E02002808,Derby 013,Middle Super Output Areas and Intermediate Zones,MSOAIZ,DE,11255,5590,2930,1431,1040,592,1890,839,177,103,2752,1601,916,500,1836,1101,1101,,,,5293,2397,5030,2271,27,12,203,90,33,24,126,103,58
E02002809,Derby 014,Middle Super Output Areas and Intermediate Zones,MSOAIZ,DE,6599,2830,4599,1947,1710,925,2889,1022,67,34,1222,540,928,392,294,148,148,,,,666,283,584,244,8,2,71,34,3,3,39,45,26
E02002810,Derby 015,Middle Super Output Areas and Intermediate Zones,MSOAIZ,DE,8180,3457,7039,3013,3194,1690,3845,1323,61,27,344,116,44,16,300,100,100,,,,691,276,636,251,5,1,43,21,7,3,25,45,25
E02002811,Derby 016,Middle Super Output Areas and Intermediate Zones,MSOAIZ,DE,9843,3684,4881,1459,2140,720,2741,739,32,13,1458,815,502,282,956,533,533,,,,3280,1319,3089,1250,20,6,117,41,54,22,69,192,78
E02002812,Derby 017,Middle Super Output Areas and Intermediate Zones,MSOAIZ,DE,6735,2722,4929,1870,1978,962,2951,908,20,8,863,426,574,279,289,147,147,,,,862,387,787,353,24,11,42,20,9,3,34,61,31
E02002813,Derby 018,Middle Super Output Areas and Intermediate Zones,MSOAIZ,DE,10164,3819,4569,1244,2512,718,2057,526,109,42,2404,1215,826,449,1578,766,766,,,,2814,1209,2688,1164,4,2,70,24,52,19,45,268,109
E02002814,Derby 019,Middle Super Output Areas and Intermediate Zones,MSOAIZ,DE,7285,3273,6236,2719,2799,1507,3437,1212,9,4,306,214,153,102,153,112,112,,,,667,296,595,262,10,4,53,26,9,4,34,67,40
E02002815,Derby 020,Middle Super Output Areas and Intermediate Zones,MSOAIZ,DE,7630,2520,4784,1487,2169,781,2615,706,30,12,726,298,164,60,562,238,238,,,,1974,682,1835,634,3,1,115,39,21,8,48,116,41
E02002816,Derby 021,Middle Super Output Areas and Intermediate Zones,MSOAIZ,DE,9357,3377,7465,2549,2531,1056,4934,1493,130,69,743,340,60,25,683,315,315,,,,965,394,895,367,22,7,36,17,12,3,27,54,25
E02002817,Derby 022,Middle Super Output Areas and Intermediate Zones,MSOAIZ,DE,6248,2377,5363,2031,2452,1150,2911,881,3,2,286,130,268,122,18,8,8,,,,566,198,495,166,6,2,63,29,2,1,32,30,16
E02002818,Derby 023,Middle Super Output Areas and Intermediate Zones,MSOAIZ,DE,7469,2852,3545,1343,1261,610,2284,733,28,12,2527,998,1965,727,562,271,271,,,,1288,464,1206,433,0,0,61,24,21,7,31,81,35
E02002819,Derby 024,Middle Super Output Areas and Intermediate Zones,MSOAIZ,DE,7241,3452,4498,2078,1500,848,2998,1230,113,68,1096,541,581,328,515,213,213,,,,1486,734,1362,679,5,3,100,41,19,11,55,48,31
E02002820,Derby 025,Middle Super Output Areas and Intermediate Zones,MSOAIZ,DE,9694,4043,5572,2348,1721,942,3851,1406,24,11,2113,875,1739,701,374,174,174,,,,1865,754,1716,693,8,3,132,53,9,5,61,120,55
E02002821,Derby 026,Middle Super Output Areas and Intermediate Zones,MSOAIZ,DE,10965,4340,4011,1620,1251,640,2760,980,53,26,4947,1866,4016,1416,931,450,450,,,,1846,776,1728,719,2,1,99,43,17,13,57,108,52
E02002822,Derby 027,Middle Super Output Areas and Intermediate Zones,MSOAIZ,DE,6708,2748,4740,1883,1961,954,2779,929,71,34,1203,540,703,329,500,211,211,,,,661,273,612,250,1,1,44,19,4,3,23,33,18
E02002823,Derby 028,Middle Super Output Areas and Intermediate Zones,MSOAIZ,DE,7424,3236,5011,2151,2079,1107,2932,1044,21,7,1767,797,893,449,874,348,348,,,,580,246,494,211,0,0,72,28,14,7,35,45,35
E02002824,Derby 029,Middle Super Output Areas and Intermediate Zones,MSOAIZ,DE,9618,3716,5101,1920,1752,816,3349,1104,77,27,3305,1332,2300,889,1005,443,443,,,,1044,391,949,353,6,2,86,33,3,3,38,91,46
E02002825,Derby 030,Middle Super Output Areas and Intermediate Zones,MSOAIZ,DE,8427,3557,6394,2535,2112,1101,4282,1434,141,72,900,524,510,276,390,248,248,,,,915,377,844,343,1,1,58,29,12,4,34,77,49
E02002826,Derby 031,Middle Super Output Areas and Intermediate Zones,MSOAIZ,DE,6651,2646,4958,1914,1601,831,3357,1083,65,28,1000,434,266,147,734,287,287,,,,599,250,562,235,4,1,32,13,1,1,15,29,20
E02002827,Leicester 001,Middle Super Output Areas and Intermediate Zones,MSOAIZ,LE,6398,2550,3744,1495,1014,476,2730,1019,42,20,1919,737,1562,600,357,137,137,,,,652,279,628,266,5,2,18,10,1,1,13,41,19
E02002828,Leicester 002,Middle Super Output Areas and Intermediate Zones,MSOAIZ,LE,7563,2804,6083,2233,2518,1062,3565,1171,33,12,220,95,62,23,158,72,72,,,,1170,439,1070,394,1,1,79,38,20,6,45,57,25
E02002829,Leicester 003,Middle Super Output Areas and Intermediate Zones,MSOAIZ,LE,10494,4340,4325,1752,1330,689,2995,1063,24,14,4650,1975,3807,1623,843,352,352,,,,1347,515,1203,458,25,7,95,41,24,9,57,148,84
E02002830,Leicester 004,Middle Super Output Areas and Intermediate Zones,MSOAIZ,LE,9984,3909,4328,1616,1091,491,3237,1125,41,17,4286,1758,2694,1070,1592,688,688,,,,1227,475,1082,415,51,22,50,23,44,15,60,102,43
E02002831,Leicester 005,Middle Super Output Areas and Intermediate Zones,MSOAIZ,LE,6755,2340,4983,1685,2170,870,2813,815,17,5,375,184,264,139,111,45,45,,,,1312,429,1241,400,1,1,56,21,14,7,29,68,37
E02002832,Leicester 006,Middle Super Output Areas and Intermediate Zones,MSOAIZ,LE,7943,2803,4365,1458,2276,853,2089,605,26,11,1362,624,419,231,943,393,393,,,,2041,651,1878,585,8,4,87,39,68,23,66,149,59
E02002833,Leicester 007,Middle Super Output Areas and Intermediate Zones,MSOAIZ,LE,8149,2609,4401,1379,2028,744,2373,635,12,5,1884,633,206,65,1678,568,568,,,,1769,555,1630,507,4,2,98,32,37,14,48,83,37
E02002834,Leicester 008,Middle Super Output Areas and Intermediate Zones,MSOAIZ,LE,9731,3975,6976,2783,2864,1393,4112,1390,167,83,499,239,149,48,350,191,191,,,,2020,838,1908,785,3,2,102,45,7,6,53,69,32
E02002835,Leicester 009,Middle Super Output Areas and Intermediate Zones,MSOAIZ,LE,12533,4369,8427,2840,2077,828,6350,2012,192,93,1346,472,258,110,1088,362,362,,,,2508,940,2393,894,7,2,88,35,20,9,46,60,24
E02002836,Leicester 010,Middle Super Output Areas and Intermediate Zones,MSOAIZ,LE,9319,3131,5137,1611,2381,888,2756,723,36,14,1820,788,798,405,1022,383,383,,,,2190,665,2054,621,4,1,118,37,14,6,44,136,53
E02002837,Leicester 011,Middle Super Output Areas and Intermediate Zones,MSOAIZ,LE,7409,2624,3008,1032,947,405,2061,627,22,7,2859,1053,2572,955,287,98,98,,,,1440,496,1349,463,0,0,72,26,19,7,33,80,36
E02002838,Leicester 012,Middle Super Output Areas and Intermediate Zones,MSOAIZ,LE,7666,3093,2753,1094,915,453,1838,641,60,28,4096,1679,3742,1526,354,153,153,,,,664,242,623,227,2,1,33,13,6,1,15,93,50
E02002839,Leicester 013,Middle Super Output Areas and Intermediate Zones,MSOAIZ,LE,7576,2911,5248,1874,1761,821,3487,1053,72,26,1381,691,1132,590,249,101,101,,,,802,272,694,233,0,0,71,27,37,12,39,73,48
E02002842,Leicester 016,Middle Super Output Areas and Intermediate Zones,MSOAIZ,LE,7628,3418,2398,1205,826,454,1572,751,73,33,1234,524,470,223,764,301,301,,,,3803,1587,3653,1517,8,3,108,53,34,14,70,120,69
E02002843,Leicester 017,Middle Super Output Areas and Intermediate Zones,MSOAIZ,LE,12961,3843,5928,1634,3055,904,2873,730,49,16,2454,911,839,396,1615,515,515,,,,4325,1206,4141,1151,27,9,93,27,64,19,55,205,76
E02002844,Leicester 018,Middle Super Output Areas and Intermediate Zones,MSOAIZ,LE,11927,3775,3130,786,1800,481,1330,305,43,13,6809,2424,5477,1947,1332,477,477,,,,1688,448,1538,402,11,3,53,19,86,24,46,257,104
E02002845,Leicester 019,Middle Super Output Areas and Intermediate Zones,MSOAIZ,LE,10230,3933,5345,1805,1831,764,3514,1041,87,32,2703,1356,2100,1066,603,290,290,,,,1937,646,1561,518,208,66,93,35,75,27,128,158,94
E02002846,Leicester 020,Middle Super Output Areas and Intermediate Zones,MSOAIZ,LE,7301,3028,5960,2422,2299,1132,3661,1290,10,4,284,134,233,108,51,26,26,,,,1000,437,901,393,8,2,87,40,4,2,44,47,31
E02002847,Leicester 021,Middle Super Output Areas and Intermediate Zones,MSOAIZ,LE,10260,2854,7232,1982,3325,1043,3907,939,30,9,358,136,271,106,87,30,30,,,,2491,667,2317,612,18,4,130,38,26,13,55,149,60
E02002848,Leicester 022,Middle Super Output Areas and Intermediate Zones,MSOAIZ,LE,11026,3344,4787,1353,2626,823,2161,530,61,19,2159,783,504,196,1655,587,587,,,,3860,1130,3655,1069,26,6,117,42,62,13,61,159,59
E02002849,Leicester 023,Middle Super Output Areas and Intermediate Zones,MSOAIZ,LE,11698,5256,3406,1610,1397,697,2009,913,77,41,1416,702,509,278,907,424,424,,,,6643,2822,6392,2724,20,10,159,64,72,24,98,156,81
E02002851,Leicester 025,Middle Super Output Areas and Intermediate Zones,MSOAIZ,LE,7896,2861,6650,2398,2898,1331,3752,1067,20,11,431,182,399,169,32,13,13,,,,738,244,697,228,3,1,27,10,11,5,16,57,26
E02002852,Leicester 026,Middle Super Output Areas and Intermediate Zones,MSOAIZ,LE,7098,2584,1752,638,371,187,1381,451,40,13,4944,1780,3975,1424,969,356,356,,,,290,106,261,91,0,0,26,13,3,2,15,72,47
E02002853,Leicester 027,Middle Super Output Areas and Intermediate Zones,MSOAIZ,LE,12703,4029,7861,2338,3936,1324,3925,1014,34,13,965,423,350,144,615,279,279,,,,3654,1186,3505,1132,16,4,109,38,24,12,54,189,69
E02002854,Leicester 028,Middle Super Output Areas and Intermediate Zones,MSOAIZ,LE,8077,3222,3397,1354,871,442,2526,912,63,27,3238,1332,2575,1099,663,233,233,,,,1266,449,1188,413,3,1,67,31,8,4,36,113,60
E02002855,Leicester 029,Middle Super Output Areas and Intermediate Zones,MSOAIZ,LE,6571,2786,3563,1531,1440,679,2123,852,25,12,234,96,124,60,110,36,36,,,,2671,1113,2533,1039,4,2,94,51,40,21,74,78,34
E02002856,Leicester 030,Middle Super Output Areas and Intermediate Zones,MSOAIZ,LE,11134,5066,5593,2536,2353,1258,3240,1278,40,23,376,249,96,58,280,191,191,,,,5021,2205,4814,2107,1,1,189,84,17,13,98,104,53
E02002857,Leicester 031,Middle Super Output Areas and Intermediate Zones,MSOAIZ,LE,6150,2925,3173,1489,1003,538,2170,951,31,20,704,332,377,177,327,155,155,,,,2180,1054,2062,997,10,3,93,47,15,7,57,62,30
E02002858,Leicester 032,Middle Super Output Areas and Intermediate Zones,MSOAIZ,LE,7136,2928,5913,2353,2448,1235,3465,1118,13,7,121,65,64,24,57,41,41,,,,998,468,938,441,11,3,43,22,6,2,27,91,35
E02002860,Leicester 034,Middle Super Output Areas and Intermediate Zones,MSOAIZ,LE,7737,3350,5614,2343,2110,1091,3504,1252,27,13,1076,530,871,385,205,145,145,,,,940,410,847,371,8,3,76,31,9,5,39,80,54
E02002861,Leicester 035,Middle Super Output Areas and Intermediate Zones,MSOAIZ,LE,7734,2775,2344,913,705,361,1639,552,35,10,4800,1638,4014,1380,786,258,258,,,,434,157,392,141,0,0,28,10,14,6,16,121,57
E02002862,Leicester 036,Middle Super Output Areas and Intermediate Zones,MSOAIZ,LE,8266,3547,3909,1616,1106,599,2803,1017,26,13,3573,1589,3294,1495,279,94,94,,,,635,246,564,219,2,1,56,21,13,5,27,123,83
E02002863,Rutland 001,Middle Super Output Areas and Intermediate Zones,MSOAIZ,PE,6375,2676,3974,1688,1829,935,2145,753,51,25,607,265,139,56,468,209,209,,,,1625,640,642,297,608,207,35,14,340,122,343,118,58
E02002864,Rutland 002,Middle Super Output Areas and Intermediate Zones,MSOAIZ,LE,5793,2519,4254,1829,1991,1027,2263,802,73,42,720,314,231,96,489,218,218,,,,696,305,639,276,14,7,36,19,7,3,29,50,29
E02002865,Rutland 003,Middle Super Output Areas and Intermediate Zones,MSOAIZ,LE,7470,3390,5376,2355,2468,1329,2908,1026,86,43,814,428,157,69,657,359,359,,,,1051,497,961,453,10,6,57,27,23,11,44,143,67
E02002866,Rutland 004,Middle Super Output Areas and Intermediate Zones,MSOAIZ,PE,7240,3088,5570,2334,2472,1274,3098,1060,38,23,603,285,128,51,475,234,234,,,,964,409,665,306,161,50,67,29,71,24,103,65,37
E02002867,Rutland 005,Middle Super Output Areas and Intermediate Zones,MSOAIZ,LE,7374,3329,5401,2350,2560,1324,2841,1026,57,27,786,393,216,97,570,296,296,,,,1002,482,856,409,75,31,56,33,15,9,73,128,77
E02002868,Nottingham 001,Middle Super Output Areas and Intermediate Zones,MSOAIZ,NG,5771,2458,4548,1932,2004,1003,2544,929,57,27,767,322,499,198,268,124,124,,,,369,158,324,137,0,0,40,19,5,2,21,30,19
E02002869,Nottingham 002,Middle Super Output Areas and Intermediate Zones,MSOAIZ,NG,7299,3297,3124,1396,996,558,2128,838,38,15,2817,1316,2298,1079,519,237,237,,,,1240,515,1165,482,0,0,64,29,11,4,33,80,55
E02002871,Nottingham 004,Middle Super Output Areas and Intermediate Zones,MSOAIZ,NG,7767,3469,5196,2255,1819,990,3377,1265,18,9,1200,632,871,462,329,170,170,,,,1288,537,1177,492,3,2,104,41,4,2,45,65,36
E02002872,Nottingham 005,Middle Super Output Areas and Intermediate Zones,MSOAIZ,NG,8644,3816,4181,1736,1332,678,2849,1058,35,16,3218,1558,2642,1282,576,276,276,,,,1122,455,1060,425,0,0,53,26,9,4,30,88,51
E02002873,Nottingham 006,Middle Super Output Areas and Intermediate Zones,MSOAIZ,NG,8983,3903,4204,1813,1219,679,2985,1134,18,8,3186,1427,2878,1306,308,121,121,,,,1488,599,1417,565,0,0,64,32,7,2,34,87,56
E02002874,Nottingham 007,Middle Super Output Areas and Intermediate Zones,MSOAIZ,NG,7288,3052,4322,1846,1521,814,2801,1032,23,9,1947,784,1744,695,203,89,89,,,,914,362,814,322,15,6,84,33,1,1,40,82,51
E02002875,Nottingham 008,Middle Super Output Areas and Intermediate Zones,MSOAIZ,NG,8190,3627,3814,1676,1040,563,2774,1113,71,37,2613,1192,1849,803,764,389,389,,,,1609,673,1485,619,5,2,103,47,16,5,54,83,49
E02002876,Nottingham 009,Middle Super Output Areas and Intermediate Zones,MSOAIZ,NG,7760,3471,4772,2023,1440,762,3332,1261,70,36,1587,816,1097,513,490,303,303,,,,1269,556,1183,519,2,2,77,31,7,4,37,62,40
E02002877,Nottingham 010,Middle Super Output Areas and Intermediate Zones,MSOAIZ,NG,7370,3650,4698,2209,1890,1043,2808,1166,34,24,532,347,306,194,226,153,153,,,,2033,1020,1892,949,5,2,123,60,13,9,71,73,50
E02002878,Nottingham 011,Middle Super Output Areas and Intermediate Zones,MSOAIZ,NG,8983,3258,2701,1066,717,374,1984,692,10,5,4975,1746,4721,1648,254,98,98,,,,1194,392,1129,367,0,0,50,21,15,4,25,103,49
E02002879,Nottingham 012,Middle Super Output Areas and Intermediate Zones,MSOAIZ,NG,8881,3936,4990,2153,1513,765,3477,1388,48,20,1233,598,295,129,938,469,469,,,,2532,1124,2425,1076,1,1,82,39,24,8,48,78,41
E02002880,Nottingham 013,Middle Super Output Areas and Intermediate Zones,MSOAIZ,NG,8639,3296,3336,1348,822,448,2514,900,26,7,3794,1418,3534,1315,260,103,103,,,,1360,470,1292,440,0,0,61,28,7,2,30,123,53
E02002881,Nottingham 014,Middle Super Output Areas and Intermediate Zones,MSOAIZ,NG,6139,2669,2796,1153,830,475,1966,678,6,4,2598,1209,1866,856,732,353,353,,,,625,250,549,215,5,1,50,17,21,17,35,114,53
E02002882,Nottingham 015,Middle Super Output Areas and Intermediate Zones,MSOAIZ,NG,7681,3784,4005,1788,1623,843,2382,945,27,18,742,414,325,146,417,268,268,,,,2836,1520,2718,1464,15,4,95,47,8,5,56,71,44
E02002883,Nottingham 016,Middle Super Output Areas and Intermediate Zones,MSOAIZ,NG,7483,3537,3238,1561,1015,571,2223,990,63,43,2529,1137,937,404,1592,733,733,,,,1589,753,1497,707,11,5,66,33,15,8,46,64,43
E02002884,Nottingham 017,Middle Super Output Areas and Intermediate Zones,MSOAIZ,NG,5953,2323,2572,902,1023,397,1549,505,20,8,765,333,152,53,613,280,280,,,,2525,1051,2423,1015,2,1,74,24,26,11,36,71,29
E02002885,Nottingham 018,Middle Super Output Areas and Intermediate Zones,MSOAIZ,NG,8126,3107,2249,763,779,306,1470,457,57,21,2161,969,1061,453,1100,516,516,,,,3513,1285,3394,1234,22,8,59,26,38,17,51,146,69
E02002886,Nottingham 019,Middle Super Output Areas and Intermediate Zones,MSOAIZ,NG,8785,3438,5668,2079,2255,1042,3413,1037,68,29,1383,733,1086,552,297,181,181,,,,1540,544,1439,492,4,2,75,36,22,14,52,126,53
E02002887,Nottingham 020,Middle Super Output Areas and Intermediate Zones,MSOAIZ,NG,6316,2832,3175,1315,1143,612,2032,703,73,29,2371,1191,2159,1055,212,136,136,,,,600,223,545,196,3,2,50,23,2,2,27,97,74
E02002888,Nottingham 021,Middle Super Output Areas and Intermediate Zones,MSOAIZ,NG,6550,3064,2355,1036,762,402,1593,634,22,10,2981,1522,2686,1370,295,152,152,,,,1034,403,948,366,0,0,75,33,11,4,37,158,93
E02002889,Nottingham 022,Middle Super Output Areas and Intermediate Zones,MSOAIZ,NG,6871,3140,636,316,274,143,362,173,50,32,2413,1450,299,163,2114,1287,1287,,,,3723,1317,3601,1254,24,12,47,23,51,28,63,49,25
E02002890,Nottingham 023,Middle Super Output Areas and Intermediate Zones,MSOAIZ,NG,9170,4727,1366,646,559,303,807,343,58,26,3904,2225,2932,1655,972,570,570,,,,3676,1740,3550,1667,14,6,60,28,52,39,73,166,90
E02002891,Nottingham 024,Middle Super Output Areas and Intermediate Zones,MSOAIZ,NG,8315,3376,5755,2284,2240,1078,3515,1206,23,12,1337,621,1173,550,164,71,71,,,,1105,409,982,361,3,1,118,45,2,2,48,95,50
E02002892,Nottingham 025,Middle Super Output Areas and Intermediate Zones,MSOAIZ,NG,6071,2565,3250,1382,1093,623,2157,759,7,4,2147,929,1856,761,291,168,168,,,,594,206,547,185,0,0,47,21,0,0,21,73,44
E02002893,Nottingham 026,Middle Super Output Areas and Intermediate Zones,MSOAIZ,NG,10458,4388,2112,839,748,376,1364,463,89,33,3049,1709,1705,948,1344,761,761,,,,5068,1741,4868,1668,4,2,150,46,46,25,73,140,66
E02002894,Nottingham 027,Middle Super Output Areas and Intermediate Zones,MSOAIZ,NG,6833,2689,5422,2072,2084,983,3338,1089,2,1,341,222,191,104,150,118,118,,,,1029,374,975,349,3,2,47,20,4,3,25,39,20
E02002895,Nottingham 028,Middle Super Output Areas and Intermediate Zones,MSOAIZ,NG,7959,3279,2062,1017,1017,545,1045,472,9,6,610,390,244,172,366,218,218,,,,5224,1834,5071,1771,6,5,131,49,16,9,63,54,32
E02002896,Nottingham 029,Middle Super Output Areas and Intermediate Zones,MSOAIZ,NG,9948,4372,3224,1316,1016,477,2208,839,35,13,2916,1483,1458,793,1458,690,690,,,,3588,1495,3397,1418,9,4,174,67,8,6,77,185,65
E02002897,Nottingham 030,Middle Super Output Areas and Intermediate Zones,MSOAIZ,NG,7896,3406,6308,2627,3112,1609,3196,1018,19,8,768,443,276,116,492,327,327,,,,750,290,697,267,6,1,40,18,7,4,23,51,38
E02002898,Nottingham 031,Middle Super Output Areas and Intermediate Zones,MSOAIZ,NG,10691,3738,1564,735,801,415,763,320,34,12,1426,880,1001,661,425,219,219,,,,7560,2058,7359,1988,24,8,141,48,36,14,70,107,53
E02002899,Nottingham 032,Middle Super Output Areas and Intermediate Zones,MSOAIZ,NG,5038,2172,2089,945,918,508,1171,437,15,7,1314,619,1100,483,214,136,136,,,,1494,548,1274,441,72,31,72,35,76,41,107,126,53
E02002901,Nottingham 034,Middle Super Output Areas and Intermediate Zones,MSOAIZ,NG,5696,2540,4409,1910,1835,998,2574,912,15,7,595,323,493,257,102,66,66,,,,636,275,569,241,4,2,61,30,2,2,34,41,25
E02002902,Nottingham 035,Middle Super Output Areas and Intermediate Zones,MSOAIZ,NG,7881,3488,4734,2034,1788,976,2946,1058,17,8,2107,1044,1901,907,206,137,137,,,,964,352,848,304,3,1,98,39,15,8,48,59,50
E02002903,Nottingham 036,Middle Super Output Areas and Intermediate Zones,MSOAIZ,NG,6334,2859,3398,1446,1225,656,2173,790,264,179,1940,948,1423,666,517,282,282,,,,661,242,559,199,1,1,91,36,10,6,43,71,44
E02002904,Nottingham 037,Middle Super Output Areas and Intermediate Zones,MSOAIZ,NG,6137,2633,3889,1667,1337,739,2552,928,7,2,1454,675,1361,627,93,48,48,,,,724,247,639,210,6,3,74,31,5,3,37,63,42
E02002905,Herefordshire 001,Middle Super Output Areas and Intermediate Zones,MSOAIZ,WR,6022,2650,4464,1973,2502,1277,1962,696,59,21,353,152,10,4,343,148,148,,,,977,425,836,366,50,21,71,25,20,13,59,169,79
E02002906,Herefordshire 002,Middle Super Output Areas and Intermediate Zones,MSOAIZ,HR,5707,2497,3419,1596,1667,960,1752,636,60,23,1282,464,103,36,1179,428,428,,,,905,387,834,353,13,5,46,23,12,6,34,41,27
E02002907,Herefordshire 003,Middle Super Output Areas and Intermediate Zones,MSOAIZ,HR,5847,2687,3661,1589,1748,923,1913,666,66,31,983,490,50,30,933,460,460,,,,1068,536,998,503,0,0,51,23,19,10,33,69,41
E02002908,Herefordshire 004,Middle Super Output Areas and Intermediate Zones,MSOAIZ,WR,8449,3635,6210,2681,3733,1814,2477,867,72,31,761,305,60,24,701,281,281,,,,1148,510,1007,448,59,23,60,31,22,8,62,258,108
E02002909,Herefordshire 005,Middle Super Output Areas and Intermediate Zones,MSOAIZ,WR,10122,4444,7194,3090,3809,1893,3385,1197,60,29,1249,576,154,60,1095,516,516,,,,1434,653,1244,570,61,26,108,47,21,10,83,185,96
E02002910,Herefordshire 006,Middle Super Output Areas and Intermediate Zones,MSOAIZ,LD,7720,3420,5285,2313,3203,1563,2082,750,54,27,903,405,132,44,771,361,361,,,,1260,563,1132,506,83,30,36,21,9,6,57,218,112
E02002911,Herefordshire 007,Middle Super Output Areas and Intermediate Zones,MSOAIZ,HR,9142,3790,6059,2577,3010,1523,3049,1054,140,51,1115,435,177,70,938,365,365,,,,1660,641,1268,505,229,74,56,29,107,33,136,168,86
E02002912,Herefordshire 008,Middle Super Output Areas and Intermediate Zones,MSOAIZ,HR,6917,2763,5398,2139,2505,1182,2893,957,102,37,528,221,111,41,417,180,180,,,,812,328,704,286,41,14,61,25,6,3,42,77,38
E02002913,Herefordshire 009,Middle Super Output Areas and Intermediate Zones,MSOAIZ,WR,5412,2399,4131,1811,2315,1169,1816,642,27,13,572,274,111,42,461,232,232,,,,578,254,489,214,30,12,45,19,14,9,40,104,47
E02002914,Herefordshire 010,Middle Super Output Areas and Intermediate Zones,MSOAIZ,HR,8903,4010,6071,2697,2487,1377,3584,1320,121,45,991,464,362,153,629,311,311,,,,1627,758,1512,703,18,7,78,38,19,10,55,93,46
E02002915,Herefordshire 011,Middle Super Output Areas and Intermediate Zones,MSOAIZ,HR,6504,2832,5086,2180,2443,1281,2643,899,46,24,512,253,162,63,350,190,190,,,,797,342,710,309,26,7,59,24,2,2,33,63,33
E02002916,Herefordshire 012,Middle Super Output Areas and Intermediate Zones,MSOAIZ,HR,9413,4424,4342,1980,1674,973,2668,1007,162,65,2146,1070,569,270,1577,800,800,,,,2620,1230,2401,1129,54,25,118,54,47,22,101,143,79
E02002917,Herefordshire 013,Middle Super Output Areas and Intermediate Zones,MSOAIZ,HR,6844,3032,4761,2119,1958,1088,2803,1031,96,32,642,264,187,78,455,186,186,,,,1259,567,1108,501,29,14,106,44,16,8,66,86,50
E02002918,Herefordshire 014,Middle Super Output Areas and Intermediate Zones,MSOAIZ,HR,5862,2422,5008,2063,2312,1212,2696,851,36,12,285,152,63,23,222,129,129,,,,472,165,407,140,8,3,44,17,13,5,25,61,30
E02002919,Herefordshire 015,Middle Super Output Areas and Intermediate Zones,MSOAIZ,HR,9259,3855,4977,2114,1762,948,3215,1166,157,60,2394,1066,960,411,1434,655,655,,,,1636,562,1066,379,296,91,86,36,188,56,183,95,53
E02002920,Herefordshire 016,Middle Super Output Areas and Intermediate Zones,MSOAIZ,HR,6493,2741,4880,2034,2034,1019,2846,1015,61,28,574,246,206,86,368,160,160,,,,899,397,820,359,13,5,53,27,13,6,38,79,36
E02002921,Herefordshire 017,Middle Super Output Areas and Intermediate Zones,MSOAIZ,HR,7757,3176,3114,1331,1039,573,2075,758,87,31,3837,1516,1603,651,2234,865,865,,,,647,254,589,226,6,2,43,22,9,4,28,72,44
E02002922,Herefordshire 018,Middle Super Output Areas and Intermediate Zones,MSOAIZ,HR,6123,2601,4567,1912,2331,1154,2236,758,26,13,565,238,75,34,490,204,204,,,,818,369,746,335,28,14,29,13,15,7,34,147,69
E02002923,Herefordshire 019,Middle Super Output Areas and Intermediate Zones,MSOAIZ,WR,9498,4315,6249,2880,3128,1751,3121,1129,177,82,1353,589,123,58,1230,531,531,,,,1611,708,1491,660,24,8,79,31,17,9,48,108,56
E02002924,Herefordshire 020,Middle Super Output Areas and Intermediate Zones,MSOAIZ,NP,6047,2573,4529,1931,2800,1330,1729,601,57,20,451,198,113,52,338,146,146,,,,858,355,761,312,17,6,72,33,8,4,43,152,69
E02002925,Herefordshire 021,Middle Super Output Areas and Intermediate Zones,MSOAIZ,HR,10824,4433,7646,3122,3675,1750,3971,1372,80,34,1162,446,370,146,792,300,300,,,,1723,735,1484,641,65,24,146,59,28,11,94,213,96
E02002926,Herefordshire 022,Middle Super Output Areas and Intermediate Zones,MSOAIZ,HR,10399,4784,7016,3183,3303,1860,3713,1323,111,49,1576,763,519,232,1057,531,531,,,,1605,724,1482,662,13,6,93,49,17,7,62,91,65
E02002927,Herefordshire 023,Middle Super Output Areas and Intermediate Zones,MSOAIZ,NP,11331,4836,8763,3699,4562,2247,4201,1452,29,12,703,316,180,84,523,232,232,,,,1534,684,1283,573,96,51,125,48,30,12,111,302,125
E02002928,Telford and Wrekin 001,Middle Super Output Areas and Intermediate Zones,MSOAIZ,TF,5935,2365,4345,1728,1646,840,2699,888,34,14,551,297,226,111,325,186,186,,,,967,304,887,277,0,0,59,21,21,6,27,38,22
E02002929,Telford and Wrekin 002,Middle Super Output Areas and Intermediate Zones,MSOAIZ,TF,5379,2135,4287,1713,2036,979,2251,734,15,8,308,138,108,47,200,91,91,,,,653,228,558,190,59,24,31,12,5,2,38,116,48
E02002930,Telford and Wrekin 003,Middle Super Output Areas and Intermediate Zones,MSOAIZ,TF,5410,2388,3670,1630,1644,885,2026,745,28,12,550,297,184,86,366,211,211,,,,1098,414,1026,385,4,2,60,22,8,5,29,64,35
E02002931,Telford and Wrekin 004,Middle Super Output Areas and Intermediate Zones,MSOAIZ,TF,6360,2472,5304,2053,1725,872,3579,1181,4,2,412,172,68,24,344,148,148,,,,601,227,508,189,18,8,61,24,14,6,38,39,18
E02002932,Telford and Wrekin 005,Middle Super Output Areas and Intermediate Zones,MSOAIZ,TF,8485,3417,4150,1706,1194,617,2956,1089,25,15,2758,1146,1343,530,1415,616,616,,,,1464,503,1241,428,101,28,59,27,63,20,75,88,47
E02002933,Telford and Wrekin 006,Middle Super Output Areas and Intermediate Zones,MSOAIZ,TF,8155,3382,6518,2629,2280,1186,4238,1443,23,7,681,387,255,147,426,240,240,,,,885,332,789,296,0,0,90,34,6,2,36,48,27
E02002934,Telford and Wrekin 007,Middle Super Output Areas and Intermediate Zones,MSOAIZ,TF,5987,2365,4238,1630,1263,614,2975,1016,21,11,817,373,284,133,533,240,240,,,,858,326,782,292,5,5,63,25,8,4,34,53,25
E02002935,Telford and Wrekin 008,Middle Super Output Areas and Intermediate Zones,MSOAIZ,TF,6671,2724,4702,1958,1893,996,2809,962,21,7,851,377,413,171,438,206,206,,,,1047,353,982,327,0,0,58,22,7,4,26,50,29
E02002936,Telford and Wrekin 009,Middle Super Output Areas and Intermediate Zones,MSOAIZ,TF,8594,3174,4648,1710,1212,567,3436,1143,35,12,1995,818,843,351,1152,467,467,,,,1807,578,1716,547,11,2,75,27,5,2,31,109,56
E02002937,Telford and Wrekin 010,Middle Super Output Areas and Intermediate Zones,MSOAIZ,TF,9917,4095,7777,3134,2906,1454,4871,1680,76,28,638,300,250,118,388,182,182,,,,1331,576,1216,530,22,9,76,28,17,9,46,95,57
E02002938,Telford and Wrekin 011,Middle Super Output Areas and Intermediate Zones,MSOAIZ,TF,6620,2631,3726,1459,1398,679,2328,780,14,6,1594,658,775,316,819,342,342,,,,1172,454,1040,399,56,21,60,26,16,8,55,114,54
E02002939,Telford and Wrekin 012,Middle Super Output Areas and Intermediate Zones,MSOAIZ,TF,6303,2893,4108,1824,1770,962,2338,862,28,11,1200,615,493,257,707,358,358,,,,912,404,858,381,1,1,42,17,11,5,23,55,39
E02002940,Telford and Wrekin 013,Middle Super Output Areas and Intermediate Zones,MSOAIZ,TF,6052,2693,3794,1623,1323,691,2471,932,52,23,1138,579,439,214,699,365,365,,,,1010,428,931,394,2,1,62,26,15,7,34,58,40
E02002941,Telford and Wrekin 014,Middle Super Output Areas and Intermediate Zones,MSOAIZ,TF,9475,4063,6097,2544,1984,1046,4113,1498,24,14,1975,951,949,422,1026,529,529,,,,1299,509,1202,468,4,2,75,31,18,8,41,80,45
E02002942,Telford and Wrekin 015,Middle Super Output Areas and Intermediate Zones,MSOAIZ,TF,6245,2267,4911,1806,1664,762,3247,1044,8,4,378,124,36,14,342,110,110,,,,918,319,599,224,180,50,24,12,115,33,95,30,14
E02002943,Telford and Wrekin 016,Middle Super Output Areas and Intermediate Zones,MSOAIZ,TF,9397,3528,6498,2453,1486,712,5012,1741,50,23,1538,559,436,174,1102,385,385,,,,1258,468,1144,423,7,3,99,40,8,2,45,53,25
E02002944,Telford and Wrekin 017,Middle Super Output Areas and Intermediate Zones,MSOAIZ,TF,7757,3189,3296,1312,870,445,2426,867,38,16,2904,1321,1387,619,1517,702,702,,,,1428,497,1280,449,5,2,90,31,53,15,48,91,43
E02002945,Telford and Wrekin 018,Middle Super Output Areas and Intermediate Zones,MSOAIZ,WV,9357,3588,5467,2081,1453,705,4014,1376,15,7,1970,856,679,309,1291,547,547,,,,1836,610,1718,567,6,1,107,40,5,2,43,69,34
E02002946,Telford and Wrekin 019,Middle Super Output Areas and Intermediate Zones,MSOAIZ,TF,7890,3407,5136,2149,1541,802,3595,1347,70,30,1529,697,607,269,922,428,428,,,,1097,490,1010,449,0,0,84,40,3,1,41,58,41
E02002947,Telford and Wrekin 020,Middle Super Output Areas and Intermediate Zones,MSOAIZ,TF,6921,2671,3751,1513,1140,568,2611,945,20,8,1478,573,629,258,849,315,315,,,,1632,555,1529,517,2,1,94,34,7,3,38,40,22
E02002948,Telford and Wrekin 021,Middle Super Output Areas and Intermediate Zones,MSOAIZ,TF,6861,2475,2664,1093,816,427,1848,666,22,7,1945,701,770,279,1175,422,422,,,,2197,653,2144,632,3,2,41,16,9,3,21,33,21
E02002949,Telford and Wrekin 022,Middle Super Output Areas and Intermediate Zones,MSOAIZ,TF,5268,2429,3255,1396,1249,652,2006,744,48,19,1211,663,574,323,637,340,340,,,,702,315,637,281,2,2,60,30,3,2,34,52,36
E02002950,Telford and Wrekin 023,Middle Super Output Areas and Intermediate Zones,MSOAIZ,TF,5401,2257,2927,1273,1239,645,1688,628,16,8,1069,504,543,237,526,267,267,,,,1324,436,1264,410,0,0,51,17,9,9,26,65,36
E02002951,Stoke-on-Trent 001,Middle Super Output Areas and Intermediate Zones,MSOAIZ,ST,7633,3204,5904,2428,2110,1099,3794,1329,13,4,1225,530,1169,505,56,25,25,,,,425,201,385,185,0,0,38,14,2,2,16,66,41
E02002952,Stoke-on-Trent 002,Middle Super Output Areas and Intermediate Zones,MSOAIZ,ST,6694,2837,4211,1728,1369,701,2842,1027,8,5,1534,708,1399,660,135,48,48,,,,869,349,786,312,4,2,77,33,2,2,37,72,47
E02002953,Stoke-on-Trent 003,Middle Super Output Areas and Intermediate Zones,MSOAIZ,ST,7338,3090,4060,1721,1589,837,2471,884,14,10,2760,1151,2252,821,508,330,330,,,,417,157,377,139,2,1,38,17,0,0,18,87,51
E02002954,Stoke-on-Trent 004,Middle Super Output Areas and Intermediate Zones,MSOAIZ,ST,8236,3619,4926,2159,2155,1154,2771,1005,25,15,2422,1086,2328,1036,94,50,50,,,,753,307,682,274,3,1,64,29,4,3,33,110,52
E02002955,Stoke-on-Trent 005,Middle Super Output Areas and Intermediate Zones,MSOAIZ,ST,7019,3012,4093,1573,1669,731,2424,842,13,4,969,556,490,271,479,285,285,,,,1810,827,1733,793,0,0,61,27,16,7,34,134,52
E02002956,Stoke-on-Trent 006,Middle Super Output Areas and Intermediate Zones,MSOAIZ,ST,9171,3855,5545,2342,2125,1121,3420,1221,27,11,2293,935,2146,864,147,71,71,,,,1196,506,1118,466,1,1,68,35,9,4,40,110,61
E02002957,Stoke-on-Trent 007,Middle Super Output Areas and Intermediate Zones,MSOAIZ,ST,9697,4274,8202,3560,3574,1899,4628,1661,17,10,442,217,421,204,21,13,13,,,,970,440,893,401,4,3,69,34,4,2,39,66,47
E02002958,Stoke-on-Trent 008,Middle Super Output Areas and Intermediate Zones,MSOAIZ,ST,7955,3568,5325,2258,1951,1026,3374,1232,7,3,1620,831,1500,764,120,67,67,,,,905,406,830,373,8,3,62,28,5,2,33,98,70
E02002959,Stoke-on-Trent 009,Middle Super Output Areas and Intermediate Zones,MSOAIZ,ST,8209,3665,3852,1549,1485,718,2367,831,68,26,2087,1018,1215,571,872,447,447,,,,2039,995,1921,946,4,1,89,37,25,11,49,163,77
E02002960,Stoke-on-Trent 010,Middle Super Output Areas and Intermediate Zones,MSOAIZ,ST,5898,2459,4490,1851,1802,925,2688,926,17,10,891,389,866,373,25,16,16,,,,443,178,402,158,2,1,39,19,0,0,20,57,31
E02002961,Stoke-on-Trent 011,Middle Super Output Areas and Intermediate Zones,MSOAIZ,ST,6471,2857,3603,1438,1602,728,2001,710,17,7,1167,628,750,369,417,259,259,,,,1503,698,1419,658,2,1,64,27,18,12,40,181,86
E02002962,Stoke-on-Trent 012,Middle Super Output Areas and Intermediate Zones,MSOAIZ,ST,6921,3004,2769,1179,1097,583,1672,596,27,16,3583,1572,2670,1137,913,435,435,,,,430,177,380,154,0,0,23,12,27,11,23,112,60
E02002963,Stoke-on-Trent 013,Middle Super Output Areas and Intermediate Zones,MSOAIZ,ST,7277,3559,4142,1853,1512,800,2630,1053,18,5,1315,818,1099,693,216,125,125,,,,1670,803,1537,741,13,3,108,53,12,6,62,132,80
E02002964,Stoke-on-Trent 014,Middle Super Output Areas and Intermediate Zones,MSOAIZ,ST,8492,3846,5964,2635,2714,1442,3250,1193,3,2,1731,843,1486,658,245,185,185,,,,706,311,617,270,2,1,77,33,10,7,41,88,55
E02002965,Stoke-on-Trent 015,Middle Super Output Areas and Intermediate Zones,MSOAIZ,ST,6722,2719,3166,1107,1171,476,1995,631,32,16,1426,745,613,340,813,405,405,,,,1915,777,1768,714,50,18,70,28,27,17,63,183,74
E02002966,Stoke-on-Trent 016,Middle Super Output Areas and Intermediate Zones,MSOAIZ,ST,8368,3900,3166,1456,1383,698,1783,758,103,58,1415,986,721,506,694,480,480,,,,3559,1327,3316,1206,13,3,104,43,126,75,121,125,73
E02002967,Stoke-on-Trent 017,Middle Super Output Areas and Intermediate Zones,MSOAIZ,ST,9652,4212,3110,1275,1168,618,1942,657,61,27,5532,2506,3757,1526,1775,980,980,,,,818,319,736,279,9,2,49,23,24,15,40,131,85
E02002968,Stoke-on-Trent 018,Middle Super Output Areas and Intermediate Zones,MSOAIZ,ST,8921,3980,5650,2482,2137,1153,3513,1329,58,29,1101,509,707,306,394,203,203,,,,2044,919,1855,835,55,20,119,57,15,7,84,68,41
E02002969,Stoke-on-Trent 019,Middle Super Output Areas and Intermediate Zones,MSOAIZ,ST,8617,4125,4523,2048,1711,911,2812,1137,40,21,1288,789,814,495,474,294,294,,,,2635,1197,2509,1134,6,5,86,42,34,16,63,131,70
E02002970,Stoke-on-Trent 020,Middle Super Output Areas and Intermediate Zones,MSOAIZ,ST,8054,3861,4520,2064,1639,895,2881,1169,7,3,1688,897,1239,686,449,211,211,,,,1740,840,1613,773,3,1,109,58,15,8,67,99,57
E02002971,Stoke-on-Trent 021,Middle Super Output Areas and Intermediate Zones,MSOAIZ,ST,5252,2262,3963,1650,1519,759,2444,891,9,7,396,209,272,137,124,72,72,,,,838,368,795,347,6,2,35,18,2,1,21,46,28
E02002972,Stoke-on-Trent 022,Middle Super Output Areas and Intermediate Zones,MSOAIZ,ST,6243,2844,3442,1473,1247,659,2195,814,12,7,1994,984,1708,824,286,160,160,,,,678,304,599,266,2,1,72,32,5,5,38,117,76
E02002973,Stoke-on-Trent 023,Middle Super Output Areas and Intermediate Zones,MSOAIZ,ST,8042,3496,4598,1917,1552,820,3046,1097,20,9,2141,967,1255,542,886,425,425,,,,1215,559,1142,525,0,0,62,29,11,5,34,68,44
E02002974,Stoke-on-Trent 024,Middle Super Output Areas and Intermediate Zones,MSOAIZ,ST,5492,2415,4352,1913,2189,1126,2163,787,52,25,766,330,519,235,247,95,95,,,,283,120,247,101,2,1,32,16,2,2,19,39,27
E02002975,Stoke-on-Trent 025,Middle Super Output Areas and Intermediate Zones,MSOAIZ,ST,7643,3136,6804,2799,2142,1113,4662,1686,57,24,301,109,279,95,22,14,14,,,,428,181,379,160,0,0,44,20,5,1,21,53,23
E02002976,Stoke-on-Trent 026,Middle Super Output Areas and Intermediate Zones,MSOAIZ,ST,5988,2420,4014,1691,1652,877,2362,814,3,1,1504,550,1483,541,21,9,9,,,,391,142,341,122,6,2,44,18,0,0,20,76,36
E02002977,Stoke-on-Trent 027,Middle Super Output Areas and Intermediate Zones,MSOAIZ,ST,5762,2814,3686,1666,1806,972,1880,694,9,6,1389,782,1265,701,124,81,81,,,,565,287,495,258,4,2,52,21,14,6,29,113,73
E02002978,Stoke-on-Trent 028,Middle Super Output Areas and Intermediate Zones,MSOAIZ,ST,6367,2793,2944,1287,1239,650,1705,637,38,19,2525,1096,2261,971,264,125,125,,,,796,347,743,318,5,2,43,26,5,1,29,64,44
E02002979,Stoke-on-Trent 029,Middle Super Output Areas and Intermediate Zones,MSOAIZ,ST,5542,2075,3800,1314,1620,663,2180,651,38,15,557,281,305,141,252,140,140,,,,1024,419,963,397,2,1,44,17,15,4,22,123,46
E02002980,Stoke-on-Trent 030,Middle Super Output Areas and Intermediate Zones,MSOAIZ,ST,6051,2692,4920,2190,2410,1291,2510,899,6,4,641,282,596,263,45,19,19,,,,422,172,371,151,3,2,48,19,0,0,21,62,44
E02002981,Stoke-on-Trent 031,Middle Super Output Areas and Intermediate Zones,MSOAIZ,ST,8242,3238,5079,1917,1547,747,3532,1170,22,8,2397,1001,2157,837,240,164,164,,,,668,271,626,251,0,0,35,14,7,6,20,76,41
E02002982,Stoke-on-Trent 032,Middle Super Output Areas and Intermediate Zones,MSOAIZ,ST,7044,3194,3202,1311,1030,546,2172,765,9,4,3032,1529,2976,1504,56,25,25,,,,706,279,665,254,1,1,36,21,4,3,25,95,71
E02002983,Stoke-on-Trent 033,Middle Super Output Areas and Intermediate Zones,MSOAIZ,ST,5578,2269,4953,1998,1806,896,3147,1102,6,2,281,128,266,123,15,5,5,,,,310,125,256,99,0,0,54,26,0,0,26,28,16
E02002984,Stoke-on-Trent 034,Middle Super Output Areas and Intermediate Zones,MSOAIZ,ST,5484,2281,5071,2096,2008,994,3063,1102,11,6,81,37,33,13,48,24,24,,,,304,132,265,116,6,3,29,12,4,1,16,17,10
E02002985,Bath and North East Somerset 001,Middle Super Output Areas and Intermediate Zones,MSOAIZ,BS,5147,2176,3617,1505,1434,755,2183,750,15,7,928,387,304,116,624,271,271,,,,519,236,460,208,5,3,54,25,0,0,28,68,41
E02002986,Bath and North East Somerset 002,Middle Super Output Areas and Intermediate Zones,MSOAIZ,BS,4972,2307,3248,1454,1360,775,1888,679,42,18,1175,596,361,176,814,420,420,,,,454,202,380,169,2,1,66,27,6,5,33,53,37
E02002987,Bath and North East Somerset 003,Middle Super Output Areas and Intermediate Zones,MSOAIZ,BS,5371,2324,4717,2002,2230,1208,2487,794,13,7,188,97,25,13,163,84,84,,,,426,202,372,179,9,4,31,14,14,5,23,27,16
E02002988,Bath and North East Somerset 004,Middle Super Output Areas and Intermediate Zones,MSOAIZ,BA,5413,2412,3934,1663,1664,871,2270,792,37,20,511,292,116,62,395,230,230,,,,885,410,789,369,8,3,69,32,19,6,41,46,27
E02002989,Bath and North East Somerset 005,Middle Super Output Areas and Intermediate Zones,MSOAIZ,BA,5281,2306,3730,1630,1712,944,2018,686,7,4,749,351,204,77,545,274,274,,,,750,298,688,267,2,2,49,23,11,6,31,45,23
E02002990,Bath and North East Somerset 006,Middle Super Output Areas and Intermediate Zones,MSOAIZ,BA,5887,2828,3437,1609,1396,767,2041,842,19,9,662,358,202,90,460,268,268,,,,1721,827,1627,784,1,1,79,34,14,8,43,48,25
E02002991,Bath and North East Somerset 007,Middle Super Output Areas and Intermediate Zones,MSOAIZ,BA,9794,5472,4231,2195,2238,1297,1993,898,39,32,1410,996,177,119,1233,877,877,,,,3923,2141,3661,1996,35,18,168,89,59,38,145,191,108
E02002992,Bath and North East Somerset 008,Middle Super Output Areas and Intermediate Zones,MSOAIZ,BA,5831,2483,4016,1587,1552,793,2464,794,27,21,632,388,69,44,563,344,344,,,,1125,463,1033,424,16,4,63,29,13,6,39,31,24
E02002993,Bath and North East Somerset 009,Middle Super Output Areas and Intermediate Zones,MSOAIZ,BA,5269,2666,2286,1074,991,544,1295,530,12,7,827,542,120,74,707,468,468,,,,2078,999,1972,944,11,6,57,31,38,18,55,66,44
E02002994,Bath and North East Somerset 010,Middle Super Output Areas and Intermediate Zones,MSOAIZ,BA,9914,4279,7968,3376,3895,1976,4073,1400,21,6,669,335,134,69,535,266,266,,,,1062,466,921,408,34,12,91,39,16,7,58,194,96
E02002995,Bath and North East Somerset 011,Middle Super Output Areas and Intermediate Zones,MSOAIZ,BA,5193,2273,2097,925,656,377,1441,548,14,6,2464,1098,738,328,1726,770,770,,,,562,209,497,182,7,2,57,24,1,1,27,56,35
E02002996,Bath and North East Somerset 012,Middle Super Output Areas and Intermediate Zones,MSOAIZ,BA,7941,3500,4882,2262,2602,1407,2280,855,37,18,295,154,71,36,224,118,118,,,,2633,1013,2538,967,19,9,64,30,12,7,46,94,53
E02002997,Bath and North East Somerset 013,Middle Super Output Areas and Intermediate Zones,MSOAIZ,BA,5823,2216,2813,1257,1198,644,1615,613,18,8,367,185,131,56,236,129,129,,,,2580,744,2428,690,5,4,138,46,9,4,54,45,22
E02002998,Bath and North East Somerset 014,Middle Super Output Areas and Intermediate Zones,MSOAIZ,BA,5819,2277,2758,1183,1081,595,1677,588,73,24,971,490,251,124,720,366,366,,,,1969,554,1863,511,9,3,87,33,10,7,43,48,26
E02002999,Bath and North East Somerset 015,Middle Super Output Areas and Intermediate Zones,MSOAIZ,BA,5529,2327,3469,1505,1464,786,2005,719,60,21,1283,533,419,170,864,363,363,,,,667,237,609,210,5,1,42,20,11,6,27,50,31
E02003000,Bath and North East Somerset 016,Middle Super Output Areas and Intermediate Zones,MSOAIZ,BS,9042,3830,7510,3094,3524,1768,3986,1326,21,11,810,406,189,91,621,315,315,,,,602,260,527,226,8,4,41,21,26,9,34,99,59
E02003001,Bath and North East Somerset 017,Middle Super Output Areas and Intermediate Zones,MSOAIZ,BA,5410,2240,4231,1717,1980,968,2251,749,23,14,309,162,28,12,281,150,150,,,,799,324,760,307,3,1,36,16,0,0,17,48,23
E02003002,Bath and North East Somerset 018,Middle Super Output Areas and Intermediate Zones,MSOAIZ,BA,5380,2336,3228,1409,1471,806,1757,603,11,4,1364,630,460,201,904,429,429,,,,723,267,676,251,0,0,41,14,6,2,16,54,26
E02003003,Bath and North East Somerset 019,Middle Super Output Areas and Intermediate Zones,MSOAIZ,BA,5681,2364,3525,1534,1352,724,2173,810,105,46,1028,418,230,101,798,317,317,,,,980,341,908,313,6,1,55,23,11,4,28,43,25
E02003004,Bath and North East Somerset 020,Middle Super Output Areas and Intermediate Zones,MSOAIZ,BS,6173,2392,5052,1903,1943,911,3109,992,19,7,528,238,103,48,425,190,190,,,,510,209,460,190,13,4,33,12,4,3,19,64,35
E02003005,Bath and North East Somerset 021,Middle Super Output Areas and Intermediate Zones,MSOAIZ,BS,6152,2479,5102,1997,2445,1152,2657,845,26,13,435,199,95,43,340,156,156,,,,511,226,425,182,37,18,31,20,18,6,44,78,44
E02003006,Bath and North East Somerset 022,Middle Super Output Areas and Intermediate Zones,MSOAIZ,BA,8474,3473,6439,2581,2315,1168,4124,1413,58,25,813,342,221,87,592,255,255,,,,1067,475,957,430,19,9,49,22,42,14,45,97,50
E02003007,Bath and North East Somerset 023,Middle Super Output Areas and Intermediate Zones,MSOAIZ,BS,8140,3371,6656,2698,2756,1373,3900,1325,32,12,677,304,218,91,459,213,213,,,,722,323,632,284,15,5,64,28,11,6,39,53,34
E02003008,Bath and North East Somerset 024,Middle Super Output Areas and Intermediate Zones,MSOAIZ,BA,5607,2300,3797,1515,1191,604,2606,911,19,6,1123,476,336,132,787,344,344,,,,607,267,539,238,12,4,53,22,3,3,29,61,36
E02003009,Bath and North East Somerset 025,Middle Super Output Areas and Intermediate Zones,MSOAIZ,BS,5857,2455,4833,1967,1748,909,3085,1058,9,4,230,114,78,34,152,80,80,,,,749,347,685,317,14,5,48,23,2,2,30,36,23
E02003010,Bath and North East Somerset 026,Middle Super Output Areas and Intermediate Zones,MSOAIZ,BA,5807,2299,4561,1798,1538,771,3023,1027,38,16,584,227,191,72,393,155,155,,,,571,230,497,200,10,3,60,26,4,1,30,53,28
E02003011,Bath and North East Somerset 027,Middle Super Output Areas and Intermediate Zones,MSOAIZ,BA,5070,2130,3958,1628,1842,934,2116,694,5,2,629,296,142,62,487,234,234,,,,441,177,404,162,2,1,31,12,4,2,15,37,27
E02003012,Bristol 001,Middle Super Output Areas and Intermediate Zones,MSOAIZ,BS,10582,4806,5544,2537,2144,1195,3400,1342,65,31,3619,1608,3200,1442,419,166,166,,,,1204,529,1120,494,8,3,53,24,23,8,35,150,101
E02003013,Bristol 002,Middle Super Output Areas and Intermediate Zones,MSOAIZ,BS,11824,4850,5733,2419,1895,1040,3838,1379,89,48,4251,1662,3847,1446,404,216,216,,,,1581,632,1465,578,2,1,96,43,18,10,54,170,89
E02003014,Bristol 003,Middle Super Output Areas and Intermediate Zones,MSOAIZ,BS,7715,3331,2944,1302,1091,618,1853,684,15,6,4119,1745,3515,1457,604,288,288,,,,548,227,484,199,10,3,48,21,6,4,28,89,51
E02003015,Bristol 004,Middle Super Output Areas and Intermediate Zones,MSOAIZ,BS,5737,2436,3326,1421,1367,722,1959,699,27,15,1311,596,1159,512,152,84,84,,,,1010,368,929,338,15,7,66,23,0,0,30,63,36
E02003016,Bristol 005,Middle Super Output Areas and Intermediate Zones,MSOAIZ,BS,7481,3059,2758,1217,884,445,1874,772,156,76,2495,986,1273,505,1222,481,481,,,,2004,747,1879,702,10,4,85,32,30,9,45,68,33
E02003017,Bristol 006,Middle Super Output Areas and Intermediate Zones,MSOAIZ,BS,5877,2736,4310,1920,1856,1035,2454,885,24,12,597,361,482,280,115,81,81,,,,878,398,820,367,9,3,38,25,11,3,31,68,45
E02003018,Bristol 007,Middle Super Output Areas and Intermediate Zones,MSOAIZ,BS,5728,2393,3459,1482,1368,734,2091,748,17,8,1690,669,1586,605,104,64,64,,,,506,201,439,174,22,6,26,11,19,10,27,56,33
E02003019,Bristol 008,Middle Super Output Areas and Intermediate Zones,MSOAIZ,BS,9261,3995,5829,2475,2092,1125,3737,1350,36,18,2025,890,1726,756,299,134,134,,,,1278,558,1182,513,13,4,68,36,15,5,45,93,54
E02003020,Bristol 009,Middle Super Output Areas and Intermediate Zones,MSOAIZ,BS,5892,2504,5110,2131,2280,1220,2830,911,16,9,241,157,87,35,154,122,122,,,,476,184,427,165,3,2,13,6,33,11,19,49,23
E02003021,Bristol 010,Middle Super Output Areas and Intermediate Zones,MSOAIZ,BS,6737,2670,3832,1663,1324,714,2508,949,63,32,445,172,376,141,69,31,31,,,,2337,781,2230,740,7,2,95,37,5,2,41,60,22
E02003022,Bristol 011,Middle Super Output Areas and Intermediate Zones,MSOAIZ,BS,5856,2389,5331,2200,2497,1288,2834,912,0,0,67,24,37,12,30,12,12,,,,430,152,393,139,0,0,27,11,10,2,13,28,13
E02003023,Bristol 012,Middle Super Output Areas and Intermediate Zones,MSOAIZ,BS,5880,2630,3773,1669,1590,861,2183,808,15,10,918,504,643,359,275,145,145,,,,1062,386,979,354,12,5,62,24,9,3,32,112,61
E02003024,Bristol 013,Middle Super Output Areas and Intermediate Zones,MSOAIZ,BS,8061,3599,4568,2085,1967,1103,2601,982,49,24,1623,783,1214,549,409,234,234,,,,1714,653,1606,600,3,1,96,46,9,6,53,107,54
E02003025,Bristol 014,Middle Super Output Areas and Intermediate Zones,MSOAIZ,BS,6701,2726,3634,1461,1301,665,2333,796,28,12,1666,758,1478,656,188,102,102,,,,1258,432,1152,396,4,1,99,34,3,1,36,115,63
E02003026,Bristol 015,Middle Super Output Areas and Intermediate Zones,MSOAIZ,BS,7261,3241,6089,2678,3094,1601,2995,1077,1,1,241,110,211,97,30,13,13,,,,852,404,816,381,4,2,30,19,2,2,23,78,48
E02003027,Bristol 016,Middle Super Output Areas and Intermediate Zones,MSOAIZ,BS,11554,4578,7721,3104,2456,1223,5265,1881,44,22,347,157,206,74,141,83,83,,,,3383,1266,3252,1212,8,5,105,43,18,6,54,59,29
E02003028,Bristol 017,Middle Super Output Areas and Intermediate Zones,MSOAIZ,BS,8312,3430,5754,2258,2019,1016,3735,1242,13,5,326,216,105,61,221,155,155,,,,2147,915,2070,876,19,7,36,17,22,15,39,72,36
E02003029,Bristol 018,Middle Super Output Areas and Intermediate Zones,MSOAIZ,BS,6203,2448,3410,1394,1063,578,2347,816,5,3,1800,661,1602,555,198,106,106,,,,906,346,812,307,0,0,71,29,23,10,39,82,44
E02003030,Bristol 019,Middle Super Output Areas and Intermediate Zones,MSOAIZ,BS,7122,3088,4274,1802,1395,727,2879,1075,72,29,606,308,303,125,303,183,183,,,,2085,905,1956,848,9,6,89,40,31,11,57,85,44
E02003031,Bristol 020,Middle Super Output Areas and Intermediate Zones,MSOAIZ,BS,10083,4083,5820,2182,2117,910,3703,1272,13,5,336,170,139,45,197,125,125,,,,3836,1691,3684,1618,15,6,117,53,20,14,73,78,35
E02003032,Bristol 021,Middle Super Output Areas and Intermediate Zones,MSOAIZ,BS,7200,3083,4430,1895,1533,818,2897,1077,94,44,941,415,594,260,347,155,155,,,,1639,686,1498,628,6,3,129,52,6,3,58,96,43
E02003033,Bristol 022,Middle Super Output Areas and Intermediate Zones,MSOAIZ,BS,8896,3613,3237,1453,1390,686,1847,767,31,11,313,175,79,37,234,138,138,,,,5268,1948,5155,1893,9,3,100,48,4,4,55,47,26
E02003034,Bristol 023,Middle Super Output Areas and Intermediate Zones,MSOAIZ,BS,12190,5569,3992,1812,1485,740,2507,1072,193,103,4106,1853,1635,672,2471,1181,1181,,,,3700,1713,3427,1605,6,3,228,90,39,15,108,199,88
E02003036,Bristol 025,Middle Super Output Areas and Intermediate Zones,MSOAIZ,BS,7934,3913,2429,1141,1001,510,1428,631,44,23,1125,669,733,377,392,292,292,,,,4255,2025,4017,1915,65,21,120,60,53,29,110,81,55
E02003037,Bristol 026,Middle Super Output Areas and Intermediate Zones,MSOAIZ,BS,8654,4038,3223,1633,1305,756,1918,877,31,11,191,120,60,27,131,93,93,,,,5135,2226,4969,2152,7,5,134,61,25,8,74,74,48
E02003038,Bristol 027,Middle Super Output Areas and Intermediate Zones,MSOAIZ,BS,6331,2795,4246,1790,1479,763,2767,1027,48,19,708,339,469,190,239,149,149,,,,1274,616,1178,574,13,4,68,33,15,5,42,55,31
E02003039,Bristol 028,Middle Super Output Areas and Intermediate Zones,MSOAIZ,BS,7936,3518,4762,2016,1509,822,3253,1194,38,15,1373,671,1027,466,346,205,205,,,,1691,769,1610,736,0,0,79,31,2,2,33,72,47
E02003040,Bristol 029,Middle Super Output Areas and Intermediate Zones,MSOAIZ,BS,9023,4392,4502,2182,1276,734,3226,1448,65,26,840,440,511,283,329,157,157,,,,3541,1694,3421,1632,9,4,99,51,12,7,62,75,50
E02003041,Bristol 030,Middle Super Output Areas and Intermediate Zones,MSOAIZ,BS,5853,2979,2565,1313,1316,736,1249,577,21,13,135,106,47,28,88,78,78,,,,2992,1480,2874,1420,38,19,62,34,18,7,60,140,67
E02003043,Bristol 032,Middle Super Output Areas and Intermediate Zones,MSOAIZ,BS,10166,4647,2037,1154,937,568,1100,586,147,88,1653,743,567,245,1086,498,498,,,,6192,2581,5750,2404,108,47,199,84,135,46,177,137,81
E02003044,Bristol 033,Middle Super Output Areas and Intermediate Zones,MSOAIZ,BS,5784,2513,4493,1906,1589,845,2904,1061,23,9,235,105,146,49,89,56,56,,,,1000,478,910,436,1,1,88,40,1,1,42,33,15
E02003045,Bristol 034,Middle Super Output Areas and Intermediate Zones,MSOAIZ,BS,6099,2988,2517,1233,1115,602,1402,631,40,25,717,469,369,214,348,255,255,,,,2740,1218,2583,1154,17,4,104,41,36,19,64,85,43
E02003046,Bristol 035,Middle Super Output Areas and Intermediate Zones,MSOAIZ,BS,9200,4107,5845,2583,1701,898,4144,1685,101,52,1291,536,755,292,536,244,244,,,,1912,899,1757,825,13,5,126,61,16,8,74,51,37
E02003047,Bristol 036,Middle Super Output Areas and Intermediate Zones,MSOAIZ,BS,9852,4474,5738,2440,1925,970,3813,1470,57,24,1182,725,787,487,395,238,238,,,,2804,1246,2666,1181,11,5,113,50,14,10,65,71,39
E02003048,Bristol 037,Middle Super Output Areas and Intermediate Zones,MSOAIZ,BS,6497,3212,3496,1586,1069,544,2427,1042,169,101,790,428,297,125,493,303,303,,,,2006,1074,1896,1021,6,2,95,47,9,4,53,36,23
E02003049,Bristol 038,Middle Super Output Areas and Intermediate Zones,MSOAIZ,BS,7163,3122,5047,2123,1810,971,3237,1152,35,14,1097,548,1028,511,69,37,37,,,,935,404,864,372,5,2,65,29,1,1,32,49,33
E02003050,Bristol 039,Middle Super Output Areas and Intermediate Zones,MSOAIZ,BS,8360,4322,3780,1783,1381,746,2399,1037,95,53,1475,889,941,545,534,344,344,,,,2914,1532,2742,1445,5,3,139,69,28,15,87,96,65
E02003051,Bristol 040,Middle Super Output Areas and Intermediate Zones,MSOAIZ,BS,6664,2831,3537,1517,1023,558,2514,959,44,23,1446,600,1223,486,223,114,114,,,,1515,643,1422,606,3,1,88,34,2,2,37,122,48
E02003052,Bristol 041,Middle Super Output Areas and Intermediate Zones,MSOAIZ,BS,6497,2835,4743,2026,1765,935,2978,1091,30,11,481,258,445,237,36,21,21,,,,1203,516,1135,483,0,0,65,32,3,1,33,40,24
E02003053,Bristol 042,Middle Super Output Areas and Intermediate Zones,MSOAIZ,BS,8012,3342,6166,2451,2321,1144,3845,1307,20,8,640,330,421,173,219,157,157,,,,1150,533,1046,481,0,0,91,42,13,10,52,36,20
E02003054,Bristol 043,Middle Super Output Areas and Intermediate Zones,MSOAIZ,BS,6391,2698,4707,1897,1636,839,3071,1058,24,10,744,363,620,297,124,66,66,,,,876,410,812,381,4,2,51,24,9,3,29,40,18
E02003055,Bristol 044,Middle Super Output Areas and Intermediate Zones,MSOAIZ,BS,8300,3118,3816,1521,1165,619,2651,902,90,42,3488,1217,3212,1086,276,131,131,,,,788,281,717,257,0,0,66,22,5,2,24,118,57
E02003056,Bristol 045,Middle Super Output Areas and Intermediate Zones,MSOAIZ,BS,7202,2841,3286,1302,1025,535,2261,767,27,10,2997,1175,2715,1074,282,101,101,,,,750,281,715,259,2,2,31,19,2,1,22,142,73
E02003057,Bristol 046,Middle Super Output Areas and Intermediate Zones,MSOAIZ,BS,5771,2434,4299,1790,1709,912,2590,878,37,18,669,292,566,244,103,48,48,,,,706,295,646,270,7,2,51,22,2,1,25,60,39
E02003058,Bristol 047,Middle Super Output Areas and Intermediate Zones,MSOAIZ,BS,8873,3836,5872,2460,2094,1086,3778,1374,67,33,1629,794,962,502,667,292,292,,,,1224,509,1128,463,2,2,86,41,8,3,46,81,40
E02003059,Bristol 048,Middle Super Output Areas and Intermediate Zones,MSOAIZ,BS,5638,2374,3793,1587,1585,828,2208,759,26,12,1260,536,1021,423,239,113,113,,,,510,212,432,183,14,4,60,21,4,4,29,49,27
E02003060,Bristol 049,Middle Super Output Areas and Intermediate Zones,MSOAIZ,BS,10661,4591,7863,3223,3159,1631,4704,1592,40,20,1806,930,1300,685,506,245,245,,,,884,378,786,334,0,0,90,39,8,5,44,68,40
E02003061,Bristol 050,Middle Super Output Areas and Intermediate Zones,MSOAIZ,BS,5747,2481,2679,1164,978,551,1701,613,33,12,2521,1053,2165,864,356,189,189,,,,429,196,372,165,2,1,49,24,6,6,31,85,56
E02003062,Bristol 051,Middle Super Output Areas and Intermediate Zones,MSOAIZ,BS,5768,2435,2659,1092,1012,526,1647,566,19,8,2620,1123,2014,893,606,230,230,,,,376,161,324,138,0,0,46,19,6,4,23,94,51
E02003063,Bristol 052,Middle Super Output Areas and Intermediate Zones,MSOAIZ,BS,7036,2947,6206,2609,2684,1409,3522,1200,23,10,277,98,235,82,42,16,16,,,,498,207,445,179,0,0,50,26,3,2,28,32,23
E02003064,Bristol 053,Middle Super Output Areas and Intermediate Zones,MSOAIZ,BS,6524,2834,2176,921,790,432,1386,489,47,22,3842,1698,3345,1531,497,167,167,,,,319,126,280,109,7,2,22,11,10,4,17,140,67
E02003065,North Somerset 001,Middle Super Output Areas and Intermediate Zones,MSOAIZ,BS,8450,3960,6140,2714,2270,1268,3870,1446,115,57,893,495,313,149,580,346,346,,,,1254,659,1172,615,5,2,71,39,6,3,44,48,35
E02003066,North Somerset 002,Middle Super Output Areas and Intermediate Zones,MSOAIZ,BS,5974,2613,5469,2354,2440,1300,3029,1054,14,7,102,64,23,13,79,51,51,,,,362,172,335,158,0,0,25,13,2,1,14,27,16
E02003067,North Somerset 003,Middle Super Output Areas and Intermediate Zones,MSOAIZ,BS,7494,3174,6096,2506,1938,1073,4158,1433,87,46,502,245,90,50,412,195,195,,,,757,345,699,314,0,0,57,30,1,1,31,52,32
E02003068,North Somerset 004,Middle Super Output Areas and Intermediate Zones,MSOAIZ,BS,6058,2671,4771,2075,2143,1133,2628,942,6,2,692,308,348,148,344,160,160,,,,519,241,451,215,18,6,39,13,11,7,26,70,45
E02003069,North Somerset 005,Middle Super Output Areas and Intermediate Zones,MSOAIZ,BS,5176,2390,4421,1979,2163,1165,2258,814,8,5,63,39,6,2,57,37,37,,,,648,345,578,318,13,4,44,18,13,5,27,36,22
E02003070,North Somerset 006,Middle Super Output Areas and Intermediate Zones,MSOAIZ,BS,12018,4942,10055,4050,3983,1969,6072,2081,131,66,776,354,209,108,567,246,246,,,,973,423,812,352,56,21,56,30,49,20,71,83,49
E02003071,North Somerset 007,Middle Super Output Areas and Intermediate Zones,MSOAIZ,BS,7530,3521,5269,2335,2121,1194,3148,1141,65,29,993,553,334,166,659,387,387,,,,1123,560,1028,510,21,8,65,37,9,5,50,80,44
E02003072,North Somerset 008,Middle Super Output Areas and Intermediate Zones,MSOAIZ,BS,9045,4127,7371,3281,3386,1887,3985,1394,17,12,734,399,284,157,450,242,242,,,,868,396,782,358,10,4,68,30,8,4,38,55,39
E02003073,North Somerset 009,Middle Super Output Areas and Intermediate Zones,MSOAIZ,BS,6546,2651,5826,2341,2426,1233,3400,1108,13,5,142,90,41,29,101,61,61,,,,525,197,476,176,0,0,41,18,8,3,21,40,18
E02003074,North Somerset 010,Middle Super Output Areas and Intermediate Zones,MSOAIZ,BS,7967,3448,6456,2749,2167,1180,4289,1569,68,21,286,136,125,52,161,84,84,,,,1136,527,1025,477,2,1,106,47,3,2,50,21,15
E02003075,North Somerset 011,Middle Super Output Areas and Intermediate Zones,MSOAIZ,BS,5747,2288,5012,1954,2146,1061,2866,893,12,3,258,128,109,56,149,72,72,,,,428,179,367,157,11,4,49,17,1,1,22,37,24
E02003076,North Somerset 012,Middle Super Output Areas and Intermediate Zones,MSOAIZ,BS,9177,3761,7513,2989,2874,1439,4639,1550,87,33,638,314,220,103,418,211,211,,,,860,379,757,332,2,2,92,40,9,5,47,79,46
E02003077,North Somerset 013,Middle Super Output Areas and Intermediate Zones,MSOAIZ,BS,5974,2491,4962,2012,2264,1132,2698,880,43,15,238,124,90,54,148,70,70,,,,663,309,572,262,10,5,76,39,5,3,47,68,31
E02003078,North Somerset 014,Middle Super Output Areas and Intermediate Zones,MSOAIZ,BS,6717,2756,5366,2183,2173,1092,3193,1091,23,7,420,194,165,79,255,115,115,,,,844,342,759,302,10,2,61,30,14,8,40,64,30
E02003079,North Somerset 015,Middle Super Output Areas and Intermediate Zones,MSOAIZ,BS,9599,3905,7565,3037,2234,1175,5331,1862,102,40,352,194,159,82,193,112,112,,,,1513,592,1364,533,8,2,131,52,10,5,59,67,42
E02003080,North Somerset 016,Middle Super Output Areas and Intermediate Zones,MSOAIZ,BS,8580,3917,6294,2921,2900,1669,3394,1252,57,24,827,421,281,142,546,279,279,,,,1326,503,1187,450,6,2,123,47,10,4,53,76,48
E02003081,North Somerset 017,Middle Super Output Areas and Intermediate Zones,MSOAIZ,BS,9166,4126,7736,3441,3409,1915,4327,1526,27,10,414,206,216,106,198,100,100,,,,925,427,823,379,4,2,92,43,6,3,48,64,42
E02003082,North Somerset 018,Middle Super Output Areas and Intermediate Zones,MSOAIZ,BS,7985,4453,5011,2580,2423,1444,2588,1136,11,6,277,179,55,36,222,143,143,,,,2624,1647,2474,1565,12,3,126,70,12,9,82,62,41
E02003084,North Somerset 020,Middle Super Output Areas and Intermediate Zones,MSOAIZ,BS,8956,4665,4556,2179,1834,1113,2722,1066,35,19,837,504,267,160,570,344,344,,,,3436,1905,3256,1806,27,13,135,77,18,9,99,92,58
E02003085,North Somerset 021,Middle Super Output Areas and Intermediate Zones,MSOAIZ,BS,7492,3307,2665,1114,727,402,1938,712,73,28,3593,1626,1955,890,1638,736,736,,,,1041,461,979,434,2,2,58,24,2,1,27,120,78
E02003086,North Somerset 022,Middle Super Output Areas and Intermediate Zones,MSOAIZ,BS,5665,2810,3819,1736,1636,923,2183,813,12,6,295,214,14,6,281,208,208,,,,1487,828,1422,786,4,2,56,35,5,5,42,52,26
E02003087,North Somerset 023,Middle Super Output Areas and Intermediate Zones,MSOAIZ,BS,9157,4029,7579,3381,3515,1932,4064,1449,20,10,492,212,266,109,226,103,103,,,,1001,391,892,339,2,2,90,43,17,7,52,65,35
E02003088,North Somerset 024,Middle Super Output Areas and Intermediate Zones,MSOAIZ,BS,8042,3451,6530,2744,3215,1645,3315,1099,25,15,430,232,178,89,252,143,143,,,,973,413,848,356,54,30,53,21,18,6,57,84,47
E02003089,North Somerset 025,Middle Super Output Areas and Intermediate Zones,MSOAIZ,BS,5700,2532,3950,1800,1913,1061,2037,739,23,12,891,392,517,227,374,165,165,,,,786,290,671,245,20,6,93,38,2,1,45,50,38
E02003090,South Gloucestershire 001,Middle Super Output Areas and Intermediate Zones,MSOAIZ,GL,6548,2802,5327,2279,2431,1280,2896,999,7,4,449,182,84,38,365,144,144,,,,709,301,629,269,4,1,71,28,5,3,32,56,36
E02003091,South Gloucestershire 002,Middle Super Output Areas and Intermediate Zones,MSOAIZ,GL,6573,2756,5132,2092,2098,1081,3034,1011,26,13,828,398,158,68,670,330,330,,,,541,222,453,184,6,5,69,25,13,8,38,46,31
E02003092,South Gloucestershire 003,Middle Super Output Areas and Intermediate Zones,MSOAIZ,GL,7342,2801,5986,2236,2244,1033,3742,1203,42,18,600,253,121,56,479,197,197,,,,631,249,563,220,24,9,37,17,7,3,29,83,45
E02003093,South Gloucestershire 004,Middle Super Output Areas and Intermediate Zones,MSOAIZ,GL,6514,2726,5473,2249,2714,1349,2759,900,21,10,296,146,51,27,245,119,119,,,,641,279,555,247,5,2,73,26,8,4,32,83,42
E02003094,South Gloucestershire 005,Middle Super Output Areas and Intermediate Zones,MSOAIZ,BS,8299,3319,6638,2631,2395,1202,4243,1429,66,29,595,239,126,58,469,181,181,,,,944,387,813,333,37,12,75,33,19,9,54,56,33
E02003095,South Gloucestershire 006,Middle Super Output Areas and Intermediate Zones,MSOAIZ,BS,6947,2723,5859,2261,1997,988,3862,1273,39,18,366,135,29,14,337,121,121,,,,634,289,582,263,5,2,42,21,5,3,26,49,20
E02003096,South Gloucestershire 007,Middle Super Output Areas and Intermediate Zones,MSOAIZ,BS,6451,2719,4772,1987,1360,741,3412,1246,22,8,680,251,209,77,471,174,174,,,,945,453,868,408,1,1,76,44,0,0,45,32,20
E02003097,South Gloucestershire 008,Middle Super Output Areas and Intermediate Zones,MSOAIZ,BS,6155,2681,4960,2119,2156,1155,2804,964,64,28,510,241,108,52,402,189,189,,,,580,267,524,236,4,2,52,29,0,0,31,41,26
E02003098,South Gloucestershire 009,Middle Super Output Areas and Intermediate Zones,MSOAIZ,BS,10021,4145,7248,2863,1426,767,5822,2096,39,14,87,35,9,3,78,32,32,,,,2584,1200,2512,1168,0,0,65,28,7,4,32,63,33
E02003099,South Gloucestershire 010,Middle Super Output Areas and Intermediate Zones,MSOAIZ,BS,6770,2842,5478,2295,2047,1112,3431,1183,13,7,442,207,71,29,371,178,178,,,,803,310,720,271,10,3,64,31,9,5,39,34,23
E02003100,South Gloucestershire 011,Middle Super Output Areas and Intermediate Zones,MSOAIZ,BS,10494,4514,7462,3177,2598,1410,4864,1767,32,14,1807,804,417,180,1390,624,624,,,,1098,465,1004,427,9,2,80,33,5,3,38,95,54
E02003101,South Gloucestershire 012,Middle Super Output Areas and Intermediate Zones,MSOAIZ,BS,10560,4289,7023,2766,1448,704,5575,2062,30,13,870,312,13,6,857,306,306,,,,2600,1182,2472,1126,11,4,107,46,10,6,56,37,16
E02003102,South Gloucestershire 013,Middle Super Output Areas and Intermediate Zones,MSOAIZ,BS,6495,2577,5428,2133,2268,1120,3160,1013,16,6,600,236,150,60,450,176,176,,,,395,166,358,150,4,1,33,15,0,0,16,56,36
E02003103,South Gloucestershire 014,Middle Super Output Areas and Intermediate Zones,MSOAIZ,BS,7198,2793,5773,2248,1558,782,4215,1466,10,5,138,73,9,7,129,66,66,,,,1259,458,1139,413,0,0,119,44,1,1,45,18,9
E02003104,South Gloucestershire 015,Middle Super Output Areas and Intermediate Zones,MSOAIZ,BS,7654,3196,5892,2400,1976,1015,3916,1385,44,17,785,377,185,94,600,283,283,,,,893,376,824,341,10,4,53,28,6,3,35,40,26
E02003105,South Gloucestershire 016,Middle Super Output Areas and Intermediate Zones,MSOAIZ,BS,6207,2554,5184,2062,2367,1158,2817,904,18,11,548,278,129,64,419,214,214,,,,420,181,364,157,0,0,51,22,5,2,24,37,22
E02003106,South Gloucestershire 017,Middle Super Output Areas and Intermediate Zones,MSOAIZ,BS,8577,3596,5761,2390,1929,988,3832,1402,86,36,782,266,48,19,734,247,247,,,,1848,838,1638,745,51,22,109,54,50,17,93,100,66
E02003107,South Gloucestershire 018,Middle Super Output Areas and Intermediate Zones,MSOAIZ,BS,10531,4514,6810,2912,2680,1456,4130,1456,60,26,1252,611,278,130,974,481,481,,,,2323,909,2197,855,9,6,95,40,22,8,54,86,56
E02003108,South Gloucestershire 019,Middle Super Output Areas and Intermediate Zones,MSOAIZ,BS,9144,3813,7471,3047,2843,1414,4628,1633,89,41,836,351,93,55,743,296,296,,,,674,329,589,284,8,6,63,35,14,4,45,74,45
E02003109,South Gloucestershire 020,Middle Super Output Areas and Intermediate Zones,MSOAIZ,BS,5985,2445,5503,2230,2411,1255,3092,975,6,4,119,58,38,17,81,41,41,,,,321,137,307,129,0,0,13,7,1,1,8,36,16
E02003110,South Gloucestershire 021,Middle Super Output Areas and Intermediate Zones,MSOAIZ,BS,10360,3998,8065,3056,1984,1007,6081,2049,4,4,184,67,11,3,173,64,64,,,,2061,845,1507,654,322,101,83,39,149,51,191,46,26
E02003111,South Gloucestershire 022,Middle Super Output Areas and Intermediate Zones,MSOAIZ,BS,6206,2689,5313,2176,2085,1113,3228,1063,15,6,247,201,32,30,215,171,171,,,,585,278,539,254,5,2,41,22,0,0,24,46,28
E02003112,South Gloucestershire 023,Middle Super Output Areas and Intermediate Zones,MSOAIZ,BS,6381,2635,4087,1615,1477,749,2610,866,36,17,1577,710,377,145,1200,565,565,,,,602,253,499,213,5,2,93,36,5,2,40,79,40
E02003113,South Gloucestershire 024,Middle Super Output Areas and Intermediate Zones,MSOAIZ,SN,10117,4161,7439,2943,3371,1584,4068,1359,34,18,1085,444,161,66,924,378,378,,,,1300,615,1115,531,51,26,104,44,30,14,84,259,141
E02003114,South Gloucestershire 025,Middle Super Output Areas and Intermediate Zones,MSOAIZ,BS,6956,3133,5404,2314,2315,1225,3089,1089,12,8,735,420,138,75,597,345,345,,,,762,359,692,330,9,4,56,22,5,3,29,43,32
E02003115,South Gloucestershire 026,Middle Super Output Areas and Intermediate Zones,MSOAIZ,BS,9000,3994,6377,2697,2351,1227,4026,1470,44,23,989,480,273,129,716,351,351,,,,1518,744,1382,683,10,5,103,43,23,13,61,72,50
E02003116,South Gloucestershire 027,Middle Super Output Areas and Intermediate Zones,MSOAIZ,BS,7482,3264,4634,1954,1815,970,2819,984,45,14,1871,853,369,175,1502,678,678,,,,846,389,770,351,0,0,58,30,18,8,38,86,54
E02003117,South Gloucestershire 028,Middle Super Output Areas and Intermediate Zones,MSOAIZ,BS,8462,3615,6123,2509,2149,1118,3974,1391,59,25,958,445,166,76,792,369,369,,,,1245,583,1129,525,14,7,90,43,12,8,58,77,53
E02003118,South Gloucestershire 029,Middle Super Output Areas and Intermediate Zones,MSOAIZ,BS,10091,4250,8023,3269,2302,1197,5721,2072,70,33,889,389,157,69,732,320,320,,,,1074,538,967,488,1,1,102,47,4,2,50,35,21
E02003119,South Gloucestershire 030,Middle Super Output Areas and Intermediate Zones,MSOAIZ,BS,10259,4163,7406,2945,2510,1239,4896,1706,9,4,2020,825,361,182,1659,643,643,,,,726,331,649,289,3,1,59,31,15,10,42,98,58
E02003120,South Gloucestershire 031,Middle Super Output Areas and Intermediate Zones,MSOAIZ,BS,8333,3531,7166,2930,3140,1617,4026,1313,24,12,485,261,87,45,398,216,216,,,,612,294,531,246,3,1,72,43,6,4,48,46,34
E02003121,South Gloucestershire 032,Middle Super Output Areas and Intermediate Zones,MSOAIZ,BS,10095,4300,9035,3801,3860,1994,5175,1807,26,11,222,85,33,14,189,71,71,,,,758,373,685,334,3,1,64,33,6,5,39,54,30
E02003122,Plymouth 001,Middle Super Output Areas and Intermediate Zones,MSOAIZ,PL,6644,2843,5329,2367,2773,1461,2556,906,78,29,321,125,157,61,164,64,64,,,,862,297,435,166,238,66,44,19,145,46,131,54,25
E02003123,Plymouth 002,Middle Super Output Areas and Intermediate Zones,MSOAIZ,PL,8018,3508,4721,2034,1663,903,3058,1131,65,31,2409,1092,1401,631,1008,461,461,,,,779,318,706,288,6,3,59,24,8,3,30,44,33
E02003124,Plymouth 003,Middle Super Output Areas and Intermediate Zones,MSOAIZ,PL,7758,3333,4420,1885,1381,747,3039,1138,57,27,2280,1014,1554,685,726,329,329,,,,949,373,852,328,0,0,82,38,15,7,45,52,34
E02003125,Plymouth 004,Middle Super Output Areas and Intermediate Zones,MSOAIZ,PL,5971,2648,3441,1497,1280,681,2161,816,22,11,1886,855,1254,538,632,317,317,,,,563,247,477,206,0,0,73,34,13,7,41,59,38
E02003126,Plymouth 005,Middle Super Output Areas and Intermediate Zones,MSOAIZ,PL,6779,2909,4684,1897,1683,811,3001,1086,17,7,1357,675,561,276,796,399,399,,,,656,291,553,225,36,28,44,19,23,19,66,65,39
E02003127,Plymouth 006,Middle Super Output Areas and Intermediate Zones,MSOAIZ,PL,7506,3060,4148,1760,1408,775,2740,985,103,41,2581,968,1749,628,832,340,340,,,,619,255,568,227,4,4,34,18,13,6,28,55,36
E02003128,Plymouth 007,Middle Super Output Areas and Intermediate Zones,MSOAIZ,PL,8553,3823,4351,1912,1483,830,2868,1082,123,62,2835,1305,1824,807,1011,498,498,,,,1163,489,1065,447,6,2,84,35,8,5,42,81,55
E02003129,Plymouth 008,Middle Super Output Areas and Intermediate Zones,MSOAIZ,PL,6518,2760,4087,1777,1737,949,2350,828,12,5,998,501,301,140,697,361,361,,,,1363,447,464,173,566,168,40,17,293,89,274,58,30
E02003130,Plymouth 009,Middle Super Output Areas and Intermediate Zones,MSOAIZ,PL,10224,4392,5939,2635,2046,1135,3893,1500,31,11,2850,1168,1025,422,1825,746,746,,,,1328,530,1181,466,14,6,111,47,22,11,64,76,48
E02003131,Plymouth 010,Middle Super Output Areas and Intermediate Zones,MSOAIZ,PL,7499,3193,4824,2036,1615,855,3209,1181,43,21,1774,794,677,306,1097,488,488,,,,816,311,685,265,7,2,109,38,15,6,46,42,31
E02003132,Plymouth 011,Middle Super Output Areas and Intermediate Zones,MSOAIZ,PL,7891,3398,5687,2397,2091,1122,3596,1275,44,19,1182,575,730,341,452,234,234,,,,915,372,798,326,29,7,74,32,14,7,46,63,35
E02003133,Plymouth 012,Middle Super Output Areas and Intermediate Zones,MSOAIZ,PL,7315,3012,5505,2304,2123,1110,3382,1194,20,10,1107,420,553,177,554,243,243,,,,638,251,550,213,18,6,53,24,17,8,38,45,27
E02003134,Plymouth 013,Middle Super Output Areas and Intermediate Zones,MSOAIZ,PL,6921,2735,3241,1351,1027,544,2214,807,41,18,3018,1107,2078,724,940,383,383,,,,548,216,483,183,5,2,49,25,11,6,33,73,43
E02003135,Plymouth 014,Middle Super Output Areas and Intermediate Zones,MSOAIZ,PL,7264,3008,3147,1412,919,510,2228,902,10,5,2923,1099,767,304,2156,795,795,,,,1138,466,1036,422,4,1,69,27,29,16,44,46,26
E02003136,Plymouth 015,Middle Super Output Areas and Intermediate Zones,MSOAIZ,PL,7655,3286,6576,2787,2901,1549,3675,1238,25,16,390,162,112,45,278,117,117,,,,622,292,563,266,5,2,45,20,9,4,26,42,29
E02003137,Plymouth 016,Middle Super Output Areas and Intermediate Zones,MSOAIZ,PL,7613,3125,6449,2590,2515,1285,3934,1305,2,2,262,163,39,17,223,146,146,,,,844,341,663,278,59,17,56,27,66,19,63,56,29
E02003138,Plymouth 017,Middle Super Output Areas and Intermediate Zones,MSOAIZ,PL,7445,3138,5416,2307,1807,948,3609,1359,39,16,113,49,12,4,101,45,45,,,,1834,742,1699,682,14,5,104,48,17,7,60,43,24
E02003139,Plymouth 018,Middle Super Output Areas and Intermediate Zones,MSOAIZ,PL,6506,2544,5136,2025,1383,681,3753,1344,178,57,305,101,33,9,272,92,92,,,,876,354,785,319,4,2,85,32,2,1,35,11,7
E02003140,Plymouth 019,Middle Super Output Areas and Intermediate Zones,MSOAIZ,PL,7582,3126,6545,2725,2422,1322,4123,1403,58,22,188,82,44,15,144,67,67,,,,760,277,683,244,7,2,69,30,1,1,33,31,20
E02003141,Plymouth 020,Middle Super Output Areas and Intermediate Zones,MSOAIZ,PL,7819,3690,4562,2050,1450,775,3112,1275,24,9,660,321,126,71,534,250,250,,,,2506,1274,2314,1183,11,3,164,80,17,8,91,67,36
E02003142,Plymouth 021,Middle Super Output Areas and Intermediate Zones,MSOAIZ,PL,9014,3877,5050,2225,1595,871,3455,1354,134,56,2414,1006,1076,427,1338,579,579,,,,1349,551,1161,480,47,13,117,50,24,8,71,67,39
E02003143,Plymouth 022,Middle Super Output Areas and Intermediate Zones,MSOAIZ,PL,7718,3295,5489,2311,1984,1039,3505,1272,51,23,941,480,262,117,679,363,363,,,,1189,452,713,293,260,78,67,33,149,48,159,48,29
E02003144,Plymouth 023,Middle Super Output Areas and Intermediate Zones,MSOAIZ,PL,8293,3257,2421,1116,955,515,1466,601,22,10,107,36,19,7,88,29,29,,,,5702,2074,5526,2006,23,8,135,51,18,9,68,41,21
E02003145,Plymouth 024,Middle Super Output Areas and Intermediate Zones,MSOAIZ,PL,6674,3049,3941,1712,1420,767,2521,945,79,38,737,370,328,149,409,221,221,,,,1835,894,1674,829,18,7,127,52,16,6,65,82,35
E02003146,Plymouth 025,Middle Super Output Areas and Intermediate Zones,MSOAIZ,PL,8801,3522,3950,1732,1328,682,2622,1050,51,19,390,150,167,63,223,87,87,,,,4332,1576,4013,1456,21,8,279,105,19,7,120,78,45
E02003147,Plymouth 026,Middle Super Output Areas and Intermediate Zones,MSOAIZ,PL,7575,3579,1536,765,534,304,1002,461,151,63,4338,1963,2053,971,2285,992,992,,,,1469,730,1363,682,16,3,70,32,20,13,48,81,58
E02003148,Plymouth 027,Middle Super Output Areas and Intermediate Zones,MSOAIZ,PL,8485,4376,1640,938,807,491,833,447,57,32,2578,1504,1082,601,1496,903,903,,,,4093,1834,3867,1718,24,12,118,70,84,34,116,117,68
E02003149,Plymouth 028,Middle Super Output Areas and Intermediate Zones,MSOAIZ,PL,9213,4158,3233,1542,1061,618,2172,924,151,71,1325,660,250,104,1075,556,556,,,,4397,1822,4121,1698,21,7,234,104,21,13,124,107,63
E02003150,Plymouth 029,Middle Super Output Areas and Intermediate Zones,MSOAIZ,PL,11277,6100,3144,1620,1240,755,1904,865,78,46,3213,1831,1143,563,2070,1268,1268,,,,4722,2531,4423,2380,52,18,169,86,78,47,151,120,72
E02003151,Plymouth 030,Middle Super Output Areas and Intermediate Zones,MSOAIZ,PL,7333,3213,6207,2734,3218,1718,2989,1016,13,7,322,175,119,66,203,109,109,,,,738,260,493,179,110,32,56,26,79,23,81,53,37
E02003152,Plymouth 031,Middle Super Output Areas and Intermediate Zones,MSOAIZ,PL,9363,3971,7590,3180,3110,1658,4480,1522,74,28,398,209,215,109,183,100,100,,,,1220,503,1021,427,79,20,75,39,45,17,76,81,51
E02003153,Plymouth 032,Middle Super Output Areas and Intermediate Zones,MSOAIZ,PL,7873,3379,5662,2534,2423,1352,3239,1182,54,29,270,135,56,25,214,110,110,,,,1844,656,911,376,543,155,73,33,317,92,280,43,25
E02003154,Torbay 001,Middle Super Output Areas and Intermediate Zones,MSOAIZ,TQ,7154,3038,4394,1958,1771,977,2623,981,56,24,1741,692,336,126,1405,566,566,,,,925,340,789,289,1,1,122,44,13,6,51,38,24
E02003155,Torbay 002,Middle Super Output Areas and Intermediate Zones,MSOAIZ,TQ,5585,2568,3772,1672,1564,880,2208,792,54,20,232,105,22,8,210,97,97,,,,1452,731,1331,673,4,1,103,45,14,12,58,75,40
E02003156,Torbay 003,Middle Super Output Areas and Intermediate Zones,MSOAIZ,TQ,9380,3944,6383,2698,2228,1173,4155,1525,157,58,838,375,75,32,763,343,343,,,,1952,783,1760,705,14,6,174,69,4,3,78,50,30
E02003157,Torbay 004,Middle Super Output Areas and Intermediate Zones,MSOAIZ,TQ,6088,2819,3404,1483,1280,662,2124,821,123,58,904,449,130,53,774,396,396,,,,1623,807,1517,751,1,1,92,47,13,8,56,34,22
E02003158,Torbay 005,Middle Super Output Areas and Intermediate Zones,MSOAIZ,TQ,5287,2529,3626,1724,1651,985,1975,739,21,8,370,177,34,21,336,156,156,,,,1215,579,1093,527,5,3,110,44,7,5,52,55,41
E02003159,Torbay 006,Middle Super Output Areas and Intermediate Zones,MSOAIZ,TQ,5624,2449,3775,1597,1171,632,2604,965,23,10,194,84,10,4,184,80,80,,,,1609,747,1458,681,13,3,134,61,4,2,66,23,11
E02003161,Torbay 008,Middle Super Output Areas and Intermediate Zones,MSOAIZ,TQ,6461,3553,2519,1275,1055,634,1464,641,106,46,528,324,26,13,502,311,311,,,,3217,1851,3082,1778,27,11,94,52,14,10,73,91,57
E02003163,Torbay 010,Middle Super Output Areas and Intermediate Zones,MSOAIZ,TQ,7369,4109,4899,2597,2835,1684,2064,913,40,25,202,139,10,4,192,135,135,,,,2169,1308,2051,1249,13,6,95,45,10,8,59,59,40
E02003164,Torbay 011,Middle Super Output Areas and Intermediate Zones,MSOAIZ,TQ,8634,3821,7111,3137,3232,1788,3879,1349,25,13,190,76,23,7,167,69,69,,,,1226,549,1127,498,4,3,92,45,3,3,51,82,46
E02003165,Torbay 012,Middle Super Output Areas and Intermediate Zones,MSOAIZ,TQ,7020,3038,5631,2446,2303,1242,3328,1204,26,14,165,66,18,10,147,56,56,,,,1170,494,1065,448,3,1,93,43,9,2,46,28,18
E02003166,Torbay 013,Middle Super Output Areas and Intermediate Zones,MSOAIZ,TQ,10475,4349,6332,2749,2490,1349,3842,1400,281,105,2055,844,264,103,1791,741,741,,,,1746,621,1599,572,8,2,132,41,7,6,49,61,30
E02003167,Torbay 014,Middle Super Output Areas and Intermediate Zones,MSOAIZ,TQ,8432,4448,4486,2189,2201,1298,2285,891,24,16,552,361,66,35,486,326,326,,,,3296,1838,3098,1736,7,4,172,86,19,12,102,74,44
E02003168,Torbay 015,Middle Super Output Areas and Intermediate Zones,MSOAIZ,TQ,6866,3081,5273,2332,2316,1268,2957,1064,192,74,288,200,23,13,265,187,187,,,,1068,453,933,393,14,7,116,49,5,4,60,45,22
E02003169,Torbay 016,Middle Super Output Areas and Intermediate Zones,MSOAIZ,TQ,6593,3027,5647,2624,3270,1779,2377,845,10,5,250,100,16,6,234,94,94,,,,635,265,577,232,9,4,45,27,4,2,33,51,33
E02003170,Torbay 017,Middle Super Output Areas and Intermediate Zones,MSOAIZ,TQ,9216,4500,6575,3199,3657,2056,2918,1143,54,36,472,264,36,17,436,247,247,,,,2052,957,1843,866,12,7,180,76,17,8,91,63,44
E02003171,Torbay 018,Middle Super Output Areas and Intermediate Zones,MSOAIZ,TQ,7252,3236,5266,2377,2442,1348,2824,1029,72,30,646,282,78,31,568,251,251,,,,1197,508,1064,447,5,2,119,53,9,6,61,71,39
E02003172,Bournemouth 001,Middle Super Output Areas and Intermediate Zones,MSOAIZ,BH,6225,2688,3991,1804,1715,985,2276,819,47,17,1416,552,881,348,535,204,204,,,,709,275,653,245,2,1,49,27,5,2,30,62,40
E02003173,Bournemouth 002,Middle Super Output Areas and Intermediate Zones,MSOAIZ,BH,6595,3027,4292,2040,1933,1089,2359,951,23,9,1459,627,1224,541,235,86,86,,,,759,309,692,276,5,3,62,30,0,0,33,62,42
E02003174,Bournemouth 003,Middle Super Output Areas and Intermediate Zones,MSOAIZ,BH,8021,3486,6535,2828,2750,1517,3785,1311,26,15,321,170,195,105,126,65,65,,,,1086,441,996,399,1,1,79,35,10,6,42,53,32
E02003175,Bournemouth 004,Middle Super Output Areas and Intermediate Zones,MSOAIZ,BH,8925,3750,6616,2807,2166,1200,4450,1607,96,42,634,291,378,164,256,127,127,,,,1525,582,1384,527,10,3,124,49,7,3,55,54,28
E02003176,Bournemouth 005,Middle Super Output Areas and Intermediate Zones,MSOAIZ,BH,7012,2976,2948,1263,985,522,1963,741,88,30,3157,1365,2470,1123,687,242,242,,,,749,274,674,247,8,1,54,22,13,4,27,70,44
E02003177,Bournemouth 006,Middle Super Output Areas and Intermediate Zones,MSOAIZ,BH,7971,3188,6505,2606,2128,1118,4377,1488,26,13,113,57,21,15,92,42,42,,,,1263,483,1147,438,7,2,96,37,13,6,45,64,29
E02003178,Bournemouth 007,Middle Super Output Areas and Intermediate Zones,MSOAIZ,BH,8292,3417,5391,2253,1916,1004,3475,1249,38,15,1142,533,881,411,261,122,122,,,,1641,574,1496,518,15,4,101,39,29,13,56,80,42
E02003179,Bournemouth 008,Middle Super Output Areas and Intermediate Zones,MSOAIZ,BH,6425,2766,3507,1496,1363,737,2144,759,71,23,2116,954,1501,703,615,251,251,,,,675,257,610,229,0,0,55,22,10,6,28,56,36
E02003180,Bournemouth 009,Middle Super Output Areas and Intermediate Zones,MSOAIZ,BH,9410,3617,4411,1794,1382,715,3029,1079,57,20,736,404,291,162,445,242,242,,,,4152,1366,3974,1290,6,4,141,63,31,9,76,54,33
E02003181,Bournemouth 010,Middle Super Output Areas and Intermediate Zones,MSOAIZ,BH,8380,3341,5947,2405,1995,1015,3952,1390,17,5,235,134,51,24,184,110,110,,,,2120,769,1971,707,1,1,138,57,10,4,62,61,28
E02003182,Bournemouth 011,Middle Super Output Areas and Intermediate Zones,MSOAIZ,BH,6503,2689,5174,2064,1953,994,3221,1070,5,3,126,91,50,42,76,49,49,,,,1165,509,1015,411,63,46,50,21,37,31,98,33,22
E02003183,Bournemouth 012,Middle Super Output Areas and Intermediate Zones,MSOAIZ,BH,6869,2765,4453,1847,1981,994,2472,853,14,6,260,138,35,12,225,126,126,,,,2104,751,2024,718,11,5,56,23,13,5,33,38,23
E02003184,Bournemouth 013,Middle Super Output Areas and Intermediate Zones,MSOAIZ,BH,7751,3171,3618,1563,1065,559,2553,1004,80,38,232,116,45,28,187,88,88,,,,3778,1429,3604,1346,8,5,128,62,38,16,83,43,25
E02003185,Bournemouth 014,Middle Super Output Areas and Intermediate Zones,MSOAIZ,BH,7498,3035,5384,2173,1786,916,3598,1257,26,10,889,352,428,194,461,158,158,,,,1134,459,1041,420,5,2,79,32,9,5,39,65,41
E02003186,Bournemouth 015,Middle Super Output Areas and Intermediate Zones,MSOAIZ,BH,8795,3684,4220,1794,1206,628,3014,1166,43,22,957,397,125,86,832,311,311,,,,3525,1444,3373,1381,2,2,114,48,36,13,63,50,27
E02003187,Bournemouth 016,Middle Super Output Areas and Intermediate Zones,MSOAIZ,BH,8962,4015,5061,2232,1848,996,3213,1236,66,34,547,281,65,22,482,259,259,,,,3228,1433,3045,1355,11,3,151,66,21,9,78,60,35
E02003188,Bournemouth 017,Middle Super Output Areas and Intermediate Zones,MSOAIZ,BH,9183,5433,3286,1955,1419,982,1867,973,33,23,981,825,351,310,630,515,515,,,,4808,2579,4580,2455,14,8,159,84,55,32,124,75,51
E02003189,Bournemouth 018,Middle Super Output Areas and Intermediate Zones,MSOAIZ,BH,7918,3935,5085,2362,2187,1223,2898,1139,26,10,429,295,65,44,364,251,251,,,,2316,1235,2185,1162,8,4,114,63,9,6,73,62,33
E02003190,Bournemouth 019,Middle Super Output Areas and Intermediate Zones,MSOAIZ,BH,9406,5441,2571,1494,972,643,1599,851,135,69,840,489,261,172,579,317,317,,,,5775,3344,5616,3244,17,10,114,77,28,13,100,85,45
E02003191,Bournemouth 020,Middle Super Output Areas and Intermediate Zones,MSOAIZ,BH,7862,3840,6094,2903,3223,1832,2871,1071,22,11,277,155,40,24,237,131,131,,,,1409,735,1335,695,2,2,69,36,3,2,40,60,36
E02003192,Bournemouth 021,Middle Super Output Areas and Intermediate Zones,MSOAIZ,BH,9154,5008,3110,1811,1748,1105,1362,706,80,38,809,529,235,192,574,337,337,,,,5027,2551,4822,2439,48,23,128,75,29,14,112,128,79
E02003194,Poole 001,Middle Super Output Areas and Intermediate Zones,MSOAIZ,BH,5795,2440,5094,2133,2407,1251,2687,882,16,6,115,78,67,46,48,32,32,,,,480,184,398,148,49,20,27,13,6,3,36,90,39
E02003195,Poole 002,Middle Super Output Areas and Intermediate Zones,MSOAIZ,BH,5510,2176,4037,1633,1285,645,2752,988,19,13,809,289,628,230,181,59,59,,,,616,224,545,196,2,1,64,24,5,3,28,29,17
E02003196,Poole 003,Middle Super Output Areas and Intermediate Zones,MSOAIZ,BH,10206,4197,9509,3880,4398,2278,5111,1602,6,3,123,78,108,66,15,12,12,,,,519,207,470,185,13,4,36,18,0,0,22,49,29
E02003197,Poole 004,Middle Super Output Areas and Intermediate Zones,MSOAIZ,BH,6815,2809,4902,1983,1710,844,3192,1139,66,23,918,459,430,224,488,235,235,,,,903,327,828,301,0,0,64,22,11,4,26,26,17
E02003198,Poole 005,Middle Super Output Areas and Intermediate Zones,MSOAIZ,BH,7205,2898,5263,2126,1762,898,3501,1228,97,39,786,276,47,14,739,262,262,,,,1018,437,921,397,24,7,65,30,8,3,40,41,20
E02003199,Poole 006,Middle Super Output Areas and Intermediate Zones,MSOAIZ,BH,9167,3986,6939,3033,2479,1355,4460,1678,48,21,1109,496,832,358,277,138,138,,,,1029,410,912,366,6,3,111,41,0,0,44,42,26
E02003200,Poole 007,Middle Super Output Areas and Intermediate Zones,MSOAIZ,BH,9937,4139,5969,2635,2259,1238,3710,1397,77,30,2321,872,1647,646,674,226,226,,,,1465,548,1323,489,0,0,107,49,35,10,59,105,54
E02003201,Poole 008,Middle Super Output Areas and Intermediate Zones,MSOAIZ,BH,10563,4458,6862,2829,2286,1201,4576,1628,190,79,1639,784,1105,546,534,238,238,,,,1791,708,1652,650,0,0,123,51,16,7,58,81,58
E02003202,Poole 009,Middle Super Output Areas and Intermediate Zones,MSOAIZ,BH,5863,2671,3688,1667,1434,770,2254,897,21,9,799,407,52,22,747,385,385,,,,1327,571,1216,524,7,3,89,37,15,7,47,28,17
E02003203,Poole 010,Middle Super Output Areas and Intermediate Zones,MSOAIZ,BH,7409,3173,5366,2323,1689,922,3677,1401,83,39,450,205,145,81,305,124,124,,,,1470,580,1373,537,6,2,87,37,4,4,43,40,26
E02003204,Poole 011,Middle Super Output Areas and Intermediate Zones,MSOAIZ,BH,8536,3781,5899,2558,2396,1257,3503,1301,18,7,1022,506,540,256,482,250,250,,,,1539,671,1439,618,16,8,70,38,14,7,53,58,39
E02003205,Poole 012,Middle Super Output Areas and Intermediate Zones,MSOAIZ,BH,8234,3354,6679,2733,2613,1398,4066,1335,50,27,539,257,440,215,99,42,42,,,,917,308,818,273,34,7,63,27,2,1,35,49,29
E02003206,Poole 013,Middle Super Output Areas and Intermediate Zones,MSOAIZ,BH,9441,4077,7201,2992,2685,1406,4516,1586,8,3,268,166,61,35,207,131,131,,,,1887,875,1792,830,20,10,68,32,7,3,45,77,41
E02003207,Poole 014,Middle Super Output Areas and Intermediate Zones,MSOAIZ,BH,7041,2861,3713,1604,1428,759,2285,845,60,21,1703,647,1247,474,456,173,173,,,,1524,563,955,377,393,119,65,32,111,35,186,41,26
E02003208,Poole 015,Middle Super Output Areas and Intermediate Zones,MSOAIZ,BH,10121,5025,4625,2338,2192,1323,2433,1015,302,153,1954,1047,1073,582,881,465,465,,,,3103,1395,2903,1295,30,15,125,66,45,19,100,137,92
E02003209,Poole 016,Middle Super Output Areas and Intermediate Zones,MSOAIZ,BH,5994,2686,3814,1679,1532,814,2282,865,95,50,984,495,555,263,429,232,232,,,,1057,432,955,384,7,3,85,39,10,6,48,44,30
E02003210,Poole 017,Middle Super Output Areas and Intermediate Zones,MSOAIZ,BH,9030,4386,6723,3198,3269,1888,3454,1310,34,23,263,170,47,43,216,127,127,,,,1940,946,1827,891,7,4,85,40,21,11,55,70,49
E02003211,Poole 018,Middle Super Output Areas and Intermediate Zones,MSOAIZ,BH,8236,4413,6157,3358,4144,2472,2013,886,15,11,210,92,116,42,94,50,50,,,,1755,889,1653,832,8,4,83,47,11,6,57,99,63
E02003212,Swindon 001,Middle Super Output Areas and Intermediate Zones,MSOAIZ,SN,8212,3607,6142,2622,2492,1332,3650,1290,29,15,1082,535,802,405,280,130,130,,,,877,386,726,324,66,23,49,25,36,14,62,82,49
E02003214,Swindon 003,Middle Super Output Areas and Intermediate Zones,MSOAIZ,SN,6328,2745,2210,974,791,445,1419,529,18,9,3704,1591,3474,1514,230,77,77,,,,323,127,273,105,3,1,43,19,4,2,22,73,44
E02003215,Swindon 004,Middle Super Output Areas and Intermediate Zones,MSOAIZ,SN,6960,3068,5916,2535,2362,1228,3554,1307,14,7,346,219,175,95,171,124,124,,,,639,287,567,257,5,2,55,24,12,4,30,45,20
E02003216,Swindon 005,Middle Super Output Areas and Intermediate Zones,MSOAIZ,SN,9070,3911,6575,2801,2523,1354,4052,1447,26,13,1561,699,1287,556,274,143,143,,,,856,369,712,303,43,19,87,43,14,4,66,52,29
E02003217,Swindon 006,Middle Super Output Areas and Intermediate Zones,MSOAIZ,SN,6487,2775,4029,1644,1202,626,2827,1018,26,16,1755,819,1570,716,185,103,103,,,,629,265,583,242,3,2,43,21,0,0,23,48,31
E02003218,Swindon 007,Middle Super Output Areas and Intermediate Zones,MSOAIZ,SN,6566,2596,3411,1356,1003,522,2408,834,1,1,2605,1020,2260,876,345,144,144,,,,466,168,402,143,2,2,55,20,7,3,25,83,51
E02003219,Swindon 008,Middle Super Output Areas and Intermediate Zones,MSOAIZ,SN,6462,2536,5097,1959,2097,962,3000,997,26,11,560,233,438,188,122,45,45,,,,673,288,565,242,31,12,52,22,25,12,46,106,45
E02003220,Swindon 009,Middle Super Output Areas and Intermediate Zones,MSOAIZ,SN,10082,4321,8406,3492,3031,1592,5375,1900,34,21,523,310,294,159,229,151,151,,,,1064,468,967,421,10,5,85,40,2,2,47,55,30
E02003221,Swindon 010,Middle Super Output Areas and Intermediate Zones,MSOAIZ,SN,6448,2872,3810,1692,1127,636,2683,1056,10,7,1025,513,752,371,273,142,142,,,,1555,634,1426,582,25,6,86,39,18,7,52,48,26
E02003222,Swindon 011,Middle Super Output Areas and Intermediate Zones,MSOAIZ,SN,6306,2525,4802,1862,1006,470,3796,1392,52,21,474,210,263,123,211,87,87,,,,945,418,900,398,0,0,44,19,1,1,20,33,14
E02003223,Swindon 012,Middle Super Output Areas and Intermediate Zones,MSOAIZ,SN,9672,4306,6721,2879,1805,988,4916,1891,39,16,320,215,159,97,161,118,118,,,,2559,1177,2422,1117,10,4,115,51,12,5,60,33,19
E02003224,Swindon 013,Middle Super Output Areas and Intermediate Zones,MSOAIZ,SN,8742,3814,7492,3229,2925,1568,4567,1661,134,63,348,173,181,93,167,80,80,,,,740,329,667,297,6,2,66,29,1,1,32,28,20
E02003225,Swindon 014,Middle Super Output Areas and Intermediate Zones,MSOAIZ,SN,5954,2552,4629,1910,1281,652,3348,1258,55,24,100,40,75,28,25,12,12,,,,1152,568,1084,535,7,2,58,29,3,2,33,18,10
E02003226,Swindon 015,Middle Super Output Areas and Intermediate Zones,MSOAIZ,SN,8313,3345,3643,1339,842,438,2801,901,35,19,954,610,737,507,217,103,103,,,,3617,1341,3406,1256,10,5,155,64,46,16,85,64,36
E02003227,Swindon 016,Middle Super Output Areas and Intermediate Zones,MSOAIZ,SN,6328,2789,2054,833,614,326,1440,507,275,124,3431,1587,2848,1358,583,229,229,,,,486,191,442,173,0,0,42,17,2,1,18,82,54
E02003228,Swindon 017,Middle Super Output Areas and Intermediate Zones,MSOAIZ,SN,6585,2698,4829,2004,1842,974,2987,1030,37,21,368,161,80,26,288,135,135,,,,1299,485,1177,444,11,4,91,31,20,6,41,52,27
E02003229,Swindon 018,Middle Super Output Areas and Intermediate Zones,MSOAIZ,SN,5661,2300,4365,1748,979,498,3386,1250,109,56,423,174,66,26,357,148,148,,,,758,318,696,289,0,0,62,29,0,0,29,6,4
E02003230,Swindon 019,Middle Super Output Areas and Intermediate Zones,MSOAIZ,SN,7088,3548,3464,1709,975,594,2489,1115,69,43,267,170,79,31,188,139,139,,,,3247,1600,3115,1527,6,4,113,61,13,8,73,41,26
E02003231,Swindon 020,Middle Super Output Areas and Intermediate Zones,MSOAIZ,SN,8452,3445,3906,1559,1045,570,2861,989,82,31,3614,1538,3203,1380,411,158,158,,,,763,267,627,223,4,2,116,35,16,7,44,87,50
E02003232,Swindon 021,Middle Super Output Areas and Intermediate Zones,MSOAIZ,SN,7882,3522,5544,2317,1757,868,3787,1449,336,185,282,157,104,71,178,86,86,,,,1696,847,1597,799,8,4,80,36,11,8,48,24,16
E02003233,Swindon 022,Middle Super Output Areas and Intermediate Zones,MSOAIZ,SN,8859,3838,5250,2195,1530,803,3720,1392,38,13,2368,1173,1579,774,789,399,399,,,,1110,409,1003,372,1,1,87,28,19,8,37,93,48
E02003234,Swindon 023,Middle Super Output Areas and Intermediate Zones,MSOAIZ,SN,8655,3615,6130,2475,2013,1018,4117,1457,29,10,1599,804,794,349,805,455,455,,,,853,298,782,266,0,0,59,24,12,8,32,44,28
E02003235,Swindon 024,Middle Super Output Areas and Intermediate Zones,MSOAIZ,SN,7276,3349,5610,2510,2533,1393,3077,1117,169,79,629,302,51,19,578,283,283,,,,833,432,790,406,11,7,27,16,5,3,26,35,26
E02003236,Swindon 025,Middle Super Output Areas and Intermediate Zones,MSOAIZ,SN,10396,4403,7814,3267,3340,1720,4474,1547,124,54,1471,656,995,456,476,200,200,,,,889,371,703,301,72,23,51,22,63,25,70,98,55
E02003237,Peterborough 001,Middle Super Output Areas and Intermediate Zones,MSOAIZ,PE,6184,2600,5220,2133,2092,1042,3128,1091,34,20,299,165,105,52,194,113,113,,,,583,259,534,234,7,3,38,18,4,4,25,48,23
E02003238,Peterborough 002,Middle Super Output Areas and Intermediate Zones,MSOAIZ,PE,5927,2466,4081,1613,1003,493,3078,1120,86,44,812,399,228,96,584,303,303,,,,910,387,862,361,3,1,44,24,1,1,26,38,23
E02003239,Peterborough 003,Middle Super Output Areas and Intermediate Zones,MSOAIZ,PE,7815,3275,6652,2776,2440,1270,4212,1506,34,13,348,147,176,66,172,81,81,,,,733,318,654,286,10,4,63,25,6,3,32,48,21
E02003240,Peterborough 004,Middle Super Output Areas and Intermediate Zones,MSOAIZ,PE,6149,2480,3712,1521,1465,713,2247,808,23,11,546,238,151,62,395,176,176,,,,1761,662,742,329,590,187,12,8,417,138,333,107,48
E02003241,Peterborough 005,Middle Super Output Areas and Intermediate Zones,MSOAIZ,PE,6123,2567,4374,1814,1583,822,2791,992,66,26,797,337,276,115,521,222,222,,,,792,345,716,313,17,7,49,22,10,3,32,94,45
E02003242,Peterborough 006,Middle Super Output Areas and Intermediate Zones,MSOAIZ,PE,7920,3584,6009,2651,2621,1442,3388,1209,26,11,852,471,288,147,564,324,324,,,,985,421,882,373,9,4,94,44,0,0,48,48,30
E02003243,Peterborough 007,Middle Super Output Areas and Intermediate Zones,MSOAIZ,PE,9694,4071,3855,1574,996,529,2859,1045,93,37,4364,1920,1907,812,2457,1108,1108,,,,1299,492,1206,452,1,1,49,22,43,17,40,83,48
E02003244,Peterborough 008,Middle Super Output Areas and Intermediate Zones,MSOAIZ,PE,8800,3685,4422,1776,1439,788,2983,988,79,32,2970,1405,1260,554,1710,851,851,,,,1219,409,1136,375,8,3,47,20,28,11,34,110,63
E02003245,Peterborough 009,Middle Super Output Areas and Intermediate Zones,MSOAIZ,PE,7658,2967,3098,1168,896,420,2202,748,51,20,2700,1199,1116,473,1584,726,726,,,,1730,553,1631,515,15,5,62,24,22,9,38,79,27
E02003246,Peterborough 010,Middle Super Output Areas and Intermediate Zones,MSOAIZ,PE,8863,3094,4589,1545,1546,608,3043,937,65,19,1192,538,439,201,753,337,337,,,,2949,962,2784,894,20,7,114,46,31,15,68,68,30
E02003247,Peterborough 011,Middle Super Output Areas and Intermediate Zones,MSOAIZ,PE,7799,3272,4278,1782,1456,754,2822,1028,20,12,1971,932,576,255,1395,677,677,,,,1474,516,1366,475,6,2,95,34,7,5,41,56,30
E02003248,Peterborough 012,Middle Super Output Areas and Intermediate Zones,MSOAIZ,PE,10161,3284,6527,2064,2320,970,4207,1094,59,24,596,291,107,50,489,241,241,,,,2875,863,2680,798,9,3,145,48,41,14,65,104,42
E02003249,Peterborough 013,Middle Super Output Areas and Intermediate Zones,MSOAIZ,PE,10529,4368,5163,2129,1923,1000,3240,1129,98,40,2712,1222,1019,428,1693,794,794,,,,2467,933,2343,883,2,1,84,35,38,14,50,89,44
E02003250,Peterborough 014,Middle Super Output Areas and Intermediate Zones,MSOAIZ,PE,9924,3835,4471,1549,1864,776,2607,773,78,33,1048,563,273,134,775,429,429,,,,4153,1623,3895,1522,66,27,138,54,54,20,101,174,67
E02003251,Peterborough 015,Middle Super Output Areas and Intermediate Zones,MSOAIZ,PE,6981,2852,5943,2409,2984,1457,2959,952,6,3,218,136,45,21,173,115,115,,,,746,276,686,249,10,6,31,13,19,8,27,68,28
E02003252,Peterborough 016,Middle Super Output Areas and Intermediate Zones,MSOAIZ,PE,10161,4163,5974,2328,1631,783,4343,1545,74,26,965,523,336,159,629,364,364,,,,3040,1239,2818,1143,36,12,147,64,39,20,96,108,47
E02003253,Peterborough 017,Middle Super Output Areas and Intermediate Zones,MSOAIZ,PE,8302,3841,4670,2059,1571,841,3099,1218,53,29,1363,727,440,221,923,506,506,,,,2130,978,2022,926,14,7,80,38,14,7,52,86,48
E02003254,Peterborough 018,Middle Super Output Areas and Intermediate Zones,MSOAIZ,PE,8646,3732,6860,2908,2830,1436,4030,1472,61,30,552,272,147,64,405,208,208,,,,1041,449,969,417,11,4,51,23,10,5,32,132,73
E02003255,Peterborough 019,Middle Super Output Areas and Intermediate Zones,MSOAIZ,PE,8807,3777,6306,2722,2443,1318,3863,1404,33,15,1296,585,472,202,824,383,383,,,,1089,417,958,362,5,1,105,46,21,8,55,83,38
E02003257,Peterborough 021,Middle Super Output Areas and Intermediate Zones,MSOAIZ,PE,8622,3532,3726,1544,962,506,2764,1038,26,13,2930,1254,1081,404,1849,850,850,,,,1858,680,1758,634,2,1,69,28,29,17,46,82,41
E02003258,Luton 001,Middle Super Output Areas and Intermediate Zones,MSOAIZ,LU,8461,3462,7300,2926,2440,1220,4860,1706,19,8,167,100,84,65,83,35,35,,,,939,408,852,374,4,1,73,29,10,4,34,36,20
E02003259,Luton 002,Middle Super Output Areas and Intermediate Zones,MSOAIZ,LU,6415,2542,4695,1877,1740,875,2955,1002,18,6,993,368,551,232,442,136,136,,,,684,275,600,243,2,1,72,27,10,4,32,25,16
E02003260,Luton 003,Middle Super Output Areas and Intermediate Zones,MSOAIZ,LU,8392,3194,3934,1434,887,432,3047,1002,57,23,3188,1293,2830,1115,358,178,178,,,,1130,406,1030,366,0,0,90,35,10,5,40,83,38
E02003261,Luton 004,Middle Super Output Areas and Intermediate Zones,MSOAIZ,LU,5959,2470,4605,1881,1949,1002,2656,879,10,3,721,330,562,266,159,64,64,,,,577,228,509,196,5,2,63,30,0,0,32,46,28
E02003262,Luton 005,Middle Super Output Areas and Intermediate Zones,MSOAIZ,LU,9687,3872,5376,2140,1754,875,3622,1265,41,14,2932,1214,2161,873,771,341,341,,,,1252,465,1188,438,0,0,52,22,12,5,27,86,39
E02003263,Luton 006,Middle Super Output Areas and Intermediate Zones,MSOAIZ,LU,11597,4325,8185,3020,2864,1375,5321,1645,48,19,1094,421,906,342,188,79,79,,,,2193,829,2034,770,20,5,128,50,11,4,59,77,36
E02003264,Luton 007,Middle Super Output Areas and Intermediate Zones,MSOAIZ,LU,9266,3226,8052,2829,2609,1214,5443,1615,24,10,141,45,18,7,123,38,38,,,,1028,332,974,312,12,5,30,12,12,3,20,21,10
E02003265,Luton 008,Middle Super Output Areas and Intermediate Zones,MSOAIZ,LU,8233,3458,6448,2638,2331,1206,4117,1432,23,9,672,341,419,236,253,105,105,,,,1016,434,911,386,9,4,86,39,10,5,48,74,36
E02003266,Luton 009,Middle Super Output Areas and Intermediate Zones,MSOAIZ,LU,9258,3618,4966,1872,1130,579,3836,1293,44,15,2903,1260,2423,1054,480,206,206,,,,1257,424,1179,393,0,0,68,26,10,5,31,88,47
E02003267,Luton 010,Middle Super Output Areas and Intermediate Zones,MSOAIZ,LU,13242,3584,9085,2335,2465,854,6620,1481,49,17,752,241,270,116,482,125,125,,,,3251,962,3022,896,0,0,181,55,48,11,66,105,29
E02003268,Luton 011,Middle Super Output Areas and Intermediate Zones,MSOAIZ,LU,10764,3487,6850,2238,2120,905,4730,1333,66,19,1250,399,165,56,1085,343,343,,,,2521,802,2328,740,4,3,162,49,27,10,62,77,29
E02003269,Luton 012,Middle Super Output Areas and Intermediate Zones,MSOAIZ,LU,9964,4040,7108,2863,2511,1299,4597,1564,28,16,663,256,428,172,235,84,84,,,,2088,863,1992,816,17,9,64,30,15,8,47,77,42
E02003270,Luton 013,Middle Super Output Areas and Intermediate Zones,MSOAIZ,LU,7992,3137,5541,2215,2259,1183,3282,1032,37,16,655,269,260,107,395,162,162,,,,1697,595,1519,522,13,6,113,39,52,28,73,62,42
E02003271,Luton 014,Middle Super Output Areas and Intermediate Zones,MSOAIZ,LU,9771,3954,7326,2930,1997,999,5329,1931,19,7,706,294,262,137,444,157,157,,,,1677,699,1594,662,0,0,81,36,2,1,37,43,24
E02003272,Luton 015,Middle Super Output Areas and Intermediate Zones,MSOAIZ,LU,10476,2643,7248,1688,2561,699,4687,989,36,14,707,221,230,89,477,132,132,,,,2312,677,2126,621,15,5,129,33,42,18,56,173,43
E02003273,Luton 016,Middle Super Output Areas and Intermediate Zones,MSOAIZ,LU,10267,3789,6327,2416,1942,943,4385,1473,39,10,2368,834,2018,705,350,129,129,,,,1468,494,1370,456,15,4,58,27,25,7,38,65,35
E02003274,Luton 017,Middle Super Output Areas and Intermediate Zones,MSOAIZ,LU,10692,3128,5146,1237,1747,500,3399,737,54,17,1414,508,420,170,994,338,338,,,,3911,1301,3694,1236,11,4,141,42,65,19,65,167,65
E02003275,Luton 018,Middle Super Output Areas and Intermediate Zones,MSOAIZ,LU,11262,5297,2912,1458,1026,596,1886,862,49,22,1968,1093,1337,765,631,328,328,,,,6208,2666,6027,2587,13,8,84,39,84,32,79,125,58
E02003276,Luton 019,Middle Super Output Areas and Intermediate Zones,MSOAIZ,LU,8364,2511,4269,1207,1346,486,2923,721,40,12,890,279,192,73,698,206,206,,,,3049,977,2908,940,6,2,88,23,47,12,37,116,36
E02003277,Luton 020,Middle Super Output Areas and Intermediate Zones,MSOAIZ,LU,10142,3720,4993,1768,1458,667,3535,1101,35,10,2879,1169,2505,1036,374,133,133,,,,2102,708,1982,665,6,2,81,31,33,10,43,133,65
E02003278,Luton 021,Middle Super Output Areas and Intermediate Zones,MSOAIZ,LU,11345,4836,4054,1724,1341,710,2713,1014,50,21,1484,780,569,357,915,423,423,,,,5681,2271,5474,2183,28,9,108,52,71,27,88,76,40
E02003279,Southend-on-Sea 001,Middle Super Output Areas and Intermediate Zones,MSOAIZ,SS,9310,3982,8051,3435,3580,1891,4471,1544,33,9,268,141,133,73,135,68,68,,,,910,373,805,330,6,1,94,40,5,2,43,48,24
E02003280,Southend-on-Sea 002,Middle Super Output Areas and Intermediate Zones,MSOAIZ,SS,9715,4205,7391,3162,2840,1527,4551,1635,32,13,1118,559,896,464,222,95,95,,,,1100,428,1016,388,3,1,75,37,6,2,40,74,43
E02003281,Southend-on-Sea 003,Middle Super Output Areas and Intermediate Zones,MSOAIZ,SS,9173,4173,7244,3250,3286,1786,3958,1464,13,8,825,440,695,366,130,74,74,,,,1035,437,955,401,19,5,54,25,7,6,36,56,38
E02003282,Southend-on-Sea 004,Middle Super Output Areas and Intermediate Zones,MSOAIZ,SS,9852,4208,7382,3076,2915,1531,4467,1545,23,11,735,405,460,236,275,169,169,,,,1660,686,1540,630,19,8,91,43,10,5,56,52,30
E02003283,Southend-on-Sea 005,Middle Super Output Areas and Intermediate Zones,MSOAIZ,SS,10423,4279,7282,2986,2615,1401,4667,1585,27,12,1843,764,1495,607,348,157,157,,,,1190,471,1069,424,2,1,109,41,10,5,47,81,46
E02003284,Southend-on-Sea 006,Middle Super Output Areas and Intermediate Zones,MSOAIZ,SS,11196,4646,7395,3071,2359,1259,5036,1812,58,23,1037,487,812,386,225,101,101,,,,2641,1027,2474,960,9,3,154,61,4,3,67,65,38
E02003285,Southend-on-Sea 007,Middle Super Output Areas and Intermediate Zones,MSOAIZ,SS,10802,4386,6851,2780,1714,912,5137,1868,34,14,167,66,49,17,118,49,49,,,,3685,1498,3505,1419,11,6,149,65,20,8,79,65,28
E02003286,Southend-on-Sea 008,Middle Super Output Areas and Intermediate Zones,MSOAIZ,SS,9102,3840,7896,3234,3172,1652,4724,1582,20,10,99,61,63,43,36,18,18,,,,1038,509,983,481,0,0,55,28,0,0,28,49,26
E02003287,Southend-on-Sea 009,Middle Super Output Areas and Intermediate Zones,MSOAIZ,SS,9631,4065,6420,2754,2845,1543,3575,1211,70,27,1938,793,1038,470,900,323,323,,,,1139,451,1072,424,7,2,43,19,17,6,27,64,40
E02003288,Southend-on-Sea 010,Middle Super Output Areas and Intermediate Zones,MSOAIZ,SS,10877,4965,4478,1969,1434,760,3044,1209,51,20,2756,1453,1898,946,858,507,507,,,,3488,1469,3287,1367,73,41,98,39,30,22,102,104,54
E02003289,Southend-on-Sea 011,Middle Super Output Areas and Intermediate Zones,MSOAIZ,SS,10014,4608,7341,3233,2406,1335,4935,1898,16,11,94,44,68,24,26,20,20,,,,2505,1288,2366,1214,5,5,123,62,11,7,74,58,32
E02003290,Southend-on-Sea 012,Middle Super Output Areas and Intermediate Zones,MSOAIZ,SS,9378,4369,6323,2717,2336,1238,3987,1479,12,9,264,189,129,92,135,97,97,,,,2687,1408,2579,1351,4,3,80,46,24,8,57,92,46
E02003291,Southend-on-Sea 013,Middle Super Output Areas and Intermediate Zones,MSOAIZ,SS,11143,4782,6419,2721,2077,1104,4342,1617,111,42,2470,1106,925,520,1545,586,586,,,,2050,874,1918,812,7,3,106,52,19,7,62,93,39
E02003292,Southend-on-Sea 014,Middle Super Output Areas and Intermediate Zones,MSOAIZ,SS,10984,5087,4068,1813,1121,622,2947,1191,115,55,2423,1230,375,265,2048,965,965,,,,4306,1951,4188,1889,14,7,77,40,27,15,62,72,38
E02003293,Southend-on-Sea 015,Middle Super Output Areas and Intermediate Zones,MSOAIZ,SS,10559,5199,4617,2347,1670,1057,2947,1290,39,21,353,144,112,33,241,111,111,,,,5422,2615,5228,2511,15,11,156,82,23,11,104,128,72
E02003294,Southend-on-Sea 016,Middle Super Output Areas and Intermediate Zones,MSOAIZ,SS,9170,3921,7866,3338,3637,1951,4229,1387,17,8,75,28,31,12,44,16,16,,,,1135,507,1037,461,3,3,85,38,10,5,46,77,40
E02003295,Southend-on-Sea 017,Middle Super Output Areas and Intermediate Zones,MSOAIZ,SS,10160,3963,6899,2780,2699,1391,4200,1389,33,13,1940,687,1427,525,513,162,162,,,,1226,447,1137,410,0,0,87,36,2,1,37,62,36
E02003296,Thurrock 001,Middle Super Output Areas and Intermediate Zones,MSOAIZ,SS,7038,2743,6430,2507,2625,1295,3805,1212,4,3,91,30,64,22,27,8,8,,,,471,182,423,162,10,3,36,16,2,1,20,42,21
E02003297,Thurrock 002,Middle Super Output Areas and Intermediate Zones,MSOAIZ,SS,7166,2895,5205,2059,2032,1035,3173,1024,4,2,1231,556,1073,495,158,61,61,,,,687,251,646,229,4,2,37,20,0,0,22,39,27
E02003298,Thurrock 003,Middle Super Output Areas and Intermediate Zones,MSOAIZ,SS,7039,2838,5384,2143,2115,1066,3269,1077,13,5,1086,475,645,307,441,168,168,,,,524,191,474,170,17,6,32,14,1,1,21,32,24
E02003299,Thurrock 004,Middle Super Output Areas and Intermediate Zones,MSOAIZ,SS,6063,2370,5157,1988,1819,863,3338,1125,17,8,317,131,312,130,5,1,1,,,,514,217,439,184,24,9,35,17,16,7,33,58,26
E02003300,Thurrock 005,Middle Super Output Areas and Intermediate Zones,MSOAIZ,SS,7652,3162,5994,2459,2108,1079,3886,1380,3,2,496,203,343,133,153,70,70,,,,1114,471,1046,440,3,1,58,27,7,3,31,45,27
E02003301,Thurrock 006,Middle Super Output Areas and Intermediate Zones,MSOAIZ,RM,9470,3827,6453,2523,1973,974,4480,1549,28,17,2063,923,1841,832,222,91,91,,,,871,334,801,305,4,1,57,24,9,4,29,55,30
E02003302,Thurrock 007,Middle Super Output Areas and Intermediate Zones,MSOAIZ,RM,9932,4082,5671,2141,1365,682,4306,1459,26,9,3356,1578,3082,1475,274,103,103,,,,830,321,776,300,6,2,44,17,4,2,21,49,33
E02003303,Thurrock 008,Middle Super Output Areas and Intermediate Zones,MSOAIZ,RM,7735,3126,5291,2078,1534,810,3757,1268,11,5,1759,754,1677,716,82,38,38,,,,616,250,539,221,0,0,68,26,9,3,29,58,39
E02003304,Thurrock 009,Middle Super Output Areas and Intermediate Zones,MSOAIZ,RM,9307,3599,6555,2413,2272,1110,4283,1303,5,3,2091,957,2044,928,47,29,29,,,,615,200,567,180,7,4,41,16,0,0,20,41,26
E02003305,Thurrock 010,Middle Super Output Areas and Intermediate Zones,MSOAIZ,RM,5760,2319,4767,1894,1965,1007,2802,887,6,4,600,268,573,259,27,9,9,,,,345,126,325,117,2,1,14,6,4,2,9,42,27
E02003307,Thurrock 012,Middle Super Output Areas and Intermediate Zones,MSOAIZ,RM,9745,3935,5757,2258,2003,1033,3754,1225,8,4,3351,1459,3127,1372,224,87,87,,,,596,192,553,174,1,1,39,15,3,2,18,33,22
E02003308,Thurrock 013,Middle Super Output Areas and Intermediate Zones,MSOAIZ,SS,6339,2447,4921,1855,1406,671,3515,1184,41,13,451,169,251,96,200,73,73,,,,884,390,803,358,20,6,47,22,14,4,32,42,20
E02003309,Thurrock 014,Middle Super Output Areas and Intermediate Zones,MSOAIZ,RM,7420,2999,6184,2431,2138,1083,4046,1348,37,15,354,222,307,195,47,27,27,,,,809,314,760,294,1,1,45,17,3,2,20,36,17
E02003310,Thurrock 015,Middle Super Output Areas and Intermediate Zones,MSOAIZ,RM,11641,4783,6036,2504,1058,537,4978,1967,228,101,2140,792,1658,630,482,162,162,,,,3159,1350,3010,1288,6,4,121,50,22,8,62,78,36
E02003311,Thurrock 016,Middle Super Output Areas and Intermediate Zones,MSOAIZ,RM,8255,3320,5128,2089,1410,739,3718,1350,35,17,594,275,483,223,111,52,52,,,,2445,917,2293,862,11,4,107,44,34,7,55,53,22
E02003312,Thurrock 017,Middle Super Output Areas and Intermediate Zones,MSOAIZ,RM,8086,3466,3191,1387,690,349,2501,1038,94,43,1866,785,1337,555,529,230,230,,,,2882,1227,2792,1183,3,2,75,38,12,4,44,53,24
E02003313,Thurrock 018,Middle Super Output Areas and Intermediate Zones,MSOAIZ,RM,12989,4921,6137,2316,1648,811,4489,1505,71,27,4846,1831,4448,1645,398,186,186,,,,1846,702,1728,657,1,1,112,40,5,4,45,89,45
E02003314,Medway 001,Middle Super Output Areas and Intermediate Zones,MSOAIZ,ME,6241,2724,4882,2131,2148,1181,2734,950,69,39,598,268,62,34,536,234,234,,,,623,248,544,214,11,3,54,24,14,7,34,69,38
E02003315,Medway 002,Middle Super Output Areas and Intermediate Zones,MSOAIZ,ME,5550,2137,4552,1715,1447,694,3105,1021,24,12,409,190,22,17,387,173,173,,,,526,196,496,180,2,2,22,11,6,3,16,39,24
E02003316,Medway 003,Middle Super Output Areas and Intermediate Zones,MSOAIZ,ME,9678,3873,7359,2931,2449,1276,4910,1655,207,95,1276,500,108,47,1168,453,453,,,,784,315,659,266,46,14,54,25,25,10,49,52,32
E02003317,Medway 004,Middle Super Output Areas and Intermediate Zones,MSOAIZ,ME,5814,2321,4620,1798,1537,782,3083,1016,61,26,574,272,56,28,518,244,244,,,,508,204,455,182,3,1,34,16,16,5,22,51,21
E02003318,Medway 005,Middle Super Output Areas and Intermediate Zones,MSOAIZ,ME,5998,2273,5199,1992,2014,999,3185,993,49,20,252,90,15,4,237,86,86,,,,474,159,433,142,4,2,29,12,8,3,17,24,12
E02003319,Medway 006,Middle Super Output Areas and Intermediate Zones,MSOAIZ,ME,7620,3181,4716,1956,1506,786,3210,1170,73,41,744,325,94,43,650,282,282,,,,2000,818,1885,773,11,4,86,35,18,6,45,87,41
E02003320,Medway 007,Middle Super Output Areas and Intermediate Zones,MSOAIZ,ME,7388,3127,3397,1421,841,458,2556,963,134,63,1295,618,357,208,938,410,410,,,,2526,1000,1832,772,389,123,63,25,242,80,228,36,25
E02003321,Medway 008,Middle Super Output Areas and Intermediate Zones,MSOAIZ,ME,6069,2481,3699,1480,1293,667,2406,813,68,32,1635,699,269,101,1366,598,598,,,,613,238,543,212,4,1,59,21,7,4,26,54,32
E02003322,Medway 009,Middle Super Output Areas and Intermediate Zones,MSOAIZ,ME,6364,2546,3097,1296,834,449,2263,847,35,16,886,345,571,228,315,117,117,,,,2319,874,2200,828,1,1,86,35,32,10,46,27,15
E02003323,Medway 010,Middle Super Output Areas and Intermediate Zones,MSOAIZ,ME,7206,2783,3841,1555,974,530,2867,1025,287,95,1716,619,700,291,1016,328,328,,,,1336,499,1265,467,0,0,62,27,9,5,32,26,15
E02003324,Medway 011,Middle Super Output Areas and Intermediate Zones,MSOAIZ,ME,8989,3572,6222,2483,1597,851,4625,1632,241,87,1390,520,155,64,1235,456,456,,,,1082,450,1020,421,4,2,42,21,16,6,29,54,32
E02003325,Medway 012,Middle Super Output Areas and Intermediate Zones,MSOAIZ,ME,6972,3079,3102,1342,925,500,2177,842,87,36,959,510,624,329,335,181,181,,,,2736,1146,2613,1089,12,6,92,44,19,7,57,88,45
E02003326,Medway 013,Middle Super Output Areas and Intermediate Zones,MSOAIZ,ME,7698,2992,5211,2050,1581,815,3630,1235,61,22,520,208,316,128,204,80,80,,,,1854,683,1711,636,21,6,92,34,30,7,47,52,29
E02003327,Medway 014,Middle Super Output Areas and Intermediate Zones,MSOAIZ,ME,7219,3518,3501,1558,1117,596,2384,962,35,16,1517,822,134,70,1383,752,752,,,,1979,1025,1858,957,23,12,67,37,31,19,68,187,97
E02003328,Medway 015,Middle Super Output Areas and Intermediate Zones,MSOAIZ,ME,7950,3580,2899,1279,955,539,1944,740,65,29,1578,863,262,115,1316,748,748,,,,3312,1355,2777,1199,203,58,96,33,236,65,156,96,54
E02003329,Medway 016,Middle Super Output Areas and Intermediate Zones,MSOAIZ,ME,6602,2637,3880,1571,1110,585,2770,986,17,6,98,47,49,18,49,29,29,,,,2565,992,2429,941,28,9,92,37,16,5,51,42,21
E02003330,Medway 017,Middle Super Output Areas and Intermediate Zones,MSOAIZ,ME,6721,2771,4222,1786,1455,744,2767,1042,171,69,993,370,102,41,891,329,329,,,,1274,518,1187,484,2,1,72,28,13,5,34,61,28
E02003331,Medway 018,Middle Super Output Areas and Intermediate Zones,MSOAIZ,ME,8789,3674,5879,2346,1931,1034,3948,1312,29,12,1974,947,1615,784,359,163,163,,,,803,300,718,266,7,2,66,27,12,5,34,104,69
E02003332,Medway 019,Middle Super Output Areas and Intermediate Zones,MSOAIZ,ME,5937,2238,4525,1678,1515,730,3010,948,13,5,720,282,554,218,166,64,64,,,,652,257,614,243,9,2,22,9,7,3,14,27,16
E02003333,Medway 020,Middle Super Output Areas and Intermediate Zones,MSOAIZ,ME,6677,2900,3029,1301,871,469,2158,832,103,34,887,474,109,61,778,413,413,,,,2600,1055,2466,1006,28,7,72,29,34,13,49,58,36
E02003334,Medway 021,Middle Super Output Areas and Intermediate Zones,MSOAIZ,ME,5903,2254,3569,1404,1244,602,2325,802,41,15,469,178,88,30,381,148,148,,,,1770,635,1673,601,6,2,76,28,15,4,34,54,22
E02003335,Medway 022,Middle Super Output Areas and Intermediate Zones,MSOAIZ,ME,7104,2719,3368,1383,943,488,2425,895,61,30,1403,501,267,93,1136,408,408,,,,2241,783,2160,751,9,3,48,20,24,9,32,31,22
E02003336,Medway 023,Middle Super Output Areas and Intermediate Zones,MSOAIZ,ME,5838,2454,5020,2138,2185,1180,2835,958,20,8,301,126,262,116,39,10,10,,,,460,157,429,144,0,0,25,10,6,3,13,37,25
E02003337,Medway 024,Middle Super Output Areas and Intermediate Zones,MSOAIZ,ME,6285,2647,4524,1861,1650,857,2874,1004,67,28,929,432,112,47,817,385,385,,,,706,295,630,260,10,5,58,27,8,3,35,59,31
E02003338,Medway 025,Middle Super Output Areas and Intermediate Zones,MSOAIZ,ME,7030,3078,4582,2004,1655,926,2927,1078,21,8,1137,470,627,276,510,194,194,,,,1234,565,1167,532,4,2,58,28,5,3,33,56,31
E02003339,Medway 026,Middle Super Output Areas and Intermediate Zones,MSOAIZ,ME,6155,2414,4831,1880,1853,919,2978,961,41,16,527,256,74,38,453,218,218,,,,702,235,633,208,2,1,59,23,8,3,27,54,27
E02003340,Medway 027,Middle Super Output Areas and Intermediate Zones,MSOAIZ,ME,7679,3190,4827,1921,1582,806,3245,1115,66,26,1919,897,261,127,1658,770,770,,,,808,306,748,282,13,3,45,19,2,2,24,59,40
E02003341,Medway 028,Middle Super Output Areas and Intermediate Zones,MSOAIZ,ME,5446,2211,4511,1811,1547,790,2964,1021,109,33,337,153,28,18,309,135,135,,,,460,199,410,180,6,2,33,12,11,5,19,29,15
E02003342,Medway 029,Middle Super Output Areas and Intermediate Zones,MSOAIZ,ME,6240,2567,5215,2108,2058,1064,3157,1044,19,5,342,172,302,157,40,15,15,,,,623,257,569,232,2,1,48,22,4,2,25,41,25
E02003343,Medway 030,Middle Super Output Areas and Intermediate Zones,MSOAIZ,ME,5937,2334,5524,2151,2314,1153,3210,998,9,8,93,50,74,42,19,8,8,,,,281,108,251,96,7,2,16,8,7,2,12,30,17
E02003344,Medway 031,Middle Super Output Areas and Intermediate Zones,MSOAIZ,ME,7022,2725,4613,1748,1183,575,3430,1173,72,29,1596,651,224,94,1372,557,557,,,,683,266,625,242,3,1,34,16,21,7,24,58,31
E02003345,Medway 032,Middle Super Output Areas and Intermediate Zones,MSOAIZ,ME,5903,2308,5093,2004,1465,711,3628,1293,19,8,57,16,13,3,44,13,13,,,,703,268,645,246,0,0,58,22,0,0,22,31,12
E02003346,Medway 033,Middle Super Output Areas and Intermediate Zones,MSOAIZ,ME,6184,2540,4933,2032,2036,1051,2897,981,23,11,502,243,90,36,412,207,207,,,,705,236,624,210,10,2,67,23,4,1,26,21,18
E02003347,Medway 034,Middle Super Output Areas and Intermediate Zones,MSOAIZ,ME,6228,2425,5060,1927,944,459,4116,1468,92,41,180,85,26,13,154,72,72,,,,882,364,800,327,0,0,71,34,11,3,37,14,8
E02003348,Medway 035,Middle Super Output Areas and Intermediate Zones,MSOAIZ,ME,7922,3139,7261,2876,2925,1457,4336,1419,6,5,41,21,11,5,30,16,16,,,,582,221,535,201,0,0,40,18,7,2,20,32,16
E02003349,Medway 036,Middle Super Output Areas and Intermediate Zones,MSOAIZ,ME,7445,3091,6079,2529,2177,1153,3902,1376,34,13,343,161,259,117,84,44,44,,,,939,356,843,318,8,3,83,32,5,3,38,50,32
E02003350,Medway 037,Middle Super Output Areas and Intermediate Zones,MSOAIZ,ME,6284,2521,4889,1905,1719,862,3170,1043,48,24,843,389,175,84,668,305,305,,,,469,181,428,163,4,2,28,13,9,3,18,35,22
E02003351,Medway 038,Middle Super Output Areas and Intermediate Zones,MSOAIZ,ME,7901,3185,6248,2502,1833,959,4415,1543,122,51,505,226,63,30,442,196,196,,,,997,389,924,356,7,2,63,28,3,3,33,29,17
E02003352,Bracknell Forest 001,Middle Super Output Areas and Intermediate Zones,MSOAIZ,SL,5805,2487,4970,2096,2277,1189,2693,907,39,23,143,73,60,23,83,50,50,,,,581,263,504,229,43,16,24,12,10,6,34,72,32
E02003353,Bracknell Forest 002,Middle Super Output Areas and Intermediate Zones,MSOAIZ,RG,8564,3534,6575,2672,1991,974,4584,1698,77,37,574,229,99,52,475,177,177,,,,1250,553,1048,478,82,22,67,35,53,18,75,88,43
E02003354,Bracknell Forest 003,Middle Super Output Areas and Intermediate Zones,MSOAIZ,RG,9800,3872,7716,3025,1928,948,5788,2077,83,38,904,357,242,96,662,261,261,,,,1049,426,974,394,6,2,58,26,11,4,32,48,26
E02003355,Bracknell Forest 004,Middle Super Output Areas and Intermediate Zones,MSOAIZ,RG,6369,2708,3346,1365,878,483,2468,882,169,71,2217,1002,826,353,1391,649,649,,,,607,246,526,212,15,5,61,26,5,3,34,30,24
E02003356,Bracknell Forest 005,Middle Super Output Areas and Intermediate Zones,MSOAIZ,SL,6589,2731,5305,2154,1803,930,3502,1224,11,5,295,138,111,57,184,81,81,,,,872,377,799,344,18,10,38,17,17,6,33,106,57
E02003357,Bracknell Forest 006,Middle Super Output Areas and Intermediate Zones,MSOAIZ,RG,8924,3951,4827,2031,1337,700,3490,1331,112,62,2581,1240,960,442,1621,798,798,,,,1311,560,1176,510,12,5,114,42,9,3,50,93,58
E02003358,Bracknell Forest 007,Middle Super Output Areas and Intermediate Zones,MSOAIZ,RG,9024,3988,4913,2017,1405,750,3508,1267,177,87,2697,1314,716,320,1981,994,994,,,,1156,522,1030,469,28,12,74,31,24,10,53,81,48
E02003359,Bracknell Forest 008,Middle Super Output Areas and Intermediate Zones,MSOAIZ,RG,6409,2835,4127,1765,674,355,3453,1410,95,42,1055,474,461,205,594,269,269,,,,1107,537,1043,505,3,1,56,30,5,1,32,25,17
E02003360,Bracknell Forest 009,Middle Super Output Areas and Intermediate Zones,MSOAIZ,RG,9493,3605,6451,2473,1506,748,4945,1725,155,60,2073,778,826,311,1247,467,467,,,,787,275,686,239,17,7,59,23,25,6,36,27,19
E02003361,Bracknell Forest 010,Middle Super Output Areas and Intermediate Zones,MSOAIZ,RG,7404,3133,4841,1989,1108,569,3733,1420,45,17,1544,738,604,282,940,456,456,,,,937,367,853,331,2,2,70,30,12,4,36,37,22
E02003362,Bracknell Forest 011,Middle Super Output Areas and Intermediate Zones,MSOAIZ,RG,6565,2757,4572,1888,1153,600,3419,1288,21,10,1187,536,490,213,697,323,323,,,,755,305,675,266,6,3,70,35,4,1,39,30,18
E02003363,Bracknell Forest 012,Middle Super Output Areas and Intermediate Zones,MSOAIZ,RG,5854,2533,4484,1874,1775,953,2709,921,68,42,228,125,91,48,137,77,77,,,,811,383,639,267,127,87,21,9,24,20,116,263,109
E02003364,Bracknell Forest 013,Middle Super Output Areas and Intermediate Zones,MSOAIZ,RG,6529,2509,5297,2013,1299,633,3998,1380,13,6,697,271,173,72,524,199,199,,,,501,210,414,175,17,7,56,22,14,6,35,21,9
E02003365,Bracknell Forest 014,Middle Super Output Areas and Intermediate Zones,MSOAIZ,RG,6513,2652,5310,2130,1751,874,3559,1256,40,14,500,230,129,73,371,157,157,,,,619,258,549,228,13,6,41,19,16,5,30,44,20
E02003366,Bracknell Forest 015,Middle Super Output Areas and Intermediate Zones,MSOAIZ,GU,6670,2583,4806,1927,1375,714,3431,1213,38,13,461,173,126,53,335,120,120,,,,1330,452,575,227,398,113,75,27,282,85,225,35,18
E02003367,West Berkshire 001,Middle Super Output Areas and Intermediate Zones,MSOAIZ,RG,5994,2368,3996,1547,1560,730,2436,817,38,16,1032,384,65,21,967,363,363,,,,740,332,608,277,97,39,16,9,19,7,55,188,89
E02003368,West Berkshire 002,Middle Super Output Areas and Intermediate Zones,MSOAIZ,SN,5528,2416,3338,1472,1334,702,2004,770,17,11,1152,466,75,29,1077,437,437,,,,828,366,678,300,85,37,44,22,21,7,66,193,101
E02003369,West Berkshire 003,Middle Super Output Areas and Intermediate Zones,MSOAIZ,RG,5853,2427,4599,1853,1887,950,2712,903,15,6,406,176,23,12,383,164,164,,,,696,320,587,272,68,27,29,14,12,7,48,137,72
E02003370,West Berkshire 004,Middle Super Output Areas and Intermediate Zones,MSOAIZ,RG,6490,2642,5564,2254,2138,1066,3426,1188,57,27,272,107,21,8,251,99,99,,,,546,230,512,212,3,1,20,11,11,6,18,51,24
E02003371,West Berkshire 005,Middle Super Output Areas and Intermediate Zones,MSOAIZ,RG,5933,2287,5541,2149,2003,1039,3538,1110,6,6,39,13,9,3,30,10,10,,,,329,107,278,87,6,2,43,17,2,1,20,18,12
E02003372,West Berkshire 006,Middle Super Output Areas and Intermediate Zones,MSOAIZ,RG,7657,2949,6324,2430,2295,1127,4029,1303,14,5,753,308,49,18,704,290,290,,,,524,187,470,168,8,3,32,10,14,6,19,42,19
E02003373,West Berkshire 007,Middle Super Output Areas and Intermediate Zones,MSOAIZ,RG,7920,2972,5537,2073,2036,942,3501,1131,111,47,740,246,28,11,712,235,235,,,,1319,511,865,364,256,81,41,14,157,52,147,213,95
E02003374,West Berkshire 008,Middle Super Output Areas and Intermediate Zones,MSOAIZ,RG,5717,2334,4306,1736,1202,596,3104,1140,17,9,764,323,13,5,751,318,318,,,,614,257,535,224,22,5,50,24,7,4,33,16,9
E02003375,West Berkshire 009,Middle Super Output Areas and Intermediate Zones,MSOAIZ,RG,5777,2440,3754,1475,1201,586,2553,889,108,44,945,481,50,24,895,457,457,,,,860,382,786,352,7,3,49,20,18,7,30,110,58
E02003376,West Berkshire 010,Middle Super Output Areas and Intermediate Zones,MSOAIZ,RG,5669,2600,3776,1692,1517,834,2259,858,35,16,804,367,66,28,738,339,339,,,,990,482,903,441,32,11,44,23,11,7,41,64,43
E02003377,West Berkshire 011,Middle Super Output Areas and Intermediate Zones,MSOAIZ,RG,9414,3854,6945,2817,2726,1387,4219,1430,134,63,888,364,50,22,838,342,342,,,,1207,503,936,393,168,69,62,23,41,18,110,240,107
E02003378,West Berkshire 012,Middle Super Output Areas and Intermediate Zones,MSOAIZ,RG,7680,3466,4701,2088,1992,1086,2709,1002,56,30,1640,772,115,56,1525,716,716,,,,1206,527,1083,473,44,18,59,29,20,7,54,77,49
E02003379,West Berkshire 013,Middle Super Output Areas and Intermediate Zones,MSOAIZ,RG,6746,2785,3924,1678,1215,634,2709,1044,184,77,1452,518,132,49,1320,469,469,,,,1120,485,1026,447,21,8,51,21,22,9,38,66,27
E02003380,West Berkshire 014,Middle Super Output Areas and Intermediate Zones,MSOAIZ,RG,7848,3110,6082,2455,1764,914,4318,1541,113,43,829,285,37,15,792,270,270,,,,801,316,741,287,2,1,57,27,1,1,29,23,11
E02003381,West Berkshire 015,Middle Super Output Areas and Intermediate Zones,MSOAIZ,RG,5883,2272,4232,1635,1408,679,2824,956,27,11,616,256,21,9,595,247,247,,,,956,345,498,203,341,100,14,7,103,35,142,52,25
E02003382,West Berkshire 016,Middle Super Output Areas and Intermediate Zones,MSOAIZ,RG,7501,3129,4589,1871,1362,715,3227,1156,72,32,1946,826,137,66,1809,760,760,,,,862,377,785,340,9,5,59,27,9,5,37,32,23
E02003383,West Berkshire 017,Middle Super Output Areas and Intermediate Zones,MSOAIZ,RG,6918,2708,5537,2126,1466,735,4071,1391,60,25,532,231,55,27,477,204,204,,,,750,307,707,286,5,3,33,15,5,3,21,39,19
E02003384,West Berkshire 018,Middle Super Output Areas and Intermediate Zones,MSOAIZ,RG,6286,2587,4226,1714,1773,854,2453,860,31,13,826,326,28,13,798,313,313,,,,986,432,889,389,49,20,34,19,14,4,43,217,102
E02003385,West Berkshire 019,Middle Super Output Areas and Intermediate Zones,MSOAIZ,RG,7468,3592,3817,1763,1240,706,2577,1057,330,150,1342,701,88,42,1254,659,659,,,,1897,938,1789,885,9,5,77,35,22,13,53,82,40
E02003386,West Berkshire 020,Middle Super Output Areas and Intermediate Zones,MSOAIZ,RG,7906,3465,4943,2062,1737,873,3206,1189,41,21,1775,838,148,64,1627,774,774,,,,1103,516,1014,471,7,5,65,31,17,9,45,44,28
E02003387,West Berkshire 021,Middle Super Output Areas and Intermediate Zones,MSOAIZ,RG,9081,3611,7386,2938,3037,1519,4349,1419,55,17,718,285,64,26,654,259,259,,,,871,344,809,319,21,7,39,17,2,1,25,51,27
E02003388,West Berkshire 022,Middle Super Output Areas and Intermediate Zones,MSOAIZ,RG,5609,2326,3978,1607,1506,781,2472,826,64,26,823,355,80,27,743,328,328,,,,659,291,618,267,12,7,22,13,7,4,24,85,47
E02003389,Reading 001,Middle Super Output Areas and Intermediate Zones,MSOAIZ,RG,7775,3115,6595,2624,2496,1275,4099,1349,77,42,199,109,55,24,144,85,85,,,,867,320,788,284,7,2,63,29,9,5,36,37,20
E02003390,Reading 002,Middle Super Output Areas and Intermediate Zones,MSOAIZ,RG,7584,2846,7032,2634,2731,1303,4301,1331,20,7,99,32,27,8,72,24,24,,,,415,162,381,148,7,2,23,11,4,1,14,18,11
E02003391,Reading 003,Middle Super Output Areas and Intermediate Zones,MSOAIZ,RG,7969,3286,6481,2619,2386,1244,4095,1375,30,20,521,250,365,169,156,81,81,,,,881,365,808,335,18,7,46,21,9,2,30,56,32
E02003392,Reading 004,Middle Super Output Areas and Intermediate Zones,MSOAIZ,RG,8116,3647,4308,2021,1417,811,2891,1210,253,104,1609,618,557,250,1052,368,368,,,,1881,862,1780,820,4,2,73,33,24,7,42,65,42
E02003393,Reading 005,Middle Super Output Areas and Intermediate Zones,MSOAIZ,RG,7806,3186,6613,2706,2301,1216,4312,1490,16,7,229,90,140,51,89,39,39,,,,903,363,804,322,9,4,78,30,12,7,41,45,20
E02003394,Reading 006,Middle Super Output Areas and Intermediate Zones,MSOAIZ,RG,7409,2927,3942,1573,941,497,3001,1076,178,72,2196,872,1916,759,280,113,113,,,,1021,364,941,338,7,2,57,20,16,4,26,72,46
E02003395,Reading 007,Middle Super Output Areas and Intermediate Zones,MSOAIZ,RG,9453,3861,4390,1851,1131,583,3259,1268,97,36,749,292,155,55,594,237,237,,,,4167,1662,3936,1573,50,18,128,54,53,17,89,50,20
E02003396,Reading 008,Middle Super Output Areas and Intermediate Zones,MSOAIZ,RG,9192,3995,5170,2224,1524,798,3646,1426,191,98,858,424,235,92,623,332,332,,,,2944,1230,2798,1175,19,5,115,46,12,4,55,29,19
E02003397,Reading 009,Middle Super Output Areas and Intermediate Zones,MSOAIZ,RG,7435,3022,5008,1972,1707,892,3301,1080,43,16,1508,705,1322,604,186,101,101,,,,831,295,766,270,0,0,63,24,2,1,25,45,34
E02003398,Reading 010,Middle Super Output Areas and Intermediate Zones,MSOAIZ,RG,10517,4040,4004,1551,1038,481,2966,1070,139,75,1310,660,555,351,755,309,309,,,,4993,1724,4764,1634,4,2,187,75,38,13,90,71,30
E02003399,Reading 011,Middle Super Output Areas and Intermediate Zones,MSOAIZ,RG,11491,5891,2919,1522,813,464,2106,1058,442,260,1781,919,468,258,1313,661,661,,,,6231,3130,6055,3053,19,11,113,49,44,17,77,118,60
E02003400,Reading 012,Middle Super Output Areas and Intermediate Zones,MSOAIZ,RG,8375,3052,3609,1443,1328,629,2281,814,47,21,218,82,74,17,144,65,65,,,,4449,1479,4279,1414,18,6,100,40,52,19,65,52,27
E02003401,Reading 013,Middle Super Output Areas and Intermediate Zones,MSOAIZ,RG,7959,3682,4081,1913,1443,824,2638,1089,62,35,1491,658,1034,454,457,204,204,,,,2247,1036,2127,983,8,3,106,46,6,4,53,78,40
E02003402,Reading 014,Middle Super Output Areas and Intermediate Zones,MSOAIZ,RG,8620,3725,3384,1536,1131,563,2253,973,129,55,802,386,389,195,413,191,191,,,,4240,1716,4041,1636,37,12,113,49,49,19,80,65,32
E02003403,Reading 015,Middle Super Output Areas and Intermediate Zones,MSOAIZ,RG,8447,3582,4982,2087,1931,1011,3051,1076,109,47,2311,1044,1858,812,453,232,232,,,,951,355,888,329,13,5,47,18,3,3,26,94,49
E02003404,Reading 016,Middle Super Output Areas and Intermediate Zones,MSOAIZ,RG,5797,2326,2647,1107,999,536,1648,571,43,22,1828,721,1339,555,489,166,166,,,,1201,436,1049,362,10,6,45,17,97,51,74,78,40
E02003405,Reading 017,Middle Super Output Areas and Intermediate Zones,MSOAIZ,RG,9929,3816,3716,1423,881,436,2835,987,307,157,4242,1568,2737,1031,1505,537,537,,,,1560,609,1461,572,8,4,74,27,17,6,37,104,59
E02003406,Reading 018,Middle Super Output Areas and Intermediate Zones,MSOAIZ,RG,7456,2870,4345,1673,1282,659,3063,1014,124,56,2071,812,1528,637,543,175,175,,,,855,286,813,269,0,0,40,16,2,1,17,61,43
E02003407,Slough 001,Middle Super Output Areas and Intermediate Zones,MSOAIZ,SL,9364,3648,4553,1735,1076,560,3477,1175,127,53,3660,1501,2898,1210,762,291,291,,,,975,332,912,296,6,3,55,31,2,2,36,49,27
E02003408,Slough 002,Middle Super Output Areas and Intermediate Zones,MSOAIZ,SL,10334,3462,6124,1991,2133,824,3991,1167,45,23,999,461,608,278,391,183,183,,,,3073,948,2890,893,11,7,125,31,47,17,55,93,39
E02003409,Slough 003,Middle Super Output Areas and Intermediate Zones,MSOAIZ,SL,10326,4198,6001,2364,1533,749,4468,1615,106,41,2097,898,1632,689,465,209,209,,,,2074,867,1989,830,5,1,64,28,16,8,37,48,28
E02003410,Slough 004,Middle Super Output Areas and Intermediate Zones,MSOAIZ,SL,11447,3334,6505,1749,2012,640,4493,1109,32,12,1876,703,1388,533,488,170,170,,,,2927,823,2726,763,23,9,137,40,41,11,60,107,47
E02003411,Slough 005,Middle Super Output Areas and Intermediate Zones,MSOAIZ,SL,10912,3759,5732,1816,1683,687,4049,1129,42,19,2689,1110,1528,628,1161,482,482,,,,2346,772,2198,711,16,11,105,35,27,15,61,103,42
E02003412,Slough 006,Middle Super Output Areas and Intermediate Zones,MSOAIZ,SL,9436,3641,6368,2403,1767,842,4601,1561,70,29,1205,487,770,344,435,143,143,,,,1724,685,1644,655,0,0,66,26,14,4,30,69,37
E02003413,Slough 007,Middle Super Output Areas and Intermediate Zones,MSOAIZ,SL,12290,3880,6272,1851,2337,770,3935,1081,201,78,1702,653,567,250,1135,403,403,,,,4001,1256,3820,1195,0,0,147,50,34,11,61,114,42
E02003414,Slough 008,Middle Super Output Areas and Intermediate Zones,MSOAIZ,SL,12105,4589,6803,2579,1484,651,5319,1928,229,93,2046,787,853,373,1193,414,414,,,,2961,1098,2848,1052,13,5,92,40,8,1,46,66,32
E02003415,Slough 009,Middle Super Output Areas and Intermediate Zones,MSOAIZ,SL,11936,4241,4640,1550,1407,534,3233,1016,244,113,1780,790,864,425,916,365,365,,,,5094,1717,4900,1655,15,5,121,36,58,21,62,178,71
E02003416,Slough 010,Middle Super Output Areas and Intermediate Zones,MSOAIZ,SL,8075,3106,5572,2051,1704,769,3868,1282,37,14,731,332,545,255,186,77,77,,,,1679,675,1638,652,4,2,37,21,0,0,23,56,34
E02003417,Slough 011,Middle Super Output Areas and Intermediate Zones,MSOAIZ,SL,9337,3654,5117,1827,1849,784,3268,1043,87,51,770,420,413,239,357,181,181,,,,3267,1314,3128,1251,40,21,55,24,44,18,63,96,42
E02003418,Slough 012,Middle Super Output Areas and Intermediate Zones,MSOAIZ,SL,9479,3445,5585,1949,1563,701,4022,1248,113,52,2321,987,2059,916,262,71,71,,,,1414,435,1351,408,12,3,47,20,4,4,27,46,22
E02003419,Slough 013,Middle Super Output Areas and Intermediate Zones,MSOAIZ,SL,8501,3276,4545,1686,1255,604,3290,1082,127,51,2259,983,993,483,1266,500,500,,,,1516,532,1454,504,0,0,56,26,6,2,28,54,24
E02003420,Slough 014,Middle Super Output Areas and Intermediate Zones,MSOAIZ,SL,6155,2533,3079,1204,821,387,2258,817,110,57,886,364,70,33,816,331,331,,,,2052,894,1947,848,17,6,80,37,8,3,46,28,14
E02003421,Windsor and Maidenhead 001,Middle Super Output Areas and Intermediate Zones,MSOAIZ,SL,5560,2148,4573,1792,2026,960,2547,832,17,6,238,79,10,5,228,74,74,,,,653,237,578,211,17,8,45,15,13,3,26,79,34
E02003422,Windsor and Maidenhead 002,Middle Super Output Areas and Intermediate Zones,MSOAIZ,SL,11311,4718,8806,3597,4131,1985,4675,1612,31,21,917,389,47,24,870,365,365,,,,1295,591,1050,480,141,58,57,29,47,24,111,262,120
E02003423,Windsor and Maidenhead 003,Middle Super Output Areas and Intermediate Zones,MSOAIZ,SL,6046,2289,3612,1350,1316,613,2296,737,13,7,1807,708,123,49,1684,659,659,,,,586,202,530,182,16,5,26,13,14,2,20,28,22
E02003424,Windsor and Maidenhead 004,Middle Super Output Areas and Intermediate Zones,MSOAIZ,SL,7935,3430,6251,2643,2676,1361,3575,1282,17,11,188,96,19,8,169,88,88,,,,1416,653,1337,622,18,6,44,21,17,4,31,63,27
E02003425,Windsor and Maidenhead 005,Middle Super Output Areas and Intermediate Zones,MSOAIZ,SL,10810,4704,5926,2398,2003,977,3923,1421,184,103,2003,1028,115,63,1888,965,965,,,,2517,1084,2348,1015,6,4,134,53,29,12,69,180,91
E02003426,Windsor and Maidenhead 006,Middle Super Output Areas and Intermediate Zones,MSOAIZ,SL,9447,3721,7565,2964,2830,1399,4735,1565,56,26,510,192,35,15,475,177,177,,,,1263,511,1116,453,61,22,51,25,35,11,58,53,28
E02003427,Windsor and Maidenhead 007,Middle Super Output Areas and Intermediate Zones,MSOAIZ,SL,7540,2833,4578,1795,1611,758,2967,1037,41,17,1592,573,100,33,1492,540,540,,,,1251,418,1173,389,8,2,56,21,14,6,29,78,30
E02003428,Windsor and Maidenhead 008,Middle Super Output Areas and Intermediate Zones,MSOAIZ,SL,9022,3545,6836,2608,2468,1182,4368,1426,60,23,1396,649,127,63,1269,586,586,,,,662,229,623,211,4,3,35,15,0,0,18,68,36
E02003429,Windsor and Maidenhead 009,Middle Super Output Areas and Intermediate Zones,MSOAIZ,SL,7341,2966,6046,2389,2320,1149,3726,1240,20,7,410,194,15,5,395,189,189,,,,778,328,699,290,23,13,40,19,16,6,38,87,48
E02003430,Windsor and Maidenhead 010,Middle Super Output Areas and Intermediate Zones,MSOAIZ,SL,5500,2609,2791,1277,1069,590,1722,687,26,15,707,366,85,44,622,322,322,,,,1356,681,1066,544,207,92,34,19,49,26,137,620,270
E02003431,Windsor and Maidenhead 011,Middle Super Output Areas and Intermediate Zones,MSOAIZ,TW,6556,2730,4607,1850,1567,780,3040,1070,19,12,911,404,115,61,796,343,343,,,,936,431,851,393,43,18,34,16,8,4,38,83,33
E02003432,Windsor and Maidenhead 012,Middle Super Output Areas and Intermediate Zones,MSOAIZ,SL,6490,3021,3964,1764,1309,723,2655,1041,23,12,768,415,98,43,670,372,372,,,,1682,809,1512,736,75,25,49,28,46,20,73,53,21
E02003433,Windsor and Maidenhead 013,Middle Super Output Areas and Intermediate Zones,MSOAIZ,SL,6611,2744,4312,1880,2012,1089,2300,791,26,16,718,337,83,39,635,298,298,,,,1500,488,621,216,477,139,17,9,385,124,272,55,23
E02003434,Windsor and Maidenhead 014,Middle Super Output Areas and Intermediate Zones,MSOAIZ,SL,8613,3688,4834,2020,1731,912,3103,1108,83,42,2463,1093,313,131,2150,962,962,,,,1170,490,1069,446,13,4,57,29,31,11,44,63,43
E02003435,Windsor and Maidenhead 015,Middle Super Output Areas and Intermediate Zones,MSOAIZ,SL,6893,2844,4791,1944,1735,865,3056,1079,16,9,355,163,46,23,309,140,140,,,,1659,696,1337,575,179,60,25,12,118,49,121,72,32
E02003436,Windsor and Maidenhead 016,Middle Super Output Areas and Intermediate Zones,MSOAIZ,TW,8270,3355,6555,2549,2615,1276,3940,1273,9,4,424,237,27,14,397,223,223,,,,1130,494,748,329,231,89,48,21,103,55,165,152,71
E02003437,Windsor and Maidenhead 017,Middle Super Output Areas and Intermediate Zones,MSOAIZ,SL,7092,2886,5025,1941,1899,896,3126,1045,51,22,883,441,65,31,818,410,410,,,,968,400,892,362,21,13,42,16,13,9,38,165,82
E02003438,Windsor and Maidenhead 018,Middle Super Output Areas and Intermediate Zones,MSOAIZ,SL,10028,4118,7318,2915,3097,1498,4221,1417,10,5,752,384,100,60,652,324,324,,,,1704,690,1622,645,37,19,31,14,14,12,45,244,124
E02003439,Wokingham 001,Middle Super Output Areas and Intermediate Zones,MSOAIZ,RG,5288,2272,4115,1719,1894,945,2221,774,4,3,559,257,473,193,86,64,64,,,,504,244,440,214,32,13,16,10,16,7,30,106,49
E02003440,Wokingham 002,Middle Super Output Areas and Intermediate Zones,MSOAIZ,RG,8786,3634,7170,2884,2665,1341,4505,1543,42,26,556,246,391,183,165,63,63,,,,984,457,910,425,9,4,53,24,12,4,32,34,21
E02003441,Wokingham 003,Middle Super Output Areas and Intermediate Zones,MSOAIZ,RG,7536,2954,6491,2499,2614,1255,3877,1244,4,3,284,143,191,109,93,34,34,,,,685,266,609,237,7,3,57,22,12,4,29,72,43
E02003442,Wokingham 004,Middle Super Output Areas and Intermediate Zones,MSOAIZ,RG,7107,2760,6195,2358,1803,882,4392,1476,33,21,102,38,27,12,75,26,26,,,,756,330,726,316,0,0,28,13,2,1,14,21,13
E02003443,Wokingham 005,Middle Super Output Areas and Intermediate Zones,MSOAIZ,RG,5942,2429,4057,1611,1582,823,2475,788,35,18,1266,575,1077,460,189,115,115,,,,527,192,487,176,4,2,28,11,8,3,16,57,33
E02003444,Wokingham 006,Middle Super Output Areas and Intermediate Zones,MSOAIZ,RG,8890,3223,7261,2649,2779,1315,4482,1334,64,24,327,156,131,49,196,107,107,,,,1173,365,1092,340,6,3,47,17,28,5,25,65,29
E02003445,Wokingham 007,Middle Super Output Areas and Intermediate Zones,MSOAIZ,RG,7911,3110,7061,2816,2518,1274,4543,1542,18,6,81,32,25,7,56,25,25,,,,735,248,669,223,7,2,55,22,4,1,25,16,8
E02003446,Wokingham 008,Middle Super Output Areas and Intermediate Zones,MSOAIZ,RG,8072,3035,7157,2685,2732,1279,4425,1406,10,7,125,64,73,28,52,36,36,,,,748,261,690,235,22,11,30,11,6,4,26,32,18
E02003447,Wokingham 009,Middle Super Output Areas and Intermediate Zones,MSOAIZ,RG,9237,3453,6679,2472,1848,884,4831,1588,359,171,1159,407,376,150,783,257,257,,,,991,382,920,353,6,3,61,24,4,2,29,49,21
E02003448,Wokingham 010,Middle Super Output Areas and Intermediate Zones,MSOAIZ,RG,6668,2617,5748,2214,2045,996,3703,1218,9,4,214,92,163,68,51,24,24,,,,629,274,567,247,24,11,33,14,5,2,27,68,33
E02003449,Wokingham 011,Middle Super Output Areas and Intermediate Zones,MSOAIZ,RG,7463,3144,6080,2488,1451,726,4629,1762,35,15,90,45,16,5,74,40,40,,,,1237,582,1169,549,4,1,61,30,3,2,33,21,14
E02003450,Wokingham 012,Middle Super Output Areas and Intermediate Zones,MSOAIZ,RG,10593,4206,7606,3030,2343,1155,5263,1875,259,125,1048,405,632,260,416,145,145,,,,1621,616,1527,570,26,11,59,31,9,4,46,59,30
E02003451,Wokingham 013,Middle Super Output Areas and Intermediate Zones,MSOAIZ,RG,7792,3725,4751,2227,1895,1113,2856,1114,28,12,1636,796,1247,593,389,203,203,,,,1298,639,1199,592,36,11,50,30,13,6,47,79,51
E02003452,Wokingham 014,Middle Super Output Areas and Intermediate Zones,MSOAIZ,RG,6068,2428,5223,2084,1927,950,3296,1134,87,36,242,87,199,71,43,16,16,,,,479,201,437,184,9,2,30,14,3,1,17,37,20
E02003453,Wokingham 015,Middle Super Output Areas and Intermediate Zones,MSOAIZ,RG,6512,2387,6023,2211,2116,983,3907,1228,0,0,58,17,55,16,3,1,1,,,,410,151,387,137,3,2,20,12,0,0,14,21,8
E02003454,Wokingham 016,Middle Super Output Areas and Intermediate Zones,MSOAIZ,RG,7408,3045,6255,2538,2246,1158,4009,1380,21,11,386,160,143,59,243,101,101,,,,715,317,676,293,4,2,33,21,2,1,24,31,19
E02003455,Wokingham 017,Middle Super Output Areas and Intermediate Zones,MSOAIZ,RG,6642,2669,5012,1945,1778,844,3234,1101,288,145,467,203,387,175,80,28,28,,,,774,329,706,298,9,4,39,19,20,8,31,101,47
E02003456,Wokingham 018,Middle Super Output Areas and Intermediate Zones,MSOAIZ,RG,6398,2535,4261,1663,1386,685,2875,978,92,40,775,343,584,265,191,78,78,,,,1180,446,490,202,431,150,27,12,232,82,244,90,43
E02003457,Wokingham 019,Middle Super Output Areas and Intermediate Zones,MSOAIZ,RG,9740,3679,8916,3335,3275,1520,5641,1815,22,7,221,108,188,86,33,22,22,,,,542,211,502,191,13,5,22,12,5,3,20,39,18
E02003458,Wokingham 020,Middle Super Output Areas and Intermediate Zones,MSOAIZ,RG,7687,3027,6828,2675,2707,1333,4121,1342,13,5,134,62,122,56,12,6,6,,,,632,244,561,219,30,8,29,14,12,3,25,80,41
E02003459,Milton Keynes 001,Middle Super Output Areas and Intermediate Zones,MSOAIZ,NN,8636,3670,6610,2712,2424,1265,4186,1447,43,14,534,253,407,192,127,61,61,,,,1383,650,1307,611,16,6,52,28,8,5,39,66,41
E02003460,Milton Keynes 002,Middle Super Output Areas and Intermediate Zones,MSOAIZ,NN,9186,3806,6976,2836,2618,1296,4358,1540,142,63,981,453,497,259,484,194,194,,,,979,400,838,353,28,9,91,31,22,7,47,108,54
E02003461,Milton Keynes 003,Middle Super Output Areas and Intermediate Zones,MSOAIZ,MK,7256,2925,5796,2319,2088,1047,3708,1272,66,25,504,231,391,183,113,48,48,,,,869,332,756,293,5,1,106,36,2,2,39,21,18
E02003462,Milton Keynes 004,Middle Super Output Areas and Intermediate Zones,MSOAIZ,MK,7694,3289,5936,2458,1862,983,4074,1475,133,60,314,170,229,126,85,44,44,,,,1260,576,1146,525,24,8,78,34,12,9,51,51,25
E02003463,Milton Keynes 005,Middle Super Output Areas and Intermediate Zones,MSOAIZ,MK,6707,2669,4552,1791,1505,731,3047,1060,337,155,883,395,688,315,195,80,80,,,,892,307,846,288,6,3,40,16,0,0,19,43,21
E02003464,Milton Keynes 006,Middle Super Output Areas and Intermediate Zones,MSOAIZ,MK,6744,2569,3432,1340,1032,522,2400,818,289,99,1814,732,1412,564,402,168,168,,,,1153,366,1092,346,0,0,47,17,14,3,20,56,32
E02003465,Milton Keynes 007,Middle Super Output Areas and Intermediate Zones,MSOAIZ,MK,6200,2685,4191,1703,1329,675,2862,1028,767,389,387,253,197,146,190,107,107,,,,824,318,764,292,8,4,46,19,6,3,26,31,22
E02003466,Milton Keynes 008,Middle Super Output Areas and Intermediate Zones,MSOAIZ,MK,7242,2905,4500,1782,1225,614,3275,1168,108,56,824,375,689,299,135,76,76,,,,1745,658,1611,599,8,3,107,46,19,10,59,65,34
E02003467,Milton Keynes 009,Middle Super Output Areas and Intermediate Zones,MSOAIZ,MK,6213,2490,3006,1191,816,434,2190,757,49,19,1631,764,1010,454,621,310,310,,,,1490,493,1377,452,8,3,83,30,22,8,41,37,23
E02003468,Milton Keynes 010,Middle Super Output Areas and Intermediate Zones,MSOAIZ,MK,7327,3191,5070,2201,1961,1027,3109,1174,187,92,594,311,433,233,161,78,78,,,,1419,555,1191,482,6,5,218,65,4,3,73,57,32
E02003469,Milton Keynes 011,Middle Super Output Areas and Intermediate Zones,MSOAIZ,MK,5801,2406,4319,1751,1427,702,2892,1049,290,140,351,159,306,140,45,19,19,,,,810,336,735,310,2,1,68,23,5,2,26,31,20
E02003470,Milton Keynes 012,Middle Super Output Areas and Intermediate Zones,MSOAIZ,MK,5610,2134,2031,747,435,214,1596,533,116,48,2559,1027,2216,827,343,200,200,,,,839,277,761,251,4,2,70,22,4,2,26,65,35
E02003471,Milton Keynes 013,Middle Super Output Areas and Intermediate Zones,MSOAIZ,MK,6556,2543,3207,1226,886,431,2321,795,329,161,1531,664,977,403,554,261,261,,,,1457,473,1323,425,2,1,116,41,16,6,48,32,19
E02003472,Milton Keynes 014,Middle Super Output Areas and Intermediate Zones,MSOAIZ,MK,8586,3815,2139,928,533,286,1606,642,486,294,2131,986,1448,637,683,349,349,,,,3712,1560,3578,1495,6,4,101,44,27,17,65,118,47
E02003473,Milton Keynes 015,Middle Super Output Areas and Intermediate Zones,MSOAIZ,MK,5683,2335,3648,1393,1114,527,2534,866,742,336,116,66,89,50,27,16,16,,,,1160,531,1070,490,3,2,79,35,8,4,41,17,9
E02003474,Milton Keynes 016,Middle Super Output Areas and Intermediate Zones,MSOAIZ,MK,8613,3238,4959,1876,1327,633,3632,1243,410,172,1428,561,463,199,965,362,362,,,,1770,608,1696,580,9,3,55,21,10,4,28,46,21
E02003475,Milton Keynes 017,Middle Super Output Areas and Intermediate Zones,MSOAIZ,MK,14713,5668,8073,2930,1487,672,6586,2258,1443,709,1744,681,81,35,1663,646,646,,,,3408,1327,3247,1268,21,8,114,41,26,10,59,45,21
E02003476,Milton Keynes 018,Middle Super Output Areas and Intermediate Zones,MSOAIZ,MK,8382,3080,2753,1048,735,330,2018,718,185,84,3013,1191,2213,873,800,318,318,,,,2349,723,2242,681,9,5,78,29,20,8,42,82,34
E02003477,Milton Keynes 019,Middle Super Output Areas and Intermediate Zones,MSOAIZ,MK,10860,4114,7187,2606,1618,760,5569,1846,924,439,1085,448,213,93,872,355,355,,,,1608,591,1518,554,3,1,82,34,5,2,37,56,30
E02003478,Milton Keynes 020,Middle Super Output Areas and Intermediate Zones,MSOAIZ,MK,6823,2684,4106,1511,1103,504,3003,1007,721,348,615,339,179,114,436,225,225,,,,1354,473,1302,452,2,1,35,15,15,5,21,27,13
E02003479,Milton Keynes 021,Middle Super Output Areas and Intermediate Zones,MSOAIZ,MK,7436,2778,2499,914,545,251,1954,663,573,251,2037,868,778,356,1259,512,512,,,,2272,716,2152,685,39,9,59,14,22,8,31,55,29
E02003480,Milton Keynes 022,Middle Super Output Areas and Intermediate Zones,MSOAIZ,MK,8178,3402,4216,1650,974,454,3242,1196,1058,477,1345,607,31,13,1314,594,594,,,,1534,651,1493,629,9,5,31,16,1,1,22,25,17
E02003481,Milton Keynes 023,Middle Super Output Areas and Intermediate Zones,MSOAIZ,MK,7100,3000,2185,974,735,401,1450,573,152,79,3594,1504,2829,1192,765,312,312,,,,1097,410,1036,382,13,5,38,18,10,5,28,72,33
E02003482,Milton Keynes 024,Middle Super Output Areas and Intermediate Zones,MSOAIZ,MK,6138,2508,4812,1885,1735,841,3077,1044,129,71,376,180,295,143,81,37,37,,,,788,352,727,323,6,2,45,23,10,4,29,33,20
E02003483,Milton Keynes 025,Middle Super Output Areas and Intermediate Zones,MSOAIZ,MK,10893,3888,7041,2344,1075,427,5966,1917,589,280,1489,600,146,68,1343,532,532,,,,1737,644,1648,607,10,3,63,28,16,6,37,37,20
E02003484,Milton Keynes 026,Middle Super Output Areas and Intermediate Zones,MSOAIZ,MK,7221,2914,4122,1512,1042,484,3080,1028,756,374,1116,554,196,117,920,437,437,,,,1189,455,1121,424,0,0,51,24,17,7,31,38,19
E02003485,Milton Keynes 027,Middle Super Output Areas and Intermediate Zones,MSOAIZ,MK,8025,3243,5326,2067,1825,908,3501,1159,87,49,1529,749,1346,669,183,80,80,,,,1024,344,957,317,0,0,60,22,7,5,27,59,34
E02003486,Milton Keynes 028,Middle Super Output Areas and Intermediate Zones,MSOAIZ,MK,8876,3410,5958,2149,1108,514,4850,1635,891,417,641,307,85,52,556,255,255,,,,1361,527,1286,496,0,0,66,28,9,3,31,25,10
E02003487,Milton Keynes 029,Middle Super Output Areas and Intermediate Zones,MSOAIZ,MK,7231,2930,5009,2011,1873,958,3136,1053,80,35,1296,571,1220,541,76,30,30,,,,786,283,725,259,4,2,57,22,0,0,24,60,30
E02003488,Milton Keynes 030,Middle Super Output Areas and Intermediate Zones,MSOAIZ,MK,7020,2881,4758,1936,1897,976,2861,960,97,54,856,414,732,351,124,63,63,,,,1244,443,1181,416,10,3,48,21,5,3,27,65,34
E02003489,Milton Keynes 031,Middle Super Output Areas and Intermediate Zones,MSOAIZ,MK,6811,2824,4823,2028,1719,908,3104,1120,292,146,623,260,460,191,163,69,69,,,,1019,361,969,336,5,2,36,21,9,2,25,54,29
E02003490,Milton Keynes 032,Middle Super Output Areas and Intermediate Zones,MSOAIZ,MK,6954,2590,2805,1094,767,382,2038,712,115,49,2965,1090,2664,966,301,124,124,,,,1015,326,968,309,0,0,28,11,19,6,17,54,31
E02003491,Brighton and Hove 001,Middle Super Output Areas and Intermediate Zones,MSOAIZ,BN,7679,3088,6029,2413,2134,1126,3895,1287,26,10,871,383,744,336,127,47,47,,,,697,249,619,217,11,4,65,27,2,1,32,56,33
E02003492,Brighton and Hove 002,Middle Super Output Areas and Intermediate Zones,MSOAIZ,BN,5928,2166,2244,900,849,434,1395,466,13,6,2413,914,2118,790,295,124,124,,,,1213,321,1128,294,5,4,36,11,44,12,27,45,25
E02003493,Brighton and Hove 003,Middle Super Output Areas and Intermediate Zones,MSOAIZ,BN,7778,3348,6316,2661,2572,1382,3744,1279,26,13,319,199,169,100,150,99,99,,,,1044,439,992,411,5,2,38,24,9,2,28,73,36
E02003494,Brighton and Hove 004,Middle Super Output Areas and Intermediate Zones,MSOAIZ,BN,6503,2641,5202,2100,1993,1024,3209,1076,30,8,432,206,376,163,56,43,43,,,,795,299,731,273,6,2,52,22,6,2,26,44,28
E02003495,Brighton and Hove 005,Middle Super Output Areas and Intermediate Zones,MSOAIZ,BN,7200,2970,5096,2140,1692,895,3404,1245,68,26,1197,490,389,185,808,305,305,,,,780,281,706,252,0,0,61,24,13,5,29,59,33
E02003496,Brighton and Hove 006,Middle Super Output Areas and Intermediate Zones,MSOAIZ,BN,7430,3146,4680,1983,1934,1042,2746,941,19,7,1814,805,1661,747,153,58,58,,,,826,294,767,268,4,2,40,19,15,5,26,91,57
E02003497,Brighton and Hove 007,Middle Super Output Areas and Intermediate Zones,MSOAIZ,BN,7224,2804,6178,2358,2411,1158,3767,1200,8,3,99,45,50,19,49,26,26,,,,888,376,838,354,5,2,39,16,6,4,22,51,22
E02003498,Brighton and Hove 008,Middle Super Output Areas and Intermediate Zones,MSOAIZ,BN,8237,3475,2793,1188,1081,570,1712,618,63,32,3306,1597,2398,1209,908,388,388,,,,1960,591,1848,543,0,0,89,39,23,9,48,115,67
E02003499,Brighton and Hove 009,Middle Super Output Areas and Intermediate Zones,MSOAIZ,BN,7986,2843,2685,1066,1016,496,1669,570,92,44,3465,1269,2060,772,1405,497,497,,,,1663,427,1551,393,0,0,84,25,28,9,34,81,37
E02003500,Brighton and Hove 010,Middle Super Output Areas and Intermediate Zones,MSOAIZ,BN,8316,3049,6303,2310,1828,834,4475,1476,16,8,163,76,48,19,115,57,57,,,,1800,638,1742,614,4,3,44,19,10,2,24,34,17
E02003501,Brighton and Hove 011,Middle Super Output Areas and Intermediate Zones,MSOAIZ,BN,8201,3685,5814,2499,2183,1121,3631,1378,38,17,173,92,63,29,110,63,63,,,,2093,1026,1981,971,11,5,96,48,5,2,55,83,51
E02003502,Brighton and Hove 012,Middle Super Output Areas and Intermediate Zones,MSOAIZ,BN,7451,3145,4873,2053,1517,824,3356,1229,112,36,1436,619,1042,442,394,177,177,,,,970,400,873,351,11,8,80,39,6,2,49,60,37
E02003503,Brighton and Hove 013,Middle Super Output Areas and Intermediate Zones,MSOAIZ,BN,8900,3487,5926,2336,2078,1077,3848,1259,44,17,1849,738,1242,462,607,276,276,,,,988,359,933,336,7,3,44,18,4,2,23,93,37
E02003504,Brighton and Hove 014,Middle Super Output Areas and Intermediate Zones,MSOAIZ,BN,8251,3838,4705,2067,1419,755,3286,1312,225,120,559,309,205,106,354,203,203,,,,2700,1312,2569,1243,3,1,113,58,15,10,69,62,30
E02003505,Brighton and Hove 015,Middle Super Output Areas and Intermediate Zones,MSOAIZ,BN,8970,3786,3539,1634,1049,544,2490,1090,46,21,557,319,281,156,276,163,163,,,,4759,1767,4543,1674,4,1,181,80,31,12,93,69,45
E02003506,Brighton and Hove 016,Middle Super Output Areas and Intermediate Zones,MSOAIZ,BN,6720,2871,4372,1816,1094,594,3278,1222,40,20,443,209,202,105,241,104,104,,,,1817,795,1717,753,3,1,90,39,7,2,42,48,31
E02003507,Brighton and Hove 017,Middle Super Output Areas and Intermediate Zones,MSOAIZ,BN,9783,3924,6913,2845,2833,1455,4080,1390,84,30,1690,664,1209,474,481,190,190,,,,1023,343,902,300,6,2,99,38,16,3,43,73,42
E02003508,Brighton and Hove 018,Middle Super Output Areas and Intermediate Zones,MSOAIZ,BN,8734,3418,4666,2039,1519,800,3147,1239,97,40,357,146,211,79,146,67,67,,,,3568,1168,3412,1108,6,2,116,49,34,9,60,46,25
E02003509,Brighton and Hove 019,Middle Super Output Areas and Intermediate Zones,MSOAIZ,BN,8607,4695,3588,1904,1133,708,2455,1196,77,42,735,492,554,377,181,115,115,,,,4125,2198,3989,2124,9,4,117,63,10,7,74,82,59
E02003510,Brighton and Hove 020,Middle Super Output Areas and Intermediate Zones,MSOAIZ,BN,8240,4055,4826,2292,1767,1021,3059,1271,67,41,254,151,32,15,222,136,136,,,,3006,1511,2896,1447,8,5,97,55,5,4,64,87,60
E02003511,Brighton and Hove 021,Middle Super Output Areas and Intermediate Zones,MSOAIZ,BN,7941,3318,5437,2217,1702,881,3735,1336,64,36,697,299,472,191,225,108,108,,,,1675,725,1586,681,0,0,82,41,7,3,44,68,41
E02003512,Brighton and Hove 022,Middle Super Output Areas and Intermediate Zones,MSOAIZ,BN,8832,3736,4139,1885,1183,631,2956,1254,46,19,791,439,300,177,491,262,262,,,,3795,1356,3613,1285,8,3,163,64,11,4,71,61,37
E02003513,Brighton and Hove 023,Middle Super Output Areas and Intermediate Zones,MSOAIZ,BN,6330,2907,4028,1680,1489,765,2539,915,32,23,761,473,515,319,246,154,154,,,,1419,680,1336,639,0,0,80,40,3,1,41,90,51
E02003514,Brighton and Hove 024,Middle Super Output Areas and Intermediate Zones,MSOAIZ,BN,8407,4856,3401,1871,1043,652,2358,1219,41,22,345,262,82,55,263,207,207,,,,4545,2659,4365,2559,7,6,168,92,5,2,100,75,42
E02003515,Brighton and Hove 025,Middle Super Output Areas and Intermediate Zones,MSOAIZ,BN,9046,3659,2104,923,780,426,1324,497,69,25,6013,2406,4920,1937,1093,469,469,,,,713,230,664,209,0,0,37,15,12,6,21,147,75
E02003516,Brighton and Hove 026,Middle Super Output Areas and Intermediate Zones,MSOAIZ,BN,8329,4972,3086,1871,1005,701,2081,1170,22,14,250,169,71,39,179,130,130,,,,4914,2875,4783,2797,12,8,98,60,21,10,78,57,43
E02003517,Brighton and Hove 027,Middle Super Output Areas and Intermediate Zones,MSOAIZ,BN,10412,5238,3160,1712,1184,729,1976,983,270,146,1372,760,510,305,862,455,455,,,,5461,2532,5172,2391,54,22,189,93,46,26,141,149,88
E02003518,Brighton and Hove 028,Middle Super Output Areas and Intermediate Zones,MSOAIZ,BN,7223,4158,3700,2019,1554,984,2146,1035,66,33,275,199,37,23,238,176,176,,,,3083,1839,2938,1749,10,6,114,72,21,12,90,99,68
E02003519,Brighton and Hove 029,Middle Super Output Areas and Intermediate Zones,MSOAIZ,BN,8579,5052,2811,1647,928,616,1883,1031,40,20,525,348,46,27,479,321,321,,,,5116,2985,4906,2867,11,7,176,96,23,15,118,87,52
E02003520,Brighton and Hove 030,Middle Super Output Areas and Intermediate Zones,MSOAIZ,BN,8568,4690,2382,1284,854,532,1528,752,89,47,2277,1354,1770,1047,507,307,307,,,,3696,1922,3517,1833,6,3,148,69,25,17,89,124,83
E02003521,Brighton and Hove 031,Middle Super Output Areas and Intermediate Zones,MSOAIZ,BN,7716,4424,3332,1753,1117,748,2215,1005,45,30,1319,986,938,678,381,308,308,,,,2886,1556,2693,1464,34,18,138,62,21,12,92,134,99
E02003522,Brighton and Hove 032,Middle Super Output Areas and Intermediate Zones,MSOAIZ,BN,6777,3584,3173,1646,1270,774,1903,872,26,14,1067,636,857,495,210,141,141,,,,2420,1225,2265,1153,10,4,132,62,13,6,72,91,63
E02003523,Brighton and Hove 033,Middle Super Output Areas and Intermediate Zones,MSOAIZ,BN,9761,4512,7936,3678,3734,2098,4202,1580,138,75,285,133,123,50,162,83,83,,,,1325,581,1215,528,8,3,90,42,12,8,53,77,45
E02003524,Portsmouth 001,Middle Super Output Areas and Intermediate Zones,MSOAIZ,PO,7986,3076,3894,1514,1085,554,2809,960,98,36,3258,1259,2749,1081,509,178,178,,,,671,227,608,202,0,0,55,20,8,5,25,65,40
E02003525,Portsmouth 002,Middle Super Output Areas and Intermediate Zones,MSOAIZ,PO,6207,2459,2583,1063,851,457,1732,606,6,3,2701,1025,1928,776,773,249,249,,,,857,329,756,285,28,13,55,24,18,7,44,60,39
E02003526,Portsmouth 003,Middle Super Output Areas and Intermediate Zones,MSOAIZ,PO,6392,2687,5562,2326,2693,1405,2869,921,34,22,212,102,59,29,153,73,73,,,,534,213,454,178,56,23,20,9,4,3,35,50,24
E02003527,Portsmouth 004,Middle Super Output Areas and Intermediate Zones,MSOAIZ,PO,5869,2571,3573,1639,1304,761,2269,878,16,6,1086,443,632,289,454,154,154,,,,1126,449,797,344,185,53,47,23,97,29,105,68,34
E02003529,Portsmouth 006,Middle Super Output Areas and Intermediate Zones,MSOAIZ,PO,7637,3027,6157,2448,2169,1125,3988,1323,14,7,656,262,473,177,183,85,85,,,,759,284,673,253,7,2,70,26,9,3,31,51,26
E02003530,Portsmouth 007,Middle Super Output Areas and Intermediate Zones,MSOAIZ,PO,7467,3101,4406,1843,1553,824,2853,1019,47,24,1540,672,544,283,996,389,389,,,,1420,530,864,349,309,96,65,27,182,58,181,54,32
E02003531,Portsmouth 008,Middle Super Output Areas and Intermediate Zones,MSOAIZ,PO,7945,3314,6525,2699,2248,1187,4277,1512,22,11,245,97,18,10,227,87,87,,,,1096,480,980,433,3,1,101,41,12,5,47,57,27
E02003532,Portsmouth 009,Middle Super Output Areas and Intermediate Zones,MSOAIZ,PO,7506,3149,5278,2094,1494,766,3784,1328,19,9,334,198,68,37,266,161,161,,,,1822,819,1666,758,5,2,132,53,19,6,61,53,29
E02003533,Portsmouth 010,Middle Super Output Areas and Intermediate Zones,MSOAIZ,PO,5548,2408,3190,1434,939,529,2251,905,46,16,879,397,576,275,303,122,122,,,,1370,530,1263,484,5,1,95,43,7,2,46,63,31
E02003534,Portsmouth 011,Middle Super Output Areas and Intermediate Zones,MSOAIZ,PO,8817,3469,6470,2531,1918,969,4552,1562,42,20,286,107,151,52,135,55,55,,,,1957,775,1785,712,6,1,135,54,31,8,63,62,36
E02003535,Portsmouth 012,Middle Super Output Areas and Intermediate Zones,MSOAIZ,PO,9482,3810,6046,2463,1469,798,4577,1665,68,33,568,212,93,37,475,175,175,,,,2749,1075,2494,992,11,4,196,66,48,13,83,51,27
E02003536,Portsmouth 013,Middle Super Output Areas and Intermediate Zones,MSOAIZ,PO,7496,3277,1671,657,467,241,1204,416,101,40,4735,2179,4148,1891,587,288,288,,,,859,331,799,308,8,3,39,13,13,7,23,130,70
E02003537,Portsmouth 014,Middle Super Output Areas and Intermediate Zones,MSOAIZ,PO,10250,4182,7460,3039,2519,1327,4941,1712,141,76,1193,493,489,245,704,248,248,,,,1374,538,1202,469,7,2,141,59,24,8,69,82,36
E02003538,Portsmouth 015,Middle Super Output Areas and Intermediate Zones,MSOAIZ,PO,10164,4386,5043,2268,1323,752,3720,1516,117,48,1245,617,503,285,742,332,332,,,,3664,1398,3378,1283,10,5,263,102,13,8,115,95,55
E02003539,Portsmouth 016,Middle Super Output Areas and Intermediate Zones,MSOAIZ,PO,10185,4872,1653,752,577,299,1076,453,251,147,6262,3053,4429,2024,1833,1029,1029,,,,1853,821,1705,752,20,12,74,31,54,26,69,166,99
E02003540,Portsmouth 017,Middle Super Output Areas and Intermediate Zones,MSOAIZ,PO,8403,3685,6051,2638,2311,1232,3740,1406,68,35,667,384,319,173,348,211,211,,,,1530,583,1354,517,12,4,152,55,12,7,66,87,45
E02003541,Portsmouth 018,Middle Super Output Areas and Intermediate Zones,MSOAIZ,PO,11334,4631,2081,956,874,493,1207,463,76,39,5201,2225,4421,1820,780,405,405,,,,3788,1318,3636,1256,19,6,107,44,26,12,62,188,93
E02003542,Portsmouth 019,Middle Super Output Areas and Intermediate Zones,MSOAIZ,PO,9456,3669,4596,1995,1666,885,2930,1110,42,19,404,196,85,38,319,158,158,,,,4349,1427,4081,1331,31,8,223,82,14,6,96,65,32
E02003543,Portsmouth 020,Middle Super Output Areas and Intermediate Zones,MSOAIZ,PO,8923,3503,3459,1565,1318,681,2141,884,59,20,417,219,149,72,268,147,147,,,,4928,1668,4661,1558,13,6,213,83,41,21,110,60,31
E02003544,Portsmouth 021,Middle Super Output Areas and Intermediate Zones,MSOAIZ,PO,6450,2851,3813,1765,1265,704,2548,1061,36,22,468,211,130,62,338,149,149,,,,2093,833,1942,768,12,4,122,51,17,10,65,40,20
E02003545,Portsmouth 022,Middle Super Output Areas and Intermediate Zones,MSOAIZ,PO,6798,3555,2611,1340,1031,627,1580,713,36,25,809,528,209,101,600,427,427,,,,3269,1612,3095,1529,33,14,97,47,44,22,83,73,50
E02003546,Portsmouth 023,Middle Super Output Areas and Intermediate Zones,MSOAIZ,PO,8441,3825,4642,2257,1887,1102,2755,1155,48,26,407,196,160,57,247,139,139,,,,3268,1303,2714,1122,289,81,80,39,185,61,181,76,43
E02003547,Portsmouth 024,Middle Super Output Areas and Intermediate Zones,MSOAIZ,PO,8208,4470,3489,2008,1803,1149,1686,859,127,83,680,324,271,86,409,238,238,,,,3789,1981,3355,1795,186,66,135,70,113,50,186,123,74
E02003548,Portsmouth 025,Middle Super Output Areas and Intermediate Zones,MSOAIZ,PO,6584,2866,3472,1496,1362,694,2110,802,77,47,186,89,52,20,134,69,69,,,,2805,1204,2629,1133,38,11,130,56,8,4,71,44,30
E02003549,Southampton 001,Middle Super Output Areas and Intermediate Zones,MSOAIZ,SO,6633,2849,4030,1768,1764,920,2266,848,48,19,733,320,611,234,122,86,86,,,,1765,714,1567,569,10,4,73,31,115,110,145,57,28
E02003550,Southampton 002,Middle Super Output Areas and Intermediate Zones,MSOAIZ,SO,7878,3216,5256,2125,1721,866,3535,1259,84,38,1545,677,1189,527,356,150,150,,,,957,355,886,321,0,0,68,33,3,1,34,36,21
E02003551,Southampton 003,Middle Super Output Areas and Intermediate Zones,MSOAIZ,SO,4841,2256,2171,969,784,445,1387,524,94,38,1700,879,494,290,1206,589,589,,,,831,345,753,300,2,1,42,22,34,22,45,45,25
E02003552,Southampton 004,Middle Super Output Areas and Intermediate Zones,MSOAIZ,SO,6168,2646,2735,1084,689,339,2046,745,37,17,2633,1256,2165,1056,468,200,200,,,,698,245,622,217,0,0,73,26,3,2,28,65,44
E02003553,Southampton 005,Middle Super Output Areas and Intermediate Zones,MSOAIZ,SO,7009,2394,1880,766,736,361,1144,405,62,20,1756,609,1589,528,167,81,81,,,,3241,964,3115,917,8,4,87,31,31,12,47,70,35
E02003554,Southampton 006,Middle Super Output Areas and Intermediate Zones,MSOAIZ,SO,5951,2646,3790,1667,1635,868,2155,799,23,11,724,385,566,309,158,76,76,,,,1368,557,1282,520,7,3,62,27,17,7,37,46,26
E02003555,Southampton 007,Middle Super Output Areas and Intermediate Zones,MSOAIZ,SO,7325,3140,4155,1763,1401,760,2754,1003,46,18,2196,972,1798,831,398,141,141,,,,864,350,803,325,3,2,58,23,0,0,25,64,37
E02003556,Southampton 008,Middle Super Output Areas and Intermediate Zones,MSOAIZ,SO,5941,2471,4192,1740,1559,811,2633,929,20,9,729,309,573,232,156,77,77,,,,972,399,909,371,4,2,49,24,10,2,28,28,14
E02003557,Southampton 009,Middle Super Output Areas and Intermediate Zones,MSOAIZ,SO,6673,2753,3223,1445,1517,839,1706,606,34,8,319,203,93,50,226,153,153,,,,3065,1073,2893,1007,20,6,109,47,43,13,66,32,24
E02003558,Southampton 010,Middle Super Output Areas and Intermediate Zones,MSOAIZ,SO,6595,2924,2579,1164,883,495,1696,669,50,28,2025,945,1514,718,511,227,227,,,,1890,755,1790,708,26,12,54,27,20,8,47,51,32
E02003559,Southampton 011,Middle Super Output Areas and Intermediate Zones,MSOAIZ,SO,7752,3065,6067,2351,2301,1157,3766,1194,69,36,396,183,150,76,246,107,107,,,,1152,464,1090,439,3,1,48,19,11,5,25,68,31
E02003560,Southampton 012,Middle Super Output Areas and Intermediate Zones,MSOAIZ,SO,7165,3040,2526,1098,837,457,1689,641,27,9,3894,1627,3573,1519,321,108,108,,,,653,266,613,246,0,0,36,17,4,3,20,65,40
E02003561,Southampton 013,Middle Super Output Areas and Intermediate Zones,MSOAIZ,SO,7817,3181,2345,1081,963,481,1382,600,57,24,1287,626,644,302,643,324,324,,,,4084,1423,3948,1370,8,2,103,43,25,8,53,44,27
E02003562,Southampton 014,Middle Super Output Areas and Intermediate Zones,MSOAIZ,SO,8025,3636,5099,2152,1605,832,3494,1320,96,56,655,332,209,94,446,238,238,,,,2119,1063,2008,1007,9,5,97,47,5,4,56,56,33
E02003563,Southampton 015,Middle Super Output Areas and Intermediate Zones,MSOAIZ,SO,7638,3483,3976,1804,1395,793,2581,1011,89,43,1580,759,1156,555,424,204,204,,,,1933,842,1824,794,0,0,86,38,23,10,48,60,35
E02003564,Southampton 016,Middle Super Output Areas and Intermediate Zones,MSOAIZ,SO,7944,3474,5090,2202,1916,1059,3174,1143,92,36,1713,783,1439,644,274,139,139,,,,983,420,914,386,1,1,65,32,3,1,34,66,33
E02003565,Southampton 017,Middle Super Output Areas and Intermediate Zones,MSOAIZ,SO,6533,2563,1484,742,597,308,887,434,58,30,508,298,176,79,332,219,219,,,,4426,1467,4295,1411,14,4,107,46,10,6,56,57,26
E02003566,Southampton 018,Middle Super Output Areas and Intermediate Zones,MSOAIZ,SO,6025,2607,3587,1549,1340,747,2247,802,76,32,1798,778,1424,587,374,191,191,,,,526,218,487,198,0,0,36,18,3,2,20,38,30
E02003567,Southampton 019,Middle Super Output Areas and Intermediate Zones,MSOAIZ,SO,7613,2991,4290,1699,1395,688,2895,1011,54,23,2081,816,1846,716,235,100,100,,,,1131,422,1030,386,2,1,85,31,14,4,36,57,31
E02003568,Southampton 020,Middle Super Output Areas and Intermediate Zones,MSOAIZ,SO,8034,3820,3681,1640,1176,601,2505,1039,61,29,367,173,62,22,305,151,151,,,,3863,1945,3728,1880,12,4,106,51,17,10,65,62,33
E02003569,Southampton 021,Middle Super Output Areas and Intermediate Zones,MSOAIZ,SO,7401,3527,3183,1563,1069,613,2114,950,76,48,1063,529,346,165,717,364,364,,,,3012,1350,2866,1280,6,3,127,59,13,8,70,67,37
E02003570,Southampton 022,Middle Super Output Areas and Intermediate Zones,MSOAIZ,SO,9809,3635,2671,821,993,357,1678,464,37,20,2549,1084,1429,621,1120,463,463,,,,4419,1661,4256,1603,15,4,108,36,40,18,58,133,49
E02003571,Southampton 023,Middle Super Output Areas and Intermediate Zones,MSOAIZ,SO,6743,3040,1156,653,499,305,657,348,12,5,994,615,452,256,542,359,359,,,,4493,1732,4377,1676,24,11,73,35,19,10,56,88,35
E02003572,Southampton 024,Middle Super Output Areas and Intermediate Zones,MSOAIZ,SO,6084,2484,4606,1870,1586,802,3020,1068,23,13,524,202,416,158,108,44,44,,,,906,384,839,351,8,2,52,27,7,4,33,25,15
E02003573,Southampton 025,Middle Super Output Areas and Intermediate Zones,MSOAIZ,SO,7434,3236,3512,1548,1414,796,2098,752,64,31,3278,1409,2910,1291,368,118,118,,,,499,198,427,169,1,1,56,24,15,4,29,81,50
E02003574,Southampton 026,Middle Super Output Areas and Intermediate Zones,MSOAIZ,SO,7752,3412,5775,2447,2033,1101,3742,1346,140,65,774,402,487,299,287,103,103,,,,1009,466,927,425,3,1,77,38,2,2,41,54,32
E02003575,Southampton 027,Middle Super Output Areas and Intermediate Zones,MSOAIZ,SO,6348,2808,2483,1057,763,403,1720,654,113,43,3125,1436,2835,1316,290,120,120,,,,553,231,492,207,4,1,51,19,6,4,24,74,41
E02003576,Southampton 028,Middle Super Output Areas and Intermediate Zones,MSOAIZ,SO,8041,3434,4812,1937,1313,668,3499,1269,89,40,1703,784,1111,528,592,256,256,,,,1383,638,1310,602,1,1,68,33,4,2,36,54,35
E02003577,Southampton 029,Middle Super Output Areas and Intermediate Zones,MSOAIZ,SO,9365,4908,2140,1211,689,409,1451,802,288,160,2793,1355,2001,959,792,396,396,,,,4030,2115,3883,2040,6,3,112,57,29,15,75,114,67
E02003578,Southampton 030,Middle Super Output Areas and Intermediate Zones,MSOAIZ,SO,6272,2641,4482,1905,1381,758,3101,1147,48,19,717,281,463,187,254,94,94,,,,990,414,890,374,17,6,80,32,3,2,40,35,22
E02003579,Southampton 031,Middle Super Output Areas and Intermediate Zones,MSOAIZ,SO,7637,3357,4874,2118,1645,886,3229,1232,61,23,918,388,377,162,541,226,226,,,,1720,799,1625,751,2,1,84,41,9,6,48,64,29
E02003580,Southampton 032,Middle Super Output Areas and Intermediate Zones,MSOAIZ,SO,6013,2617,2287,934,675,361,1612,573,47,22,3172,1452,2784,1322,388,130,130,,,,436,174,396,157,1,1,39,16,0,0,17,71,35
E02003581,Isle of Wight 001,Middle Super Output Areas and Intermediate Zones,MSOAIZ,PO,7735,3669,4764,2313,1812,1097,2952,1216,30,13,615,293,34,20,581,273,273,,,,2235,991,2087,921,15,6,115,56,18,8,70,91,59
E02003582,Isle of Wight 002,Middle Super Output Areas and Intermediate Zones,MSOAIZ,PO,8136,3516,6675,2912,3095,1681,3580,1231,18,11,430,181,27,11,403,170,170,,,,946,369,838,319,5,4,97,45,6,1,50,67,43
E02003583,Isle of Wight 003,Middle Super Output Areas and Intermediate Zones,MSOAIZ,PO,6334,2847,4161,1931,2003,1117,2158,814,79,36,1133,477,97,45,1036,432,432,,,,932,385,861,351,6,4,51,23,14,7,34,29,18
E02003584,Isle of Wight 004,Middle Super Output Areas and Intermediate Zones,MSOAIZ,PO,5925,3149,3163,1550,1324,778,1839,772,4,3,320,202,25,18,295,184,184,,,,2365,1347,2272,1298,9,5,76,40,8,4,49,73,47
E02003585,Isle of Wight 005,Middle Super Output Areas and Intermediate Zones,MSOAIZ,PO,6539,3018,5240,2455,2791,1550,2449,905,152,57,239,132,26,8,213,124,124,,,,853,343,741,295,26,12,81,32,5,4,48,55,31
E02003586,Isle of Wight 006,Middle Super Output Areas and Intermediate Zones,MSOAIZ,PO,7461,3268,5305,2357,2376,1288,2929,1069,47,18,879,391,86,41,793,350,350,,,,1180,472,1081,426,4,2,78,35,17,9,46,50,30
E02003587,Isle of Wight 007,Middle Super Output Areas and Intermediate Zones,MSOAIZ,PO,8305,3610,4945,2190,2067,1138,2878,1052,35,19,1544,639,154,76,1390,563,563,,,,1721,726,1591,667,6,1,113,51,11,7,59,60,36
E02003588,Isle of Wight 008,Middle Super Output Areas and Intermediate Zones,MSOAIZ,PO,6659,2917,4467,1922,1911,1007,2556,915,29,11,1310,592,146,70,1164,522,522,,,,809,360,700,315,9,4,93,39,7,2,45,44,32
E02003589,Isle of Wight 009,Middle Super Output Areas and Intermediate Zones,MSOAIZ,PO,7357,3320,4162,1829,1444,808,2718,1021,36,13,1073,532,150,73,923,459,459,,,,2056,927,1886,846,25,12,128,62,17,7,81,30,19
E02003590,Isle of Wight 010,Middle Super Output Areas and Intermediate Zones,MSOAIZ,PO,7228,3549,5868,2899,3597,2054,2271,845,24,13,307,151,17,7,290,144,144,,,,924,413,830,363,22,9,68,37,4,4,50,105,73
E02003591,Isle of Wight 011,Middle Super Output Areas and Intermediate Zones,MSOAIZ,PO,9111,3750,6631,2762,2796,1428,3835,1334,56,27,1073,422,133,56,940,366,366,,,,1278,496,1171,450,14,5,82,37,11,4,46,73,43
E02003592,Isle of Wight 012,Middle Super Output Areas and Intermediate Zones,MSOAIZ,PO,9243,4475,6649,3289,4095,2310,2554,979,51,19,1030,482,54,32,976,450,450,,,,1415,625,1260,560,5,3,122,52,28,10,65,98,60
E02003593,Isle of Wight 013,Middle Super Output Areas and Intermediate Zones,MSOAIZ,PO,5263,2350,4393,1962,2413,1250,1980,712,15,7,256,124,1,1,255,123,123,,,,525,219,425,175,20,7,62,26,18,11,44,74,38
E02003594,Isle of Wight 014,Middle Super Output Areas and Intermediate Zones,MSOAIZ,PO,8871,3910,5670,2552,2549,1388,3121,1164,229,80,1089,425,92,38,997,387,387,,,,1796,803,1621,723,15,4,142,70,18,6,80,87,50
E02003595,Isle of Wight 015,Middle Super Output Areas and Intermediate Zones,MSOAIZ,PO,8043,3613,6622,3002,3434,1856,3188,1146,13,6,535,238,28,8,507,230,230,,,,819,336,706,286,4,2,107,46,2,2,50,54,31
E02003596,Isle of Wight 016,Middle Super Output Areas and Intermediate Zones,MSOAIZ,PO,8348,4020,5372,2504,2776,1542,2596,962,40,13,1006,518,100,46,906,472,472,,,,1860,934,1714,861,4,2,138,68,4,3,73,70,51
E02003597,Isle of Wight 017,Middle Super Output Areas and Intermediate Zones,MSOAIZ,PO,5610,2464,4318,1905,2339,1199,1979,706,15,5,549,248,48,18,501,230,230,,,,655,267,563,233,14,6,74,25,4,3,34,73,39
E02003598,Isle of Wight 018,Middle Super Output Areas and Intermediate Zones,MSOAIZ,PO,7545,3640,5147,2483,2893,1600,2254,883,28,11,985,476,71,30,914,446,446,,,,1305,626,1184,574,9,6,87,38,25,8,52,80,44
E02003599,Central Bedfordshire 001,Middle Super Output Areas and Intermediate Zones,MSOAIZ,SG,5600,2236,3878,1494,903,454,2975,1040,93,38,1048,457,95,44,953,413,413,,,,552,225,528,214,0,0,24,11,0,0,11,29,22
E02003600,Central Bedfordshire 002,Middle Super Output Areas and Intermediate Zones,MSOAIZ,SG,5984,2556,4334,1793,1454,760,2880,1033,41,18,925,398,118,53,807,345,345,,,,623,307,592,291,3,2,21,11,7,3,16,61,40
E02003601,Central Bedfordshire 003,Middle Super Output Areas and Intermediate Zones,MSOAIZ,SG,7193,3029,5486,2217,2054,1015,3432,1202,44,19,826,372,117,59,709,313,313,,,,775,382,711,355,14,4,33,17,17,6,27,62,39
E02003602,Central Bedfordshire 004,Middle Super Output Areas and Intermediate Zones,MSOAIZ,SG,5907,2444,4197,1699,1867,912,2330,787,7,4,866,377,74,33,792,344,344,,,,765,328,686,296,27,11,32,12,20,9,32,72,36
E02003603,Central Bedfordshire 005,Middle Super Output Areas and Intermediate Zones,MSOAIZ,SG,9555,4186,6611,2794,2190,1154,4421,1640,89,42,1313,586,126,54,1187,532,532,,,,1474,714,1383,672,6,2,70,32,15,8,42,68,50
E02003604,Central Bedfordshire 006,Middle Super Output Areas and Intermediate Zones,MSOAIZ,SG,6896,2729,5045,1969,1661,830,3384,1139,90,36,1221,486,134,44,1087,442,442,,,,485,203,443,187,9,3,33,13,0,0,16,55,35
E02003605,Central Bedfordshire 007,Middle Super Output Areas and Intermediate Zones,MSOAIZ,MK,7750,3066,5451,2175,2204,1079,3247,1096,23,11,724,311,42,18,682,293,293,,,,1473,529,1097,409,69,21,35,18,272,81,120,79,40
E02003606,Central Bedfordshire 008,Middle Super Output Areas and Intermediate Zones,MSOAIZ,SG,7578,3068,6052,2376,2343,1163,3709,1213,50,18,868,400,56,28,812,372,372,,,,546,231,466,201,21,7,41,18,18,5,30,62,43
E02003607,Central Bedfordshire 009,Middle Super Output Areas and Intermediate Zones,MSOAIZ,MK,8423,3499,5939,2379,1976,971,3963,1408,86,31,966,435,38,21,928,414,414,,,,1256,563,1092,493,56,25,55,23,53,22,70,176,91
E02003608,Central Bedfordshire 010,Middle Super Output Areas and Intermediate Zones,MSOAIZ,SG,10835,4562,8041,3309,2435,1255,5606,2054,106,49,1613,731,136,56,1477,675,675,,,,1015,440,897,392,26,9,79,33,13,6,48,60,33
E02003609,Central Bedfordshire 011,Middle Super Output Areas and Intermediate Zones,MSOAIZ,SG,9782,4001,6612,2639,2225,1124,4387,1515,96,44,1454,673,55,29,1399,644,644,,,,1528,597,800,361,372,112,74,34,282,90,236,92,48
E02003610,Central Bedfordshire 012,Middle Super Output Areas and Intermediate Zones,MSOAIZ,MK,7143,2966,5709,2300,2201,1115,3508,1185,6,3,592,288,75,25,517,263,263,,,,776,343,636,292,11,5,74,34,55,12,51,60,32
E02003611,Central Bedfordshire 013,Middle Super Output Areas and Intermediate Zones,MSOAIZ,SG,8245,3353,6062,2487,2280,1177,3782,1310,79,38,797,326,40,14,757,312,312,,,,1280,482,506,220,463,156,30,17,281,89,262,27,20
E02003612,Central Bedfordshire 014,Middle Super Output Areas and Intermediate Zones,MSOAIZ,SG,9632,3978,7607,3077,2263,1171,5344,1906,113,52,1004,414,96,41,908,373,373,,,,826,388,763,359,6,1,53,25,4,3,29,82,47
E02003613,Central Bedfordshire 015,Middle Super Output Areas and Intermediate Zones,MSOAIZ,MK,5828,2387,4135,1594,1343,665,2792,929,26,9,1036,469,54,25,982,444,444,,,,584,287,538,268,5,1,37,16,4,2,19,47,28
E02003614,Central Bedfordshire 016,Middle Super Output Areas and Intermediate Zones,MSOAIZ,MK,7347,3020,6178,2477,1978,973,4200,1504,38,22,173,101,18,9,155,92,92,,,,905,395,801,348,23,10,73,31,8,6,47,53,25
E02003615,Central Bedfordshire 017,Middle Super Output Areas and Intermediate Zones,MSOAIZ,MK,8752,3451,7264,2808,2714,1320,4550,1488,57,29,685,303,34,14,651,289,289,,,,664,268,593,239,15,6,34,16,22,7,29,82,43
E02003616,Bedford 001,Middle Super Output Areas and Intermediate Zones,MSOAIZ,PE,5615,2275,4487,1807,2075,987,2412,820,38,15,427,187,18,8,409,179,179,,,,559,222,447,179,29,10,47,20,36,13,43,104,44
E02003617,Bedford 002,Middle Super Output Areas and Intermediate Zones,MSOAIZ,NN,8854,3714,7092,2882,3033,1542,4059,1340,86,40,620,303,33,16,587,287,287,,,,928,417,830,371,26,11,52,23,20,12,46,128,72
E02003618,Bedford 003,Middle Super Output Areas and Intermediate Zones,MSOAIZ,MK,8556,3521,6827,2759,2601,1356,4226,1403,112,46,699,317,112,44,587,273,273,,,,872,371,775,328,1,1,77,33,19,9,43,46,28
E02003619,Bedford 004,Middle Super Output Areas and Intermediate Zones,MSOAIZ,PE,9908,4057,7525,3083,2931,1478,4594,1605,202,78,1175,457,124,43,1051,414,414,,,,880,379,804,344,27,9,36,19,13,7,35,126,60
E02003620,Bedford 005,Middle Super Output Areas and Intermediate Zones,MSOAIZ,MK,8125,3497,6355,2670,2956,1505,3399,1165,37,13,1002,504,111,50,891,454,454,,,,672,277,592,243,6,2,62,25,12,7,34,59,33
E02003621,Bedford 006,Middle Super Output Areas and Intermediate Zones,MSOAIZ,MK,8048,3304,6781,2787,3196,1627,3585,1160,22,8,669,305,52,22,617,283,283,,,,561,191,472,160,2,1,80,28,7,2,31,15,13
E02003622,Bedford 007,Middle Super Output Areas and Intermediate Zones,MSOAIZ,MK,9090,3762,5022,2147,1863,996,3159,1151,89,35,2919,1162,448,170,2471,992,992,,,,959,363,895,335,4,1,53,25,7,2,28,101,55
E02003623,Bedford 008,Middle Super Output Areas and Intermediate Zones,MSOAIZ,MK,8120,3285,6923,2793,2813,1410,4110,1383,100,43,449,179,15,7,434,172,172,,,,600,241,555,221,14,6,24,11,7,3,20,48,29
E02003624,Bedford 009,Middle Super Output Areas and Intermediate Zones,MSOAIZ,MK,4808,2346,2995,1337,1313,701,1682,636,22,11,382,206,54,22,328,184,184,,,,1313,746,1253,704,6,4,44,31,10,7,42,96,46
E02003625,Bedford 010,Middle Super Output Areas and Intermediate Zones,MSOAIZ,MK,7574,3737,3437,1546,1282,670,2155,876,37,16,1409,888,185,90,1224,798,798,,,,2619,1247,2493,1174,16,5,86,54,24,14,73,72,40
E02003626,Bedford 011,Middle Super Output Areas and Intermediate Zones,MSOAIZ,MK,5388,2259,3893,1632,1383,723,2510,909,37,13,518,219,74,23,444,196,196,,,,909,379,833,348,12,4,59,24,5,3,31,31,16
E02003627,Bedford 012,Middle Super Output Areas and Intermediate Zones,MSOAIZ,MK,8822,4080,4336,1813,1642,832,2694,981,55,36,1194,690,170,74,1024,616,616,,,,3145,1485,3000,1424,10,4,78,33,57,24,61,92,56
E02003628,Bedford 013,Middle Super Output Areas and Intermediate Zones,MSOAIZ,MK,8526,2801,4709,1545,1765,711,2944,834,79,31,1320,445,210,64,1110,381,381,,,,2275,730,2131,686,13,4,95,31,36,9,44,143,50
E02003629,Bedford 014,Middle Super Output Areas and Intermediate Zones,MSOAIZ,MK,9418,3940,4765,2041,1457,786,3308,1255,76,30,2910,1165,481,189,2429,976,976,,,,1570,654,1477,614,19,5,64,30,10,5,40,97,50
E02003630,Bedford 015,Middle Super Output Areas and Intermediate Zones,MSOAIZ,MK,9680,3681,4606,1730,1583,717,3023,1013,133,61,2376,929,355,137,2021,792,792,,,,2462,910,2295,836,50,25,63,29,54,20,74,103,51
E02003631,Bedford 016,Middle Super Output Areas and Intermediate Zones,MSOAIZ,MK,5410,2180,3359,1318,1261,581,2098,737,68,26,1385,588,87,31,1298,557,557,,,,552,233,498,210,9,3,27,13,18,7,23,46,15
E02003632,Bedford 017,Middle Super Output Areas and Intermediate Zones,MSOAIZ,MK,6028,2491,4184,1701,1433,747,2751,954,65,39,633,275,82,32,551,243,243,,,,1087,445,1000,408,13,5,58,28,16,4,37,59,31
E02003633,Bedford 018,Middle Super Output Areas and Intermediate Zones,MSOAIZ,MK,7761,2982,5343,2045,1880,908,3463,1137,52,16,1495,585,178,64,1317,521,521,,,,823,312,738,272,16,6,53,26,16,8,40,48,24
E02003634,Bedford 019,Middle Super Output Areas and Intermediate Zones,MSOAIZ,MK,9460,3747,6520,2612,1934,1005,4586,1607,235,98,1732,634,138,49,1594,585,585,,,,911,367,828,334,12,4,48,19,23,10,33,62,36
E02003635,Bedford 020,Middle Super Output Areas and Intermediate Zones,MSOAIZ,MK,5345,2153,4392,1689,1490,736,2902,953,24,10,451,214,44,20,407,194,194,,,,340,141,290,119,10,4,30,12,10,6,22,138,99
E02003636,Central Bedfordshire 018,Middle Super Output Areas and Intermediate Zones,MSOAIZ,MK,7296,2974,6003,2407,2062,1036,3941,1371,57,23,416,195,286,141,130,54,54,,,,780,329,718,299,7,4,49,23,6,3,30,40,20
E02003637,Central Bedfordshire 019,Middle Super Output Areas and Intermediate Zones,MSOAIZ,MK,9349,3878,7487,3042,2879,1448,4608,1594,48,24,906,393,789,351,117,42,42,,,,805,364,710,328,25,9,59,24,11,3,36,103,55
E02003638,Central Bedfordshire 020,Middle Super Output Areas and Intermediate Zones,MSOAIZ,LU,7399,2933,6156,2475,2269,1144,3887,1331,18,8,659,232,616,219,43,13,13,,,,518,198,478,177,11,5,27,14,2,2,21,48,20
E02003639,Central Bedfordshire 021,Middle Super Output Areas and Intermediate Zones,MSOAIZ,LU,8549,3948,5113,2248,1705,932,3408,1316,55,35,1992,940,1502,708,490,232,232,,,,1277,648,1134,578,7,3,118,61,18,6,70,112,77
E02003640,Central Bedfordshire 022,Middle Super Output Areas and Intermediate Zones,MSOAIZ,LU,5948,2621,4522,1933,1851,944,2671,989,39,14,503,230,321,155,182,75,75,,,,844,414,767,384,14,5,56,22,7,3,30,40,30
E02003641,Central Bedfordshire 023,Middle Super Output Areas and Intermediate Zones,MSOAIZ,LU,5474,2233,4779,1896,1520,777,3259,1119,12,5,139,70,104,38,35,32,32,,,,521,246,465,221,4,2,50,21,2,2,25,23,16
E02003642,Central Bedfordshire 025,Middle Super Output Areas and Intermediate Zones,MSOAIZ,LU,8789,3325,4902,1888,1231,583,3671,1305,117,38,2689,977,2424,878,265,99,99,,,,1023,392,952,362,9,2,51,25,11,3,30,58,30
E02003643,Central Bedfordshire 024,Middle Super Output Areas and Intermediate Zones,MSOAIZ,LU,9839,3946,7209,2895,1791,913,5418,1982,172,78,1097,415,271,124,826,291,291,,,,1321,535,1183,483,36,11,64,29,38,12,52,40,23
E02003644,Central Bedfordshire 026,Middle Super Output Areas and Intermediate Zones,MSOAIZ,LU,8388,3473,5700,2333,1662,855,4038,1478,69,30,1590,671,541,248,1049,423,423,,,,969,404,857,355,3,2,70,36,39,11,49,60,35
E02003645,Central Bedfordshire 027,Middle Super Output Areas and Intermediate Zones,MSOAIZ,LU,6675,2648,5708,2272,2135,1114,3573,1158,51,25,221,79,27,11,194,68,68,,,,667,261,588,229,22,7,53,22,4,3,32,28,11
E02003646,Central Bedfordshire 028,Middle Super Output Areas and Intermediate Zones,MSOAIZ,LU,8830,3557,6034,2425,2086,1052,3948,1373,77,37,1867,745,1463,599,404,146,146,,,,782,302,700,268,5,2,74,30,3,2,34,70,48
E02003647,Central Bedfordshire 029,Middle Super Output Areas and Intermediate Zones,MSOAIZ,LU,8477,3862,5650,2407,1974,1044,3676,1363,55,26,1016,556,596,322,420,234,234,,,,1683,825,1573,773,13,5,74,39,23,8,52,73,48
E02003648,Central Bedfordshire 030,Middle Super Output Areas and Intermediate Zones,MSOAIZ,LU,5184,2206,3065,1290,1015,565,2050,725,31,14,1629,694,1242,557,387,137,137,,,,411,179,391,168,0,0,16,7,4,4,11,48,29
E02003649,Central Bedfordshire 031,Middle Super Output Areas and Intermediate Zones,MSOAIZ,LU,6851,2786,5763,2263,2245,1108,3518,1155,72,32,226,111,112,68,114,43,43,,,,767,366,724,351,10,3,28,10,5,2,15,23,14
E02003650,Central Bedfordshire 032,Middle Super Output Areas and Intermediate Zones,MSOAIZ,LU,6730,2914,5396,2302,2497,1261,2899,1041,42,14,788,346,740,330,48,16,16,,,,434,216,355,178,36,14,33,18,10,6,38,70,36
E02003651,Central Bedfordshire 033,Middle Super Output Areas and Intermediate Zones,MSOAIZ,LU,5892,2564,4818,2080,2091,1125,2727,955,12,8,460,200,313,148,147,52,52,,,,553,251,486,222,25,10,32,14,10,5,29,49,25
E02003652,Aylesbury Vale 001,Middle Super Output Areas and Intermediate Zones,MSOAIZ,NN,7808,3079,6109,2386,2206,1094,3903,1292,69,25,553,225,136,50,417,175,175,,,,992,400,925,367,22,7,36,21,9,5,33,85,43
E02003653,Aylesbury Vale 002,Middle Super Output Areas and Intermediate Zones,MSOAIZ,MK,6138,2616,4188,1758,1538,828,2650,930,25,14,898,385,252,112,646,273,273,,,,981,433,902,401,12,5,56,22,11,5,32,46,26
E02003654,Aylesbury Vale 003,Middle Super Output Areas and Intermediate Zones,MSOAIZ,MK,5522,2208,4647,1791,1810,856,2837,935,38,18,389,190,132,65,257,125,125,,,,380,168,324,145,8,4,45,17,3,2,23,68,41
E02003655,Aylesbury Vale 004,Middle Super Output Areas and Intermediate Zones,MSOAIZ,OX,9421,3706,7274,2790,2430,1151,4844,1639,86,32,898,376,223,96,675,280,280,,,,1015,435,878,382,41,14,74,29,22,10,53,148,73
E02003656,Aylesbury Vale 005,Middle Super Output Areas and Intermediate Zones,MSOAIZ,MK,5674,2485,4333,1829,1796,927,2537,902,19,8,584,285,141,68,443,217,217,,,,655,319,603,291,9,5,35,19,8,4,28,83,44
E02003657,Aylesbury Vale 006,Middle Super Output Areas and Intermediate Zones,MSOAIZ,MK,5971,2411,4626,1811,1899,889,2727,922,46,18,547,271,173,82,374,189,189,,,,650,264,571,230,27,11,41,18,11,5,34,102,47
E02003658,Aylesbury Vale 007,Middle Super Output Areas and Intermediate Zones,MSOAIZ,LU,6901,2869,5467,2225,2149,1055,3318,1170,64,25,665,305,140,69,525,236,236,,,,605,261,517,226,13,4,59,23,16,8,35,100,53
E02003659,Aylesbury Vale 008,Middle Super Output Areas and Intermediate Zones,MSOAIZ,MK,8321,3272,5679,2202,1946,935,3733,1267,125,49,1372,546,179,82,1193,464,464,,,,977,396,870,351,49,26,41,14,17,5,45,168,79
E02003660,Aylesbury Vale 009,Middle Super Output Areas and Intermediate Zones,MSOAIZ,LU,9523,3823,7859,3084,2795,1346,5064,1738,40,15,863,372,246,113,617,259,259,,,,678,306,613,275,18,10,36,16,11,5,31,83,46
E02003661,Aylesbury Vale 010,Middle Super Output Areas and Intermediate Zones,MSOAIZ,OX,5202,2066,4177,1602,1533,729,2644,873,18,9,303,162,69,39,234,123,123,,,,631,261,552,227,35,13,30,14,14,7,34,73,32
E02003662,Aylesbury Vale 011,Middle Super Output Areas and Intermediate Zones,MSOAIZ,HP,6219,2592,4035,1620,1127,533,2908,1087,52,17,928,415,280,111,648,304,304,,,,1164,518,1097,485,10,3,47,25,10,5,33,40,22
E02003663,Aylesbury Vale 012,Middle Super Output Areas and Intermediate Zones,MSOAIZ,HP,5413,2044,3201,1195,704,342,2497,853,15,5,1552,613,567,215,985,398,398,,,,598,210,540,189,11,5,36,13,11,3,21,47,21
E02003664,Aylesbury Vale 013,Middle Super Output Areas and Intermediate Zones,MSOAIZ,HP,6060,2440,3921,1605,1207,646,2714,959,53,16,1214,473,303,116,911,357,357,,,,808,309,748,281,3,1,46,23,11,4,28,64,37
E02003665,Aylesbury Vale 014,Middle Super Output Areas and Intermediate Zones,MSOAIZ,HP,5514,2209,4120,1658,1279,663,2841,995,52,17,429,166,98,37,331,129,129,,,,897,362,835,336,1,1,52,22,9,3,26,16,6
E02003666,Aylesbury Vale 015,Middle Super Output Areas and Intermediate Zones,MSOAIZ,HP,6678,2974,3454,1434,1386,641,2068,793,212,123,990,520,130,82,860,438,438,,,,1949,865,1813,809,21,6,93,40,22,10,56,73,32
E02003667,Aylesbury Vale 016,Middle Super Output Areas and Intermediate Zones,MSOAIZ,HP,9344,3887,6587,2694,1237,624,5350,2070,83,36,788,332,186,88,602,244,244,,,,1848,809,1732,755,14,4,96,47,6,3,54,38,16
E02003668,Aylesbury Vale 017,Middle Super Output Areas and Intermediate Zones,MSOAIZ,HP,8757,3472,7683,3013,3085,1577,4598,1436,34,14,156,96,36,18,120,78,78,,,,829,323,662,265,81,24,46,19,40,15,58,55,26
E02003669,Aylesbury Vale 018,Middle Super Output Areas and Intermediate Zones,MSOAIZ,HP,6893,2506,3297,1137,877,368,2420,769,74,36,2584,967,953,349,1631,618,618,,,,858,321,778,294,4,2,74,24,2,1,27,80,45
E02003670,Aylesbury Vale 019,Middle Super Output Areas and Intermediate Zones,MSOAIZ,HP,8644,3650,6330,2556,1960,975,4370,1581,91,44,915,442,120,54,795,388,388,,,,1277,587,1145,512,23,14,81,37,28,24,75,31,21
E02003671,Aylesbury Vale 020,Middle Super Output Areas and Intermediate Zones,MSOAIZ,HP,5882,2395,3700,1513,839,432,2861,1081,54,27,1273,493,453,171,820,322,322,,,,816,342,760,318,3,2,53,22,0,0,24,39,20
E02003672,Aylesbury Vale 021,Middle Super Output Areas and Intermediate Zones,MSOAIZ,HP,9463,3837,7984,3181,3125,1525,4859,1656,9,6,607,275,165,78,442,197,197,,,,793,332,643,273,54,20,40,22,56,17,59,70,43
E02003673,Aylesbury Vale 022,Middle Super Output Areas and Intermediate Zones,MSOAIZ,OX,8006,3387,6520,2691,2946,1462,3574,1229,39,16,652,311,175,80,477,231,231,,,,714,325,634,292,16,8,56,21,8,4,33,81,44
E02003674,Aylesbury Vale 023,Middle Super Output Areas and Intermediate Zones,MSOAIZ,OX,5257,2137,4229,1667,1810,868,2419,799,18,7,589,280,157,68,432,212,212,,,,375,154,320,132,13,6,34,14,8,2,22,46,29
E02003675,Aylesbury Vale 024,Middle Super Output Areas and Intermediate Zones,MSOAIZ,HP,8040,3341,5493,2260,2115,1141,3378,1119,55,23,990,482,169,90,821,392,392,,,,1431,534,577,260,545,166,39,17,270,91,274,71,42
E02003676,Chiltern 001,Middle Super Output Areas and Intermediate Zones,MSOAIZ,WD,7969,3190,6808,2695,3416,1605,3392,1090,10,5,528,209,69,26,459,183,183,,,,528,234,471,209,26,10,28,13,3,2,25,95,47
E02003677,Chiltern 002,Middle Super Output Areas and Intermediate Zones,MSOAIZ,HP,9576,3751,6191,2437,2398,1206,3793,1231,116,54,2565,1001,478,176,2087,825,825,,,,652,235,610,218,0,0,29,13,13,4,17,52,24
E02003678,Chiltern 003,Middle Super Output Areas and Intermediate Zones,MSOAIZ,HP,5474,2195,4462,1792,1674,835,2788,957,30,8,390,152,86,28,304,124,124,,,,550,223,499,205,1,1,45,16,5,1,18,42,20
E02003679,Chiltern 004,Middle Super Output Areas and Intermediate Zones,MSOAIZ,HP,6311,2796,3856,1673,1451,767,2405,906,58,20,1345,644,180,85,1165,559,559,,,,995,431,933,403,15,4,37,18,10,6,28,57,28
E02003680,Chiltern 005,Middle Super Output Areas and Intermediate Zones,MSOAIZ,HP,9983,4032,8252,3266,3667,1813,4585,1453,30,9,840,392,96,49,744,343,343,,,,767,316,681,282,46,18,29,12,11,4,34,94,49
E02003681,Chiltern 006,Middle Super Output Areas and Intermediate Zones,MSOAIZ,HP,10051,3982,7695,3011,3502,1706,4193,1305,18,8,1108,492,177,72,931,420,420,,,,1168,441,1082,408,21,9,49,17,16,7,33,62,30
E02003682,Chiltern 007,Middle Super Output Areas and Intermediate Zones,MSOAIZ,HP,7306,3000,5545,2227,2203,1097,3342,1130,108,37,651,308,89,35,562,273,273,,,,932,395,886,373,9,5,34,15,3,2,22,70,33
E02003683,Chiltern 008,Middle Super Output Areas and Intermediate Zones,MSOAIZ,HP,6285,2509,4667,1831,2176,1049,2491,782,139,52,913,413,128,60,785,353,353,,,,505,187,490,180,7,3,5,3,3,1,7,61,26
E02003685,Chiltern 010,Middle Super Output Areas and Intermediate Zones,MSOAIZ,SL,7957,3185,6552,2592,2944,1424,3608,1168,67,26,567,276,67,37,500,239,239,,,,690,257,647,241,10,3,13,5,20,8,16,81,34
E02003686,Chiltern 011,Middle Super Output Areas and Intermediate Zones,MSOAIZ,WD,6858,2702,5970,2310,2611,1250,3359,1060,23,14,241,128,41,18,200,110,110,,,,584,232,475,195,79,26,22,6,8,5,37,40,18
E02003687,Chiltern 012,Middle Super Output Areas and Intermediate Zones,MSOAIZ,SL,5592,2182,4456,1694,1736,844,2720,850,19,7,680,315,78,39,602,276,276,,,,388,141,341,123,18,6,14,7,15,5,18,49,25
E02003688,South Bucks 001,Middle Super Output Areas and Intermediate Zones,MSOAIZ,HP,11786,4733,8363,3261,3832,1842,4531,1419,88,41,1452,655,100,45,1352,610,610,,,,1720,700,1441,596,129,51,62,24,88,29,104,163,76
E02003689,South Bucks 002,Middle Super Output Areas and Intermediate Zones,MSOAIZ,UB,8525,3160,6916,2531,3142,1396,3774,1135,27,11,266,127,29,11,237,116,116,,,,1179,426,1091,390,28,13,31,11,29,12,36,137,65
E02003690,South Bucks 003,Middle Super Output Areas and Intermediate Zones,MSOAIZ,WD,6374,2806,4593,1958,1936,1040,2657,918,112,44,876,459,72,39,804,420,420,,,,728,315,637,273,23,10,51,25,17,7,42,65,30
E02003691,South Bucks 004,Middle Super Output Areas and Intermediate Zones,MSOAIZ,SL,6665,2698,5087,2015,2135,1028,2952,987,139,61,643,300,59,20,584,280,280,,,,692,276,604,242,52,20,29,11,7,3,34,104,46
E02003692,South Bucks 005,Middle Super Output Areas and Intermediate Zones,MSOAIZ,SL,8328,3354,6668,2640,2939,1433,3729,1207,148,63,713,323,80,32,633,291,291,,,,697,284,613,244,45,22,32,13,7,5,40,102,44
E02003693,South Bucks 006,Middle Super Output Areas and Intermediate Zones,MSOAIZ,SL,6105,2520,5076,2051,2320,1133,2756,918,52,21,242,105,31,12,211,93,93,,,,641,295,549,255,43,18,28,11,21,11,40,94,48
E02003694,South Bucks 007,Middle Super Output Areas and Intermediate Zones,MSOAIZ,SL,7837,3294,5223,2126,1842,948,3381,1178,72,37,1661,734,105,47,1556,687,687,,,,821,362,762,334,10,3,28,16,21,9,28,60,35
E02003695,South Bucks 008,Middle Super Output Areas and Intermediate Zones,MSOAIZ,SL,10199,3949,7718,2871,2743,1279,4975,1592,291,124,1221,563,121,55,1100,508,508,,,,890,353,812,319,6,3,54,23,18,8,34,79,38
E02003696,Wycombe 001,Middle Super Output Areas and Intermediate Zones,MSOAIZ,HP,7954,3500,5882,2537,2635,1422,3247,1115,31,19,1206,569,935,432,271,137,137,,,,770,329,678,289,20,8,46,21,26,11,40,65,46
E02003697,Wycombe 002,Middle Super Output Areas and Intermediate Zones,MSOAIZ,OX,6041,2384,4573,1808,2057,996,2516,812,14,7,354,141,231,94,123,47,47,,,,1028,382,547,219,270,86,28,13,183,64,163,72,46
E02003698,Wycombe 003,Middle Super Output Areas and Intermediate Zones,MSOAIZ,HP,8332,3247,7155,2797,3127,1514,4028,1283,47,18,161,71,81,42,80,29,29,,,,864,317,366,145,285,94,31,15,182,63,172,105,44
E02003699,Wycombe 004,Middle Super Output Areas and Intermediate Zones,MSOAIZ,OX,5533,2290,4187,1692,1523,766,2664,926,49,19,575,257,307,142,268,115,115,,,,640,280,540,241,43,15,46,19,11,5,39,82,42
E02003701,Wycombe 006,Middle Super Output Areas and Intermediate Zones,MSOAIZ,HP,10864,4149,7893,2971,2638,1223,5255,1748,69,29,1471,624,869,406,602,218,218,,,,1338,483,1228,444,19,8,64,25,27,6,39,93,42
E02003702,Wycombe 007,Middle Super Output Areas and Intermediate Zones,MSOAIZ,SL,7940,3207,5977,2353,2604,1213,3373,1140,40,15,401,171,189,73,212,98,98,,,,1291,563,923,424,237,89,35,14,96,36,139,231,105
E02003703,Wycombe 008,Middle Super Output Areas and Intermediate Zones,MSOAIZ,HP,7608,3049,5131,1980,1856,823,3275,1157,49,25,508,229,277,112,231,117,117,,,,1843,777,1729,729,15,7,54,26,45,15,48,77,38
E02003704,Wycombe 009,Middle Super Output Areas and Intermediate Zones,MSOAIZ,HP,5909,2330,5254,2021,1877,906,3377,1115,45,17,199,97,158,77,41,20,20,,,,385,179,342,156,12,5,25,16,6,2,23,26,16
E02003705,Wycombe 010,Middle Super Output Areas and Intermediate Zones,MSOAIZ,HP,6917,2491,4134,1436,1257,496,2877,940,57,20,998,417,671,296,327,121,121,,,,1680,590,1554,548,3,1,84,29,39,12,42,48,28
E02003706,Wycombe 011,Middle Super Output Areas and Intermediate Zones,MSOAIZ,HP,6562,2657,3684,1447,1166,572,2518,875,328,157,1710,705,1037,477,673,228,228,,,,766,305,708,281,14,4,37,18,7,2,24,74,43
E02003707,Wycombe 012,Middle Super Output Areas and Intermediate Zones,MSOAIZ,HP,6197,2445,4008,1550,1161,543,2847,1007,72,30,886,341,559,220,327,121,121,,,,1178,500,1085,462,5,4,76,30,12,4,38,53,24
E02003708,Wycombe 013,Middle Super Output Areas and Intermediate Zones,MSOAIZ,HP,9387,3075,5148,1535,1596,517,3552,1018,112,46,1613,623,1163,454,450,169,169,,,,2445,842,2281,793,19,5,84,26,61,18,49,69,29
E02003709,Wycombe 014,Middle Super Output Areas and Intermediate Zones,MSOAIZ,HP,5804,2315,2962,1164,824,393,2138,771,53,21,2106,844,1303,561,803,283,283,,,,609,247,549,223,6,2,40,18,14,4,24,74,39
E02003710,Wycombe 015,Middle Super Output Areas and Intermediate Zones,MSOAIZ,HP,9299,3520,6012,2164,2160,965,3852,1199,114,47,656,313,266,135,390,178,178,,,,2390,936,2036,789,159,68,76,33,119,46,147,127,60
E02003711,Wycombe 016,Middle Super Output Areas and Intermediate Zones,MSOAIZ,HP,8475,3848,4800,2103,1383,698,3417,1405,193,91,1538,708,695,359,843,349,349,,,,1876,906,1773,856,14,5,71,38,18,7,50,68,40
E02003712,Wycombe 017,Middle Super Output Areas and Intermediate Zones,MSOAIZ,RG,7621,3246,5117,2183,1919,1010,3198,1173,86,50,1635,674,1269,532,366,142,142,,,,704,285,666,268,8,3,26,11,4,3,17,79,54
E02003713,Wycombe 018,Middle Super Output Areas and Intermediate Zones,MSOAIZ,HP,5960,2390,5015,2020,2039,1033,2976,987,3,1,486,188,454,176,32,12,12,,,,410,154,364,135,19,7,26,11,1,1,19,46,27
E02003714,Wycombe 019,Middle Super Output Areas and Intermediate Zones,MSOAIZ,SL,6595,2829,4714,1980,1657,839,3057,1141,95,35,889,377,706,278,183,99,99,,,,853,409,780,370,13,6,57,32,3,1,39,44,28
E02003715,Wycombe 020,Middle Super Output Areas and Intermediate Zones,MSOAIZ,SL,6710,2563,5334,2053,2370,1129,2964,924,7,6,286,117,89,54,197,63,63,,,,1029,359,395,171,439,127,9,3,186,58,188,54,28
E02003716,Wycombe 021,Middle Super Output Areas and Intermediate Zones,MSOAIZ,SL,5467,2460,4257,1832,1882,974,2375,858,9,4,466,239,372,180,94,59,59,,,,661,341,618,316,5,2,35,21,3,2,25,74,44
E02003717,Wycombe 022,Middle Super Output Areas and Intermediate Zones,MSOAIZ,SL,8716,3729,6684,2788,2865,1493,3819,1295,10,7,874,421,744,368,130,53,53,,,,1077,461,995,428,24,8,49,21,9,4,33,71,52
E02003718,Wycombe 023,Middle Super Output Areas and Intermediate Zones,MSOAIZ,SL,5518,2377,3808,1625,1394,723,2414,902,30,10,683,297,535,250,148,47,47,,,,939,415,877,388,10,3,47,21,5,3,27,58,30
E02003719,Cambridge 001,Middle Super Output Areas and Intermediate Zones,MSOAIZ,CB,8992,3918,3552,1552,1208,617,2344,935,255,135,3409,1535,2800,1293,609,242,242,,,,1701,646,1497,567,45,19,60,24,99,36,79,75,50
E02003720,Cambridge 002,Middle Super Output Areas and Intermediate Zones,MSOAIZ,CB,8916,3886,4164,1828,2059,1045,2105,783,64,34,2443,1114,2272,1051,171,63,63,,,,2127,846,1989,786,22,10,90,37,26,13,60,118,64
E02003721,Cambridge 003,Middle Super Output Areas and Intermediate Zones,MSOAIZ,CB,9239,4038,3338,1556,1439,769,1899,787,192,90,3597,1456,1226,473,2371,983,983,,,,2034,895,1933,853,10,4,76,31,15,7,42,78,41
E02003722,Cambridge 004,Middle Super Output Areas and Intermediate Zones,MSOAIZ,CB,8331,3729,4843,1986,2290,1102,2553,884,25,10,812,473,319,126,493,347,347,,,,2553,1216,2447,1164,19,10,59,25,28,17,52,98,44
E02003723,Cambridge 005,Middle Super Output Areas and Intermediate Zones,MSOAIZ,CB,4529,2082,2631,1175,1384,718,1247,457,7,5,399,246,185,95,214,151,151,,,,1402,619,1157,499,35,18,61,27,149,75,120,90,37
E02003724,Cambridge 006,Middle Super Output Areas and Intermediate Zones,MSOAIZ,CB,9861,4106,3971,1704,1376,719,2595,985,61,28,3569,1447,2759,1145,810,302,302,,,,2143,861,2047,816,7,3,77,38,12,4,45,117,66
E02003725,Cambridge 007,Middle Super Output Areas and Intermediate Zones,MSOAIZ,CB,7235,3372,3376,1544,2132,1103,1244,441,39,23,668,364,192,107,476,257,257,,,,2937,1336,2263,1020,274,132,66,28,334,156,316,215,105
E02003726,Cambridge 008,Middle Super Output Areas and Intermediate Zones,MSOAIZ,CB,7564,3366,3302,1430,1446,725,1856,705,41,17,927,531,481,282,446,249,249,,,,3196,1344,2979,1261,31,13,80,31,106,39,83,98,44
E02003727,Cambridge 009,Middle Super Output Areas and Intermediate Zones,MSOAIZ,CB,9206,3857,4055,1825,1490,781,2565,1044,64,30,1234,538,897,360,337,178,178,,,,3788,1426,3625,1358,20,8,103,43,40,17,68,65,38
E02003728,Cambridge 010,Middle Super Output Areas and Intermediate Zones,MSOAIZ,CB,8977,3788,4284,1753,1713,848,2571,905,43,24,1895,915,1569,745,326,170,170,,,,2659,1049,2539,1004,16,5,82,31,22,9,45,96,47
E02003729,Cambridge 011,Middle Super Output Areas and Intermediate Zones,MSOAIZ,CB,8780,3676,5134,2142,2080,1067,3054,1075,38,14,1992,928,1536,739,456,189,189,,,,1529,548,1426,506,5,3,86,35,12,4,42,87,44
E02003730,Cambridge 012,Middle Super Output Areas and Intermediate Zones,MSOAIZ,CB,7415,3472,3622,1627,1785,931,1837,696,181,97,1443,749,767,346,676,403,403,,,,1979,906,1819,836,59,27,47,21,54,22,70,190,93
E02003731,Cambridge 013,Middle Super Output Areas and Intermediate Zones,MSOAIZ,CB,8300,3424,5295,2049,2583,1214,2712,835,53,19,1339,727,862,347,477,380,380,,,,1478,566,1343,500,55,29,58,23,22,14,66,135,63
E02003732,East Cambridgeshire 001,Middle Super Output Areas and Intermediate Zones,MSOAIZ,PE,8617,3584,5321,2166,1806,939,3515,1227,120,53,1731,723,193,75,1538,648,648,,,,1331,573,1193,514,37,14,82,35,19,10,59,114,69
E02003733,East Cambridgeshire 002,Middle Super Output Areas and Intermediate Zones,MSOAIZ,CB,8352,3414,6498,2647,2477,1223,4021,1424,78,30,1030,411,80,33,950,378,378,,,,650,274,560,237,19,6,64,26,7,5,37,96,52
E02003734,East Cambridgeshire 003,Middle Super Output Areas and Intermediate Zones,MSOAIZ,CB,11658,4897,7656,3195,2857,1478,4799,1717,255,123,1777,782,173,71,1604,711,711,,,,1763,721,1603,664,34,11,92,32,34,14,57,207,76
E02003735,East Cambridgeshire 004,Middle Super Output Areas and Intermediate Zones,MSOAIZ,CB,8243,3642,5446,2257,1872,993,3574,1264,142,66,868,472,64,35,804,437,437,,,,1607,765,1508,713,33,13,57,35,9,4,52,180,82
E02003736,East Cambridgeshire 005,Middle Super Output Areas and Intermediate Zones,MSOAIZ,PE,9886,4024,7796,3116,3126,1519,4670,1597,86,39,988,445,95,47,893,398,398,,,,884,359,796,320,8,4,73,32,7,3,39,132,65
E02003737,East Cambridgeshire 006,Middle Super Output Areas and Intermediate Zones,MSOAIZ,CB,11668,4782,7857,3131,2618,1296,5239,1835,248,103,1714,755,193,85,1521,670,670,,,,1727,728,1590,674,26,8,110,45,1,1,54,122,65
E02003738,East Cambridgeshire 007,Middle Super Output Areas and Intermediate Zones,MSOAIZ,IP,6146,2534,4321,1725,1688,826,2633,899,43,20,841,359,81,30,760,329,329,,,,818,366,711,319,30,11,50,24,27,12,47,123,64
E02003739,East Cambridgeshire 008,Middle Super Output Areas and Intermediate Zones,MSOAIZ,CB,6296,2631,5041,2054,1933,988,3108,1066,56,20,660,306,68,34,592,272,272,,,,467,207,437,193,5,2,22,11,3,1,14,72,44
E02003740,East Cambridgeshire 009,Middle Super Output Areas and Intermediate Zones,MSOAIZ,CB,5846,2393,4152,1643,1962,923,2190,720,57,23,823,377,70,31,753,346,346,,,,697,287,595,248,38,14,50,19,14,6,39,117,63
E02003742,Fenland 001,Middle Super Output Areas and Intermediate Zones,MSOAIZ,PE,6284,2775,4960,2201,2479,1286,2481,915,59,23,589,254,80,40,509,214,214,,,,618,264,553,234,8,3,49,22,8,5,30,58,33
E02003743,Fenland 002,Middle Super Output Areas and Intermediate Zones,MSOAIZ,PE,9997,4066,5264,2253,2069,1140,3195,1113,66,25,2156,870,564,214,1592,656,656,,,,2420,860,2263,798,16,5,125,52,16,5,62,91,58
E02003744,Fenland 003,Middle Super Output Areas and Intermediate Zones,MSOAIZ,PE,12469,5517,7424,3265,3223,1736,4201,1529,57,21,2118,1078,397,189,1721,889,889,,,,2739,1074,2589,1000,21,11,98,45,31,18,74,131,79
E02003745,Fenland 004,Middle Super Output Areas and Intermediate Zones,MSOAIZ,PE,9606,4050,7113,3015,3052,1539,4061,1476,88,32,1116,483,229,96,887,387,387,,,,1147,442,1018,385,12,8,98,42,19,7,57,142,78
E02003746,Fenland 005,Middle Super Output Areas and Intermediate Zones,MSOAIZ,PE,7342,3066,5388,2293,2181,1175,3207,1118,51,23,669,237,77,25,592,212,212,,,,1176,480,1056,433,27,7,80,35,13,5,47,58,33
E02003747,Fenland 006,Middle Super Output Areas and Intermediate Zones,MSOAIZ,PE,11097,4861,8278,3511,3229,1732,5049,1779,37,14,1131,542,175,80,956,462,462,,,,1568,739,1411,674,14,4,135,58,8,3,65,83,55
E02003748,Fenland 007,Middle Super Output Areas and Intermediate Zones,MSOAIZ,PE,7410,3444,4732,2137,2065,1159,2667,978,30,12,1056,573,148,82,908,491,491,,,,1506,672,1430,637,4,2,54,24,18,9,35,86,50
E02003749,Fenland 008,Middle Super Output Areas and Intermediate Zones,MSOAIZ,PE,5998,2509,4835,2024,1780,916,3055,1108,10,4,316,127,68,26,248,101,101,,,,752,308,688,278,4,1,47,23,13,6,30,85,46
E02003750,Fenland 009,Middle Super Output Areas and Intermediate Zones,MSOAIZ,PE,6850,3068,5217,2262,2404,1292,2813,970,44,20,561,264,77,36,484,228,228,,,,939,471,856,436,4,2,72,30,7,3,35,89,51
E02003751,Fenland 010,Middle Super Output Areas and Intermediate Zones,MSOAIZ,PE,6467,2727,5272,2233,2056,1076,3216,1157,12,5,385,176,104,42,281,134,134,,,,685,264,598,229,33,10,54,25,0,0,35,113,49
E02003752,Fenland 011,Middle Super Output Areas and Intermediate Zones,MSOAIZ,PE,10414,4537,7638,3242,2683,1439,4955,1803,61,26,953,450,133,65,820,385,385,,,,1675,767,1504,698,6,2,138,58,27,9,69,87,52
E02003753,Huntingdonshire 001,Middle Super Output Areas and Intermediate Zones,MSOAIZ,PE,10997,4448,8294,3292,2678,1313,5616,1979,110,47,1337,576,343,152,994,424,424,,,,1201,498,1059,440,13,5,117,45,12,8,58,55,35
E02003754,Huntingdonshire 002,Middle Super Output Areas and Intermediate Zones,MSOAIZ,PE,5749,2381,4360,1768,1859,885,2501,883,3,2,532,232,116,51,416,181,181,,,,765,341,698,310,18,8,35,16,14,7,31,89,38
E02003755,Huntingdonshire 003,Middle Super Output Areas and Intermediate Zones,MSOAIZ,PE,8447,3559,5981,2399,2172,1104,3809,1295,10,6,1109,526,290,132,819,394,394,,,,1231,566,1112,512,13,5,92,43,14,6,54,116,62
E02003756,Huntingdonshire 004,Middle Super Output Areas and Intermediate Zones,MSOAIZ,PE,6436,2641,5046,1992,1740,855,3306,1137,9,5,541,269,88,50,453,219,219,,,,792,350,707,314,10,4,68,29,7,3,36,48,25
E02003757,Huntingdonshire 005,Middle Super Output Areas and Intermediate Zones,MSOAIZ,PE,6298,2553,4815,1913,1678,839,3137,1074,30,9,706,322,151,61,555,261,261,,,,702,284,639,258,3,3,53,20,7,3,26,45,25
E02003758,Huntingdonshire 006,Middle Super Output Areas and Intermediate Zones,MSOAIZ,PE,9286,3775,6659,2751,2273,1160,4386,1591,72,33,883,338,163,67,720,271,271,,,,1594,614,1080,441,309,95,54,23,151,55,173,78,39
E02003759,Huntingdonshire 007,Middle Super Output Areas and Intermediate Zones,MSOAIZ,PE,6108,2414,5252,2045,1901,930,3351,1115,24,6,362,163,69,29,293,134,134,,,,431,184,375,163,13,3,42,17,1,1,21,39,16
E02003760,Huntingdonshire 008,Middle Super Output Areas and Intermediate Zones,MSOAIZ,PE,8357,3081,3790,1434,892,432,2898,1002,105,46,3135,1176,867,315,2268,861,861,,,,1258,393,1170,363,10,2,59,20,19,8,30,69,32
E02003761,Huntingdonshire 009,Middle Super Output Areas and Intermediate Zones,MSOAIZ,PE,5824,2386,4455,1846,1682,865,2773,981,35,13,668,278,131,63,537,215,215,,,,617,230,572,212,3,2,38,15,4,1,18,49,19
E02003762,Huntingdonshire 010,Middle Super Output Areas and Intermediate Zones,MSOAIZ,PE,8177,3431,5967,2479,2382,1228,3585,1251,39,12,619,329,87,53,532,276,276,,,,1414,552,901,376,278,81,49,30,186,65,176,138,59
E02003763,Huntingdonshire 011,Middle Super Output Areas and Intermediate Zones,MSOAIZ,PE,9863,4072,7555,3071,2498,1248,5057,1823,108,46,723,322,151,54,572,268,268,,,,1449,616,1343,567,5,2,100,46,1,1,49,28,17
E02003764,Huntingdonshire 012,Middle Super Output Areas and Intermediate Zones,MSOAIZ,PE,9300,3929,5674,2273,1556,797,4118,1476,172,78,1201,520,84,44,1117,476,476,,,,2212,1030,2005,929,116,46,63,36,28,19,101,41,28
E02003765,Huntingdonshire 013,Middle Super Output Areas and Intermediate Zones,MSOAIZ,PE,6481,2938,4455,1916,2006,1060,2449,856,14,10,787,427,119,63,668,364,364,,,,1153,549,1076,510,23,9,39,20,15,10,39,72,36
E02003766,Huntingdonshire 014,Middle Super Output Areas and Intermediate Zones,MSOAIZ,PE,6711,2879,4793,1926,1576,818,3217,1108,46,28,955,467,146,68,809,399,399,,,,833,422,783,396,2,1,33,19,15,6,26,84,36
E02003767,Huntingdonshire 015,Middle Super Output Areas and Intermediate Zones,MSOAIZ,PE,6459,2591,5033,1973,2041,962,2992,1011,4,2,528,215,110,44,418,171,171,,,,791,349,707,312,27,12,38,19,19,6,37,103,52
E02003768,Huntingdonshire 016,Middle Super Output Areas and Intermediate Zones,MSOAIZ,PE,9273,3974,7543,3192,3520,1786,4023,1406,27,12,617,272,88,44,529,228,228,,,,1009,462,929,426,18,5,51,26,11,5,36,77,36
E02003769,Huntingdonshire 017,Middle Super Output Areas and Intermediate Zones,MSOAIZ,PE,6257,2657,5026,2087,1970,1036,3056,1051,20,12,508,230,80,32,428,198,198,,,,672,311,617,284,5,3,37,18,13,6,27,31,17
E02003770,Huntingdonshire 018,Middle Super Output Areas and Intermediate Zones,MSOAIZ,SG,7872,3202,5910,2395,2248,1124,3662,1271,152,73,1086,394,155,57,931,337,337,,,,658,301,595,269,28,12,35,20,0,0,32,66,39
E02003771,Huntingdonshire 019,Middle Super Output Areas and Intermediate Zones,MSOAIZ,PE,6225,2785,4215,1818,1593,890,2622,928,10,6,907,432,202,87,705,345,345,,,,1043,487,980,451,7,5,43,24,13,7,36,50,42
E02003772,Huntingdonshire 020,Middle Super Output Areas and Intermediate Zones,MSOAIZ,PE,6772,2856,5789,2345,2163,1097,3626,1248,2,1,220,121,21,10,199,111,111,,,,736,374,660,335,5,1,65,34,6,4,39,25,15
E02003773,Huntingdonshire 021,Middle Super Output Areas and Intermediate Zones,MSOAIZ,PE,10418,4334,7089,2873,2069,1064,5020,1809,102,52,1775,779,434,204,1341,575,575,,,,1386,598,1272,544,8,4,96,44,10,6,54,66,32
E02003774,Huntingdonshire 022,Middle Super Output Areas and Intermediate Zones,MSOAIZ,PE,5642,2447,3784,1610,1301,678,2483,932,19,9,1223,551,328,131,895,420,420,,,,583,259,513,224,4,3,54,29,12,3,35,33,18
E02003775,South Cambridgeshire 001,Middle Super Output Areas and Intermediate Zones,MSOAIZ,PE,6875,2750,5480,2127,2000,961,3480,1166,82,46,740,324,468,227,272,97,97,,,,519,223,456,200,9,3,52,19,2,1,23,54,30
E02003776,South Cambridgeshire 002,Middle Super Output Areas and Intermediate Zones,MSOAIZ,CB,6457,2658,4976,1978,2031,982,2945,996,69,41,643,316,499,259,144,57,57,,,,721,296,657,270,3,2,48,18,13,6,26,48,27
E02003777,South Cambridgeshire 003,Middle Super Output Areas and Intermediate Zones,MSOAIZ,CB,6646,2715,5136,2039,1780,868,3356,1171,56,36,597,260,401,188,196,72,72,,,,783,339,721,315,10,6,47,16,5,2,24,74,41
E02003778,South Cambridgeshire 004,Middle Super Output Areas and Intermediate Zones,MSOAIZ,CB,5515,2290,3353,1418,1459,719,1894,699,41,22,696,332,458,237,238,95,95,,,,1349,472,563,231,461,138,22,11,303,92,241,76,46
E02003779,South Cambridgeshire 005,Middle Super Output Areas and Intermediate Zones,MSOAIZ,CB,5040,2139,4109,1707,1601,804,2508,903,40,20,240,113,122,51,118,62,62,,,,604,272,571,255,2,1,29,15,2,1,17,47,27
E02003780,South Cambridgeshire 006,Middle Super Output Areas and Intermediate Zones,MSOAIZ,CB,10444,4211,6608,2659,2832,1367,3776,1292,411,173,2030,816,738,361,1292,455,455,,,,1318,523,1213,482,32,11,62,25,11,5,41,77,40
E02003781,South Cambridgeshire 007,Middle Super Output Areas and Intermediate Zones,MSOAIZ,CB,6321,2626,4394,1753,1881,857,2513,896,83,36,504,240,369,166,135,74,74,,,,1292,566,1187,520,23,9,64,31,18,6,46,48,31
E02003783,South Cambridgeshire 009,Middle Super Output Areas and Intermediate Zones,MSOAIZ,CB,6571,2772,4683,1917,2235,1108,2448,809,193,90,837,405,473,238,364,167,167,,,,760,311,630,263,42,17,22,10,66,21,48,98,49
E02003784,South Cambridgeshire 010,Middle Super Output Areas and Intermediate Zones,MSOAIZ,SG,8641,3395,6968,2686,2779,1324,4189,1362,146,71,757,306,424,193,333,113,113,,,,668,283,591,256,17,6,53,18,7,3,27,102,49
E02003785,South Cambridgeshire 011,Middle Super Output Areas and Intermediate Zones,MSOAIZ,CB,8572,3602,5378,2246,2389,1208,2989,1038,126,66,1287,535,732,346,555,189,189,,,,1694,711,1609,672,18,7,49,22,18,10,39,87,44
E02003786,South Cambridgeshire 012,Middle Super Output Areas and Intermediate Zones,MSOAIZ,CB,6089,2673,4484,1905,2243,1159,2241,746,78,44,745,370,600,300,145,70,70,,,,716,322,672,302,2,1,28,11,14,8,20,66,32
E02003787,South Cambridgeshire 013,Middle Super Output Areas and Intermediate Zones,MSOAIZ,SG,7228,3019,5441,2217,2342,1154,3099,1063,51,33,929,428,683,328,246,100,100,,,,682,279,586,241,28,8,52,25,16,5,38,125,62
E02003788,South Cambridgeshire 014,Middle Super Output Areas and Intermediate Zones,MSOAIZ,SG,6359,2592,4979,1986,2442,1157,2537,829,48,28,700,307,613,276,87,31,31,,,,564,236,507,215,15,6,35,13,7,2,21,68,35
E02003789,South Cambridgeshire 015,Middle Super Output Areas and Intermediate Zones,MSOAIZ,CB,7106,2992,4979,2029,2105,1030,2874,999,181,84,1298,606,895,433,403,173,173,,,,602,239,542,212,13,4,43,21,4,2,27,46,34
E02003790,South Cambridgeshire 016,Middle Super Output Areas and Intermediate Zones,MSOAIZ,CB,9426,3831,7071,2779,2840,1408,4231,1371,109,50,1255,582,1004,476,251,106,106,,,,841,342,750,303,34,12,46,21,11,6,39,150,78
E02003791,South Cambridgeshire 017,Middle Super Output Areas and Intermediate Zones,MSOAIZ,SG,7813,3215,5639,2248,2316,1115,3323,1133,54,27,1150,517,738,358,412,159,159,,,,871,369,741,315,80,31,37,17,13,6,54,99,54
E02003792,South Cambridgeshire 018,Middle Super Output Areas and Intermediate Zones,MSOAIZ,SG,9222,3829,6880,2755,2888,1408,3992,1347,139,65,1422,659,945,464,477,195,195,,,,695,300,605,257,42,20,31,17,17,6,43,86,50
E02003793,South Cambridgeshire 019,Middle Super Output Areas and Intermediate Zones,MSOAIZ,SG,7250,2871,5213,2030,2072,980,3141,1050,69,38,888,409,654,327,234,82,82,,,,987,344,571,218,202,61,24,11,190,54,126,93,50
E02003794,Cheshire West and Chester 022,Middle Super Output Areas and Intermediate Zones,MSOAIZ,WA,8426,3531,7170,2941,2837,1425,4333,1516,35,19,433,208,91,39,342,169,169,,,,709,327,624,289,22,11,47,20,16,7,38,79,36
E02003795,Cheshire West and Chester 025,Middle Super Output Areas and Intermediate Zones,MSOAIZ,L,5454,2211,4190,1724,1897,956,2293,768,6,3,390,165,157,59,233,106,106,,,,823,295,385,153,300,92,17,8,121,42,142,45,24
E02003796,Cheshire West and Chester 027,Middle Super Output Areas and Intermediate Zones,MSOAIZ,CH,7169,3254,5022,2235,2322,1269,2700,966,23,11,1513,747,612,289,901,458,458,,,,544,220,471,188,15,6,38,18,20,8,32,67,41
E02003797,Cheshire West and Chester 028,Middle Super Output Areas and Intermediate Zones,MSOAIZ,CH,9252,3990,7366,3093,3017,1576,4349,1517,48,25,308,148,48,18,260,130,130,,,,1469,684,1351,623,26,15,62,29,30,17,61,61,40
E02003798,Cheshire West and Chester 029,Middle Super Output Areas and Intermediate Zones,MSOAIZ,CH,6009,2488,3081,1244,897,467,2184,777,5,5,2411,1025,878,348,1533,677,677,,,,460,179,396,152,0,0,47,20,17,7,27,52,35
E02003799,Cheshire West and Chester 031,Middle Super Output Areas and Intermediate Zones,MSOAIZ,CH,6994,3103,3753,1613,1420,752,2333,861,66,30,2568,1224,885,395,1683,829,829,,,,544,198,459,160,17,4,60,29,8,5,38,63,38
E02003800,Cheshire West and Chester 030,Middle Super Output Areas and Intermediate Zones,MSOAIZ,CW,6243,2603,5350,2213,2552,1271,2798,942,55,21,308,138,98,37,210,101,101,,,,486,205,429,183,4,1,48,18,5,3,22,44,26
E02003801,Cheshire West and Chester 032,Middle Super Output Areas and Intermediate Zones,MSOAIZ,CH,6977,2888,5766,2349,2348,1189,3418,1160,14,6,579,265,202,87,377,178,178,,,,572,235,524,213,9,3,36,18,3,1,22,46,33
E02003802,Cheshire West and Chester 033,Middle Super Output Areas and Intermediate Zones,MSOAIZ,CH,7831,4274,2999,1561,1123,668,1876,893,133,95,1541,1029,320,212,1221,817,817,,,,3059,1538,2907,1467,10,3,104,53,38,15,71,99,51
E02003803,Cheshire West and Chester 034,Middle Super Output Areas and Intermediate Zones,MSOAIZ,CH,8405,3869,2910,1501,1334,758,1576,743,144,94,764,481,127,62,637,419,419,,,,4462,1725,4103,1605,14,6,112,59,233,55,120,125,68
E02003804,Cheshire West and Chester 036,Middle Super Output Areas and Intermediate Zones,MSOAIZ,CH,6764,3217,4566,2070,1560,868,3006,1202,33,21,515,341,120,70,395,271,271,,,,1598,749,1495,698,9,2,85,44,9,5,51,52,36
E02003805,Cheshire West and Chester 039,Middle Super Output Areas and Intermediate Zones,MSOAIZ,CH,6113,2535,5327,2161,2435,1232,2892,929,6,4,228,122,66,31,162,91,91,,,,511,227,486,213,8,5,12,7,5,2,14,41,21
E02003806,Cheshire West and Chester 041,Middle Super Output Areas and Intermediate Zones,MSOAIZ,CH,5942,2547,5118,2195,2250,1191,2868,1004,69,30,128,61,41,21,87,40,40,,,,582,242,519,213,11,4,47,23,5,2,29,45,19
E02003807,Cheshire West and Chester 043,Middle Super Output Areas and Intermediate Zones,MSOAIZ,CH,8129,3832,6369,2930,3199,1758,3170,1172,8,5,453,242,100,49,353,193,193,,,,1234,612,1162,575,17,7,46,25,9,5,37,65,43
E02003808,Cheshire West and Chester 044,Middle Super Output Areas and Intermediate Zones,MSOAIZ,CH,6419,2776,3836,1620,1124,589,2712,1031,47,16,1779,774,714,286,1065,488,488,,,,699,327,642,298,6,2,48,25,3,2,29,58,39
E02003809,Cheshire West and Chester 046,Middle Super Output Areas and Intermediate Zones,MSOAIZ,CW,7406,3061,5038,2033,2467,1165,2571,868,107,47,511,229,96,48,415,181,181,,,,1455,624,1324,568,66,24,46,23,19,9,56,295,128
E02003810,Cheshire West and Chester 047,Middle Super Output Areas and Intermediate Zones,MSOAIZ,SY,7915,3445,6052,2540,2885,1421,3167,1119,88,44,591,307,152,72,439,235,235,,,,1073,494,938,439,37,15,81,34,17,6,55,111,60
E02003811,Cheshire East 022,Middle Super Output Areas and Intermediate Zones,MSOAIZ,WA,5880,2433,5044,2056,2597,1226,2447,830,7,5,364,165,58,24,306,141,141,,,,358,159,324,144,8,3,22,10,4,2,15,107,48
E02003812,Cheshire East 023,Middle Super Output Areas and Intermediate Zones,MSOAIZ,CW,5576,2419,4793,2027,2124,1118,2669,909,8,5,288,146,55,29,233,117,117,,,,430,205,392,187,5,2,24,13,9,3,18,57,36
E02003813,Cheshire East 024,Middle Super Output Areas and Intermediate Zones,MSOAIZ,CW,6144,2710,4965,2098,1990,1026,2975,1072,28,19,513,287,119,53,394,234,234,,,,611,287,571,266,2,1,31,17,7,3,21,27,19
E02003814,Cheshire East 025,Middle Super Output Areas and Intermediate Zones,MSOAIZ,CW,7346,2961,5835,2292,1532,793,4303,1499,26,15,730,335,263,115,467,220,220,,,,719,295,683,275,5,3,31,17,0,0,20,36,24
E02003815,Cheshire East 026,Middle Super Output Areas and Intermediate Zones,MSOAIZ,CW,6747,2897,4246,1762,1667,835,2579,927,17,8,1942,859,395,171,1547,688,688,,,,490,233,455,212,2,1,32,19,1,1,21,52,35
E02003816,Cheshire East 027,Middle Super Output Areas and Intermediate Zones,MSOAIZ,CW,6703,3192,4666,2106,2045,1072,2621,1034,25,19,850,463,137,71,713,392,392,,,,1103,563,977,504,31,13,84,41,11,5,59,59,41
E02003817,Cheshire East 028,Middle Super Output Areas and Intermediate Zones,MSOAIZ,CW,6951,3005,6137,2591,2699,1404,3438,1187,12,8,282,174,34,25,248,149,149,,,,475,206,440,188,4,3,28,14,3,1,18,45,26
E02003818,Cheshire East 029,Middle Super Output Areas and Intermediate Zones,MSOAIZ,CW,5745,2467,5221,2207,2265,1166,2956,1041,28,13,38,13,0,0,38,13,13,,,,415,207,377,187,0,0,33,17,5,3,20,43,27
E02003819,Cheshire East 030,Middle Super Output Areas and Intermediate Zones,MSOAIZ,CW,5681,2540,4844,2104,2333,1200,2511,904,25,16,292,168,70,29,222,139,139,,,,486,235,446,218,2,2,31,13,7,2,17,34,17
E02003820,Cheshire East 031,Middle Super Output Areas and Intermediate Zones,MSOAIZ,CW,6745,2770,5630,2280,1745,896,3885,1384,5,4,272,99,37,13,235,86,86,,,,817,374,751,342,3,2,56,27,7,3,32,21,13
E02003821,Cheshire East 032,Middle Super Output Areas and Intermediate Zones,MSOAIZ,CW,5408,2530,3910,1764,1845,982,2065,782,40,20,891,466,205,99,686,367,367,,,,523,247,464,215,0,0,43,23,16,9,32,44,33
E02003822,Cheshire East 033,Middle Super Output Areas and Intermediate Zones,MSOAIZ,ST,10551,4584,8758,3762,4077,2042,4681,1720,30,14,779,355,119,53,660,302,302,,,,874,401,766,352,14,6,71,32,23,11,49,110,52
E02003823,Cheshire East 040,Middle Super Output Areas and Intermediate Zones,MSOAIZ,ST,6504,2967,5221,2318,2461,1340,2760,978,22,11,658,363,165,72,493,291,291,,,,547,242,497,220,3,1,36,17,11,4,22,56,33
E02003824,Cheshire East 042,Middle Super Output Areas and Intermediate Zones,MSOAIZ,ST,5163,2216,4185,1724,1741,894,2444,830,10,5,387,221,84,43,303,178,178,,,,544,242,505,220,1,1,37,20,1,1,22,37,24
E02003825,Cheshire East 034,Middle Super Output Areas and Intermediate Zones,MSOAIZ,CW,6768,2618,6015,2307,1265,616,4750,1691,25,7,142,61,56,20,86,41,41,,,,572,232,536,210,5,2,27,16,4,4,22,14,11
E02003826,Cheshire East 035,Middle Super Output Areas and Intermediate Zones,MSOAIZ,CW,7402,2998,4351,1829,1386,763,2965,1066,5,3,2035,765,1000,350,1035,415,415,,,,947,367,871,334,4,2,59,24,13,7,33,64,34
E02003827,Cheshire East 036,Middle Super Output Areas and Intermediate Zones,MSOAIZ,CW,8707,3882,4285,1951,1758,967,2527,984,51,18,2195,971,741,326,1454,645,645,,,,2108,894,2019,848,13,6,55,30,21,10,46,68,48
E02003828,Cheshire East 037,Middle Super Output Areas and Intermediate Zones,MSOAIZ,CW,6664,2804,3500,1517,1284,686,2216,831,35,27,2268,899,933,351,1335,548,548,,,,825,339,789,320,0,0,28,14,8,5,19,36,22
E02003829,Cheshire East 038,Middle Super Output Areas and Intermediate Zones,MSOAIZ,CW,5546,2549,4632,2103,2182,1182,2450,921,17,5,244,160,38,31,206,129,129,,,,605,251,554,228,0,0,45,21,6,2,23,48,30
E02003830,Cheshire East 039,Middle Super Output Areas and Intermediate Zones,MSOAIZ,CW,7163,3213,4031,1780,1353,716,2678,1064,26,12,1124,513,345,142,779,371,371,,,,1917,873,1828,831,5,4,67,32,17,6,42,65,35
E02003831,Cheshire East 041,Middle Super Output Areas and Intermediate Zones,MSOAIZ,ST,8968,3660,7664,3070,3138,1522,4526,1548,36,13,281,146,63,25,218,121,121,,,,890,383,787,340,11,5,43,20,49,18,43,97,48
E02003832,Cheshire East 043,Middle Super Output Areas and Intermediate Zones,MSOAIZ,CW,6008,2488,3335,1405,1232,644,2103,761,26,9,330,225,65,46,265,179,179,,,,2283,830,2206,798,18,5,53,24,6,3,32,34,19
E02003833,Cheshire East 044,Middle Super Output Areas and Intermediate Zones,MSOAIZ,CW,6361,2640,4909,2036,1771,916,3138,1120,11,5,896,384,394,154,502,230,230,,,,507,190,442,161,6,2,54,24,5,3,29,38,25
E02003834,Cheshire East 045,Middle Super Output Areas and Intermediate Zones,MSOAIZ,CW,6671,2786,3941,1621,1290,657,2651,964,17,5,1064,492,472,193,592,299,299,,,,1597,639,1526,611,3,1,61,25,7,2,28,52,29
E02003835,Cheshire East 046,Middle Super Output Areas and Intermediate Zones,MSOAIZ,CW,7846,3303,7383,3107,3396,1746,3987,1361,7,4,47,18,22,7,25,11,11,,,,376,157,323,134,3,1,46,19,4,3,23,33,17
E02003836,Cheshire East 047,Middle Super Output Areas and Intermediate Zones,MSOAIZ,CW,6787,3419,4804,2332,2345,1372,2459,960,50,32,943,550,222,110,721,440,440,,,,939,470,840,423,5,2,81,38,13,7,47,51,35
E02003837,Cheshire East 049,Middle Super Output Areas and Intermediate Zones,MSOAIZ,CW,11739,4612,9739,3759,3521,1662,6218,2097,30,14,391,177,123,47,268,130,130,,,,1460,605,1275,519,56,30,108,45,21,11,86,119,57
E02003838,Cheshire East 048,Middle Super Output Areas and Intermediate Zones,MSOAIZ,CW,6104,2764,5326,2397,2500,1354,2826,1043,8,4,161,91,26,15,135,76,76,,,,579,248,505,216,0,0,65,26,9,6,32,30,24
E02003839,Cheshire East 050,Middle Super Output Areas and Intermediate Zones,MSOAIZ,CW,6964,3291,4904,2242,2187,1233,2717,1009,71,47,884,432,224,108,660,324,324,,,,1049,533,966,488,10,4,65,36,8,5,45,56,37
E02003840,Cheshire East 051,Middle Super Output Areas and Intermediate Zones,MSOAIZ,TF,9941,4140,7857,3206,3754,1817,4103,1389,31,17,658,304,174,69,484,235,235,,,,1191,522,1023,453,61,24,74,28,33,17,69,204,91
E02003841,Cheshire West and Chester 001,Middle Super Output Areas and Intermediate Zones,MSOAIZ,L,7573,3462,5294,2369,2519,1340,2775,1029,25,11,1372,672,809,393,563,279,279,,,,810,367,755,336,6,4,41,24,8,3,31,72,43
E02003842,Cheshire West and Chester 004,Middle Super Output Areas and Intermediate Zones,MSOAIZ,L,5280,2367,4615,2040,2362,1245,2253,795,13,8,200,92,113,50,87,42,42,,,,412,204,384,188,9,5,13,7,6,4,16,40,23
E02003843,Cheshire West and Chester 005,Middle Super Output Areas and Intermediate Zones,MSOAIZ,L,5824,2612,4218,1821,1627,860,2591,961,46,31,1016,504,907,437,109,67,67,,,,500,230,455,211,5,2,32,13,8,4,19,44,26
E02003844,Cheshire West and Chester 006,Middle Super Output Areas and Intermediate Zones,MSOAIZ,L,6761,2948,5705,2459,2474,1313,3231,1146,10,7,453,225,331,174,122,51,51,,,,550,228,498,205,2,1,45,19,5,3,23,43,29
E02003845,Cheshire West and Chester 007,Middle Super Output Areas and Intermediate Zones,MSOAIZ,L,8000,3846,3706,1661,998,557,2708,1104,101,49,2347,1222,1854,931,493,291,291,,,,1752,852,1673,811,16,7,60,32,3,2,41,94,62
E02003846,Cheshire West and Chester 008,Middle Super Output Areas and Intermediate Zones,MSOAIZ,L,6736,2928,3213,1422,1028,577,2185,845,12,7,2818,1184,2655,1053,163,131,131,,,,628,269,541,236,1,1,79,29,7,3,33,65,46
E02003847,Cheshire West and Chester 009,Middle Super Output Areas and Intermediate Zones,MSOAIZ,L,9625,3844,8910,3536,3055,1545,5855,1991,39,20,53,21,17,6,36,15,15,,,,564,235,513,210,0,0,43,22,8,3,25,59,32
E02003848,Cheshire West and Chester 010,Middle Super Output Areas and Intermediate Zones,MSOAIZ,L,5048,2135,3170,1336,1106,579,2064,757,12,4,1436,621,1408,612,28,9,9,,,,367,140,312,120,4,2,45,17,6,1,20,63,34
E02003849,Cheshire West and Chester 011,Middle Super Output Areas and Intermediate Zones,MSOAIZ,L,6820,3003,3260,1346,892,471,2368,875,65,35,2862,1320,2563,1155,299,165,165,,,,560,248,501,220,9,4,31,18,19,6,28,73,54
E02003850,Cheshire West and Chester 013,Middle Super Output Areas and Intermediate Zones,MSOAIZ,L,5351,2265,4463,1828,1682,848,2781,980,5,2,523,292,511,286,12,6,6,,,,311,116,252,91,3,1,56,24,0,0,25,49,27
E02003851,Cheshire West and Chester 014,Middle Super Output Areas and Intermediate Zones,MSOAIZ,L,5826,2375,5323,2174,1996,1039,3327,1135,33,13,117,39,91,32,26,7,7,,,,329,137,301,122,0,0,26,14,2,1,15,24,12
E02003852,Cheshire West and Chester 016,Middle Super Output Areas and Intermediate Zones,MSOAIZ,L,6829,2792,6376,2587,2349,1192,4027,1395,26,13,29,10,13,4,16,6,6,,,,382,172,349,151,4,2,23,15,6,4,21,16,10
E02003853,Cheshire East 001,Middle Super Output Areas and Intermediate Zones,MSOAIZ,SK,5638,2472,4832,2074,2154,1116,2678,958,65,28,223,118,63,24,160,94,94,,,,475,224,427,205,5,2,34,12,9,5,19,43,28
E02003854,Cheshire East 002,Middle Super Output Areas and Intermediate Zones,MSOAIZ,SK,6402,2697,5529,2251,2310,1184,3219,1067,6,4,501,282,89,44,412,238,238,,,,334,141,287,119,7,3,36,17,4,2,22,32,19
E02003855,Cheshire East 003,Middle Super Output Areas and Intermediate Zones,MSOAIZ,SK,6479,2811,5889,2528,2858,1502,3031,1026,6,3,105,59,28,12,77,47,47,,,,446,196,392,172,10,3,42,20,2,1,24,33,25
E02003856,Cheshire East 004,Middle Super Output Areas and Intermediate Zones,MSOAIZ,SK,10165,4778,6659,2888,2457,1328,4202,1560,121,73,2171,1182,114,59,2057,1123,1123,,,,1148,593,1059,541,17,7,59,39,13,6,52,66,42
E02003857,Cheshire East 005,Middle Super Output Areas and Intermediate Zones,MSOAIZ,SK,6396,2735,4868,2048,1741,877,3127,1171,44,25,674,303,158,64,516,239,239,,,,774,337,737,317,2,1,34,18,1,1,20,36,22
E02003858,Cheshire East 006,Middle Super Output Areas and Intermediate Zones,MSOAIZ,SK,6568,2911,5319,2276,2434,1247,2885,1029,10,5,236,136,31,15,205,121,121,,,,941,456,892,431,14,5,29,16,6,4,25,62,38
E02003859,Cheshire East 007,Middle Super Output Areas and Intermediate Zones,MSOAIZ,WA,10978,4801,8478,3633,4071,2050,4407,1583,54,27,555,273,132,62,423,211,211,,,,1671,757,1521,685,30,16,80,38,40,18,72,220,111
E02003860,Cheshire East 008,Middle Super Output Areas and Intermediate Zones,MSOAIZ,SK,6988,2889,6348,2591,2644,1361,3704,1230,17,8,83,45,17,6,66,39,39,,,,488,214,450,197,2,2,29,13,7,2,17,52,31
E02003861,Cheshire East 009,Middle Super Output Areas and Intermediate Zones,MSOAIZ,WA,6374,2896,4211,1893,1736,962,2475,931,28,14,1375,648,231,101,1144,547,547,,,,692,305,610,269,21,10,60,25,1,1,36,68,36
E02003862,Cheshire East 011,Middle Super Output Areas and Intermediate Zones,MSOAIZ,SK,4970,2093,4403,1810,2318,1117,2085,693,8,6,125,73,39,20,86,53,53,,,,357,164,333,150,7,4,8,5,9,5,14,77,40
E02003863,Cheshire East 010,Middle Super Output Areas and Intermediate Zones,MSOAIZ,WA,6762,3014,5530,2359,2499,1316,3031,1043,14,8,439,240,75,27,364,213,213,,,,717,372,677,346,9,5,26,19,5,2,26,62,35
E02003864,Cheshire East 012,Middle Super Output Areas and Intermediate Zones,MSOAIZ,WA,7812,3624,6313,2824,3076,1635,3237,1189,5,3,413,250,84,50,329,200,200,,,,987,489,934,463,15,7,30,16,8,3,26,94,58
E02003865,Cheshire East 013,Middle Super Output Areas and Intermediate Zones,MSOAIZ,SK,7522,3437,5711,2518,2235,1204,3476,1314,7,3,619,297,173,76,446,221,221,,,,1131,587,1063,548,7,4,43,25,18,10,39,54,32
E02003866,Cheshire East 014,Middle Super Output Areas and Intermediate Zones,MSOAIZ,SK,5959,2402,5411,2181,2173,1103,3238,1078,18,6,98,39,0,0,98,39,39,,,,405,162,375,145,3,2,21,12,6,3,17,27,14
E02003867,Cheshire East 015,Middle Super Output Areas and Intermediate Zones,MSOAIZ,SK,7450,3140,5836,2392,2007,1027,3829,1365,31,13,764,365,188,92,576,273,273,,,,767,341,720,319,0,0,46,21,1,1,22,52,29
E02003868,Cheshire East 016,Middle Super Output Areas and Intermediate Zones,MSOAIZ,SK,8244,3901,5491,2449,1998,1081,3493,1368,31,18,1637,889,429,215,1208,674,674,,,,996,488,915,449,4,2,72,33,5,4,39,89,57
E02003869,Cheshire East 017,Middle Super Output Areas and Intermediate Zones,MSOAIZ,SK,6819,2992,5890,2503,2387,1252,3503,1251,50,35,271,152,82,39,189,113,113,,,,568,282,514,252,4,4,46,22,4,4,30,40,20
E02003870,Cheshire East 018,Middle Super Output Areas and Intermediate Zones,MSOAIZ,SK,10201,5079,6816,3163,2271,1248,4545,1915,42,32,545,377,47,26,498,351,351,,,,2746,1471,2557,1377,9,5,138,70,42,19,94,52,36
E02003871,Cheshire East 019,Middle Super Output Areas and Intermediate Zones,MSOAIZ,SK,6996,3058,4653,1924,1681,875,2972,1049,24,17,1745,871,595,257,1150,614,614,,,,495,197,424,167,3,1,59,23,9,6,30,79,49
E02003872,Cheshire East 020,Middle Super Output Areas and Intermediate Zones,MSOAIZ,SK,9588,4188,7898,3343,4048,1997,3850,1346,78,41,535,301,137,76,398,225,225,,,,936,425,826,366,27,13,56,33,27,13,59,141,78
E02003873,Cheshire East 021,Middle Super Output Areas and Intermediate Zones,MSOAIZ,SK,5971,2665,3214,1365,993,517,2221,848,67,26,1928,939,526,229,1402,710,710,,,,712,308,650,282,1,1,50,21,11,4,26,50,27
E02003874,Cheshire West and Chester 002,Middle Super Output Areas and Intermediate Zones,MSOAIZ,WA,8985,4025,7185,3106,3229,1726,3956,1380,64,34,800,412,328,170,472,242,242,,,,858,423,743,371,10,5,78,38,27,9,52,78,50
E02003875,Cheshire West and Chester 003,Middle Super Output Areas and Intermediate Zones,MSOAIZ,WA,6410,2681,5511,2286,2587,1254,2924,1032,38,17,362,170,134,63,228,107,107,,,,420,173,356,150,9,4,26,9,29,10,23,79,35
E02003876,Cheshire West and Chester 012,Middle Super Output Areas and Intermediate Zones,MSOAIZ,CW,5601,2393,4341,1836,1613,858,2728,978,14,8,640,283,403,166,237,117,117,,,,556,238,489,210,6,4,52,21,9,3,28,50,28
E02003877,Cheshire West and Chester 015,Middle Super Output Areas and Intermediate Zones,MSOAIZ,WA,9098,3884,7869,3292,3589,1820,4280,1472,34,21,361,196,139,74,222,122,122,,,,770,342,678,299,10,3,72,35,10,5,43,64,33
E02003878,Cheshire West and Chester 017,Middle Super Output Areas and Intermediate Zones,MSOAIZ,WA,7842,3299,6485,2712,2852,1424,3633,1288,31,11,648,284,340,147,308,137,137,,,,614,260,514,218,11,5,54,25,35,12,42,64,32
E02003879,Cheshire West and Chester 018,Middle Super Output Areas and Intermediate Zones,MSOAIZ,CW,6145,2800,3860,1695,1228,680,2632,1015,60,28,828,425,252,123,576,302,302,,,,1360,630,1280,592,7,4,61,30,12,4,38,37,22
E02003880,Cheshire West and Chester 019,Middle Super Output Areas and Intermediate Zones,MSOAIZ,CW,6361,2755,4601,1956,1835,978,2766,978,26,13,1179,548,695,307,484,241,241,,,,503,205,443,182,7,3,53,20,0,0,23,52,33
E02003881,Cheshire West and Chester 020,Middle Super Output Areas and Intermediate Zones,MSOAIZ,CW,6036,2730,4012,1755,1346,708,2666,1047,74,31,818,392,360,152,458,240,240,,,,1086,526,1004,489,11,5,66,30,5,2,37,46,26
E02003882,Cheshire West and Chester 021,Middle Super Output Areas and Intermediate Zones,MSOAIZ,CW,9512,3989,6128,2483,2038,1041,4090,1442,127,55,2273,1019,1255,538,1018,481,481,,,,895,377,806,335,20,11,64,29,5,2,42,89,55
E02003883,Cheshire West and Chester 023,Middle Super Output Areas and Intermediate Zones,MSOAIZ,CW,9891,4031,8634,3411,2902,1438,5732,1973,106,53,219,107,76,44,143,63,63,,,,879,437,814,408,11,4,38,18,16,7,29,53,23
E02003884,Cheshire West and Chester 024,Middle Super Output Areas and Intermediate Zones,MSOAIZ,WA,7784,3318,6655,2801,3012,1570,3643,1231,24,18,431,206,212,93,219,113,113,,,,580,253,506,217,14,7,56,28,4,1,36,94,40
E02003885,Cheshire West and Chester 026,Middle Super Output Areas and Intermediate Zones,MSOAIZ,CW,5582,2408,4625,1974,1903,1003,2722,971,20,7,362,184,141,73,221,111,111,,,,508,210,443,184,8,2,47,20,10,4,26,67,33
E02003886,Cheshire West and Chester 035,Middle Super Output Areas and Intermediate Zones,MSOAIZ,CW,6532,2599,4344,1752,1299,667,3045,1085,14,7,1415,527,807,290,608,237,237,,,,702,285,661,269,2,1,39,15,0,0,16,57,28
E02003887,Cheshire West and Chester 037,Middle Super Output Areas and Intermediate Zones,MSOAIZ,CW,6137,2496,4998,1971,1429,731,3569,1240,49,23,538,253,273,120,265,133,133,,,,522,229,473,206,3,2,43,19,3,2,23,30,20
E02003888,Cheshire West and Chester 038,Middle Super Output Areas and Intermediate Zones,MSOAIZ,CW,5989,2627,4000,1658,1250,658,2750,1000,38,17,1194,606,658,333,536,273,273,,,,723,325,644,290,21,10,53,22,5,3,35,34,21
E02003889,Cheshire West and Chester 040,Middle Super Output Areas and Intermediate Zones,MSOAIZ,CW,5643,2297,2834,1156,1046,544,1788,612,61,36,2305,917,1181,431,1124,486,486,,,,378,152,332,134,0,0,41,14,5,4,18,65,36
E02003890,Cheshire West and Chester 042,Middle Super Output Areas and Intermediate Zones,MSOAIZ,CW,5923,2454,4221,1746,1495,771,2726,975,15,8,918,375,95,39,823,336,336,,,,746,310,678,280,6,3,54,25,8,2,30,23,15
E02003891,Cheshire West and Chester 045,Middle Super Output Areas and Intermediate Zones,MSOAIZ,CW,5644,2455,4534,1913,2248,1137,2286,776,34,25,381,196,126,63,255,133,133,,,,617,280,541,249,31,11,30,15,15,5,31,78,41
E02003892,Cornwall 010,Middle Super Output Areas and Intermediate Zones,MSOAIZ,PL,6253,2769,4881,2159,2519,1314,2362,845,63,30,560,236,352,167,208,69,69,,,,674,299,590,261,1,1,58,28,25,9,38,75,45
E02003893,Cornwall 012,Middle Super Output Areas and Intermediate Zones,MSOAIZ,PL,6481,2819,5118,2205,2551,1281,2567,924,41,18,458,219,352,177,106,42,42,,,,759,321,628,269,10,4,106,42,15,6,52,105,56
E02003894,Cornwall 013,Middle Super Output Areas and Intermediate Zones,MSOAIZ,PL,8017,3479,5617,2436,2522,1340,3095,1096,114,50,925,379,420,208,505,171,171,,,,1259,558,1108,499,3,3,137,52,11,4,59,102,56
E02003895,Cornwall 016,Middle Super Output Areas and Intermediate Zones,MSOAIZ,PL,7965,3379,5280,2290,2392,1257,2888,1033,74,27,1115,447,528,227,587,220,220,,,,1429,576,1242,506,27,8,129,53,31,9,70,67,39
E02003896,Cornwall 017,Middle Super Output Areas and Intermediate Zones,MSOAIZ,PL,5593,2608,3198,1444,1414,778,1784,666,26,11,1258,589,1042,485,216,104,104,,,,1037,508,955,471,1,1,73,33,8,3,37,74,56
E02003897,Cornwall 022,Middle Super Output Areas and Intermediate Zones,MSOAIZ,PL,5412,2228,4451,1839,1840,926,2611,913,52,19,123,51,52,30,71,21,21,,,,740,296,623,250,46,15,57,24,14,7,46,46,23
E02003898,Cornwall 023,Middle Super Output Areas and Intermediate Zones,MSOAIZ,PL,6606,2879,4950,2133,2553,1268,2397,865,15,7,598,257,480,210,118,47,47,,,,935,430,826,384,18,7,72,27,19,12,46,108,52
E02003899,Cornwall 025,Middle Super Output Areas and Intermediate Zones,MSOAIZ,PL,5251,2372,3671,1588,1525,810,2146,778,63,26,967,502,801,433,166,69,69,,,,501,221,441,195,8,2,50,22,2,2,26,49,35
E02003900,Cornwall 026,Middle Super Output Areas and Intermediate Zones,MSOAIZ,PL,7163,3090,5305,2280,2035,1085,3270,1195,85,33,811,345,481,222,330,123,123,,,,927,407,821,363,5,1,87,39,14,4,44,35,25
E02003901,Cornwall 028,Middle Super Output Areas and Intermediate Zones,MSOAIZ,PL,7451,3369,4976,2258,2897,1488,2079,770,28,17,1179,517,988,451,191,66,66,,,,1120,488,925,407,31,13,136,57,28,11,81,148,89
E02003902,Cornwall 029,Middle Super Output Areas and Intermediate Zones,MSOAIZ,PL,5408,2383,3465,1506,1435,780,2030,726,8,5,867,430,524,294,343,136,136,,,,1025,416,711,313,149,44,80,34,85,25,103,43,26
E02003903,Cornwall 034,Middle Super Output Areas and Intermediate Zones,MSOAIZ,PL,6404,2872,4591,2078,2135,1160,2456,918,41,17,785,337,553,243,232,94,94,,,,895,392,770,343,38,12,59,29,28,8,49,92,48
E02003904,Cornwall 037,Middle Super Output Areas and Intermediate Zones,MSOAIZ,PL,5269,2509,4006,1864,2161,1173,1845,691,19,9,367,185,243,136,124,49,49,,,,795,405,688,354,17,7,77,37,13,7,51,82,46
E02003905,Cornwall 032,Middle Super Output Areas and Intermediate Zones,MSOAIZ,TR,6173,2556,4626,1911,2033,988,2593,923,51,23,383,152,245,102,138,50,50,,,,1055,439,928,383,22,10,92,40,13,6,56,58,31
E02003906,Cornwall 033,Middle Super Output Areas and Intermediate Zones,MSOAIZ,TR,5406,2362,4107,1741,2137,1042,1970,699,19,8,386,182,237,116,149,66,66,,,,782,368,666,318,11,5,85,37,20,8,50,112,63
E02003907,Cornwall 040,Middle Super Output Areas and Intermediate Zones,MSOAIZ,TR,7565,3404,5635,2498,2842,1512,2793,986,88,41,554,246,279,144,275,102,102,,,,1181,559,1016,470,13,10,136,72,16,7,89,107,60
E02003908,Cornwall 042,Middle Super Output Areas and Intermediate Zones,MSOAIZ,TR,7860,3387,4961,2191,2118,1177,2843,1014,96,38,1606,656,1052,465,554,191,191,,,,1105,451,1030,417,14,5,57,27,4,2,34,92,51
E02003909,Cornwall 043,Middle Super Output Areas and Intermediate Zones,MSOAIZ,TR,8989,3914,5885,2595,2687,1443,3198,1152,60,27,1445,635,1000,487,445,148,148,,,,1516,609,1375,543,22,11,95,44,24,11,66,83,48
E02003910,Cornwall 044,Middle Super Output Areas and Intermediate Zones,MSOAIZ,TR,6059,3002,3642,1697,1738,1001,1904,696,89,49,699,435,284,208,415,227,227,,,,1522,758,1375,688,9,6,116,54,22,10,70,107,63
E02003911,Cornwall 047,Middle Super Output Areas and Intermediate Zones,MSOAIZ,TR,8381,3594,6471,2781,3415,1752,3056,1029,50,23,450,195,361,158,89,37,37,,,,1279,520,1195,482,9,3,69,30,6,5,38,131,75
E02003912,Cornwall 048,Middle Super Output Areas and Intermediate Zones,MSOAIZ,TR,7704,3496,5333,2472,2965,1615,2368,857,79,34,838,362,571,251,267,111,111,,,,1235,527,1061,452,66,26,83,37,25,12,75,219,101
E02003913,Cornwall 056,Middle Super Output Areas and Intermediate Zones,MSOAIZ,TR,5804,2564,4472,1994,2572,1327,1900,667,19,8,433,186,344,160,89,26,26,,,,775,320,603,267,19,7,62,26,91,20,53,105,56
E02003914,Cornwall 060,Middle Super Output Areas and Intermediate Zones,MSOAIZ,TR,7093,3146,4053,1825,1690,899,2363,926,75,34,1277,525,854,357,423,168,168,,,,1635,725,1522,680,3,1,93,41,17,3,45,53,37
E02003915,Cornwall 062,Middle Super Output Areas and Intermediate Zones,MSOAIZ,TR,7725,3308,3517,1582,1655,888,1862,694,22,9,2388,1006,2094,867,294,139,139,,,,1669,634,1496,567,6,2,146,57,21,8,67,129,77
E02003916,Cornwall 063,Middle Super Output Areas and Intermediate Zones,MSOAIZ,TR,6614,3034,3733,1738,2043,1135,1690,603,74,36,268,173,71,41,197,132,132,,,,2453,1031,2296,956,17,9,117,51,23,15,75,86,56
E02003917,Cornwall 064,Middle Super Output Areas and Intermediate Zones,MSOAIZ,TR,7456,3167,5856,2536,2571,1377,3285,1159,39,15,509,214,240,116,269,98,98,,,,1000,370,890,325,23,8,77,34,10,3,45,52,32
E02003918,Cornwall 045,Middle Super Output Areas and Intermediate Zones,MSOAIZ,TR,6740,2969,5153,2253,2426,1267,2727,986,37,13,582,281,221,97,361,184,184,,,,892,381,786,339,12,4,91,36,3,2,42,76,41
E02003919,Cornwall 046,Middle Super Output Areas and Intermediate Zones,MSOAIZ,TR,6740,2998,3705,1605,1509,804,2196,801,21,11,1708,778,631,261,1077,517,517,,,,1231,545,1126,503,7,2,79,34,19,6,42,75,59
E02003920,Cornwall 049,Middle Super Output Areas and Intermediate Zones,MSOAIZ,TR,7063,3093,5123,2222,2123,1112,3000,1110,80,28,302,133,50,24,252,109,109,,,,1508,677,1379,621,6,2,100,43,23,11,56,50,33
E02003921,Cornwall 050,Middle Super Output Areas and Intermediate Zones,MSOAIZ,TR,5816,2517,4482,1939,2187,1134,2295,805,27,13,511,222,114,49,397,173,173,,,,753,320,672,282,6,3,68,31,7,4,38,43,23
E02003922,Cornwall 051,Middle Super Output Areas and Intermediate Zones,MSOAIZ,TR,7686,3262,5476,2280,2286,1151,3190,1129,50,28,953,444,176,71,777,373,373,,,,1152,480,1029,425,8,3,101,48,14,4,55,55,30
E02003923,Cornwall 052,Middle Super Output Areas and Intermediate Zones,MSOAIZ,TR,7141,3090,4672,2064,2202,1162,2470,902,30,11,598,252,181,73,417,179,179,,,,1792,733,1647,677,10,3,123,48,12,5,56,49,30
E02003924,Cornwall 053,Middle Super Output Areas and Intermediate Zones,MSOAIZ,TR,6856,3123,4378,1979,2278,1201,2100,778,17,11,1064,533,422,184,642,349,349,,,,1319,556,1187,494,7,4,104,49,21,9,62,78,44
E02003925,Cornwall 055,Middle Super Output Areas and Intermediate Zones,MSOAIZ,TR,7067,2892,4612,1966,2020,1056,2592,910,62,25,1386,497,443,153,943,344,344,,,,941,368,838,330,1,1,89,35,13,2,38,66,36
E02003926,Cornwall 059,Middle Super Output Areas and Intermediate Zones,MSOAIZ,TR,7764,3117,6204,2492,2862,1367,3342,1125,27,12,419,160,149,52,270,108,108,,,,1027,406,903,359,6,3,100,39,18,5,47,87,47
E02003927,Cornwall 066,Middle Super Output Areas and Intermediate Zones,MSOAIZ,TR,8422,3674,6459,2845,3628,1856,2831,989,62,31,635,273,199,83,436,190,190,,,,1155,455,918,368,27,14,84,33,126,40,87,111,70
E02003928,Cornwall 071,Middle Super Output Areas and Intermediate Zones,MSOAIZ,TR,11633,4916,7533,3219,2975,1596,4558,1623,46,26,1260,562,300,126,960,436,436,,,,2705,1048,1724,729,580,172,147,62,254,85,319,89,61
E02003929,Cornwall 072,Middle Super Output Areas and Intermediate Zones,MSOAIZ,TR,6585,2957,4991,2227,2727,1410,2264,817,43,13,622,289,132,66,490,223,223,,,,845,374,735,326,23,8,72,35,15,5,48,84,54
E02003930,Cornwall 073,Middle Super Output Areas and Intermediate Zones,MSOAIZ,TR,8150,3600,5860,2601,3494,1759,2366,842,60,23,965,401,220,97,745,304,304,,,,1088,495,890,402,45,22,125,60,28,11,93,177,80
E02003931,Cornwall 001,Middle Super Output Areas and Intermediate Zones,MSOAIZ,EX,9716,4484,6412,2966,3450,1886,2962,1080,192,86,1337,584,593,267,744,317,317,,,,1656,793,1504,729,6,2,139,57,7,5,64,119,55
E02003932,Cornwall 002,Middle Super Output Areas and Intermediate Zones,MSOAIZ,PL,6797,2853,5103,2170,2965,1448,2138,722,27,10,599,236,386,166,213,70,70,,,,890,352,782,308,19,7,84,36,5,1,44,178,85
E02003933,Cornwall 003,Middle Super Output Areas and Intermediate Zones,MSOAIZ,PL,6750,3078,5138,2329,2974,1528,2164,801,38,19,548,224,319,133,229,91,91,,,,913,445,784,382,9,4,103,49,17,10,63,113,61
E02003934,Cornwall 004,Middle Super Output Areas and Intermediate Zones,MSOAIZ,PL,6571,2734,4652,1969,2517,1216,2135,753,31,15,695,274,384,170,311,104,104,,,,1078,416,925,359,23,9,111,41,19,7,57,115,60
E02003935,Cornwall 005,Middle Super Output Areas and Intermediate Zones,MSOAIZ,PL,8977,3926,5276,2280,2090,1130,3186,1150,84,32,1459,623,1013,410,446,213,213,,,,2078,941,1915,869,21,9,130,59,12,4,72,80,50
E02003936,Cornwall 006,Middle Super Output Areas and Intermediate Zones,MSOAIZ,PL,7949,3414,6234,2670,3371,1658,2863,1012,34,18,365,167,228,121,137,46,46,,,,1153,478,1047,423,8,6,92,43,6,6,55,163,81
E02003937,Cornwall 007,Middle Super Output Areas and Intermediate Zones,MSOAIZ,PL,5257,2396,3623,1643,2274,1166,1349,477,18,9,655,293,444,204,211,89,89,,,,804,370,684,307,32,19,81,40,7,4,63,157,81
E02003938,Cornwall 008,Middle Super Output Areas and Intermediate Zones,MSOAIZ,TR,6433,2810,4184,1870,2358,1201,1826,669,28,13,1034,412,715,288,319,124,124,,,,1071,452,840,363,89,30,110,47,32,12,89,116,63
E02003939,Cornwall 009,Middle Super Output Areas and Intermediate Zones,MSOAIZ,PL,6529,2955,4457,2009,2263,1228,2194,781,68,31,987,423,632,302,355,121,121,,,,961,450,842,395,14,5,100,48,5,2,55,56,42
E02003940,Cornwall 011,Middle Super Output Areas and Intermediate Zones,MSOAIZ,PL,5982,2553,4560,1956,2711,1317,1849,639,17,8,541,214,363,150,178,64,64,,,,739,314,636,269,16,6,75,34,12,5,45,125,61
E02003941,Cornwall 014,Middle Super Output Areas and Intermediate Zones,MSOAIZ,PL,7264,3098,4657,1991,1939,1008,2718,983,33,14,1077,410,663,235,414,175,175,,,,1433,648,1277,592,42,10,92,40,22,6,56,64,35
E02003942,Cornwall 015,Middle Super Output Areas and Intermediate Zones,MSOAIZ,PL,7211,3148,4071,1780,1613,883,2458,897,26,11,1909,848,1505,689,404,159,159,,,,1162,476,1046,421,14,11,94,40,8,4,55,43,33
E02003943,Cornwall 054,Middle Super Output Areas and Intermediate Zones,MSOAIZ,TR,7343,3445,4751,2207,2490,1378,2261,829,76,36,1311,573,157,76,1154,497,497,,,,1091,564,961,497,16,9,99,49,15,9,67,114,65
E02003944,Cornwall 057,Middle Super Output Areas and Intermediate Zones,MSOAIZ,TR,9225,4031,6196,2740,2936,1564,3260,1176,141,60,1554,637,252,103,1302,534,534,,,,1245,541,1096,476,20,9,119,50,10,6,65,89,53
E02003945,Cornwall 058,Middle Super Output Areas and Intermediate Zones,MSOAIZ,TR,5736,2656,4555,2120,2539,1352,2016,768,37,20,125,59,19,11,106,48,48,,,,955,423,838,376,25,8,84,34,8,5,47,64,34
E02003946,Cornwall 061,Middle Super Output Areas and Intermediate Zones,MSOAIZ,TR,8482,3714,5943,2639,3104,1607,2839,1032,132,48,973,387,142,63,831,324,324,,,,1274,559,1089,485,17,5,148,61,20,8,74,160,81
E02003947,Cornwall 065,Middle Super Output Areas and Intermediate Zones,MSOAIZ,TR,6270,2753,4384,1968,2378,1237,2006,731,35,17,671,260,63,27,608,233,233,,,,1053,447,904,380,30,11,107,50,12,6,67,127,61
E02003948,Cornwall 067,Middle Super Output Areas and Intermediate Zones,MSOAIZ,TR,8106,3685,4711,2158,2411,1336,2300,822,33,20,2123,893,237,98,1886,795,795,,,,1130,554,1030,509,9,3,82,38,9,4,45,109,60
E02003949,Cornwall 068,Middle Super Output Areas and Intermediate Zones,MSOAIZ,TR,6476,3472,3382,1709,1696,991,1686,718,18,8,1138,706,184,104,954,602,602,,,,1822,983,1616,892,26,10,152,67,28,14,91,116,66
E02003950,Cornwall 069,Middle Super Output Areas and Intermediate Zones,MSOAIZ,TR,5223,2429,3649,1668,1976,1042,1673,626,39,16,595,287,52,30,543,257,257,,,,829,395,739,349,6,3,74,37,10,6,46,111,63
E02003951,Cornwall 070,Middle Super Output Areas and Intermediate Zones,MSOAIZ,TR,6027,2920,4172,2057,2489,1404,1683,653,17,9,790,342,111,52,679,290,290,,,,937,443,827,394,22,6,80,39,8,4,49,111,69
E02003952,Cornwall 018,Middle Super Output Areas and Intermediate Zones,MSOAIZ,TR,6434,2853,4353,1897,1985,1014,2368,883,23,12,598,285,149,60,449,225,225,,,,1363,602,974,457,189,64,107,48,93,33,145,97,57
E02003953,Cornwall 019,Middle Super Output Areas and Intermediate Zones,MSOAIZ,TR,10310,4232,7250,2993,3348,1635,3902,1358,109,42,929,368,219,84,710,284,284,,,,1873,760,1625,657,19,10,201,82,28,11,103,149,69
E02003954,Cornwall 020,Middle Super Output Areas and Intermediate Zones,MSOAIZ,TR,6600,3091,3878,1732,1614,887,2264,845,51,20,587,349,70,46,517,303,303,,,,2008,945,1825,859,20,7,134,63,29,16,86,76,45
E02003955,Cornwall 021,Middle Super Output Areas and Intermediate Zones,MSOAIZ,TR,9155,4032,6272,2692,2545,1336,3727,1356,75,31,866,394,158,76,708,318,318,,,,1824,847,1552,735,98,37,134,60,40,15,112,118,68
E02003956,Cornwall 024,Middle Super Output Areas and Intermediate Zones,MSOAIZ,TR,7013,2884,4625,1918,2067,999,2558,919,129,53,967,369,217,77,750,292,292,,,,1222,507,1106,459,18,9,96,38,2,1,48,70,37
E02003957,Cornwall 027,Middle Super Output Areas and Intermediate Zones,MSOAIZ,PL,9930,4192,6992,3002,3341,1694,3651,1308,36,25,1006,375,289,104,717,271,271,,,,1788,737,1641,678,22,8,118,46,7,5,59,108,53
E02003958,Cornwall 030,Middle Super Output Areas and Intermediate Zones,MSOAIZ,TR,7815,3180,5606,2301,2430,1197,3176,1104,109,42,797,300,243,85,554,215,215,,,,1251,512,1130,456,5,3,88,43,28,10,56,52,25
E02003959,Cornwall 031,Middle Super Output Areas and Intermediate Zones,MSOAIZ,PL,6718,2841,4457,1897,1833,962,2624,935,34,11,1109,449,298,120,811,329,329,,,,1048,439,916,376,5,4,115,52,12,7,63,70,45
E02003960,Cornwall 035,Middle Super Output Areas and Intermediate Zones,MSOAIZ,PL,5622,2577,4225,1949,2269,1242,1956,707,22,11,395,164,104,43,291,121,121,,,,909,420,844,386,4,2,51,26,10,6,34,71,33
E02003961,Cornwall 036,Middle Super Output Areas and Intermediate Zones,MSOAIZ,PL,9183,3866,6981,3001,3184,1664,3797,1337,162,63,750,307,132,57,618,250,250,,,,1221,449,1083,396,7,4,126,46,5,3,53,69,46
E02003962,Cornwall 038,Middle Super Output Areas and Intermediate Zones,MSOAIZ,PL,6017,2587,4480,1882,2064,1037,2416,845,77,37,370,152,120,44,250,108,108,,,,1042,491,934,441,14,6,90,42,4,2,50,48,25
E02003963,Cornwall 039,Middle Super Output Areas and Intermediate Zones,MSOAIZ,PL,9058,4195,5365,2439,2519,1423,2846,1016,90,37,1752,858,416,200,1336,658,658,,,,1746,793,1600,724,2,1,122,55,22,13,69,105,68
E02003964,Cornwall 041,Middle Super Output Areas and Intermediate Zones,MSOAIZ,TR,7488,3407,5648,2589,3327,1752,2321,837,23,14,324,147,120,47,204,100,100,,,,1354,593,1166,521,43,16,122,45,23,11,72,139,64
E02003965,Allerdale 001,Middle Super Output Areas and Intermediate Zones,MSOAIZ,CA,10690,4705,8118,3448,3997,2008,4121,1440,7,5,1475,722,198,92,1277,630,630,,,,942,452,841,403,4,3,93,43,4,3,49,148,78
E02003966,Allerdale 002,Middle Super Output Areas and Intermediate Zones,MSOAIZ,CA,6928,2945,5700,2384,3391,1581,2309,803,48,18,253,134,40,20,213,114,114,,,,758,336,590,277,42,14,110,40,16,5,59,169,73
E02003967,Allerdale 003,Middle Super Output Areas and Intermediate Zones,MSOAIZ,CA,8260,3580,6099,2545,3078,1490,3021,1055,38,14,1150,540,119,55,1031,485,485,,,,846,413,735,357,12,5,94,48,5,3,56,127,68
E02003968,Allerdale 004,Middle Super Output Areas and Intermediate Zones,MSOAIZ,CA,8520,3755,6650,2795,3097,1555,3553,1240,24,11,1070,562,81,51,989,511,511,,,,701,346,619,302,6,3,70,38,6,3,44,75,41
E02003969,Allerdale 005,Middle Super Output Areas and Intermediate Zones,MSOAIZ,CA,6637,2898,3386,1454,1516,771,1870,683,5,2,2713,1201,352,150,2361,1051,1051,,,,439,193,381,163,7,2,45,26,6,2,30,94,48
E02003970,Allerdale 006,Middle Super Output Areas and Intermediate Zones,MSOAIZ,CA,7669,3454,5978,2515,2851,1432,3127,1083,32,20,722,396,56,38,666,358,358,,,,838,469,745,424,12,5,65,33,16,7,45,99,54
E02003971,Allerdale 007,Middle Super Output Areas and Intermediate Zones,MSOAIZ,CA,7945,3513,6170,2665,3206,1635,2964,1030,100,41,812,379,134,68,678,311,311,,,,770,368,638,310,36,11,64,35,32,12,58,93,60
E02003972,Allerdale 008,Middle Super Output Areas and Intermediate Zones,MSOAIZ,CA,9200,4141,6876,2938,2802,1447,4074,1491,15,11,1362,709,199,108,1163,601,601,,,,883,441,817,402,1,1,48,27,17,11,39,64,42
E02003973,Allerdale 009,Middle Super Output Areas and Intermediate Zones,MSOAIZ,CA,8717,4132,4627,2036,1998,1023,2629,1013,10,6,3097,1560,464,232,2633,1328,1328,,,,845,454,731,400,10,5,95,45,9,4,54,138,76
E02003974,Allerdale 010,Middle Super Output Areas and Intermediate Zones,MSOAIZ,CA,7710,3461,5023,2133,2293,1145,2730,988,72,45,2271,1095,343,184,1928,911,911,,,,279,141,224,111,2,1,39,23,14,6,30,65,47
E02003975,Allerdale 011,Middle Super Output Areas and Intermediate Zones,MSOAIZ,CA,6258,2749,5324,2280,2413,1221,2911,1059,2,1,514,247,69,33,445,214,214,,,,366,187,339,172,0,0,22,12,5,3,15,52,34
E02003976,Allerdale 012,Middle Super Output Areas and Intermediate Zones,MSOAIZ,CA,6436,3012,4398,2024,2655,1378,1743,646,56,26,1165,543,219,92,946,451,451,,,,680,342,535,274,41,18,49,27,55,23,68,137,77
E02003977,Barrow-in-Furness 001,Middle Super Output Areas and Intermediate Zones,MSOAIZ,LA,6375,2680,5592,2312,2153,1103,3439,1209,7,4,93,53,70,35,23,18,18,,,,621,274,556,235,7,5,57,33,1,1,39,62,37
E02003978,Barrow-in-Furness 002,Middle Super Output Areas and Intermediate Zones,MSOAIZ,LA,5890,2618,4902,2131,1943,1045,2959,1086,8,3,414,215,371,179,43,36,36,,,,509,238,460,212,4,2,40,22,5,2,26,57,31
E02003979,Barrow-in-Furness 003,Middle Super Output Areas and Intermediate Zones,MSOAIZ,LA,7487,3350,7012,3127,3631,1980,3381,1147,9,4,47,17,30,9,17,8,8,,,,379,175,280,126,37,16,35,19,27,14,49,40,27
E02003980,Barrow-in-Furness 004,Middle Super Output Areas and Intermediate Zones,MSOAIZ,LA,6705,3189,3751,1673,1272,709,2479,964,8,4,1961,1056,1701,897,260,159,159,,,,897,400,817,362,12,7,58,25,10,6,38,88,56
E02003981,Barrow-in-Furness 005,Middle Super Output Areas and Intermediate Zones,MSOAIZ,LA,6743,2990,5738,2462,1964,1050,3774,1412,6,3,104,76,62,43,42,33,33,,,,826,414,766,380,3,1,56,32,1,1,34,69,35
E02003982,Barrow-in-Furness 006,Middle Super Output Areas and Intermediate Zones,MSOAIZ,LA,7552,3224,6518,2739,2610,1358,3908,1381,3,3,597,283,571,271,26,12,12,,,,381,172,332,147,2,1,44,22,3,2,25,53,27
E02003983,Barrow-in-Furness 007,Middle Super Output Areas and Intermediate Zones,MSOAIZ,LA,7690,3426,4899,2190,1642,925,3257,1265,11,7,1555,675,1302,564,253,111,111,,,,1137,513,1016,456,21,5,98,50,2,2,57,88,41
E02003984,Barrow-in-Furness 008,Middle Super Output Areas and Intermediate Zones,MSOAIZ,LA,6742,3422,3442,1702,1418,830,2024,872,11,5,707,402,158,116,549,286,286,,,,2524,1276,2352,1188,16,8,122,60,34,20,88,58,37
E02003985,Barrow-in-Furness 009,Middle Super Output Areas and Intermediate Zones,MSOAIZ,LA,6626,3088,5311,2448,2242,1307,3069,1141,1,1,666,335,599,297,67,38,38,,,,600,271,540,241,1,1,59,29,0,0,30,48,33
E02003986,Barrow-in-Furness 010,Middle Super Output Areas and Intermediate Zones,MSOAIZ,LA,6582,3237,4725,2154,1979,1116,2746,1038,7,2,500,342,427,293,73,49,49,,,,1307,709,1195,658,5,3,95,40,12,8,51,43,30
E02003987,Carlisle 001,Middle Super Output Areas and Intermediate Zones,MSOAIZ,TD,5983,2629,4528,1890,2388,1127,2140,763,13,7,476,273,101,60,375,213,213,,,,827,378,726,334,16,7,78,33,7,4,44,139,81
E02003988,Carlisle 002,Middle Super Output Areas and Intermediate Zones,MSOAIZ,CA,6537,2948,4548,1957,2146,1115,2402,842,19,9,865,482,127,75,738,407,407,,,,999,441,827,373,66,25,65,30,41,13,68,106,59
E02003989,Carlisle 003,Middle Super Output Areas and Intermediate Zones,MSOAIZ,CA,7609,3335,6262,2706,2628,1420,3634,1286,57,43,458,211,64,28,394,183,183,,,,785,347,698,305,9,4,73,34,5,4,42,47,28
E02003990,Carlisle 004,Middle Super Output Areas and Intermediate Zones,MSOAIZ,CA,9550,4217,8072,3483,3509,1824,4563,1659,179,107,390,214,58,31,332,183,183,,,,867,385,779,349,15,4,56,25,17,7,36,42,28
E02003991,Carlisle 005,Middle Super Output Areas and Intermediate Zones,MSOAIZ,CA,7628,3197,6862,2824,3007,1500,3855,1324,21,13,212,112,28,14,184,98,98,,,,481,216,419,188,4,2,53,24,5,2,28,52,32
E02003992,Carlisle 006,Middle Super Output Areas and Intermediate Zones,MSOAIZ,CA,8329,4201,4697,2190,1980,1106,2717,1084,106,72,905,576,83,63,822,513,513,,,,2513,1289,2352,1208,14,5,97,50,50,26,81,108,74
E02003993,Carlisle 007,Middle Super Output Areas and Intermediate Zones,MSOAIZ,CA,8550,3720,7168,3058,3685,1830,3483,1228,13,6,320,173,44,19,276,154,154,,,,917,415,806,366,42,18,54,26,15,5,49,132,68
E02003994,Carlisle 008,Middle Super Output Areas and Intermediate Zones,MSOAIZ,CA,7308,3519,4460,2066,1748,988,2712,1078,7,5,1425,734,271,121,1154,613,613,,,,1349,674,1193,601,40,15,98,48,18,10,73,67,40
E02003995,Carlisle 009,Middle Super Output Areas and Intermediate Zones,MSOAIZ,CA,9445,4475,6004,2636,2164,1184,3840,1452,20,13,2647,1473,487,290,2160,1183,1183,,,,678,290,587,249,3,1,86,39,2,1,41,96,63
E02003996,Carlisle 010,Middle Super Output Areas and Intermediate Zones,MSOAIZ,CA,9614,4756,5885,2801,1966,1127,3919,1674,13,7,694,436,95,59,599,377,377,,,,2937,1457,2727,1353,13,9,181,88,16,7,104,85,55
E02003997,Carlisle 011,Middle Super Output Areas and Intermediate Zones,MSOAIZ,CA,9545,4280,5220,2234,1390,785,3830,1449,17,8,3401,1594,691,325,2710,1269,1269,,,,819,379,725,333,5,2,80,41,9,3,46,88,65
E02003998,Carlisle 012,Middle Super Output Areas and Intermediate Zones,MSOAIZ,CA,6841,3007,4290,1808,1572,849,2718,959,40,26,1969,926,390,173,1579,753,753,,,,465,201,406,172,0,0,52,24,7,5,29,77,46
E02003999,Carlisle 013,Middle Super Output Areas and Intermediate Zones,MSOAIZ,CA,9199,4058,7795,3346,3664,1899,4131,1447,31,16,347,190,53,25,294,165,165,,,,914,442,800,390,29,12,59,31,26,9,52,112,64
E02004000,Copeland 001,Middle Super Output Areas and Intermediate Zones,MSOAIZ,CA,5416,2309,3767,1545,1557,755,2210,790,0,0,1226,557,396,170,830,387,387,,,,367,173,333,157,1,1,33,15,0,0,16,56,34
E02004001,Copeland 002,Middle Super Output Areas and Intermediate Zones,MSOAIZ,CA,5520,2735,3714,1587,1481,788,2233,799,77,56,1113,705,519,297,594,408,408,,,,536,329,474,295,16,9,39,19,7,6,34,80,58
E02004002,Copeland 003,Middle Super Output Areas and Intermediate Zones,MSOAIZ,CA,10247,4325,8662,3537,3293,1661,5369,1876,1,1,959,488,446,195,513,293,293,,,,573,270,463,214,58,25,29,19,23,12,56,52,29
E02004003,Copeland 004,Middle Super Output Areas and Intermediate Zones,MSOAIZ,CA,11950,5278,8640,3636,3803,1917,4837,1719,27,12,2289,1110,642,303,1647,807,807,,,,869,449,752,395,5,3,90,39,22,12,54,125,71
E02004004,Copeland 005,Middle Super Output Areas and Intermediate Zones,MSOAIZ,CA,9292,3983,5763,2395,2272,1141,3491,1254,8,4,2854,1265,1741,717,1113,548,548,,,,565,258,478,217,2,1,72,33,13,7,41,102,61
E02004005,Copeland 006,Middle Super Output Areas and Intermediate Zones,MSOAIZ,CA,8156,3605,5862,2491,2396,1243,3466,1248,9,4,1599,767,724,324,875,443,443,,,,621,305,519,257,0,0,92,42,10,6,48,65,38
E02004006,Copeland 007,Middle Super Output Areas and Intermediate Zones,MSOAIZ,CA,8882,3926,7482,3273,3812,1929,3670,1344,16,9,488,212,176,65,312,147,147,,,,778,369,667,324,21,8,70,30,20,7,45,118,63
E02004007,Copeland 008,Middle Super Output Areas and Intermediate Zones,MSOAIZ,LA,9849,4375,7434,3207,3716,1881,3718,1326,25,10,1075,564,219,101,856,463,463,,,,1171,512,1034,456,9,4,112,46,16,6,56,144,82
E02004008,Eden 001,Middle Super Output Areas and Intermediate Zones,MSOAIZ,CA,6344,2771,4730,2009,2576,1250,2154,759,42,19,533,262,73,36,460,226,226,,,,867,403,745,353,29,11,83,35,10,4,50,172,78
E02004009,Eden 002,Middle Super Output Areas and Intermediate Zones,MSOAIZ,CA,5854,2493,4410,1824,2317,1108,2093,716,33,14,224,121,59,25,165,96,96,,,,977,440,890,401,26,10,49,24,12,5,39,210,94
E02004010,Eden 003,Middle Super Output Areas and Intermediate Zones,MSOAIZ,CA,6971,3354,4084,1831,1605,877,2479,954,90,41,1457,816,207,112,1250,704,704,,,,1251,605,1085,533,43,17,114,49,9,6,72,89,61
E02004011,Eden 004,Middle Super Output Areas and Intermediate Zones,MSOAIZ,CA,9627,4311,7615,3400,3957,2103,3658,1297,118,51,673,309,107,53,566,256,256,,,,1114,495,955,422,40,15,104,53,15,5,73,107,56
E02004012,Eden 005,Middle Super Output Areas and Intermediate Zones,MSOAIZ,CA,5540,2491,3800,1702,2343,1178,1457,524,29,13,518,245,49,27,469,218,218,,,,1014,447,827,368,69,28,73,36,45,15,79,179,84
E02004013,Eden 006,Middle Super Output Areas and Intermediate Zones,MSOAIZ,DL,9754,4319,7168,3119,3875,1955,3293,1164,137,65,699,319,86,34,613,285,285,,,,1525,707,1369,621,21,12,113,59,22,15,86,225,109
E02004014,Eden 007,Middle Super Output Areas and Intermediate Zones,MSOAIZ,LA,7523,3304,5497,2373,3291,1577,2206,796,23,8,508,249,40,20,468,229,229,,,,1304,588,1153,518,16,10,118,54,17,6,70,191,86
E02004015,South Lakeland 001,Middle Super Output Areas and Intermediate Zones,MSOAIZ,LA,5802,2924,3185,1629,2052,1174,1133,455,30,16,1165,620,474,260,691,360,360,,,,1255,578,1088,506,57,23,80,35,30,14,72,167,81
E02004016,South Lakeland 002,Middle Super Output Areas and Intermediate Zones,MSOAIZ,LA,8092,3738,5395,2486,2838,1553,2557,933,73,32,1047,489,690,329,357,160,160,,,,1429,656,1280,586,51,22,91,45,7,3,70,148,75
E02004017,South Lakeland 003,Middle Super Output Areas and Intermediate Zones,MSOAIZ,LA,8373,3865,6099,2712,2741,1449,3358,1263,29,17,962,492,631,302,331,190,190,,,,1188,586,1060,524,11,3,100,54,17,5,62,95,58
E02004018,South Lakeland 004,Middle Super Output Areas and Intermediate Zones,MSOAIZ,LA,7956,3783,4622,2112,1974,1094,2648,1018,43,21,1735,800,1251,560,484,240,240,,,,1452,785,1321,718,11,6,106,52,14,9,67,104,65
E02004019,South Lakeland 005,Middle Super Output Areas and Intermediate Zones,MSOAIZ,LA,7865,3397,6601,2818,3282,1672,3319,1146,44,17,354,175,300,139,54,36,36,,,,753,333,677,302,2,1,67,26,7,4,31,113,54
E02004020,South Lakeland 006,Middle Super Output Areas and Intermediate Zones,MSOAIZ,LA,8188,3597,6987,2978,3006,1593,3981,1385,31,17,401,247,180,105,221,142,142,,,,718,325,633,285,6,4,76,33,3,3,40,51,30
E02004021,South Lakeland 007,Middle Super Output Areas and Intermediate Zones,MSOAIZ,LA,5120,2404,3510,1661,2157,1119,1353,542,21,12,367,161,172,77,195,84,84,,,,1073,498,951,442,42,19,51,22,29,15,56,149,72
E02004022,South Lakeland 008,Middle Super Output Areas and Intermediate Zones,MSOAIZ,LA,5535,2493,4178,1880,2522,1268,1656,612,26,10,417,184,209,98,208,86,86,,,,814,369,654,295,51,22,76,39,33,13,74,100,50
E02004023,South Lakeland 009,Middle Super Output Areas and Intermediate Zones,MSOAIZ,LA,5493,2661,3783,1781,2220,1199,1563,582,44,22,458,266,350,210,108,56,56,,,,1041,502,866,415,62,30,105,51,8,6,87,167,90
E02004024,South Lakeland 010,Middle Super Output Areas and Intermediate Zones,MSOAIZ,LA,7125,3107,5949,2600,3289,1662,2660,938,28,14,189,74,130,45,59,29,29,,,,826,360,739,319,13,8,72,32,2,1,41,133,59
E02004025,South Lakeland 011,Middle Super Output Areas and Intermediate Zones,MSOAIZ,LA,7816,3656,6221,2890,3269,1809,2952,1081,24,11,667,326,511,225,156,101,101,,,,808,378,674,329,37,8,85,36,12,5,49,96,51
E02004026,South Lakeland 012,Middle Super Output Areas and Intermediate Zones,MSOAIZ,LA,7844,3745,5482,2473,2353,1269,3129,1204,32,19,1130,597,983,522,147,75,75,,,,1113,595,990,532,26,12,81,44,16,7,63,87,61
E02004027,South Lakeland 013,Middle Super Output Areas and Intermediate Zones,MSOAIZ,LA,7613,3744,6151,2968,3787,2080,2364,888,28,16,468,253,295,182,173,71,71,,,,815,420,694,357,29,14,83,43,9,6,63,151,87
E02004028,South Lakeland 014,Middle Super Output Areas and Intermediate Zones,MSOAIZ,LA,7692,3438,6726,2979,3524,1852,3202,1127,18,7,343,169,243,118,100,51,51,,,,544,248,492,221,9,4,29,18,14,5,27,61,35
E02004029,Amber Valley 001,Middle Super Output Areas and Intermediate Zones,MSOAIZ,DE,6360,2845,4144,1802,1784,933,2360,869,13,5,1294,594,530,220,764,374,374,,,,829,395,753,358,4,2,64,30,8,5,37,80,49
E02004030,Amber Valley 002,Middle Super Output Areas and Intermediate Zones,MSOAIZ,DE,5592,2550,4449,1975,2368,1204,2081,771,24,8,571,278,247,108,324,170,170,,,,490,248,397,208,5,4,70,28,18,8,40,58,41
E02004031,Amber Valley 003,Middle Super Output Areas and Intermediate Zones,MSOAIZ,NG,7387,3218,3548,1524,1297,692,2251,832,6,3,2841,1209,1182,498,1659,711,711,,,,881,415,788,363,3,1,53,29,37,22,52,111,67
E02004032,Amber Valley 004,Middle Super Output Areas and Intermediate Zones,MSOAIZ,DE,8229,3643,7004,3051,3137,1638,3867,1413,27,12,441,202,188,81,253,121,121,,,,689,339,627,306,1,1,60,31,1,1,33,68,39
E02004033,Amber Valley 005,Middle Super Output Areas and Intermediate Zones,MSOAIZ,NG,8661,3828,6588,2882,2657,1381,3931,1501,58,32,666,252,278,108,388,144,144,,,,1278,615,1174,563,13,7,88,43,3,2,52,71,47
E02004034,Amber Valley 006,Middle Super Output Areas and Intermediate Zones,MSOAIZ,DE,7260,3197,6205,2652,3029,1510,3176,1142,15,7,430,259,131,85,299,174,174,,,,572,246,501,213,0,0,65,31,6,2,33,38,33
E02004035,Amber Valley 007,Middle Super Output Areas and Intermediate Zones,MSOAIZ,DE,6404,2727,5404,2300,2773,1386,2631,914,18,12,336,133,175,67,161,66,66,,,,588,249,517,218,14,8,34,16,23,7,31,58,33
E02004036,Amber Valley 008,Middle Super Output Areas and Intermediate Zones,MSOAIZ,DE,9910,4267,6900,2934,3006,1544,3894,1390,32,15,1990,817,872,357,1118,460,460,,,,902,440,816,399,5,4,76,34,5,3,41,86,61
E02004037,Amber Valley 009,Middle Super Output Areas and Intermediate Zones,MSOAIZ,DE,7670,3154,6648,2709,2506,1307,4142,1402,61,28,332,126,86,30,246,96,96,,,,599,269,542,245,0,0,40,17,17,7,24,30,22
E02004038,Amber Valley 010,Middle Super Output Areas and Intermediate Zones,MSOAIZ,DE,7573,3643,5398,2505,2188,1229,3210,1276,31,16,774,381,394,180,380,201,201,,,,1276,683,1151,622,10,6,90,44,25,11,61,94,58
E02004039,Amber Valley 011,Middle Super Output Areas and Intermediate Zones,MSOAIZ,DE,7988,3413,6526,2747,2480,1267,4046,1480,38,20,547,225,289,113,258,112,112,,,,828,389,767,361,6,2,46,22,9,4,28,49,32
E02004040,Amber Valley 012,Middle Super Output Areas and Intermediate Zones,MSOAIZ,NG,8955,3658,7103,2907,2700,1347,4403,1560,28,15,597,238,280,110,317,128,128,,,,1155,457,1087,430,5,2,60,24,3,1,27,72,41
E02004041,Amber Valley 013,Middle Super Output Areas and Intermediate Zones,MSOAIZ,NG,6954,2938,5577,2322,2108,1051,3469,1271,3,1,554,219,240,92,314,127,127,,,,772,363,703,332,6,2,54,26,9,3,31,48,33
E02004043,Amber Valley 015,Middle Super Output Areas and Intermediate Zones,MSOAIZ,DE,6977,3009,5479,2306,2424,1213,3055,1093,11,6,902,437,337,173,565,264,264,,,,509,218,462,196,3,2,42,19,2,1,22,76,42
E02004044,Amber Valley 016,Middle Super Output Areas and Intermediate Zones,MSOAIZ,S,7629,3151,6324,2501,3059,1506,3265,995,28,22,344,189,134,69,210,120,120,,,,829,386,777,364,10,5,32,13,10,4,22,104,53
E02004045,Bolsover 001,Middle Super Output Areas and Intermediate Zones,MSOAIZ,S,9036,3899,7187,2992,2890,1438,4297,1554,8,4,625,358,550,301,75,57,57,,,,1130,503,1027,455,0,0,94,45,9,3,48,86,42
E02004046,Bolsover 002,Middle Super Output Areas and Intermediate Zones,MSOAIZ,S,6195,2738,4332,1866,1789,933,2543,933,14,6,1184,572,1086,523,98,49,49,,,,603,255,522,220,10,4,62,27,9,4,35,62,39
E02004047,Bolsover 003,Middle Super Output Areas and Intermediate Zones,MSOAIZ,S,5554,2507,2939,1320,1176,626,1763,694,8,4,1319,639,902,463,417,176,176,,,,1222,506,1129,463,18,8,69,32,6,3,43,66,38
E02004048,Bolsover 004,Middle Super Output Areas and Intermediate Zones,MSOAIZ,S,6662,2919,4140,1792,1643,863,2497,929,3,3,1327,561,1081,451,246,110,110,,,,1130,524,1042,479,3,2,77,39,8,4,45,62,39
E02004049,Bolsover 005,Middle Super Output Areas and Intermediate Zones,MSOAIZ,S,7703,3478,5820,2509,2509,1314,3311,1195,9,4,1177,640,1052,555,125,85,85,,,,611,265,526,229,5,3,78,32,2,1,36,86,60
E02004050,Bolsover 006,Middle Super Output Areas and Intermediate Zones,MSOAIZ,NG,6989,2969,4071,1689,1754,880,2317,809,44,25,2039,911,1660,762,379,149,149,,,,739,281,664,251,0,0,70,29,5,1,30,96,63
E02004051,Bolsover 007,Middle Super Output Areas and Intermediate Zones,MSOAIZ,S,8930,3831,5519,2331,2383,1196,3136,1135,23,12,1413,703,906,474,507,229,229,,,,1841,712,1727,661,13,3,88,43,13,5,51,134,73
E02004052,Bolsover 008,Middle Super Output Areas and Intermediate Zones,MSOAIZ,S,7794,3382,5856,2453,2341,1182,3515,1271,33,16,1120,544,1098,533,22,11,11,,,,691,309,596,268,7,4,78,32,10,5,41,94,60
E02004053,Bolsover 009,Middle Super Output Areas and Intermediate Zones,MSOAIZ,DE,7835,3347,5196,2159,1823,954,3373,1205,22,14,1526,680,1269,561,257,119,119,,,,1000,440,906,400,2,1,75,33,17,6,40,91,54
E02004054,Bolsover 010,Middle Super Output Areas and Intermediate Zones,MSOAIZ,NG,8553,3731,6713,2852,2519,1305,4194,1547,7,4,746,357,652,299,94,58,58,,,,1025,481,936,445,4,2,80,32,5,2,36,62,37
E02004055,Chesterfield 001,Middle Super Output Areas and Intermediate Zones,MSOAIZ,S,7040,3286,4666,2129,2012,1096,2654,1033,14,13,1612,750,1344,649,268,101,101,,,,701,361,638,331,6,2,49,23,8,5,30,47,33
E02004056,Chesterfield 002,Middle Super Output Areas and Intermediate Zones,MSOAIZ,S,7752,3228,3793,1582,1424,746,2369,836,6,3,3301,1353,3244,1325,57,28,28,,,,622,267,554,243,2,1,65,22,1,1,24,30,23
E02004057,Chesterfield 003,Middle Super Output Areas and Intermediate Zones,MSOAIZ,S,7616,3398,4834,2087,1640,846,3194,1241,19,11,1547,703,1107,502,440,201,201,,,,1168,568,1060,520,2,1,92,40,14,7,48,48,29
E02004058,Chesterfield 004,Middle Super Output Areas and Intermediate Zones,MSOAIZ,S,7732,3638,3914,1763,1619,900,2295,863,7,6,3145,1538,3079,1494,66,44,44,,,,611,292,527,254,4,2,66,31,14,5,38,55,39
E02004059,Chesterfield 005,Middle Super Output Areas and Intermediate Zones,MSOAIZ,S,7100,3232,5430,2408,2325,1250,3105,1158,10,3,1077,551,941,479,136,72,72,,,,541,245,481,218,3,1,53,24,4,2,27,42,25
E02004060,Chesterfield 006,Middle Super Output Areas and Intermediate Zones,MSOAIZ,S,7554,3190,4986,2102,2114,1082,2872,1020,4,3,1992,813,1550,608,442,205,205,,,,541,248,499,226,0,0,34,18,8,4,22,31,24
E02004061,Chesterfield 007,Middle Super Output Areas and Intermediate Zones,MSOAIZ,S,7136,3430,4641,2055,2006,1088,2635,967,7,4,1593,878,1430,763,163,115,115,,,,843,457,775,418,2,1,55,33,11,5,39,52,36
E02004062,Chesterfield 008,Middle Super Output Areas and Intermediate Zones,MSOAIZ,S,7949,3680,5579,2274,2158,1073,3421,1201,54,43,1900,1175,1713,1056,187,119,119,,,,367,154,330,137,5,1,26,14,6,2,17,49,34
E02004063,Chesterfield 009,Middle Super Output Areas and Intermediate Zones,MSOAIZ,S,7912,3655,6364,2799,2851,1534,3513,1265,7,5,627,392,549,340,78,52,52,,,,854,423,773,385,12,4,60,30,9,4,38,60,36
E02004064,Chesterfield 010,Middle Super Output Areas and Intermediate Zones,MSOAIZ,S,8625,4271,4317,2023,1642,898,2675,1125,54,21,1443,631,1093,434,350,197,197,,,,2721,1541,2525,1440,5,4,136,76,55,21,101,90,55
E02004065,Chesterfield 011,Middle Super Output Areas and Intermediate Zones,MSOAIZ,S,8340,3672,7719,3374,3750,1993,3969,1381,19,8,75,30,67,25,8,5,5,,,,460,225,401,191,2,1,47,28,10,5,34,67,35
E02004066,Chesterfield 012,Middle Super Output Areas and Intermediate Zones,MSOAIZ,S,11515,5124,8592,3721,3681,1886,4911,1835,57,33,1135,515,664,320,471,195,195,,,,1637,805,1448,721,55,19,110,54,24,11,84,94,50
E02004067,Chesterfield 013,Middle Super Output Areas and Intermediate Zones,MSOAIZ,S,6410,2992,2751,1230,1283,673,1468,557,4,3,3126,1503,2952,1390,174,113,113,,,,467,227,422,207,2,1,42,18,1,1,20,62,29
E02004068,Derbyshire Dales 001,Middle Super Output Areas and Intermediate Zones,MSOAIZ,SK,7500,3302,5667,2393,2988,1486,2679,907,79,33,824,416,273,132,551,284,284,,,,835,409,699,348,11,4,110,51,15,6,61,95,51
E02004069,Derbyshire Dales 002,Middle Super Output Areas and Intermediate Zones,MSOAIZ,SK,6660,3099,4815,2210,2834,1483,1981,727,30,19,419,215,145,68,274,147,147,,,,1044,491,869,413,68,29,58,25,49,24,78,352,164
E02004070,Derbyshire Dales 003,Middle Super Output Areas and Intermediate Zones,MSOAIZ,SK,6158,2763,4447,1967,2633,1332,1814,635,48,23,866,410,335,170,531,240,240,,,,690,308,578,261,12,7,85,34,15,6,47,107,55
E02004071,Derbyshire Dales 004,Middle Super Output Areas and Intermediate Zones,MSOAIZ,DE,5096,2229,3810,1624,1887,958,1923,666,19,8,618,298,244,118,374,180,180,,,,580,259,504,228,34,12,30,13,12,6,31,69,40
E02004072,Derbyshire Dales 005,Middle Super Output Areas and Intermediate Zones,MSOAIZ,DE,8390,3722,6970,3031,3423,1770,3547,1261,38,18,499,238,164,72,335,166,166,,,,790,391,687,350,13,6,71,30,19,5,41,93,44
E02004073,Derbyshire Dales 006,Middle Super Output Areas and Intermediate Zones,MSOAIZ,DE,8947,4129,6264,2767,3267,1651,2997,1116,21,8,1681,821,590,258,1091,563,563,,,,889,475,771,420,18,7,84,41,16,7,55,92,58
E02004074,Derbyshire Dales 007,Middle Super Output Areas and Intermediate Zones,MSOAIZ,DE,5796,2582,4415,1931,2204,1153,2211,778,18,13,791,350,301,124,490,226,226,,,,512,256,478,240,0,0,27,12,7,4,16,60,32
E02004075,Derbyshire Dales 008,Middle Super Output Areas and Intermediate Zones,MSOAIZ,SK,7390,3156,5728,2357,3007,1458,2721,899,52,25,441,199,176,79,265,120,120,,,,1001,493,898,451,11,5,82,33,10,4,42,168,82
E02004076,Derbyshire Dales 009,Middle Super Output Areas and Intermediate Zones,MSOAIZ,DE,6512,2796,4229,1731,1655,860,2574,871,144,72,1444,673,608,267,836,406,406,,,,630,285,583,267,5,2,30,12,12,4,18,65,35
E02004077,Derbyshire Dales 010,Middle Super Output Areas and Intermediate Zones,MSOAIZ,ST,7113,2966,5529,2258,2823,1362,2706,896,24,10,230,116,78,42,152,74,74,,,,1138,493,1033,445,34,14,52,25,19,9,48,192,89
E02004078,Erewash 001,Middle Super Output Areas and Intermediate Zones,MSOAIZ,DE,7117,3159,3581,1621,1376,766,2205,855,12,5,2479,1063,1036,420,1443,643,643,,,,962,409,883,366,0,0,58,28,21,15,43,83,61
E02004080,Erewash 003,Middle Super Output Areas and Intermediate Zones,MSOAIZ,DE,9266,4284,6215,2725,2331,1266,3884,1459,28,16,849,483,275,155,574,328,328,,,,2082,1005,1945,942,0,0,112,50,25,13,63,92,55
E02004081,Erewash 004,Middle Super Output Areas and Intermediate Zones,MSOAIZ,DE,5660,2470,4569,1953,2098,1080,2471,873,3,1,573,287,133,56,440,231,231,,,,464,199,420,178,6,2,29,15,9,4,21,51,30
E02004082,Erewash 005,Middle Super Output Areas and Intermediate Zones,MSOAIZ,DE,6128,2550,5604,2316,2397,1224,3207,1092,8,7,99,49,33,15,66,34,34,,,,380,154,338,133,0,0,31,16,11,5,21,37,24
E02004083,Erewash 006,Middle Super Output Areas and Intermediate Zones,MSOAIZ,NG,7745,3310,5897,2501,2162,1120,3735,1381,39,20,690,313,215,85,475,228,228,,,,1069,448,1007,422,0,0,45,18,17,8,26,50,28
E02004084,Erewash 007,Middle Super Output Areas and Intermediate Zones,MSOAIZ,DE,6140,2667,4075,1733,1672,897,2403,836,10,5,1554,725,610,265,944,460,460,,,,442,167,416,154,0,0,24,11,2,2,13,59,37
E02004085,Erewash 008,Middle Super Output Areas and Intermediate Zones,MSOAIZ,NG,8572,3726,6476,2769,2565,1358,3911,1411,8,7,1131,486,361,153,770,333,333,,,,886,422,775,382,13,4,84,32,14,4,40,71,42
E02004086,Erewash 009,Middle Super Output Areas and Intermediate Zones,MSOAIZ,DE,7236,3175,5679,2445,2373,1271,3306,1174,48,19,730,341,231,102,499,239,239,,,,718,331,647,297,5,3,65,30,1,1,34,61,39
E02004087,Erewash 010,Middle Super Output Areas and Intermediate Zones,MSOAIZ,NG,7776,3414,5327,2306,1788,980,3539,1326,62,26,1221,553,399,173,822,380,380,,,,1122,496,1041,453,0,0,78,40,3,3,43,44,33
E02004088,Erewash 011,Middle Super Output Areas and Intermediate Zones,MSOAIZ,NG,7434,3124,6634,2748,2630,1321,4004,1427,11,6,107,39,4,2,103,37,37,,,,607,290,562,265,5,3,39,21,1,1,25,75,41
E02004089,Erewash 012,Middle Super Output Areas and Intermediate Zones,MSOAIZ,NG,6668,3259,3903,1773,1136,641,2767,1132,38,26,972,600,211,147,761,453,453,,,,1671,819,1576,774,14,6,76,34,5,5,45,84,41
E02004090,Erewash 013,Middle Super Output Areas and Intermediate Zones,MSOAIZ,NG,6082,2733,4661,2038,2024,1056,2637,982,30,15,670,342,235,113,435,229,229,,,,662,305,609,281,5,2,42,19,6,3,24,59,33
E02004091,Erewash 014,Middle Super Output Areas and Intermediate Zones,MSOAIZ,NG,8821,3905,7258,3169,2693,1429,4565,1740,37,19,317,154,58,32,259,122,122,,,,1156,533,1061,488,17,7,77,37,1,1,45,53,30
E02004092,Erewash 015,Middle Super Output Areas and Intermediate Zones,MSOAIZ,NG,9556,4194,6897,2931,2374,1272,4523,1659,107,49,1585,764,437,212,1148,552,552,,,,899,403,819,367,12,4,53,24,15,8,36,68,47
E02004093,High Peak 001,Middle Super Output Areas and Intermediate Zones,MSOAIZ,SK,6358,2751,4647,1980,1527,804,3120,1176,28,16,776,321,487,220,289,101,101,,,,866,412,796,382,0,0,58,26,12,4,30,41,22
E02004094,High Peak 002,Middle Super Output Areas and Intermediate Zones,MSOAIZ,SK,7257,2994,4310,1711,1322,675,2988,1036,17,10,2301,997,2120,918,181,79,79,,,,553,225,491,197,2,1,53,23,7,4,28,76,51
E02004095,High Peak 003,Middle Super Output Areas and Intermediate Zones,MSOAIZ,SK,9828,4463,6695,2882,2298,1239,4397,1643,36,18,1280,661,1047,515,233,146,146,,,,1680,830,1537,756,9,4,124,67,10,3,74,137,72
E02004096,High Peak 004,Middle Super Output Areas and Intermediate Zones,MSOAIZ,SK,9408,3795,8558,3420,3214,1612,5344,1808,24,12,164,75,147,69,17,6,6,,,,591,256,519,222,1,1,52,26,19,7,34,71,32
E02004097,High Peak 005,Middle Super Output Areas and Intermediate Zones,MSOAIZ,SK,7638,3328,6428,2704,2598,1322,3830,1382,15,6,193,103,148,76,45,27,27,,,,970,491,884,450,0,0,54,28,32,13,41,32,24
E02004098,High Peak 006,Middle Super Output Areas and Intermediate Zones,MSOAIZ,SK,7262,3227,5021,2182,1983,1073,3038,1109,96,41,1420,667,1074,514,346,153,153,,,,645,286,551,249,4,1,84,34,6,2,37,80,51
E02004100,High Peak 008,Middle Super Output Areas and Intermediate Zones,MSOAIZ,SK,7525,3216,6248,2589,2777,1376,3471,1213,26,9,403,195,376,177,27,18,18,,,,769,381,692,342,3,2,68,34,6,3,39,79,42
E02004102,High Peak 010,Middle Super Output Areas and Intermediate Zones,MSOAIZ,SK,8037,3909,5094,2281,2344,1256,2750,1025,39,27,691,465,308,209,383,256,256,,,,2109,1087,1950,1010,17,9,113,56,29,12,77,104,49
E02004103,High Peak 011,Middle Super Output Areas and Intermediate Zones,MSOAIZ,SK,7069,2938,4171,1746,1637,840,2534,906,42,19,1901,779,1407,600,494,179,179,,,,890,361,782,316,3,2,89,37,16,6,45,65,33
E02004104,High Peak 012,Middle Super Output Areas and Intermediate Zones,MSOAIZ,SK,7045,2912,6028,2444,2519,1263,3509,1181,28,17,272,135,192,98,80,37,37,,,,666,289,569,244,14,8,80,34,3,3,45,51,27
E02004105,North East Derbyshire 001,Middle Super Output Areas and Intermediate Zones,MSOAIZ,S,9390,3845,6914,2747,2422,1152,4492,1595,32,16,1756,775,1707,750,49,25,25,,,,639,272,546,232,4,2,63,30,26,8,40,49,35
E02004106,North East Derbyshire 002,Middle Super Output Areas and Intermediate Zones,MSOAIZ,S,6986,3111,6045,2637,3042,1587,3003,1050,7,4,450,233,407,211,43,22,22,,,,418,205,361,182,2,1,53,21,2,1,23,66,32
E02004108,North East Derbyshire 004,Middle Super Output Areas and Intermediate Zones,MSOAIZ,S,7438,3387,4878,2111,2073,1083,2805,1028,45,24,1888,938,1362,664,526,274,274,,,,580,286,511,250,5,4,41,20,23,12,36,47,28
E02004109,North East Derbyshire 005,Middle Super Output Areas and Intermediate Zones,MSOAIZ,S,6702,2880,5922,2510,3064,1537,2858,973,7,3,417,202,364,182,53,20,20,,,,284,125,243,106,2,2,32,14,7,3,19,72,40
E02004110,North East Derbyshire 006,Middle Super Output Areas and Intermediate Zones,MSOAIZ,S,7464,3136,6856,2822,2881,1482,3975,1340,50,32,254,139,188,104,66,35,35,,,,264,122,228,106,4,1,28,13,4,2,16,40,21
E02004111,North East Derbyshire 007,Middle Super Output Areas and Intermediate Zones,MSOAIZ,S,5449,2414,4248,1857,2067,1074,2181,783,9,4,730,354,499,226,231,128,128,,,,413,170,368,149,4,2,34,14,7,5,21,49,29
E02004112,North East Derbyshire 008,Middle Super Output Areas and Intermediate Zones,MSOAIZ,S,6482,2894,5581,2462,3033,1582,2548,880,14,8,388,199,307,163,81,36,36,,,,457,199,395,173,3,2,45,19,14,5,26,42,26
E02004113,North East Derbyshire 009,Middle Super Output Areas and Intermediate Zones,MSOAIZ,S,9115,4027,4341,1881,1802,950,2539,931,16,9,3995,1777,3804,1658,191,119,119,,,,690,323,632,293,1,1,48,26,9,3,30,73,37
E02004114,North East Derbyshire 010,Middle Super Output Areas and Intermediate Zones,MSOAIZ,S,7217,3163,6209,2681,3427,1704,2782,977,10,4,482,234,434,211,48,23,23,,,,455,213,368,174,11,4,72,32,4,3,39,61,31
E02004115,North East Derbyshire 011,Middle Super Output Areas and Intermediate Zones,MSOAIZ,S,8962,3978,6877,2947,2794,1423,4083,1524,48,22,1227,614,1193,592,34,22,22,,,,768,369,693,334,1,1,71,32,3,2,35,42,26
E02004116,North East Derbyshire 012,Middle Super Output Areas and Intermediate Zones,MSOAIZ,S,7810,3604,4338,1883,1677,883,2661,1000,57,25,2591,1289,2470,1224,121,65,65,,,,757,368,679,327,8,4,53,30,17,7,41,67,39
E02004117,North East Derbyshire 013,Middle Super Output Areas and Intermediate Zones,MSOAIZ,S,7253,3170,4840,2078,2341,1167,2499,911,0,0,1853,824,1683,752,170,72,72,,,,493,232,427,203,11,3,47,23,8,3,29,67,36
E02004118,South Derbyshire 001,Middle Super Output Areas and Intermediate Zones,MSOAIZ,DE,6523,2700,5301,2128,2166,1037,3135,1091,13,7,271,123,245,114,26,9,9,,,,857,401,781,366,17,7,37,21,22,7,35,81,41
E02004119,South Derbyshire 002,Middle Super Output Areas and Intermediate Zones,MSOAIZ,DE,10791,4330,8862,3465,2533,1245,6329,2220,35,18,603,283,361,183,242,100,100,,,,1256,544,1156,499,12,5,78,36,10,4,45,35,20
E02004120,South Derbyshire 003,Middle Super Output Areas and Intermediate Zones,MSOAIZ,DE,7236,2903,6055,2414,2406,1115,3649,1299,7,4,303,125,205,93,98,32,32,,,,816,329,749,300,4,2,61,25,2,2,29,55,31
E02004121,South Derbyshire 004,Middle Super Output Areas and Intermediate Zones,MSOAIZ,DE,6634,2800,5833,2411,2342,1191,3491,1220,18,11,237,127,178,101,59,26,26,,,,505,227,444,193,7,4,46,25,8,5,34,41,24
E02004122,South Derbyshire 005,Middle Super Output Areas and Intermediate Zones,MSOAIZ,DE,5855,2472,4848,2011,2223,1107,2625,904,24,11,170,83,140,67,30,16,16,,,,650,288,457,209,123,50,61,24,9,5,79,163,79
E02004123,South Derbyshire 006,Middle Super Output Areas and Intermediate Zones,MSOAIZ,LE,6323,2816,4736,1991,2130,1081,2606,910,6,4,539,300,404,236,135,64,64,,,,973,479,908,443,11,5,40,23,14,8,36,69,42
E02004124,South Derbyshire 007,Middle Super Output Areas and Intermediate Zones,MSOAIZ,DE,7607,3141,5306,2262,2201,1159,3105,1103,2,1,1624,596,1401,532,223,64,64,,,,634,255,575,226,1,1,57,27,1,1,29,41,27
E02004125,South Derbyshire 008,Middle Super Output Areas and Intermediate Zones,MSOAIZ,DE,8950,3775,6485,2656,2363,1204,4122,1452,19,8,1161,551,889,425,272,126,126,,,,1229,521,1143,483,7,3,73,32,6,3,38,56,39
E02004126,South Derbyshire 009,Middle Super Output Areas and Intermediate Zones,MSOAIZ,DE,6852,3009,5168,2129,1945,976,3223,1153,20,9,766,441,596,364,170,77,77,,,,785,366,717,339,21,6,44,20,3,1,27,113,64
E02004128,South Derbyshire 011,Middle Super Output Areas and Intermediate Zones,MSOAIZ,DE,10093,4296,7883,3329,3205,1645,4678,1684,25,12,1026,429,867,374,159,55,55,,,,1026,462,919,411,5,4,92,42,10,5,51,133,64
E02004129,East Devon 001,Middle Super Output Areas and Intermediate Zones,MSOAIZ,TA,5449,2363,4367,1916,2512,1238,1855,678,38,17,274,102,171,63,103,39,39,,,,656,275,541,222,17,9,91,40,7,4,53,114,53
E02004130,East Devon 002,Middle Super Output Areas and Intermediate Zones,MSOAIZ,EX,5881,2873,3805,1828,1952,1135,1853,693,12,7,999,498,699,354,300,144,144,,,,998,491,923,457,11,4,58,28,6,2,34,67,49
E02004131,East Devon 003,Middle Super Output Areas and Intermediate Zones,MSOAIZ,EX,5507,2421,4254,1930,1875,1050,2379,880,30,11,502,172,320,110,182,62,62,,,,688,291,642,267,0,0,41,21,5,3,24,33,17
E02004132,East Devon 004,Middle Super Output Areas and Intermediate Zones,MSOAIZ,EX,8203,3349,6523,2653,3029,1488,3494,1165,33,14,497,204,357,147,140,57,57,,,,1016,414,884,362,23,9,97,38,12,5,52,134,64
E02004133,East Devon 005,Middle Super Output Areas and Intermediate Zones,MSOAIZ,EX,8060,3711,5659,2646,3096,1702,2563,944,44,24,1174,493,826,343,348,150,150,,,,1089,490,929,418,18,10,132,57,10,5,72,94,58
E02004134,East Devon 006,Middle Super Output Areas and Intermediate Zones,MSOAIZ,EX,6793,2810,4944,2021,2232,1089,2712,932,34,16,670,283,467,204,203,79,79,,,,1035,434,867,363,40,17,78,33,50,21,71,110,56
E02004135,East Devon 007,Middle Super Output Areas and Intermediate Zones,MSOAIZ,EX,7917,3604,6245,2865,3796,2020,2449,845,20,11,738,319,511,238,227,81,81,,,,793,344,667,294,25,7,82,38,19,5,50,121,65
E02004136,East Devon 008,Middle Super Output Areas and Intermediate Zones,MSOAIZ,EX,7894,3398,6316,2704,3208,1647,3108,1057,57,24,565,250,430,194,135,56,56,,,,899,383,785,342,22,8,84,30,8,3,41,57,37
E02004137,East Devon 009,Middle Super Output Areas and Intermediate Zones,MSOAIZ,EX,5272,2375,4126,1862,2628,1344,1498,518,38,15,439,188,324,150,115,38,38,,,,580,264,480,221,32,13,55,25,13,5,43,89,46
E02004138,East Devon 010,Middle Super Output Areas and Intermediate Zones,MSOAIZ,EX,6902,3564,5255,2744,3327,1993,1928,751,28,16,492,252,284,159,208,93,93,,,,1060,513,974,469,15,8,69,34,2,2,44,67,39
E02004139,East Devon 011,Middle Super Output Areas and Intermediate Zones,MSOAIZ,EX,6353,3032,4620,2245,2712,1536,1908,709,102,44,1056,480,753,364,303,116,116,,,,515,224,453,196,3,1,50,24,9,3,28,60,39
E02004140,East Devon 012,Middle Super Output Areas and Intermediate Zones,MSOAIZ,EX,4905,2606,3971,2108,2771,1668,1200,440,10,4,220,115,125,67,95,48,48,,,,629,326,558,293,16,7,39,20,16,6,33,75,53
E02004141,East Devon 013,Middle Super Output Areas and Intermediate Zones,MSOAIZ,EX,5673,2472,4186,1843,2121,1110,2065,733,19,6,469,205,389,174,80,31,31,,,,879,359,790,324,37,14,38,14,14,7,35,120,59
E02004142,East Devon 014,Middle Super Output Areas and Intermediate Zones,MSOAIZ,EX,5088,2224,3916,1720,2071,1078,1845,642,42,17,249,103,192,84,57,19,19,,,,810,344,539,244,108,38,56,24,107,38,100,71,40
E02004143,East Devon 015,Middle Super Output Areas and Intermediate Zones,MSOAIZ,EX,6233,2679,5184,2247,2151,1190,3033,1057,26,11,379,185,252,131,127,54,54,,,,595,209,510,178,28,10,34,12,23,9,31,49,27
E02004144,East Devon 016,Middle Super Output Areas and Intermediate Zones,MSOAIZ,EX,6670,2973,5386,2457,2512,1393,2874,1064,15,6,444,165,118,50,326,115,115,,,,776,319,608,252,87,28,53,29,28,10,67,49,26
E02004145,East Devon 017,Middle Super Output Areas and Intermediate Zones,MSOAIZ,EX,5844,2896,4492,2253,2841,1658,1651,595,43,21,460,230,305,179,155,51,51,,,,773,344,681,307,24,5,55,24,13,8,37,76,48
E02004146,East Devon 018,Middle Super Output Areas and Intermediate Zones,MSOAIZ,EX,7166,3043,4804,2037,1816,967,2988,1070,54,28,1462,646,936,437,526,209,209,,,,816,311,680,259,35,11,73,31,28,10,52,30,21
E02004147,East Devon 019,Middle Super Output Areas and Intermediate Zones,MSOAIZ,EX,6926,3328,3938,1862,1598,917,2340,945,27,17,253,147,70,36,183,111,111,,,,2609,1238,2398,1133,38,13,162,84,11,8,105,99,64
E02004148,East Devon 020,Middle Super Output Areas and Intermediate Zones,MSOAIZ,EX,6792,3350,4683,2342,2746,1614,1937,728,18,10,1033,478,903,431,130,47,47,,,,984,468,905,433,6,3,58,25,15,7,35,74,52
E02004149,Exeter 001,Middle Super Output Areas and Intermediate Zones,MSOAIZ,EX,6177,2681,4671,2083,2353,1238,2318,845,66,35,303,150,111,47,192,103,103,,,,1092,388,1042,364,10,6,29,14,11,4,24,45,25
E02004150,Exeter 002,Middle Super Output Areas and Intermediate Zones,MSOAIZ,EX,6816,2835,3437,1512,1229,663,2208,849,21,9,1705,755,1450,660,255,95,95,,,,1625,536,1528,496,5,2,80,32,12,6,40,28,23
E02004151,Exeter 003,Middle Super Output Areas and Intermediate Zones,MSOAIZ,EX,7925,3284,5536,2400,2471,1310,3065,1090,70,33,1588,549,708,248,880,301,301,,,,668,267,568,236,29,6,57,20,14,5,31,63,35
E02004152,Exeter 004,Middle Super Output Areas and Intermediate Zones,MSOAIZ,EX,7726,2986,2184,1090,1044,598,1140,492,77,24,425,244,77,46,348,198,198,,,,4967,1602,4796,1537,24,6,123,50,24,9,65,73,26
E02004153,Exeter 005,Middle Super Output Areas and Intermediate Zones,MSOAIZ,EX,7522,3219,4424,1936,1364,737,3060,1199,157,62,1663,682,381,117,1282,565,565,,,,1232,515,1124,469,6,2,92,39,10,5,46,46,24
E02004154,Exeter 006,Middle Super Output Areas and Intermediate Zones,MSOAIZ,EX,7798,3183,4122,1801,1453,787,2669,1014,67,26,715,325,143,69,572,256,256,,,,2850,1004,2681,945,6,2,160,55,3,2,59,44,27
E02004155,Exeter 007,Middle Super Output Areas and Intermediate Zones,MSOAIZ,EX,7533,3305,4605,1949,1869,1003,2736,946,28,12,2197,1023,2084,979,113,44,44,,,,606,252,540,221,4,3,55,26,7,2,31,97,69
E02004156,Exeter 008,Middle Super Output Areas and Intermediate Zones,MSOAIZ,EX,8615,4766,2426,1335,1087,694,1339,641,131,78,2278,1481,846,538,1432,943,943,,,,3617,1765,3481,1697,18,8,101,52,17,8,68,163,107
E02004157,Exeter 009,Middle Super Output Areas and Intermediate Zones,MSOAIZ,EX,6182,2993,3946,1801,1721,961,2225,840,31,15,405,284,160,116,245,168,168,,,,1733,857,1654,821,0,0,57,27,22,9,36,67,36
E02004158,Exeter 010,Middle Super Output Areas and Intermediate Zones,MSOAIZ,EX,7772,3317,5049,2188,1670,911,3379,1277,56,22,972,379,390,170,582,209,209,,,,1626,685,1453,615,9,4,139,58,25,8,70,69,43
E02004159,Exeter 011,Middle Super Output Areas and Intermediate Zones,MSOAIZ,EX,9232,3939,7039,2983,2582,1371,4457,1612,152,59,638,270,197,106,441,164,164,,,,1355,601,1275,564,9,4,68,31,3,2,37,48,26
E02004160,Exeter 012,Middle Super Output Areas and Intermediate Zones,MSOAIZ,EX,7021,3030,5433,2356,2314,1286,3119,1070,19,8,968,416,489,237,479,179,179,,,,555,228,488,197,8,3,49,25,10,3,31,46,22
E02004161,Exeter 013,Middle Super Output Areas and Intermediate Zones,MSOAIZ,EX,7915,3313,3849,1691,1300,760,2549,931,80,41,2879,1104,2618,985,261,119,119,,,,1017,420,847,341,63,29,72,34,35,16,79,90,57
E02004162,Exeter 014,Middle Super Output Areas and Intermediate Zones,MSOAIZ,EX,7007,3247,4529,2068,1791,1018,2738,1050,52,27,718,335,282,141,436,194,194,,,,1670,795,1571,748,6,2,90,44,3,1,47,38,22
E02004163,Exeter 015,Middle Super Output Areas and Intermediate Zones,MSOAIZ,EX,6567,3144,4618,2250,2514,1472,2104,778,32,19,944,389,714,310,230,79,79,,,,856,421,747,382,35,10,71,27,3,2,39,117,65
E02004164,Mid Devon 001,Middle Super Output Areas and Intermediate Zones,MSOAIZ,TA,6529,2747,5018,2094,2685,1286,2333,808,36,13,418,169,323,145,95,24,24,,,,926,407,806,357,19,7,89,36,12,7,50,131,64
E02004165,Mid Devon 002,Middle Super Output Areas and Intermediate Zones,MSOAIZ,EX,7990,3433,6082,2667,2870,1533,3212,1134,57,27,216,78,12,6,204,72,72,,,,1572,624,1459,572,26,10,68,33,19,9,52,63,37
E02004166,Mid Devon 003,Middle Super Output Areas and Intermediate Zones,MSOAIZ,TA,6476,2715,4637,1920,2178,1073,2459,847,104,42,834,356,425,192,409,164,164,,,,771,333,677,296,26,7,66,28,2,2,37,130,64
E02004167,Mid Devon 004,Middle Super Output Areas and Intermediate Zones,MSOAIZ,EX,6977,3015,3432,1445,1195,646,2237,799,197,79,2024,891,1672,693,352,198,198,,,,1192,527,1110,489,10,6,70,30,2,2,38,132,73
E02004168,Mid Devon 005,Middle Super Output Areas and Intermediate Zones,MSOAIZ,EX,6040,2734,3177,1359,1276,666,1901,693,33,10,1331,682,932,465,399,217,217,,,,1391,623,1254,562,53,23,55,26,29,12,61,108,60
E02004169,Mid Devon 006,Middle Super Output Areas and Intermediate Zones,MSOAIZ,EX,7065,2858,5423,2193,2328,1133,3095,1060,45,18,634,268,457,196,177,72,72,,,,856,327,768,293,21,7,60,24,7,3,34,107,52
E02004170,Mid Devon 007,Middle Super Output Areas and Intermediate Zones,MSOAIZ,EX,7522,3223,5166,2202,1911,1013,3255,1189,67,31,1102,470,594,277,508,193,193,,,,1109,478,1008,436,13,6,71,31,17,5,42,78,42
E02004171,Mid Devon 008,Middle Super Output Areas and Intermediate Zones,MSOAIZ,EX,7492,3144,5552,2324,2578,1306,2974,1018,18,10,714,306,519,241,195,65,65,,,,1080,443,990,408,20,7,53,23,17,5,35,128,61
E02004172,Mid Devon 009,Middle Super Output Areas and Intermediate Zones,MSOAIZ,EX,6099,2571,4770,1999,2412,1164,2358,835,48,15,451,195,354,167,97,28,28,,,,737,315,651,277,17,8,67,29,2,1,38,93,47
E02004173,Mid Devon 010,Middle Super Output Areas and Intermediate Zones,MSOAIZ,EX,7212,2922,5525,2195,2599,1217,2926,978,47,16,501,238,428,211,73,27,27,,,,1009,413,869,358,47,19,81,33,12,3,55,130,60
E02004174,Mid Devon 011,Middle Super Output Areas and Intermediate Zones,MSOAIZ,EX,7464,3396,5095,2228,2151,1169,2944,1059,88,44,1010,482,531,250,479,232,232,,,,1210,601,1125,557,23,8,53,31,9,5,44,61,41
E02004175,North Devon 001,Middle Super Output Areas and Intermediate Zones,MSOAIZ,EX,5312,2491,2923,1307,1228,673,1695,634,20,10,463,266,89,48,374,218,218,,,,1854,870,1742,820,7,4,91,37,14,9,50,52,38
E02004176,North Devon 002,Middle Super Output Areas and Intermediate Zones,MSOAIZ,EX,5345,2421,4007,1797,2294,1176,1713,621,17,6,261,129,44,22,217,107,107,,,,945,427,830,375,16,6,82,38,17,8,52,115,62
E02004177,North Devon 003,Middle Super Output Areas and Intermediate Zones,MSOAIZ,EX,5797,2541,3937,1675,1703,880,2234,795,17,9,552,267,121,45,431,222,222,,,,1219,555,1136,521,13,4,68,28,2,2,34,72,35
E02004178,North Devon 004,Middle Super Output Areas and Intermediate Zones,MSOAIZ,EX,5342,2260,4260,1796,2243,1118,2017,678,17,7,189,71,43,15,146,56,56,,,,755,332,608,269,47,23,83,33,17,7,63,121,54
E02004179,North Devon 005,Middle Super Output Areas and Intermediate Zones,MSOAIZ,EX,8520,3717,5810,2580,2872,1553,2938,1027,65,31,732,347,137,65,595,282,282,,,,1816,702,1023,450,391,116,96,41,306,95,252,97,57
E02004180,North Devon 006,Middle Super Output Areas and Intermediate Zones,MSOAIZ,EX,5795,2273,4674,1818,2370,1074,2304,744,26,12,262,90,69,22,193,68,68,,,,745,308,593,251,47,16,78,31,27,10,57,88,45
E02004181,North Devon 007,Middle Super Output Areas and Intermediate Zones,MSOAIZ,EX,5794,2571,3876,1690,1615,874,2261,816,71,34,847,405,183,74,664,331,331,,,,947,408,793,334,37,25,95,37,22,12,74,53,34
E02004182,North Devon 008,Middle Super Output Areas and Intermediate Zones,MSOAIZ,EX,6176,2896,3011,1306,1073,597,1938,709,22,10,1465,793,425,180,1040,613,613,,,,1625,751,1499,697,17,9,79,33,30,12,54,53,36
E02004183,North Devon 009,Middle Super Output Areas and Intermediate Zones,MSOAIZ,EX,5706,2654,4125,1904,2163,1187,1962,717,13,8,544,238,149,54,395,184,184,,,,966,465,866,411,28,13,64,34,8,7,54,58,39
E02004184,North Devon 010,Middle Super Output Areas and Intermediate Zones,MSOAIZ,EX,8552,3532,5319,2166,1763,916,3556,1250,39,15,1621,650,565,215,1056,435,435,,,,1530,673,1434,628,3,1,85,40,8,4,45,43,28
E02004185,North Devon 011,Middle Super Output Areas and Intermediate Zones,MSOAIZ,EX,5724,2510,4657,2070,2423,1302,2234,768,51,24,335,138,99,36,236,102,102,,,,636,255,571,225,11,5,36,18,18,7,30,45,23
E02004186,North Devon 012,Middle Super Output Areas and Intermediate Zones,MSOAIZ,EX,8201,3426,6083,2568,2684,1382,3399,1186,93,38,617,256,144,53,473,203,203,,,,1332,522,1198,465,15,6,105,43,14,8,57,76,42
E02004187,North Devon 013,Middle Super Output Areas and Intermediate Zones,MSOAIZ,TA,9104,3966,6052,2610,3111,1552,2941,1058,120,52,927,412,219,91,708,321,321,,,,1779,763,1536,669,70,22,161,65,12,7,94,226,129
E02004188,North Devon 014,Middle Super Output Areas and Intermediate Zones,MSOAIZ,TA,6224,2743,4834,2096,2738,1354,2096,742,38,15,519,254,90,51,429,203,203,,,,694,310,589,262,24,11,71,30,10,7,48,139,68
E02004189,South Hams 001,Middle Super Output Areas and Intermediate Zones,MSOAIZ,PL,5663,2417,4309,1791,1462,716,2847,1075,41,18,299,131,41,24,258,107,107,,,,948,446,855,405,11,5,75,33,7,3,41,66,31
E02004190,South Hams 002,Middle Super Output Areas and Intermediate Zones,MSOAIZ,TQ,7741,3285,5736,2381,2909,1411,2827,970,90,34,821,348,107,52,714,296,296,,,,984,460,854,407,21,8,86,37,23,8,53,110,62
E02004191,South Hams 003,Middle Super Output Areas and Intermediate Zones,MSOAIZ,TQ,8024,3848,4768,2239,2458,1389,2310,850,131,57,1606,793,222,94,1384,699,699,,,,1446,706,1340,653,4,1,94,48,8,4,53,73,53
E02004192,South Hams 004,Middle Super Output Areas and Intermediate Zones,MSOAIZ,TQ,7143,3230,5788,2616,3233,1691,2555,925,26,10,276,128,43,20,233,108,108,,,,906,399,785,347,19,9,85,35,17,8,52,147,77
E02004193,South Hams 005,Middle Super Output Areas and Intermediate Zones,MSOAIZ,PL,11703,4741,9344,3731,3198,1652,6146,2079,125,57,864,390,116,55,748,335,335,,,,1285,517,1172,463,17,6,89,42,7,6,54,85,46
E02004194,South Hams 006,Middle Super Output Areas and Intermediate Zones,MSOAIZ,TQ,6163,2655,4472,1879,2396,1155,2076,724,92,36,530,251,73,29,457,222,222,,,,988,444,837,384,36,11,103,43,12,6,60,81,45
E02004195,South Hams 007,Middle Super Output Areas and Intermediate Zones,MSOAIZ,TQ,5315,2635,3105,1563,1670,967,1435,596,67,25,1140,570,243,111,897,459,459,,,,938,436,751,357,77,32,54,25,56,22,79,65,41
E02004196,South Hams 008,Middle Super Output Areas and Intermediate Zones,MSOAIZ,TQ,7034,3111,5113,2252,2780,1418,2333,834,55,26,684,324,105,49,579,275,275,,,,1071,453,955,407,12,4,79,34,25,8,46,111,56
E02004197,South Hams 009,Middle Super Output Areas and Intermediate Zones,MSOAIZ,PL,6229,2874,4946,2270,2777,1475,2169,795,147,63,471,223,57,34,414,189,189,,,,626,292,543,251,30,11,40,21,13,9,41,39,26
E02004198,South Hams 010,Middle Super Output Areas and Intermediate Zones,MSOAIZ,TQ,6341,2980,3974,1835,2021,1115,1953,720,98,37,1107,555,233,103,874,452,452,,,,1087,508,970,450,16,7,88,44,13,7,58,75,45
E02004199,South Hams 011,Middle Super Output Areas and Intermediate Zones,MSOAIZ,TQ,5350,2550,4134,1994,2688,1449,1446,545,32,17,432,195,65,35,367,160,160,,,,689,301,621,269,10,5,53,24,5,3,32,63,43
E02004200,South Hams 012,Middle Super Output Areas and Intermediate Zones,MSOAIZ,TQ,5099,2532,3797,1889,2355,1337,1442,552,42,20,563,287,78,36,485,251,251,,,,622,297,519,245,13,7,81,38,9,7,52,75,39
E02004201,Teignbridge 001,Middle Super Output Areas and Intermediate Zones,MSOAIZ,TQ,5121,2231,4177,1804,2494,1225,1683,579,34,12,208,100,80,44,128,56,56,,,,650,284,580,257,25,8,37,15,8,4,27,52,31
E02004202,Teignbridge 002,Middle Super Output Areas and Intermediate Zones,MSOAIZ,EX,7677,3332,5753,2459,2472,1262,3281,1197,43,15,564,275,128,61,436,214,214,,,,1219,533,1144,497,20,10,47,21,8,5,36,98,50
E02004203,Teignbridge 003,Middle Super Output Areas and Intermediate Zones,MSOAIZ,TQ,5519,2425,4338,1875,2393,1187,1945,688,29,12,400,183,83,42,317,141,141,,,,667,305,542,254,34,13,83,34,8,4,51,85,50
E02004204,Teignbridge 004,Middle Super Output Areas and Intermediate Zones,MSOAIZ,TQ,9227,4038,6997,3046,2998,1617,3999,1429,70,26,804,345,200,77,604,268,268,,,,1278,571,1151,510,12,7,90,43,25,11,61,78,50
E02004205,Teignbridge 005,Middle Super Output Areas and Intermediate Zones,MSOAIZ,EX,6301,2759,4867,2151,2269,1234,2598,917,84,34,292,109,58,21,234,88,88,,,,1006,432,885,382,19,8,98,39,4,3,50,52,33
E02004206,Teignbridge 006,Middle Super Output Areas and Intermediate Zones,MSOAIZ,TQ,6450,3216,4151,2015,2265,1292,1886,723,105,59,703,375,180,74,523,301,301,,,,1402,700,1302,645,5,3,82,45,13,7,55,89,67
E02004207,Teignbridge 007,Middle Super Output Areas and Intermediate Zones,MSOAIZ,TQ,5943,2534,4680,2019,2112,1128,2568,891,49,22,494,193,99,46,395,147,147,,,,651,277,599,256,5,1,47,20,0,0,21,69,23
E02004208,Teignbridge 008,Middle Super Output Areas and Intermediate Zones,MSOAIZ,TQ,7724,3423,6559,2896,3131,1659,3428,1237,37,19,188,64,25,6,163,58,58,,,,893,414,809,371,1,1,77,38,6,4,43,47,30
E02004209,Teignbridge 009,Middle Super Output Areas and Intermediate Zones,MSOAIZ,TQ,8253,3553,6282,2677,2335,1288,3947,1389,42,22,784,363,133,60,651,303,303,,,,1088,455,963,399,16,5,101,47,8,4,56,57,36
E02004210,Teignbridge 010,Middle Super Output Areas and Intermediate Zones,MSOAIZ,TQ,6526,3268,3627,1761,1646,999,1981,762,74,36,1135,540,306,133,829,407,407,,,,1595,870,1460,806,15,6,105,50,15,8,64,95,61
E02004211,Teignbridge 011,Middle Super Output Areas and Intermediate Zones,MSOAIZ,TQ,6363,2946,5361,2467,2870,1550,2491,917,42,27,175,64,43,15,132,49,49,,,,732,357,647,316,10,4,70,35,5,2,41,53,31
E02004212,Teignbridge 012,Middle Super Output Areas and Intermediate Zones,MSOAIZ,TQ,5881,2494,4388,1851,1666,888,2722,963,88,42,595,274,142,66,453,208,208,,,,778,307,702,274,6,1,66,30,4,2,33,32,20
E02004213,Teignbridge 013,Middle Super Output Areas and Intermediate Zones,MSOAIZ,TQ,4792,2049,3853,1660,1657,847,2196,813,42,20,68,23,21,8,47,15,15,,,,796,333,722,301,8,3,60,25,6,4,32,33,13
E02004214,Teignbridge 014,Middle Super Output Areas and Intermediate Zones,MSOAIZ,TQ,5906,2821,3203,1498,997,622,2206,876,100,41,920,484,262,125,658,359,359,,,,1637,763,1461,688,21,6,144,64,11,5,75,46,35
E02004215,Teignbridge 015,Middle Super Output Areas and Intermediate Zones,MSOAIZ,TQ,5407,2390,3700,1560,1427,765,2273,795,25,9,819,381,153,59,666,322,322,,,,808,410,746,380,10,5,40,18,12,7,30,55,30
E02004216,Teignbridge 016,Middle Super Output Areas and Intermediate Zones,MSOAIZ,TQ,5562,2383,4281,1874,1935,1030,2346,844,31,13,682,271,252,100,430,171,171,,,,545,210,468,183,10,2,50,20,17,5,27,23,15
E02004217,Teignbridge 017,Middle Super Output Areas and Intermediate Zones,MSOAIZ,TQ,7607,3382,4855,2168,2228,1197,2627,971,102,41,1196,503,334,145,862,358,358,,,,1381,626,1231,553,35,16,96,47,19,10,73,73,44
E02004218,Teignbridge 018,Middle Super Output Areas and Intermediate Zones,MSOAIZ,TQ,5659,2462,4616,2006,2068,1122,2548,884,71,30,384,139,128,45,256,94,94,,,,554,264,476,230,11,4,64,27,3,3,34,34,23
E02004219,Teignbridge 019,Middle Super Output Areas and Intermediate Zones,MSOAIZ,TQ,5419,2297,4478,1891,2135,1103,2343,788,30,15,301,127,116,42,185,85,85,,,,584,247,523,224,12,4,47,18,2,1,23,26,17
E02004220,Torridge 001,Middle Super Output Areas and Intermediate Zones,MSOAIZ,EX,6145,3027,4350,2118,2316,1321,2034,797,76,30,644,336,178,85,466,251,251,,,,985,495,890,445,3,2,89,47,3,1,50,90,48
E02004221,Torridge 002,Middle Super Output Areas and Intermediate Zones,MSOAIZ,EX,5608,2767,4567,2207,2705,1504,1862,703,25,12,117,63,14,6,103,57,57,,,,855,456,781,423,11,4,60,27,3,2,33,44,29
E02004222,Torridge 003,Middle Super Output Areas and Intermediate Zones,MSOAIZ,EX,5641,2762,3622,1650,1621,900,2001,750,12,5,476,277,38,27,438,250,250,,,,1438,775,1331,722,2,2,94,44,11,7,53,93,55
E02004223,Torridge 004,Middle Super Output Areas and Intermediate Zones,MSOAIZ,EX,11259,4793,7144,3089,2891,1522,4253,1567,179,78,2206,876,585,222,1621,654,654,,,,1638,688,1498,627,15,6,112,47,13,8,61,92,62
E02004224,Torridge 005,Middle Super Output Areas and Intermediate Zones,MSOAIZ,EX,6182,2640,4456,1905,2335,1183,2121,722,37,14,344,142,81,29,263,113,113,,,,1194,502,995,432,58,17,131,46,10,7,70,151,77
E02004225,Torridge 006,Middle Super Output Areas and Intermediate Zones,MSOAIZ,EX,5619,2438,3776,1621,1624,862,2152,759,16,5,750,306,137,55,613,251,251,,,,1033,477,934,433,11,4,76,35,12,5,44,44,29
E02004226,Torridge 007,Middle Super Output Areas and Intermediate Zones,MSOAIZ,EX,6852,3047,5447,2410,3096,1538,2351,872,55,21,311,142,65,30,246,112,112,,,,881,403,769,356,30,13,77,33,5,1,47,158,71
E02004227,Torridge 008,Middle Super Output Areas and Intermediate Zones,MSOAIZ,EX,8809,3682,6594,2738,3560,1730,3034,1008,51,19,654,261,133,59,521,202,202,,,,1335,585,1166,520,31,13,127,47,11,5,65,175,79
E02004228,Torridge 009,Middle Super Output Areas and Intermediate Zones,MSOAIZ,PL,6772,2830,5486,2260,3068,1438,2418,822,32,13,255,121,53,29,202,92,92,,,,855,365,734,317,24,8,88,37,9,3,48,144,71
E02004229,West Devon 001,Middle Super Output Areas and Intermediate Zones,MSOAIZ,EX,7798,3272,5941,2484,3273,1548,2668,936,58,25,542,219,125,51,417,168,168,,,,1136,490,985,422,19,11,120,53,12,4,68,121,54
E02004230,West Devon 002,Middle Super Output Areas and Intermediate Zones,MSOAIZ,EX,7382,3242,4963,2152,2236,1194,2727,958,51,23,913,413,191,89,722,324,324,,,,1389,618,1287,571,12,3,80,37,10,7,47,66,36
E02004231,West Devon 003,Middle Super Output Areas and Intermediate Zones,MSOAIZ,TQ,6228,2710,4384,1906,2433,1194,1951,712,37,15,637,254,226,81,411,173,173,,,,1036,468,905,406,17,9,81,34,33,19,62,134,67
E02004232,West Devon 004,Middle Super Output Areas and Intermediate Zones,MSOAIZ,PL,6418,2639,4883,2005,2590,1217,2293,788,19,8,368,135,140,54,228,81,81,,,,999,429,901,385,32,14,59,27,7,3,44,149,62
E02004233,West Devon 005,Middle Super Output Areas and Intermediate Zones,MSOAIZ,PL,11876,5467,8571,3847,4108,2269,4463,1578,119,51,1329,641,349,177,980,464,464,,,,1698,836,1578,776,22,6,92,49,6,5,60,159,92
E02004234,West Devon 006,Middle Super Output Areas and Intermediate Zones,MSOAIZ,PL,5983,2630,4854,2133,2571,1333,2283,800,23,10,507,221,143,64,364,157,157,,,,541,233,461,195,2,2,63,30,15,6,38,58,33
E02004235,West Devon 007,Middle Super Output Areas and Intermediate Zones,MSOAIZ,PL,6229,2765,4800,2103,2402,1248,2398,855,33,16,599,275,152,66,447,209,209,,,,739,335,579,270,62,19,66,34,32,12,65,58,36
E02004236,Christchurch 001,Middle Super Output Areas and Intermediate Zones,MSOAIZ,BH,5723,2440,4463,1910,1950,1026,2513,884,66,22,540,249,31,13,509,236,236,,,,599,233,542,209,4,3,48,18,5,3,24,55,26
E02004237,Christchurch 002,Middle Super Output Areas and Intermediate Zones,MSOAIZ,BH,7688,3105,6130,2462,2574,1350,3556,1112,52,20,829,363,50,20,779,343,343,,,,631,231,562,208,3,1,63,20,3,2,23,46,29
E02004238,Christchurch 003,Middle Super Output Areas and Intermediate Zones,MSOAIZ,BH,7015,3503,5637,2792,3458,2025,2179,767,28,23,474,281,96,43,378,238,238,,,,813,375,713,331,12,6,84,35,4,3,44,63,32
E02004239,Christchurch 004,Middle Super Output Areas and Intermediate Zones,MSOAIZ,BH,5552,2627,4872,2329,2674,1527,2198,802,45,21,90,41,4,2,86,39,39,,,,485,202,441,180,6,3,33,18,5,1,22,60,34
E02004240,Christchurch 005,Middle Super Output Areas and Intermediate Zones,MSOAIZ,BH,6072,2576,2881,1233,1048,577,1833,656,96,33,2566,1088,173,74,2393,1014,1014,,,,495,199,446,178,2,1,45,18,2,2,21,34,23
E02004241,Christchurch 006,Middle Super Output Areas and Intermediate Zones,MSOAIZ,BH,8925,4132,5878,2671,2619,1512,3259,1159,127,48,1081,603,76,41,1005,562,562,,,,1741,755,1594,699,30,10,107,42,10,4,56,98,55
E02004242,Christchurch 007,Middle Super Output Areas and Intermediate Zones,MSOAIZ,BH,6323,3092,5270,2570,3199,1797,2071,773,26,15,256,159,15,7,241,152,152,,,,734,326,706,310,2,1,24,13,2,2,16,37,22
E02004243,East Dorset 001,Middle Super Output Areas and Intermediate Zones,MSOAIZ,SP,6403,2605,4591,1867,1962,981,2629,886,10,5,679,268,48,22,631,246,246,,,,921,374,783,321,49,20,49,19,40,14,53,202,91
E02004244,East Dorset 002,Middle Super Output Areas and Intermediate Zones,MSOAIZ,BH,7207,3096,6379,2765,2637,1419,3742,1346,20,10,113,41,24,7,89,34,34,,,,646,254,590,220,0,0,52,30,4,4,34,49,26
E02004245,East Dorset 003,Middle Super Output Areas and Intermediate Zones,MSOAIZ,BH,7562,2965,5850,2316,2297,1164,3553,1152,13,7,1144,411,130,50,1014,361,361,,,,511,202,455,180,6,2,37,18,13,2,22,44,29
E02004246,East Dorset 004,Middle Super Output Areas and Intermediate Zones,MSOAIZ,BH,6660,3040,6061,2787,3624,1920,2437,867,5,4,120,57,3,2,117,55,55,,,,424,161,361,137,15,6,35,12,13,6,24,50,31
E02004247,East Dorset 005,Middle Super Output Areas and Intermediate Zones,MSOAIZ,SP,5877,2373,3999,1617,1952,931,2047,686,4,3,563,223,21,9,542,214,214,,,,1083,425,933,361,55,22,36,17,59,25,64,228,105
E02004248,East Dorset 006,Middle Super Output Areas and Intermediate Zones,MSOAIZ,BH,7414,3492,5990,2880,3497,1966,2493,914,20,11,717,320,70,34,647,286,286,,,,640,254,441,183,98,33,30,15,71,23,71,47,27
E02004249,East Dorset 007,Middle Super Output Areas and Intermediate Zones,MSOAIZ,BH,5393,2223,4756,1949,2215,1106,2541,843,12,4,325,152,27,11,298,141,141,,,,279,106,250,97,4,1,22,7,3,1,9,21,12
E02004250,East Dorset 008,Middle Super Output Areas and Intermediate Zones,MSOAIZ,BH,7547,3569,5494,2689,3213,1838,2281,851,41,21,1193,492,126,47,1067,445,445,,,,779,341,713,303,7,4,38,23,21,11,38,40,26
E02004251,East Dorset 009,Middle Super Output Areas and Intermediate Zones,MSOAIZ,BH,6277,2757,5407,2403,2465,1340,2942,1063,18,10,286,132,26,10,260,122,122,,,,523,192,467,174,16,4,40,14,0,0,18,43,20
E02004252,East Dorset 010,Middle Super Output Areas and Intermediate Zones,MSOAIZ,BH,6911,3422,4324,2088,2186,1301,2138,787,44,23,1318,702,99,56,1219,646,646,,,,1124,551,1045,512,18,7,37,23,24,9,39,101,58
E02004253,East Dorset 011,Middle Super Output Areas and Intermediate Zones,MSOAIZ,BH,8816,3944,7938,3575,4144,2268,3794,1307,12,6,152,62,27,8,125,54,54,,,,653,268,580,239,18,8,48,18,7,3,29,61,33
E02004254,East Dorset 012,Middle Super Output Areas and Intermediate Zones,MSOAIZ,BH,10126,4078,8519,3435,3495,1783,5024,1652,21,7,624,260,84,36,540,224,224,,,,897,343,800,301,15,5,72,32,10,5,42,65,33
E02004255,North Dorset 001,Middle Super Output Areas and Intermediate Zones,MSOAIZ,SP,7378,3399,5256,2411,2350,1333,2906,1078,52,22,985,452,82,35,903,417,417,,,,1025,482,945,442,3,3,73,33,4,4,40,60,32
E02004256,North Dorset 002,Middle Super Output Areas and Intermediate Zones,MSOAIZ,SP,9027,3769,6912,2930,3170,1612,3742,1318,155,61,686,252,68,17,618,235,235,,,,1155,461,1008,408,43,16,85,29,19,8,53,119,65
E02004257,North Dorset 003,Middle Super Output Areas and Intermediate Zones,MSOAIZ,SP,7139,3235,4946,2214,2108,1180,2838,1034,59,22,1103,491,68,30,1035,461,461,,,,965,468,887,426,11,4,58,34,9,4,42,66,40
E02004258,North Dorset 004,Middle Super Output Areas and Intermediate Zones,MSOAIZ,DT,10235,4545,7279,3242,3794,2004,3485,1238,95,39,1509,670,96,45,1413,625,625,,,,1251,535,1097,471,53,20,85,37,16,7,64,101,59
E02004259,North Dorset 005,Middle Super Output Areas and Intermediate Zones,MSOAIZ,SP,6257,2759,4531,2033,2465,1288,2066,745,35,12,898,372,63,31,835,341,341,,,,659,283,494,218,58,20,57,27,50,18,65,134,59
E02004260,North Dorset 006,Middle Super Output Areas and Intermediate Zones,MSOAIZ,SP,8178,3328,4494,1964,2185,1128,2309,836,44,17,950,379,63,28,887,351,351,,,,2438,858,963,382,965,303,70,27,440,146,476,252,110
E02004261,North Dorset 007,Middle Super Output Areas and Intermediate Zones,MSOAIZ,DT,9834,4438,6643,2888,2420,1324,4223,1564,81,30,1705,830,143,64,1562,766,766,,,,1330,647,1206,593,31,10,65,32,28,12,54,75,43
E02004262,North Dorset 008,Middle Super Output Areas and Intermediate Zones,MSOAIZ,DT,7524,3197,5398,2320,2852,1417,2546,903,29,14,1042,419,61,32,981,387,387,,,,852,360,730,307,37,14,56,27,29,12,53,203,84
E02004263,Purbeck 001,Middle Super Output Areas and Intermediate Zones,MSOAIZ,DT,5673,2463,4047,1707,1818,938,2229,769,38,12,687,355,160,79,527,276,276,,,,776,333,699,296,27,9,32,18,18,10,37,125,56
E02004264,Purbeck 002,Middle Super Output Areas and Intermediate Zones,MSOAIZ,BH,7983,3372,5946,2595,2470,1352,3476,1243,135,49,679,263,182,60,497,203,203,,,,1160,428,1035,381,20,6,95,37,10,4,47,63,37
E02004265,Purbeck 003,Middle Super Output Areas and Intermediate Zones,MSOAIZ,BH,8227,3690,5759,2589,3001,1619,2758,970,48,21,1227,556,230,96,997,460,460,,,,1118,478,993,425,53,19,65,30,7,4,53,75,46
E02004266,Purbeck 004,Middle Super Output Areas and Intermediate Zones,MSOAIZ,DT,8055,3313,4294,1905,2053,1086,2241,819,81,33,1396,531,262,95,1134,436,436,,,,2105,758,935,402,746,223,47,25,377,108,356,179,86
E02004267,Purbeck 005,Middle Super Output Areas and Intermediate Zones,MSOAIZ,BH,4978,2241,3459,1585,2125,1109,1334,476,72,25,530,225,100,32,430,193,193,,,,771,340,662,287,43,22,32,15,34,16,53,146,66
E02004268,Purbeck 006,Middle Super Output Areas and Intermediate Zones,MSOAIZ,BH,9418,4504,6676,3232,3901,2202,2775,1030,69,25,1163,516,219,82,944,434,434,,,,1403,668,1264,600,18,8,111,55,10,5,68,107,63
E02004269,West Dorset 001,Middle Super Output Areas and Intermediate Zones,MSOAIZ,DT,8420,4213,5099,2585,2899,1747,2200,838,47,23,1651,783,77,41,1574,742,742,,,,1390,704,1277,646,50,22,47,26,16,10,58,233,118
E02004270,West Dorset 002,Middle Super Output Areas and Intermediate Zones,MSOAIZ,DT,7371,3226,5359,2372,3082,1581,2277,791,50,21,706,297,44,17,662,280,280,,,,1059,442,916,390,69,24,44,17,30,11,52,197,94
E02004271,West Dorset 003,Middle Super Output Areas and Intermediate Zones,MSOAIZ,TA,9658,4408,6610,3060,3902,2069,2708,991,46,21,1283,558,67,37,1216,521,521,,,,1454,650,1261,573,80,30,99,41,14,6,77,265,119
E02004272,West Dorset 004,Middle Super Output Areas and Intermediate Zones,MSOAIZ,DT,11315,4925,8062,3488,4005,2034,4057,1454,148,55,1237,544,94,37,1143,507,507,,,,1570,699,1338,608,121,45,87,37,24,9,91,298,139
E02004273,West Dorset 005,Middle Super Output Areas and Intermediate Zones,MSOAIZ,TA,6893,3338,4963,2417,3171,1731,1792,686,71,29,996,465,43,18,953,447,447,,,,742,356,641,307,24,8,48,27,29,14,49,121,71
E02004274,West Dorset 006,Middle Super Output Areas and Intermediate Zones,MSOAIZ,DT,6383,3001,4379,2053,2325,1295,2054,758,31,15,1184,549,66,34,1118,515,515,,,,715,342,620,305,7,3,80,31,8,3,37,74,42
E02004275,West Dorset 007,Middle Super Output Areas and Intermediate Zones,MSOAIZ,DT,7386,3366,5533,2575,3548,1842,1985,733,79,30,635,268,38,18,597,250,250,,,,1008,428,846,358,48,18,88,39,26,13,70,131,65
E02004276,West Dorset 008,Middle Super Output Areas and Intermediate Zones,MSOAIZ,DT,5568,2813,3668,1861,2266,1317,1402,544,75,31,966,479,45,20,921,459,459,,,,794,410,721,371,9,7,52,25,12,7,39,65,32
E02004277,West Dorset 009,Middle Super Output Areas and Intermediate Zones,MSOAIZ,DT,9739,4573,5753,2691,2542,1492,3211,1199,118,63,2197,976,101,47,2096,929,929,,,,1566,778,1451,722,8,6,90,42,17,8,56,105,65
E02004278,West Dorset 010,Middle Super Output Areas and Intermediate Zones,MSOAIZ,DT,8750,3876,6461,2840,2951,1616,3510,1224,52,25,1160,535,46,18,1114,517,517,,,,1015,437,934,397,18,6,52,28,11,6,40,62,39
E02004279,West Dorset 011,Middle Super Output Areas and Intermediate Zones,MSOAIZ,DT,7539,3323,5622,2477,2781,1446,2841,1031,82,35,736,341,50,25,686,316,316,,,,915,378,778,323,65,27,60,23,12,5,55,184,92
E02004280,West Dorset 012,Middle Super Output Areas and Intermediate Zones,MSOAIZ,DT,7574,3324,5427,2404,2626,1393,2801,1011,59,22,791,364,114,55,677,309,309,,,,1161,469,1044,419,33,15,78,33,6,2,50,136,65
E02004281,Weymouth and Portland 001,Middle Super Output Areas and Intermediate Zones,MSOAIZ,DT,7295,3176,4277,1885,1539,832,2738,1053,67,29,1848,779,667,293,1181,486,486,,,,1030,445,940,404,14,4,73,36,3,1,41,73,38
E02004282,Weymouth and Portland 002,Middle Super Output Areas and Intermediate Zones,MSOAIZ,DT,8454,3912,7134,3297,3928,2140,3206,1157,32,16,221,127,62,32,159,95,95,,,,991,427,887,382,10,6,71,33,23,6,45,76,45
E02004283,Weymouth and Portland 003,Middle Super Output Areas and Intermediate Zones,MSOAIZ,DT,8582,3709,6293,2713,2892,1541,3401,1172,40,19,1267,583,436,197,831,386,386,,,,900,344,802,297,13,5,79,39,6,3,47,82,50
E02004284,Weymouth and Portland 004,Middle Super Output Areas and Intermediate Zones,MSOAIZ,DT,9121,4743,4331,2276,2370,1417,1961,859,74,32,1088,519,354,142,734,377,377,,,,3490,1822,3245,1702,32,14,154,84,59,22,120,138,94
E02004285,Weymouth and Portland 005,Middle Super Output Areas and Intermediate Zones,MSOAIZ,DT,7358,3299,4881,2098,1816,994,3065,1104,32,16,1135,570,387,199,748,371,371,,,,1255,574,1161,535,4,1,85,36,5,2,39,55,41
E02004286,Weymouth and Portland 006,Middle Super Output Areas and Intermediate Zones,MSOAIZ,DT,5140,2122,3648,1497,1486,751,2162,746,22,9,827,313,278,105,549,208,208,,,,612,281,557,258,2,2,50,20,3,1,23,31,22
E02004287,Weymouth and Portland 007,Middle Super Output Areas and Intermediate Zones,MSOAIZ,DT,5560,2399,4066,1771,1731,946,2335,825,12,8,710,300,217,88,493,212,212,,,,745,304,667,271,6,2,64,26,8,5,33,27,16
E02004288,Weymouth and Portland 008,Middle Super Output Areas and Intermediate Zones,MSOAIZ,DT,4674,2094,2546,1177,1130,618,1416,559,17,8,1140,468,417,160,723,308,308,,,,950,427,871,393,7,3,61,25,11,6,34,21,14
E02004289,Weymouth and Portland 009,Middle Super Output Areas and Intermediate Zones,MSOAIZ,DT,7189,3081,5395,2347,2139,1182,3256,1165,54,24,617,235,211,77,406,158,158,,,,1078,449,976,409,4,1,67,28,31,11,40,45,26
E02004290,County Durham 002,Middle Super Output Areas and Intermediate Zones,MSOAIZ,DH,5981,2518,5188,2135,1745,904,3443,1231,1,1,328,178,88,48,240,130,130,,,,431,189,369,161,4,1,58,27,0,0,28,33,15
E02004291,County Durham 005,Middle Super Output Areas and Intermediate Zones,MSOAIZ,DH,6702,3131,4376,1946,1414,771,2962,1175,25,9,1373,714,577,296,796,418,418,,,,887,434,830,404,0,0,44,23,13,7,30,41,28
E02004292,County Durham 007,Middle Super Output Areas and Intermediate Zones,MSOAIZ,NE,7916,3523,6468,2800,2839,1510,3629,1290,31,18,668,365,256,131,412,234,234,,,,682,303,599,268,11,3,71,31,1,1,35,67,37
E02004293,County Durham 011,Middle Super Output Areas and Intermediate Zones,MSOAIZ,DH,9278,4412,5168,2221,1504,833,3664,1388,53,29,3106,1741,1196,669,1910,1072,1072,,,,875,380,784,331,2,1,72,34,17,14,49,76,41
E02004294,County Durham 013,Middle Super Output Areas and Intermediate Zones,MSOAIZ,DH,8421,3655,7515,3208,2940,1533,4575,1675,14,5,71,36,28,13,43,23,23,,,,766,375,702,340,2,1,61,33,1,1,35,55,31
E02004295,County Durham 015,Middle Super Output Areas and Intermediate Zones,MSOAIZ,DH,7459,3213,5577,2297,2039,1026,3538,1271,8,5,1084,573,393,203,691,370,370,,,,732,305,678,278,0,0,41,22,13,5,27,58,33
E02004296,County Durham 019,Middle Super Output Areas and Intermediate Zones,MSOAIZ,DH,7936,3529,5564,2352,1918,983,3646,1369,15,7,1674,843,714,351,960,492,492,,,,618,289,559,260,4,2,51,24,4,3,29,65,38
E02004297,County Durham 001,Middle Super Output Areas and Intermediate Zones,MSOAIZ,NE,7825,3550,6344,2747,2275,1184,4069,1563,17,10,738,431,413,224,325,207,207,,,,662,323,594,287,2,1,62,32,4,3,36,64,39
E02004298,County Durham 003,Middle Super Output Areas and Intermediate Zones,MSOAIZ,NE,9486,4178,7642,3276,3079,1607,4563,1669,5,3,960,472,488,214,472,258,258,,,,818,388,732,344,1,1,78,39,7,4,44,61,39
E02004299,County Durham 004,Middle Super Output Areas and Intermediate Zones,MSOAIZ,NE,8352,3758,5956,2546,2128,1090,3828,1456,4,2,1274,689,734,365,540,324,324,,,,1078,490,957,438,5,2,101,42,15,8,52,40,31
E02004300,County Durham 006,Middle Super Output Areas and Intermediate Zones,MSOAIZ,NE,7663,3491,4694,2016,1766,927,2928,1089,11,5,1935,1039,1112,585,823,454,454,,,,989,408,927,375,0,0,55,29,7,4,33,34,23
E02004301,County Durham 008,Middle Super Output Areas and Intermediate Zones,MSOAIZ,DH,8770,3913,4682,1985,1504,798,3178,1187,7,3,2968,1424,1744,837,1224,587,587,,,,1053,462,962,421,2,1,69,33,20,7,41,60,39
E02004302,County Durham 009,Middle Super Output Areas and Intermediate Zones,MSOAIZ,DH,7692,3530,5230,2290,2037,1072,3193,1218,7,3,723,411,321,165,402,246,246,,,,1672,787,1527,725,0,0,126,52,19,10,62,60,39
E02004303,County Durham 010,Middle Super Output Areas and Intermediate Zones,MSOAIZ,DH,11304,5253,8335,3693,2885,1590,5450,2103,34,22,833,542,271,165,562,377,377,,,,2002,938,1847,850,17,6,125,70,13,12,88,100,58
E02004304,County Durham 012,Middle Super Output Areas and Intermediate Zones,MSOAIZ,DH,8770,3896,6280,2727,2116,1176,4164,1551,3,2,1310,663,646,296,664,367,367,,,,1102,464,1005,419,1,1,84,36,12,8,45,75,40
E02004305,County Durham 014,Middle Super Output Areas and Intermediate Zones,MSOAIZ,DH,8607,3816,5561,2336,1876,985,3685,1351,4,3,1986,1008,809,403,1177,605,605,,,,978,423,878,373,7,4,72,36,21,10,50,78,46
E02004306,County Durham 020,Middle Super Output Areas and Intermediate Zones,MSOAIZ,DL,5785,2681,4583,2085,2176,1158,2407,927,6,3,672,355,355,190,317,165,165,,,,453,198,390,168,16,6,43,23,4,1,30,71,40
E02004307,County Durham 024,Middle Super Output Areas and Intermediate Zones,MSOAIZ,DL,6458,2878,4663,2030,1776,953,2887,1077,45,20,984,475,449,225,535,250,250,,,,715,320,651,286,2,2,60,31,2,1,34,51,33
E02004308,County Durham 022,Middle Super Output Areas and Intermediate Zones,MSOAIZ,DH,6763,2987,5977,2582,2568,1333,3409,1249,21,12,156,84,56,27,100,57,57,,,,566,284,495,249,4,1,59,31,8,3,35,43,25
E02004309,County Durham 023,Middle Super Output Areas and Intermediate Zones,MSOAIZ,DH,5842,2769,3897,1756,1437,797,2460,959,13,7,1084,609,890,491,194,118,118,,,,823,382,750,349,4,1,51,25,18,7,33,25,15
E02004310,County Durham 026,Middle Super Output Areas and Intermediate Zones,MSOAIZ,DH,7895,3526,5287,2253,1868,963,3419,1290,11,6,1741,899,1541,789,200,110,110,,,,798,338,699,294,3,1,86,37,10,6,44,58,30
E02004311,County Durham 027,Middle Super Output Areas and Intermediate Zones,MSOAIZ,DH,9072,4118,6452,2780,2336,1200,4116,1580,47,18,1853,986,1687,877,166,109,109,,,,661,302,581,263,6,2,65,31,9,6,39,59,32
E02004312,County Durham 028,Middle Super Output Areas and Intermediate Zones,MSOAIZ,DH,7492,3409,6518,2901,3285,1702,3233,1199,2,2,263,151,247,140,16,11,11,,,,656,326,600,294,2,2,51,28,3,2,32,53,29
E02004313,County Durham 029,Middle Super Output Areas and Intermediate Zones,MSOAIZ,DH,6671,2957,2465,1118,1151,595,1314,523,33,9,2513,1159,1280,640,1233,519,519,,,,1634,653,1551,616,8,2,58,27,17,8,37,26,18
E02004314,County Durham 030,Middle Super Output Areas and Intermediate Zones,MSOAIZ,DH,6044,2363,1457,754,865,504,592,250,30,10,579,387,381,260,198,127,127,,,,3813,1136,3653,1068,41,19,73,27,46,22,68,165,76
E02004315,County Durham 033,Middle Super Output Areas and Intermediate Zones,MSOAIZ,DH,9750,3845,6694,2767,2900,1444,3794,1323,21,7,174,79,97,41,77,38,38,,,,2772,953,2648,904,10,4,100,37,14,8,49,89,39
E02004316,County Durham 031,Middle Super Output Areas and Intermediate Zones,MSOAIZ,DL,5683,2644,3874,1742,1455,785,2419,957,28,12,1023,542,870,465,153,77,77,,,,712,319,634,285,0,0,74,32,4,2,34,46,29
E02004317,County Durham 038,Middle Super Output Areas and Intermediate Zones,MSOAIZ,DL,7590,3554,4578,1948,1673,856,2905,1092,2,2,2293,1283,1948,1051,345,232,232,,,,653,281,582,250,2,2,69,29,0,0,31,64,40
E02004318,County Durham 041,Middle Super Output Areas and Intermediate Zones,MSOAIZ,DH,5968,2666,4248,1823,1655,845,2593,978,23,11,915,480,720,391,195,89,89,,,,727,321,674,293,1,1,51,26,1,1,28,55,31
E02004319,County Durham 044,Middle Super Output Areas and Intermediate Zones,MSOAIZ,TS,7456,3293,5375,2254,1962,988,3413,1266,1,1,1400,724,1260,655,140,69,69,,,,633,289,555,251,4,2,58,31,16,5,38,47,25
E02004320,County Durham 016,Middle Super Output Areas and Intermediate Zones,MSOAIZ,SR,8858,3851,7023,2890,2392,1194,4631,1696,12,5,897,551,754,449,143,102,102,,,,832,337,737,293,13,7,79,36,3,1,44,94,68
E02004321,County Durham 017,Middle Super Output Areas and Intermediate Zones,MSOAIZ,SR,8192,3662,5763,2438,2247,1132,3516,1306,4,3,849,540,680,417,169,123,123,,,,1512,635,1394,585,5,3,111,46,2,1,50,64,46
E02004322,County Durham 018,Middle Super Output Areas and Intermediate Zones,MSOAIZ,SR,8436,3769,4044,1716,1485,782,2559,934,5,3,3492,1634,2891,1326,601,308,308,,,,791,345,686,301,5,2,83,33,17,9,44,104,71
E02004323,County Durham 021,Middle Super Output Areas and Intermediate Zones,MSOAIZ,SR,7802,3337,5688,2369,2095,1047,3593,1322,7,4,889,456,629,321,260,135,135,,,,1142,462,1073,429,9,4,51,26,9,3,33,76,46
E02004324,County Durham 025,Middle Super Output Areas and Intermediate Zones,MSOAIZ,SR,5732,2588,4094,1766,1681,864,2413,902,3,1,633,345,275,166,358,179,179,,,,956,445,890,409,0,0,50,29,16,7,36,46,31
E02004325,County Durham 032,Middle Super Output Areas and Intermediate Zones,MSOAIZ,SR,8532,3722,4575,1858,1425,753,3150,1105,17,12,2806,1377,2565,1231,241,146,146,,,,1033,404,968,375,0,0,57,26,8,3,29,101,71
E02004326,County Durham 034,Middle Super Output Areas and Intermediate Zones,MSOAIZ,SR,6144,2713,4028,1669,1556,798,2472,871,8,5,1395,714,1013,501,382,213,213,,,,640,275,562,246,0,0,76,27,2,2,29,73,50
E02004327,County Durham 036,Middle Super Output Areas and Intermediate Zones,MSOAIZ,SR,6302,2913,3890,1683,1650,860,2240,823,15,5,1182,672,575,321,607,351,351,,,,1128,498,1052,461,0,0,66,29,10,8,37,87,55
E02004328,County Durham 035,Middle Super Output Areas and Intermediate Zones,MSOAIZ,SR,7336,3115,4869,1975,1481,772,3388,1203,12,5,1552,789,1425,721,127,68,68,,,,834,298,774,271,3,1,55,25,2,1,27,69,48
E02004329,County Durham 037,Middle Super Output Areas and Intermediate Zones,MSOAIZ,SR,6689,2807,5252,2116,1790,878,3462,1238,11,4,865,470,766,417,99,53,53,,,,500,181,449,156,1,1,41,18,9,6,25,61,36
E02004330,County Durham 039,Middle Super Output Areas and Intermediate Zones,MSOAIZ,TS,5904,2742,4257,1873,1871,1016,2386,857,3,3,932,520,584,315,348,205,205,,,,677,320,615,288,2,2,45,21,15,9,32,35,26
E02004331,County Durham 040,Middle Super Output Areas and Intermediate Zones,MSOAIZ,TS,6986,3084,4563,1921,1781,918,2782,1003,4,2,1567,784,1238,621,329,163,163,,,,740,311,693,291,10,3,35,16,2,1,20,112,66
E02004332,County Durham 043,Middle Super Output Areas and Intermediate Zones,MSOAIZ,TS,7250,3113,5340,2200,2025,984,3315,1216,12,4,1068,538,1000,499,68,39,39,,,,742,316,663,281,14,4,62,29,3,2,35,88,55
E02004333,County Durham 047,Middle Super Output Areas and Intermediate Zones,MSOAIZ,DL,7181,3195,5672,2446,2414,1250,3258,1196,19,11,990,511,528,269,462,242,242,,,,448,198,383,167,2,2,59,26,4,3,31,52,29
E02004334,County Durham 048,Middle Super Output Areas and Intermediate Zones,MSOAIZ,TS,7351,3192,5116,2111,1727,894,3389,1217,7,5,1391,721,1002,504,389,217,217,,,,805,331,722,301,10,2,68,25,5,3,30,32,24
E02004335,County Durham 049,Middle Super Output Areas and Intermediate Zones,MSOAIZ,DL,6268,2929,3164,1375,1213,643,1951,732,17,10,2075,1029,1297,588,778,441,441,,,,967,485,916,459,0,0,47,23,4,3,26,45,30
E02004336,County Durham 050,Middle Super Output Areas and Intermediate Zones,MSOAIZ,DL,6792,3264,4135,1790,1584,828,2551,962,8,3,1741,1028,1307,727,434,301,301,,,,855,411,768,367,1,1,65,32,21,11,44,53,32
E02004337,County Durham 052,Middle Super Output Areas and Intermediate Zones,MSOAIZ,DL,9058,4037,6377,2691,2386,1215,3991,1476,10,5,1529,832,900,484,629,348,348,,,,1042,452,968,414,0,0,60,31,14,7,38,100,57
E02004338,County Durham 053,Middle Super Output Areas and Intermediate Zones,MSOAIZ,DL,6725,3029,4554,1920,1706,878,2848,1042,16,8,1122,624,749,401,373,223,223,,,,976,446,903,411,15,6,55,27,3,2,35,57,31
E02004339,County Durham 054,Middle Super Output Areas and Intermediate Zones,MSOAIZ,TS,6821,2997,5634,2364,2546,1263,3088,1101,8,5,521,306,333,186,188,120,120,,,,595,289,523,262,15,5,50,20,7,2,27,63,33
E02004340,County Durham 059,Middle Super Output Areas and Intermediate Zones,MSOAIZ,DL,10239,4812,6095,2690,2358,1291,3737,1399,7,5,2300,1250,1521,815,779,435,435,,,,1735,808,1636,756,2,2,82,43,15,7,52,102,59
E02004341,County Durham 060,Middle Super Output Areas and Intermediate Zones,MSOAIZ,DL,8335,3474,7043,2859,2177,1096,4866,1763,23,10,545,295,283,133,262,162,162,,,,699,291,644,266,4,2,42,18,9,5,25,25,19
E02004342,County Durham 061,Middle Super Output Areas and Intermediate Zones,MSOAIZ,DL,5839,2401,2217,892,554,274,1663,618,27,11,2469,1099,1867,782,602,317,317,,,,1095,383,1018,354,0,0,75,28,2,1,29,31,16
E02004343,County Durham 062,Middle Super Output Areas and Intermediate Zones,MSOAIZ,DL,5441,2492,3520,1493,1131,615,2389,878,13,11,1344,759,894,490,450,269,269,,,,528,204,451,169,1,1,68,30,8,4,35,36,25
E02004344,County Durham 063,Middle Super Output Areas and Intermediate Zones,MSOAIZ,DL,7034,3244,4570,2034,1823,994,2747,1040,5,4,1668,871,1133,575,535,296,296,,,,753,309,672,268,9,5,65,33,7,3,41,38,26
E02004345,County Durham 064,Middle Super Output Areas and Intermediate Zones,MSOAIZ,DL,12608,5755,9135,4036,4619,2355,4516,1681,25,15,1428,750,420,205,1008,545,545,,,,1753,816,1570,736,33,14,121,52,29,14,80,267,138
E02004346,County Durham 065,Middle Super Output Areas and Intermediate Zones,MSOAIZ,DL,5225,2344,3501,1537,2093,1015,1408,522,33,12,322,156,79,36,243,120,120,,,,1164,539,1047,481,24,11,77,38,16,9,58,205,100
E02004347,County Durham 066,Middle Super Output Areas and Intermediate Zones,MSOAIZ,DL,6240,3012,4382,2026,2258,1243,2124,783,21,13,902,497,81,37,821,460,460,,,,845,422,753,379,3,3,69,36,20,4,43,90,54
E02004348,County Durham 042,Middle Super Output Areas and Intermediate Zones,MSOAIZ,DL,8016,3700,6087,2718,3031,1591,3056,1127,24,10,741,410,479,279,262,131,131,,,,959,457,807,386,19,8,117,55,16,8,71,205,105
E02004349,County Durham 045,Middle Super Output Areas and Intermediate Zones,MSOAIZ,DL,9189,4081,5607,2354,2161,1117,3446,1237,3,2,2516,1259,1473,707,1043,552,552,,,,961,403,878,359,3,2,73,38,7,4,44,102,63
E02004350,County Durham 046,Middle Super Output Areas and Intermediate Zones,MSOAIZ,DL,9489,4378,7409,3278,3017,1599,4392,1679,9,7,622,381,391,233,231,148,148,,,,1345,646,1203,571,19,10,114,58,9,7,75,104,66
E02004351,County Durham 051,Middle Super Output Areas and Intermediate Zones,MSOAIZ,DL,6909,3135,3919,1661,1539,784,2380,877,2,1,2200,1127,1700,864,500,263,263,,,,735,308,659,271,13,4,62,32,1,1,37,53,38
E02004352,County Durham 055,Middle Super Output Areas and Intermediate Zones,MSOAIZ,DL,7405,3409,4949,2184,1942,1038,3007,1146,36,24,586,348,410,225,176,123,123,,,,1775,816,1659,747,7,6,92,52,17,11,69,59,37
E02004353,County Durham 056,Middle Super Output Areas and Intermediate Zones,MSOAIZ,DL,7431,3313,6247,2725,2690,1425,3557,1300,2,1,229,134,34,19,195,115,115,,,,885,410,830,382,0,0,54,27,1,1,28,68,43
E02004354,County Durham 057,Middle Super Output Areas and Intermediate Zones,MSOAIZ,DL,8697,3891,6298,2684,2329,1192,3969,1492,6,6,1201,639,1067,567,134,72,72,,,,1114,518,1012,467,9,3,87,43,6,5,51,78,44
E02004355,County Durham 058,Middle Super Output Areas and Intermediate Zones,MSOAIZ,DL,7201,3247,3852,1637,1335,725,2517,912,9,6,2554,1246,1914,921,640,325,325,,,,719,313,679,295,6,2,30,15,4,1,18,67,45
E02004356,Eastbourne 001,Middle Super Output Areas and Intermediate Zones,MSOAIZ,BN,7479,3009,4192,1791,1402,773,2790,1018,148,60,2128,756,1507,550,621,206,206,,,,959,370,894,342,2,2,63,26,0,0,28,52,32
E02004357,Eastbourne 002,Middle Super Output Areas and Intermediate Zones,MSOAIZ,BN,7689,3050,4193,1748,1461,773,2732,975,52,19,2037,816,1033,403,1004,413,413,,,,1361,443,1319,426,0,0,41,16,1,1,17,46,24
E02004358,Eastbourne 003,Middle Super Output Areas and Intermediate Zones,MSOAIZ,BN,7771,3537,5152,2393,2330,1321,2822,1072,40,19,1637,750,1093,564,544,186,186,,,,873,330,780,298,3,1,78,27,12,4,32,69,45
E02004359,Eastbourne 004,Middle Super Output Areas and Intermediate Zones,MSOAIZ,BN,7790,3484,5091,2232,2357,1260,2734,972,28,11,1532,789,1019,514,513,275,275,,,,1084,415,1006,380,5,2,69,31,4,2,35,55,37
E02004361,Eastbourne 006,Middle Super Output Areas and Intermediate Zones,MSOAIZ,BN,7874,3330,6029,2529,2658,1389,3371,1140,14,5,1057,489,906,404,151,85,85,,,,720,278,670,262,11,3,27,10,12,3,16,54,29
E02004362,Eastbourne 007,Middle Super Output Areas and Intermediate Zones,MSOAIZ,BN,8684,3585,6049,2457,2025,1083,4024,1374,38,21,646,315,250,110,396,205,205,,,,1895,757,1753,699,13,4,119,49,10,5,58,56,35
E02004363,Eastbourne 008,Middle Super Output Areas and Intermediate Zones,MSOAIZ,BN,6203,3280,3846,1893,1781,1039,2065,854,19,11,293,236,50,34,243,202,202,,,,1989,1112,1707,952,140,68,66,36,76,56,160,56,28
E02004364,Eastbourne 009,Middle Super Output Areas and Intermediate Zones,MSOAIZ,BN,8041,3908,5593,2620,2452,1436,3141,1184,38,17,660,452,341,202,319,250,250,,,,1689,783,1552,716,8,2,119,58,10,7,67,61,36
E02004365,Eastbourne 010,Middle Super Output Areas and Intermediate Zones,MSOAIZ,BN,7342,3590,2325,1170,844,508,1481,662,82,42,611,389,306,207,305,182,182,,,,4265,1952,4082,1864,57,26,105,50,21,12,88,59,37
E02004366,Eastbourne 011,Middle Super Output Areas and Intermediate Zones,MSOAIZ,BN,6321,3758,2821,1781,1743,1213,1078,568,41,28,220,135,98,50,122,85,85,,,,3092,1730,2886,1615,84,42,100,63,22,10,115,147,84
E02004367,Eastbourne 012,Middle Super Output Areas and Intermediate Zones,MSOAIZ,BN,6333,3401,4825,2602,3085,1898,1740,704,16,8,237,151,89,43,148,108,108,,,,1176,594,1122,563,17,8,32,18,5,5,31,79,46
E02004368,Hastings 001,Middle Super Output Areas and Intermediate Zones,MSOAIZ,TN,7987,3253,6172,2494,2006,1063,4166,1431,50,19,600,295,109,48,491,247,247,,,,1094,414,978,354,25,12,74,38,17,10,60,71,31
E02004369,Hastings 002,Middle Super Output Areas and Intermediate Zones,MSOAIZ,TN,9473,4206,8165,3606,4032,2194,4133,1412,25,10,392,237,48,21,344,216,216,,,,835,322,750,290,8,3,64,23,13,6,32,56,31
E02004370,Hastings 003,Middle Super Output Areas and Intermediate Zones,MSOAIZ,TN,7698,3223,3269,1310,945,494,2324,816,36,12,3362,1528,484,224,2878,1304,1304,,,,970,340,899,313,5,1,51,21,15,5,27,61,33
E02004371,Hastings 004,Middle Super Output Areas and Intermediate Zones,MSOAIZ,TN,6944,3007,4236,1862,1598,870,2638,992,34,16,1094,462,202,87,892,375,375,,,,1529,641,1465,608,3,1,52,27,9,5,33,51,26
E02004372,Hastings 005,Middle Super Output Areas and Intermediate Zones,MSOAIZ,TN,6495,2801,2528,1101,834,475,1694,626,19,9,2494,1066,401,172,2093,894,894,,,,1423,604,1340,564,4,2,76,35,3,3,40,31,21
E02004373,Hastings 006,Middle Super Output Areas and Intermediate Zones,MSOAIZ,TN,8481,3638,5624,2366,2034,1085,3590,1281,66,34,1145,514,118,49,1027,465,465,,,,1564,676,1425,614,7,4,116,49,16,9,62,82,48
E02004374,Hastings 007,Middle Super Output Areas and Intermediate Zones,MSOAIZ,TN,7648,3530,4705,2137,1900,1067,2805,1070,34,14,713,319,101,43,612,276,276,,,,2109,1006,1976,947,12,4,105,44,16,11,59,87,54
E02004375,Hastings 008,Middle Super Output Areas and Intermediate Zones,MSOAIZ,TN,8341,3973,4562,2016,1784,964,2778,1052,22,9,582,286,54,21,528,265,265,,,,3099,1625,2956,1544,20,11,108,59,15,11,81,76,37
E02004376,Hastings 009,Middle Super Output Areas and Intermediate Zones,MSOAIZ,TN,6916,3793,2516,1327,1023,649,1493,678,50,19,587,320,53,21,534,299,299,,,,3700,2086,3540,2001,42,14,95,60,23,11,85,63,41
E02004377,Hastings 010,Middle Super Output Areas and Intermediate Zones,MSOAIZ,TN,9979,4480,6867,3042,2485,1420,4382,1622,47,30,763,308,74,26,689,282,282,,,,2257,1073,2090,997,29,8,115,57,23,11,76,45,27
E02004378,Hastings 011,Middle Super Output Areas and Intermediate Zones,MSOAIZ,TN,8600,5255,2335,1445,1073,790,1262,655,28,21,1128,653,88,51,1040,602,602,,,,4997,3076,4815,2959,24,12,122,86,36,19,117,112,60
E02004379,Lewes 001,Middle Super Output Areas and Intermediate Zones,MSOAIZ,TN,7540,3008,5661,2228,2355,1121,3306,1107,90,35,954,391,664,280,290,111,111,,,,743,305,602,253,44,16,81,31,16,5,52,92,49
E02004380,Lewes 002,Middle Super Output Areas and Intermediate Zones,MSOAIZ,RH,8451,3491,6750,2748,3258,1607,3492,1141,38,12,559,245,446,202,113,43,43,,,,934,400,804,346,40,17,74,29,16,8,54,170,86
E02004381,Lewes 003,Middle Super Output Areas and Intermediate Zones,MSOAIZ,BN,9547,4363,5869,2622,2437,1356,3432,1266,83,32,1873,859,1631,739,242,120,120,,,,1593,778,1474,713,13,9,82,45,24,11,65,129,72
E02004382,Lewes 004,Middle Super Output Areas and Intermediate Zones,MSOAIZ,TN,6361,2769,4082,1784,1996,1058,2086,726,55,22,882,403,394,181,488,222,222,,,,1177,483,1069,439,33,13,51,21,24,10,44,165,77
E02004383,Lewes 005,Middle Super Output Areas and Intermediate Zones,MSOAIZ,BN,7369,3094,5472,2255,2425,1242,3047,1013,17,10,926,432,823,345,103,87,87,,,,907,373,824,338,6,4,74,29,3,2,35,47,24
E02004384,Lewes 006,Middle Super Output Areas and Intermediate Zones,MSOAIZ,BN,7375,3161,6088,2560,2236,1225,3852,1335,35,15,267,155,114,64,153,91,91,,,,958,416,868,378,4,1,75,33,11,4,38,27,15
E02004385,Lewes 007,Middle Super Output Areas and Intermediate Zones,MSOAIZ,BN,7585,3421,5903,2588,2428,1316,3475,1272,53,20,327,201,189,115,138,86,86,,,,1242,576,1127,518,2,1,108,53,5,4,58,60,36
E02004386,Lewes 008,Middle Super Output Areas and Intermediate Zones,MSOAIZ,BN,6235,2784,4557,2062,2011,1104,2546,958,37,15,390,174,280,116,110,58,58,,,,1198,507,1088,465,15,7,73,30,22,5,42,53,26
E02004387,Lewes 009,Middle Super Output Areas and Intermediate Zones,MSOAIZ,BN,5928,2468,3479,1441,952,516,2527,925,59,24,1143,494,916,379,227,115,115,,,,1207,485,1152,462,0,0,55,23,0,0,23,40,24
E02004388,Lewes 010,Middle Super Output Areas and Intermediate Zones,MSOAIZ,BN,6382,2828,4437,1971,1860,1040,2577,931,100,50,897,420,458,213,439,207,207,,,,910,364,822,329,8,3,65,25,15,7,35,38,23
E02004389,Lewes 011,Middle Super Output Areas and Intermediate Zones,MSOAIZ,BN,9219,4180,7912,3617,4173,2282,3739,1335,68,27,285,137,153,76,132,61,61,,,,900,366,837,334,2,1,56,28,5,3,32,54,33
E02004390,Lewes 012,Middle Super Output Areas and Intermediate Zones,MSOAIZ,BN,7834,3473,6216,2810,3234,1768,2982,1042,45,16,946,416,760,328,186,88,88,,,,574,201,517,177,2,2,54,21,1,1,24,53,30
E02004391,Lewes 013,Middle Super Output Areas and Intermediate Zones,MSOAIZ,BN,6054,3141,3904,1962,1852,1162,2052,800,13,7,450,282,262,158,188,124,124,,,,1638,854,1532,805,10,4,83,38,13,7,49,49,36
E02004392,Rother 001,Middle Super Output Areas and Intermediate Zones,MSOAIZ,TN,8907,3639,6927,2778,2794,1380,4133,1398,79,30,956,417,138,64,818,353,353,,,,823,352,721,306,26,11,68,32,8,3,46,122,62
E02004393,Rother 002,Middle Super Output Areas and Intermediate Zones,MSOAIZ,TN,6042,2763,4429,2007,2371,1250,2058,757,26,13,852,395,106,52,746,343,343,,,,621,285,534,241,39,20,36,18,12,6,44,114,63
E02004394,Rother 003,Middle Super Output Areas and Intermediate Zones,MSOAIZ,TN,7571,3195,5932,2468,2752,1392,3180,1076,18,8,703,316,118,54,585,262,262,,,,767,333,672,290,27,14,54,22,14,7,43,151,70
E02004395,Rother 004,Middle Super Output Areas and Intermediate Zones,MSOAIZ,TN,7552,3642,4952,2421,2636,1521,2316,900,50,22,1341,602,277,116,1064,486,486,,,,1091,516,926,426,86,43,56,31,23,16,90,118,81
E02004396,Rother 005,Middle Super Output Areas and Intermediate Zones,MSOAIZ,TN,8446,3815,7082,3234,3958,2119,3124,1115,46,20,547,240,99,39,448,201,201,,,,668,268,591,235,7,3,50,21,20,9,33,103,53
E02004397,Rother 006,Middle Super Output Areas and Intermediate Zones,MSOAIZ,TN,7790,3362,5774,2427,2681,1388,3093,1039,32,13,818,390,167,82,651,308,308,,,,1062,478,949,421,15,8,87,42,11,7,57,104,54
E02004398,Rother 007,Middle Super Output Areas and Intermediate Zones,MSOAIZ,TN,8631,3679,4510,1943,1660,937,2850,1006,69,35,2505,1115,527,212,1978,903,903,,,,1479,540,1344,491,10,6,114,37,11,6,49,68,46
E02004399,Rother 008,Middle Super Output Areas and Intermediate Zones,MSOAIZ,TN,7342,3572,5541,2795,2960,1790,2581,1005,43,18,566,227,85,28,481,199,199,,,,1120,488,1051,454,4,3,65,31,0,0,34,72,44
E02004400,Rother 009,Middle Super Output Areas and Intermediate Zones,MSOAIZ,TN,10013,4697,8996,4272,5328,2962,3668,1310,41,20,218,92,72,28,146,64,64,,,,696,280,646,258,12,5,35,14,3,3,22,62,33
E02004401,Rother 010,Middle Super Output Areas and Intermediate Zones,MSOAIZ,TN,7548,3801,6222,3139,3703,2192,2519,947,31,17,352,217,21,17,331,200,200,,,,869,379,787,335,0,0,77,41,5,3,44,74,49
E02004402,Rother 011,Middle Super Output Areas and Intermediate Zones,MSOAIZ,TN,8307,4712,4577,2576,2445,1623,2132,953,40,23,337,231,37,20,300,211,211,,,,3264,1823,3102,1733,14,7,120,71,28,12,90,89,59
E02004403,Wealden 001,Middle Super Output Areas and Intermediate Zones,MSOAIZ,TN,6330,2623,4720,1895,2058,994,2662,901,14,7,443,216,315,163,128,53,53,,,,948,412,871,377,31,15,44,18,2,2,35,205,93
E02004404,Wealden 002,Middle Super Output Areas and Intermediate Zones,MSOAIZ,TN,6407,2570,5178,2032,2254,1061,2924,971,21,15,388,154,226,96,162,58,58,,,,673,290,600,258,19,8,42,19,12,5,32,147,79
E02004405,Wealden 003,Middle Super Output Areas and Intermediate Zones,MSOAIZ,TN,5801,2342,4677,1914,1952,1030,2725,884,158,60,396,140,117,45,279,95,95,,,,516,205,492,188,1,1,21,14,2,2,17,54,23
E02004406,Wealden 004,Middle Super Output Areas and Intermediate Zones,MSOAIZ,TN,6864,2988,5924,2510,2682,1405,3242,1105,49,23,173,109,17,6,156,103,103,,,,672,322,589,275,9,5,58,31,16,11,47,46,24
E02004407,Wealden 005,Middle Super Output Areas and Intermediate Zones,MSOAIZ,TN,7642,3295,6083,2546,2784,1427,3299,1119,12,7,560,273,316,166,244,107,107,,,,820,379,747,340,14,9,53,27,6,3,39,167,90
E02004408,Wealden 006,Middle Super Output Areas and Intermediate Zones,MSOAIZ,TN,7637,3126,5486,2220,1786,927,3700,1293,113,44,1088,452,727,335,361,117,117,,,,888,374,804,337,6,2,69,31,9,4,37,62,36
E02004409,Wealden 007,Middle Super Output Areas and Intermediate Zones,MSOAIZ,TN,5223,2189,4325,1778,2072,1002,2253,776,15,6,204,93,158,75,46,18,18,,,,546,245,469,210,25,13,37,13,15,9,35,133,67
E02004410,Wealden 008,Middle Super Output Areas and Intermediate Zones,MSOAIZ,TN,7725,3153,6475,2590,2902,1382,3573,1208,43,25,420,206,265,151,155,55,55,,,,649,262,583,233,13,5,39,19,14,5,29,138,70
E02004411,Wealden 009,Middle Super Output Areas and Intermediate Zones,MSOAIZ,TN,8479,3668,6444,2728,2396,1313,4048,1415,78,29,862,431,566,306,296,125,125,,,,1033,432,973,403,3,2,55,25,2,2,29,62,48
E02004412,Wealden 010,Middle Super Output Areas and Intermediate Zones,MSOAIZ,TN,7699,3330,6008,2527,2370,1269,3638,1258,82,38,493,228,388,187,105,41,41,,,,1053,500,971,455,6,4,65,37,11,4,45,63,37
E02004413,Wealden 011,Middle Super Output Areas and Intermediate Zones,MSOAIZ,TN,6658,2806,5512,2267,2424,1203,3088,1064,38,25,400,184,233,116,167,68,68,,,,632,286,575,261,8,6,38,14,11,5,25,76,44
E02004414,Wealden 012,Middle Super Output Areas and Intermediate Zones,MSOAIZ,TN,5928,2409,4699,1873,1380,710,3319,1163,47,18,442,186,173,76,269,110,110,,,,678,302,639,281,1,1,28,15,10,5,21,62,30
E02004415,Wealden 013,Middle Super Output Areas and Intermediate Zones,MSOAIZ,TN,6063,2398,4710,1864,2094,987,2616,877,56,24,558,205,188,88,370,117,117,,,,646,259,574,231,8,4,39,14,25,10,28,93,46
E02004416,Wealden 014,Middle Super Output Areas and Intermediate Zones,MSOAIZ,TN,6353,2695,5179,2165,2542,1246,2637,919,42,16,387,178,238,114,149,64,64,,,,658,286,514,231,27,9,87,35,30,11,55,87,50
E02004417,Wealden 015,Middle Super Output Areas and Intermediate Zones,MSOAIZ,BN,5563,2520,4497,2025,1889,1078,2608,947,59,25,186,102,95,62,91,40,40,,,,771,341,695,311,0,0,74,29,2,1,30,50,27
E02004418,Wealden 016,Middle Super Output Areas and Intermediate Zones,MSOAIZ,BN,5428,2284,3979,1668,1602,837,2377,831,61,29,848,371,191,93,657,278,278,,,,486,193,409,167,13,4,60,20,4,2,26,54,23
E02004419,Wealden 017,Middle Super Output Areas and Intermediate Zones,MSOAIZ,BN,5849,2473,3365,1512,1463,829,1902,683,64,26,1728,674,1326,507,402,167,167,,,,617,224,554,202,0,0,62,21,1,1,22,75,37
E02004420,Wealden 018,Middle Super Output Areas and Intermediate Zones,MSOAIZ,TN,10049,4527,8377,3810,4298,2342,4079,1468,66,30,334,146,179,81,155,65,65,,,,1091,454,949,393,35,17,99,40,8,4,61,181,87
E02004421,Wealden 019,Middle Super Output Areas and Intermediate Zones,MSOAIZ,BN,7489,3649,5878,2906,2845,1710,3033,1196,45,22,466,232,303,146,163,86,86,,,,1035,459,919,409,17,6,92,39,7,5,50,65,30
E02004422,Wealden 020,Middle Super Output Areas and Intermediate Zones,MSOAIZ,BN,9431,4125,7797,3412,3281,1826,4516,1586,38,24,353,149,158,89,195,60,60,,,,1141,484,1043,435,17,5,74,40,7,4,49,102,56
E02004423,Wealden 021,Middle Super Output Areas and Intermediate Zones,MSOAIZ,BN,7421,3506,6590,3113,3252,1905,3338,1208,15,10,146,79,89,54,57,25,25,,,,601,264,494,217,16,6,89,39,2,2,47,69,40
E02004424,Basildon 001,Middle Super Output Areas and Intermediate Zones,MSOAIZ,CM,7122,2755,6672,2578,2678,1285,3994,1293,13,4,68,19,46,12,22,7,7,,,,345,136,323,123,4,1,17,11,1,1,13,24,18
E02004425,Basildon 002,Middle Super Output Areas and Intermediate Zones,MSOAIZ,CM,7288,3169,5919,2505,2161,1158,3758,1347,7,3,651,311,398,194,253,117,117,,,,674,327,627,303,6,2,30,18,11,4,24,37,23
E02004426,Basildon 003,Middle Super Output Areas and Intermediate Zones,MSOAIZ,CM,7815,3284,6329,2580,2451,1237,3878,1343,10,4,744,365,398,200,346,165,165,,,,690,314,654,296,6,2,30,16,0,0,18,42,21
E02004427,Basildon 004,Middle Super Output Areas and Intermediate Zones,MSOAIZ,CM,7558,3333,6602,2845,3129,1665,3473,1180,5,3,449,252,396,219,53,33,33,,,,425,194,375,166,13,5,34,21,3,2,28,77,39
E02004428,Basildon 005,Middle Super Output Areas and Intermediate Zones,MSOAIZ,SS,6049,2694,4548,1936,1838,992,2710,944,17,10,805,443,716,387,89,56,56,,,,653,289,605,268,11,5,36,15,1,1,21,26,16
E02004429,Basildon 006,Middle Super Output Areas and Intermediate Zones,MSOAIZ,SS,7463,3111,6746,2748,2934,1513,3812,1235,32,13,213,138,154,110,59,28,28,,,,439,189,406,176,2,1,30,11,1,1,13,33,23
E02004430,Basildon 007,Middle Super Output Areas and Intermediate Zones,MSOAIZ,SS,8049,3206,7308,2901,2302,1193,5006,1708,13,8,135,43,45,13,90,30,30,,,,576,244,523,221,11,3,39,19,3,1,23,17,10
E02004431,Basildon 008,Middle Super Output Areas and Intermediate Zones,MSOAIZ,SS,9068,3814,6920,2807,1822,939,5098,1868,147,57,868,397,325,184,543,213,213,,,,1100,531,1011,493,9,4,79,33,1,1,38,33,22
E02004432,Basildon 009,Middle Super Output Areas and Intermediate Zones,MSOAIZ,SS,6887,2604,6191,2328,2872,1233,3319,1095,10,5,156,62,108,46,48,16,16,,,,503,196,451,172,7,3,37,16,8,5,24,27,13
E02004433,Basildon 010,Middle Super Output Areas and Intermediate Zones,MSOAIZ,SS,8485,3691,5392,2272,1611,838,3781,1434,71,35,1998,846,883,415,1115,431,431,,,,982,505,906,468,9,3,56,28,11,6,37,42,33
E02004434,Basildon 011,Middle Super Output Areas and Intermediate Zones,MSOAIZ,SS,8265,3454,5165,2049,1319,647,3846,1402,492,245,1458,624,1106,487,352,137,137,,,,1088,503,1020,466,4,2,55,29,9,6,37,62,33
E02004435,Basildon 012,Middle Super Output Areas and Intermediate Zones,MSOAIZ,SS,8035,3324,5011,2026,1499,803,3512,1223,29,11,2152,938,1644,705,508,233,233,,,,770,303,707,277,0,0,55,20,8,6,26,73,46
E02004436,Basildon 013,Middle Super Output Areas and Intermediate Zones,MSOAIZ,SS,7640,3142,3063,1220,787,393,2276,827,32,17,3578,1525,2888,1228,690,297,297,,,,900,344,853,324,1,1,39,16,7,3,20,67,36
E02004437,Basildon 014,Middle Super Output Areas and Intermediate Zones,MSOAIZ,SS,7849,3583,4730,2038,1761,935,2969,1103,87,47,2337,1151,1700,864,637,287,287,,,,652,319,604,289,0,0,45,28,3,2,30,43,28
E02004438,Basildon 015,Middle Super Output Areas and Intermediate Zones,MSOAIZ,SS,8273,3660,4338,1832,1442,790,2896,1042,95,45,2708,1311,1846,936,862,375,375,,,,1047,420,991,391,3,3,46,22,7,4,29,85,52
E02004439,Basildon 016,Middle Super Output Areas and Intermediate Zones,MSOAIZ,SS,8779,3472,2957,1237,849,446,2108,791,60,21,4644,1760,1623,714,3021,1046,1046,,,,1053,413,976,378,1,1,38,16,38,18,35,65,41
E02004440,Basildon 017,Middle Super Output Areas and Intermediate Zones,MSOAIZ,SS,7880,3354,5015,2094,1675,923,3340,1171,55,18,1842,862,1430,687,412,175,175,,,,921,348,868,323,0,0,49,21,4,4,25,47,32
E02004441,Basildon 018,Middle Super Output Areas and Intermediate Zones,MSOAIZ,SS,7440,3209,4098,1643,1326,683,2772,960,27,14,2557,1247,1861,893,696,354,354,,,,700,276,647,255,3,1,46,17,4,3,21,58,29
E02004442,Basildon 019,Middle Super Output Areas and Intermediate Zones,MSOAIZ,SS,8185,3350,2935,1198,798,436,2137,762,97,56,4284,1731,1301,573,2983,1158,1158,,,,825,329,758,297,0,0,42,21,25,11,32,44,36
E02004443,Basildon 020,Middle Super Output Areas and Intermediate Zones,MSOAIZ,SS,8145,3415,5703,2312,2128,1101,3575,1211,54,37,1429,684,1134,532,295,152,152,,,,904,348,736,275,57,22,88,39,23,12,73,55,34
E02004444,Basildon 021,Middle Super Output Areas and Intermediate Zones,MSOAIZ,SS,8972,3602,7170,2823,2229,1092,4941,1731,106,54,874,351,603,248,271,103,103,,,,785,354,732,328,16,5,28,15,9,6,26,37,20
E02004445,Basildon 022,Middle Super Output Areas and Intermediate Zones,MSOAIZ,SS,8125,3520,4821,2000,1406,735,3415,1265,23,13,2049,916,1427,662,622,254,254,,,,1189,566,1123,536,4,1,59,27,3,2,30,43,25
E02004446,Braintree 001,Middle Super Output Areas and Intermediate Zones,MSOAIZ,CO,6875,2749,5371,2114,2062,1003,3309,1111,23,7,846,351,194,87,652,264,264,,,,554,237,495,211,20,7,30,15,9,4,26,81,40
E02004447,Braintree 002,Middle Super Output Areas and Intermediate Zones,MSOAIZ,CO,5835,2500,4534,1913,2226,1102,2308,811,28,14,482,226,104,44,378,182,182,,,,684,301,590,260,22,10,56,25,16,6,41,107,46
E02004448,Braintree 003,Middle Super Output Areas and Intermediate Zones,MSOAIZ,CO,6266,2688,4648,1932,1866,969,2782,963,41,17,716,320,157,79,559,241,241,,,,803,382,757,360,10,6,26,11,10,5,22,58,37
E02004449,Braintree 004,Middle Super Output Areas and Intermediate Zones,MSOAIZ,CO,8383,3831,5115,2275,1818,998,3297,1277,43,23,1982,910,547,260,1435,650,650,,,,1197,590,1117,549,4,2,57,29,19,10,41,46,33
E02004450,Braintree 005,Middle Super Output Areas and Intermediate Zones,MSOAIZ,CO,5993,2548,4442,1836,1872,938,2570,898,25,13,662,308,117,50,545,258,258,,,,752,333,546,245,95,39,50,24,61,25,88,112,58
E02004451,Braintree 006,Middle Super Output Areas and Intermediate Zones,MSOAIZ,CO,8448,3521,6629,2700,2471,1300,4158,1400,11,8,868,381,215,92,653,289,289,,,,860,383,787,350,10,4,54,24,9,5,33,80,49
E02004452,Braintree 007,Middle Super Output Areas and Intermediate Zones,MSOAIZ,CO,8913,3522,7419,2878,2430,1224,4989,1654,13,6,610,266,136,57,474,209,209,,,,813,342,740,312,4,1,55,24,14,5,30,58,30
E02004453,Braintree 008,Middle Super Output Areas and Intermediate Zones,MSOAIZ,CM,7037,2969,3604,1480,1184,633,2420,847,92,36,2510,1102,701,307,1809,795,795,,,,786,323,694,286,14,3,68,29,10,5,37,45,28
E02004454,Braintree 009,Middle Super Output Areas and Intermediate Zones,MSOAIZ,CM,8825,4219,5300,2375,1888,1066,3412,1309,67,33,816,512,127,86,689,426,426,,,,2576,1258,2441,1185,21,9,107,58,7,6,73,66,41
E02004455,Braintree 010,Middle Super Output Areas and Intermediate Zones,MSOAIZ,CM,7623,2884,6345,2411,2174,1058,4171,1353,49,25,487,156,49,21,438,135,135,,,,704,274,634,247,29,9,35,15,6,3,27,38,18
E02004456,Braintree 011,Middle Super Output Areas and Intermediate Zones,MSOAIZ,CM,8878,3809,5381,2303,1547,853,3834,1450,24,10,2175,904,604,243,1571,661,661,,,,1249,560,1142,509,20,8,79,40,8,3,51,49,32
E02004457,Braintree 012,Middle Super Output Areas and Intermediate Zones,MSOAIZ,CO,10231,4041,6430,2556,1962,1011,4468,1545,92,45,2622,999,492,220,2130,779,779,,,,1010,395,943,367,12,4,44,20,11,4,28,77,46
E02004458,Braintree 013,Middle Super Output Areas and Intermediate Zones,MSOAIZ,CM,9425,3540,7793,2909,2218,1081,5575,1828,55,25,636,227,57,25,579,202,202,,,,912,363,827,335,24,7,53,17,8,4,28,29,16
E02004459,Braintree 014,Middle Super Output Areas and Intermediate Zones,MSOAIZ,CO,10248,4339,7759,3116,2984,1507,4775,1609,21,8,1246,629,323,156,923,473,473,,,,1117,531,1007,478,15,8,78,35,17,10,53,105,55
E02004460,Braintree 015,Middle Super Output Areas and Intermediate Zones,MSOAIZ,CM,8825,3706,6102,2593,2192,1169,3910,1424,50,27,1843,748,485,179,1358,569,569,,,,782,310,664,261,15,5,90,35,13,9,49,48,28
E02004461,Braintree 016,Middle Super Output Areas and Intermediate Zones,MSOAIZ,CM,5820,2258,3284,1277,702,371,2582,906,5,2,1828,732,443,176,1385,556,556,,,,684,231,607,198,9,3,59,27,9,3,33,19,16
E02004462,Braintree 017,Middle Super Output Areas and Intermediate Zones,MSOAIZ,CM,9961,4655,6443,2891,2097,1202,4346,1689,92,43,1636,840,415,204,1221,636,636,,,,1709,838,1615,789,9,6,69,37,16,6,49,81,43
E02004463,Braintree 018,Middle Super Output Areas and Intermediate Zones,MSOAIZ,CM,7877,3264,5707,2313,2286,1124,3421,1189,41,20,1033,444,206,92,827,352,352,,,,981,432,893,390,40,17,40,20,8,5,42,115,55
E02004464,Brentwood 001,Middle Super Output Areas and Intermediate Zones,MSOAIZ,RM,9674,3742,8349,3181,3587,1710,4762,1471,35,16,794,332,480,208,314,124,124,,,,403,165,334,139,24,8,37,13,8,5,26,93,48
E02004465,Brentwood 002,Middle Super Output Areas and Intermediate Zones,MSOAIZ,CM,5950,2588,4654,1962,2295,1167,2359,795,8,7,571,288,520,252,51,36,36,,,,619,279,549,248,8,3,35,18,27,10,31,98,52
E02004466,Brentwood 003,Middle Super Output Areas and Intermediate Zones,MSOAIZ,CM,8044,3314,6010,2426,2302,1183,3708,1243,14,6,1386,615,1275,564,111,51,51,,,,546,217,510,198,8,2,21,12,7,5,19,88,50
E02004467,Brentwood 004,Middle Super Output Areas and Intermediate Zones,MSOAIZ,CM,7359,3062,4986,2008,1743,880,3243,1128,53,24,1611,709,1184,530,427,179,179,,,,646,284,589,253,6,3,40,22,11,6,31,63,37
E02004468,Brentwood 005,Middle Super Output Areas and Intermediate Zones,MSOAIZ,CM,10394,4144,9429,3677,4508,2153,4921,1524,9,4,119,55,112,50,7,5,5,,,,785,376,707,338,22,9,41,24,15,5,38,52,32
E02004469,Brentwood 006,Middle Super Output Areas and Intermediate Zones,MSOAIZ,CM,6862,2749,5951,2346,2417,1190,3534,1156,30,13,267,120,240,105,27,15,15,,,,550,236,479,208,30,11,32,13,9,4,28,64,34
E02004470,Brentwood 007,Middle Super Output Areas and Intermediate Zones,MSOAIZ,CM,10548,5127,6509,3027,2045,1196,4464,1831,181,110,1320,680,545,274,775,406,406,,,,2426,1248,2288,1173,43,19,72,45,23,11,75,112,62
E02004471,Brentwood 008,Middle Super Output Areas and Intermediate Zones,MSOAIZ,RM,7810,3360,5384,2215,1997,1012,3387,1203,20,9,1530,726,1430,681,100,45,45,,,,797,361,726,327,19,7,38,20,14,7,34,79,49
E02004472,Brentwood 009,Middle Super Output Areas and Intermediate Zones,MSOAIZ,CM,6148,2560,5410,2186,2343,1143,3067,1043,12,5,132,61,108,39,24,22,22,,,,547,286,509,264,3,3,31,17,4,2,22,47,22
E02004473,Castle Point 001,Middle Super Output Areas and Intermediate Zones,MSOAIZ,SS,7674,3088,6722,2658,2614,1317,4108,1341,18,7,184,102,147,91,37,11,11,,,,711,298,667,279,0,0,41,17,3,2,19,39,23
E02004474,Castle Point 002,Middle Super Output Areas and Intermediate Zones,MSOAIZ,SS,6980,2994,6154,2637,2777,1495,3377,1142,43,16,162,79,62,36,100,43,43,,,,578,237,543,215,0,0,33,20,2,2,22,43,25
E02004475,Castle Point 003,Middle Super Output Areas and Intermediate Zones,MSOAIZ,SS,6533,2607,5883,2318,2392,1190,3491,1128,9,6,155,80,155,80,0,0,0,,,,443,180,404,161,3,1,30,15,6,3,19,43,23
E02004476,Castle Point 004,Middle Super Output Areas and Intermediate Zones,MSOAIZ,SS,7967,3140,7177,2838,2974,1479,4203,1359,16,7,72,33,58,25,14,8,8,,,,632,232,577,206,0,0,52,23,3,3,26,70,30
E02004477,Castle Point 005,Middle Super Output Areas and Intermediate Zones,MSOAIZ,SS,5946,2606,5413,2375,2699,1450,2714,925,18,10,68,36,53,29,15,7,7,,,,409,162,370,143,1,1,38,18,0,0,19,38,23
E02004478,Castle Point 006,Middle Super Output Areas and Intermediate Zones,MSOAIZ,SS,6495,2864,4861,2071,1976,1085,2885,986,8,6,528,303,408,234,120,69,69,,,,1050,456,954,410,2,1,83,39,11,6,46,48,28
E02004479,Castle Point 007,Middle Super Output Areas and Intermediate Zones,MSOAIZ,SS,7828,3270,6808,2807,2711,1414,4097,1393,22,9,206,113,153,74,53,39,39,,,,738,311,664,280,5,2,62,26,7,3,31,54,30
E02004480,Castle Point 008,Middle Super Output Areas and Intermediate Zones,MSOAIZ,SS,7100,2709,6040,2265,1924,917,4116,1348,29,12,293,123,106,50,187,73,73,,,,703,288,649,263,6,2,44,22,4,1,25,35,21
E02004481,Castle Point 009,Middle Super Output Areas and Intermediate Zones,MSOAIZ,SS,6733,3194,5670,2714,3036,1750,2634,964,22,12,180,74,159,66,21,8,8,,,,833,372,758,336,5,2,65,30,5,4,36,28,22
E02004482,Castle Point 010,Middle Super Output Areas and Intermediate Zones,MSOAIZ,SS,8310,3147,5107,1950,1581,798,3526,1152,12,10,1806,729,1277,558,529,171,171,,,,1337,430,1233,391,3,1,96,37,5,1,39,48,28
E02004483,Castle Point 011,Middle Super Output Areas and Intermediate Zones,MSOAIZ,SS,8084,3460,6718,2770,2820,1455,3898,1315,9,5,163,101,89,67,74,34,34,,,,1140,552,985,487,6,3,92,34,57,28,65,54,32
E02004484,Castle Point 012,Middle Super Output Areas and Intermediate Zones,MSOAIZ,SS,7735,3361,6344,2698,2482,1341,3862,1357,5,3,319,176,251,143,68,33,33,,,,1021,450,930,413,2,1,68,30,21,6,37,46,34
E02004485,Chelmsford 001,Middle Super Output Areas and Intermediate Zones,MSOAIZ,CM,6987,2805,5192,2024,1936,942,3256,1082,65,29,1001,451,117,64,884,387,387,,,,630,250,546,219,32,10,24,10,28,11,31,99,51
E02004486,Chelmsford 002,Middle Super Output Areas and Intermediate Zones,MSOAIZ,CM,8012,3336,6678,2751,2714,1419,3964,1332,38,21,442,205,35,19,407,186,186,,,,818,341,766,313,15,9,30,15,7,4,28,36,18
E02004487,Chelmsford 003,Middle Super Output Areas and Intermediate Zones,MSOAIZ,CM,7048,2946,4756,1956,1856,932,2900,1024,29,21,1510,660,292,138,1218,522,522,,,,647,250,572,218,23,8,43,19,9,5,32,106,59
E02004488,Chelmsford 004,Middle Super Output Areas and Intermediate Zones,MSOAIZ,CM,8187,3446,6985,2839,2331,1182,4654,1657,18,12,374,233,57,31,317,202,202,,,,771,340,705,308,6,2,58,29,2,1,32,39,22
E02004489,Chelmsford 005,Middle Super Output Areas and Intermediate Zones,MSOAIZ,CM,9038,3480,6872,2620,2244,1046,4628,1574,50,29,1316,493,109,48,1207,445,445,,,,733,301,661,264,8,5,52,26,12,6,37,67,37
E02004490,Chelmsford 006,Middle Super Output Areas and Intermediate Zones,MSOAIZ,CM,7672,3275,3122,1288,1054,568,2068,720,37,19,3624,1586,650,291,2974,1295,1295,,,,798,317,734,292,13,3,27,13,24,9,25,91,65
E02004491,Chelmsford 007,Middle Super Output Areas and Intermediate Zones,MSOAIZ,CM,7369,2989,6263,2529,2240,1143,4023,1386,37,13,192,71,30,13,162,58,58,,,,819,343,767,315,0,0,46,23,6,5,28,58,33
E02004492,Chelmsford 008,Middle Super Output Areas and Intermediate Zones,MSOAIZ,CM,9290,3910,6774,2779,1729,890,5045,1889,51,22,1030,450,190,81,840,369,369,,,,1390,641,1305,602,21,7,55,26,9,6,39,45,18
E02004493,Chelmsford 009,Middle Super Output Areas and Intermediate Zones,MSOAIZ,CM,9983,4209,6000,2467,1980,991,4020,1476,49,27,2038,904,288,136,1750,768,768,,,,1814,763,1717,712,10,4,64,35,23,12,51,82,48
E02004494,Chelmsford 010,Middle Super Output Areas and Intermediate Zones,MSOAIZ,CM,8904,4664,4506,2361,1679,1014,2827,1347,159,98,722,450,86,48,636,402,402,,,,3405,1694,3244,1608,13,8,118,64,30,14,86,112,61
E02004495,Chelmsford 011,Middle Super Output Areas and Intermediate Zones,MSOAIZ,CM,7879,3421,6183,2614,3107,1556,3076,1058,27,7,908,461,149,68,759,393,393,,,,683,294,613,260,17,8,41,20,12,6,34,78,45
E02004496,Chelmsford 012,Middle Super Output Areas and Intermediate Zones,MSOAIZ,CM,7245,2874,6282,2460,2273,1135,4009,1325,8,3,229,96,30,12,199,84,84,,,,693,294,650,274,0,0,41,18,2,2,20,33,21
E02004497,Chelmsford 013,Middle Super Output Areas and Intermediate Zones,MSOAIZ,CM,7779,3308,6599,2751,2812,1461,3787,1290,33,20,419,207,79,44,340,163,163,,,,652,292,586,266,11,3,51,21,4,2,26,76,38
E02004498,Chelmsford 014,Middle Super Output Areas and Intermediate Zones,MSOAIZ,CM,9720,4209,6055,2507,2148,1094,3907,1413,91,51,2544,1189,380,187,2164,1002,1002,,,,966,414,864,369,18,4,70,33,14,8,45,64,48
E02004499,Chelmsford 015,Middle Super Output Areas and Intermediate Zones,MSOAIZ,CM,6927,2698,6135,2414,2336,1148,3799,1266,45,18,261,83,14,6,247,77,77,,,,446,165,408,149,10,3,26,12,2,1,16,40,18
E02004500,Chelmsford 016,Middle Super Output Areas and Intermediate Zones,MSOAIZ,CM,9094,3647,7520,2940,3093,1517,4427,1423,37,15,847,402,145,61,702,341,341,,,,611,245,533,215,14,4,54,22,10,4,30,79,45
E02004501,Chelmsford 017,Middle Super Output Areas and Intermediate Zones,MSOAIZ,CM,7243,3006,5721,2287,2511,1215,3210,1072,16,6,973,498,203,104,770,394,394,,,,484,191,424,165,6,2,43,19,11,5,26,49,24
E02004502,Chelmsford 018,Middle Super Output Areas and Intermediate Zones,MSOAIZ,SS,6542,2791,5498,2281,2659,1335,2839,946,21,9,449,230,119,52,330,178,178,,,,504,236,460,211,20,11,21,12,3,2,25,70,35
E02004503,Chelmsford 019,Middle Super Output Areas and Intermediate Zones,MSOAIZ,CM,8087,3257,6950,2753,2298,1184,4652,1569,40,23,187,82,33,14,154,68,68,,,,855,365,725,311,29,9,97,43,4,2,54,55,34
E02004504,Chelmsford 020,Middle Super Output Areas and Intermediate Zones,MSOAIZ,CM,8294,3343,6847,2592,1901,902,4946,1690,7,4,451,273,29,20,422,253,253,,,,962,457,881,417,14,4,60,32,7,4,40,27,17
E02004505,Chelmsford 021,Middle Super Output Areas and Intermediate Zones,MSOAIZ,SS,4882,2053,4248,1765,2021,1022,2227,743,6,3,242,96,53,19,189,77,77,,,,331,156,276,133,19,7,32,13,4,3,23,55,33
E02004506,Colchester 001,Middle Super Output Areas and Intermediate Zones,MSOAIZ,CO,6686,2696,5561,2189,2422,1162,3139,1027,23,12,520,233,351,166,169,67,67,,,,511,228,441,196,18,7,41,20,11,5,32,71,34
E02004507,Colchester 002,Middle Super Output Areas and Intermediate Zones,MSOAIZ,CO,9916,4172,6259,2550,1412,755,4847,1795,83,38,1425,596,181,90,1244,506,506,,,,2116,971,1947,900,28,9,136,60,5,2,71,33,17
E02004508,Colchester 003,Middle Super Output Areas and Intermediate Zones,MSOAIZ,CO,6480,2620,5331,2135,2255,1120,3076,1015,10,5,582,250,480,215,102,35,35,,,,519,210,468,191,13,3,32,14,6,2,19,38,20
E02004509,Colchester 004,Middle Super Output Areas and Intermediate Zones,MSOAIZ,CO,10398,4413,6789,2803,1885,988,4904,1815,87,46,883,379,231,113,652,266,266,,,,2596,1155,2470,1098,24,10,79,36,23,11,57,43,30
E02004512,Colchester 007,Middle Super Output Areas and Intermediate Zones,MSOAIZ,CO,9809,4961,4742,2347,1855,1098,2887,1249,52,31,1112,566,349,186,763,380,380,,,,3783,1939,3605,1841,9,6,136,79,33,13,98,120,78
E02004513,Colchester 008,Middle Super Output Areas and Intermediate Zones,MSOAIZ,CO,10216,4268,2970,1324,1061,570,1909,754,54,23,3845,1748,2787,1337,1058,411,411,,,,3246,1122,3108,1066,12,5,74,31,52,20,56,101,51
E02004514,Colchester 009,Middle Super Output Areas and Intermediate Zones,MSOAIZ,CO,5444,2311,4299,1826,1903,1018,2396,808,4,2,493,207,392,160,101,47,47,,,,589,247,515,215,15,5,55,25,4,2,32,59,29
E02004515,Colchester 010,Middle Super Output Areas and Intermediate Zones,MSOAIZ,CO,7058,2880,6002,2363,2334,1148,3668,1215,7,5,359,182,276,133,83,49,49,,,,636,299,607,285,6,3,19,8,4,3,14,54,31
E02004516,Colchester 011,Middle Super Output Areas and Intermediate Zones,MSOAIZ,CO,9331,4437,4305,2088,1188,701,3117,1387,30,15,1486,770,322,210,1164,560,560,,,,3445,1523,3258,1431,12,5,133,63,42,24,92,65,41
E02004517,Colchester 012,Middle Super Output Areas and Intermediate Zones,MSOAIZ,CO,8157,3506,6401,2656,2429,1276,3972,1380,20,12,775,412,451,254,324,158,158,,,,917,399,828,356,7,4,75,36,7,3,43,44,27
E02004518,Colchester 013,Middle Super Output Areas and Intermediate Zones,MSOAIZ,CO,6171,2583,4400,1781,1588,822,2812,959,32,13,344,146,81,54,263,92,92,,,,1352,622,1035,488,113,45,55,30,149,59,134,43,21
E02004519,Colchester 014,Middle Super Output Areas and Intermediate Zones,MSOAIZ,CO,7347,3076,6247,2617,2966,1553,3281,1064,8,3,417,197,277,134,140,63,63,,,,606,221,528,196,9,2,57,20,12,3,25,69,38
E02004520,Colchester 015,Middle Super Output Areas and Intermediate Zones,MSOAIZ,CO,8355,3163,3373,1374,1043,543,2330,831,47,17,1918,813,1139,514,779,299,299,,,,2965,928,880,305,1144,335,103,41,838,247,623,52,31
E02004521,Colchester 016,Middle Super Output Areas and Intermediate Zones,MSOAIZ,CO,8712,3904,5389,2342,1830,996,3559,1346,33,13,1747,819,1308,650,439,169,169,,,,1493,700,1395,652,13,7,80,38,5,3,48,50,30
E02004522,Colchester 017,Middle Super Output Areas and Intermediate Zones,MSOAIZ,CO,7892,3457,5764,2566,2641,1435,3123,1131,32,10,341,161,188,102,153,59,59,,,,1701,687,1466,578,14,6,99,42,122,61,109,54,33
E02004523,Colchester 018,Middle Super Output Areas and Intermediate Zones,MSOAIZ,CO,8757,3634,5348,2249,1610,871,3738,1378,36,20,1936,777,1228,547,708,230,230,,,,1378,552,1220,490,25,10,118,47,15,5,62,59,36
E02004524,Colchester 019,Middle Super Output Areas and Intermediate Zones,MSOAIZ,CO,8127,3231,6965,2751,2888,1390,4077,1361,14,8,417,169,326,131,91,38,38,,,,639,251,573,220,17,8,31,17,18,6,31,92,52
E02004525,Colchester 020,Middle Super Output Areas and Intermediate Zones,MSOAIZ,CO,7558,3293,6160,2613,2772,1471,3388,1142,22,8,562,288,420,215,142,73,73,,,,743,335,630,282,73,27,33,20,7,6,53,71,49
E02004526,Colchester 021,Middle Super Output Areas and Intermediate Zones,MSOAIZ,CO,7172,3300,5933,2711,3162,1731,2771,980,32,17,409,208,247,132,162,76,76,,,,733,326,627,282,8,3,85,36,13,5,44,65,38
E02004527,Epping Forest 001,Middle Super Output Areas and Intermediate Zones,MSOAIZ,CM,8586,3667,6503,2667,2321,1175,4182,1492,38,17,1044,471,666,310,378,161,161,,,,919,463,825,421,13,4,70,34,11,4,42,82,49
E02004528,Epping Forest 002,Middle Super Output Areas and Intermediate Zones,MSOAIZ,EN,8031,3242,6937,2767,2949,1462,3988,1305,4,3,601,263,508,225,93,38,38,,,,411,166,377,153,10,4,14,6,10,3,13,78,43
E02004529,Epping Forest 003,Middle Super Output Areas and Intermediate Zones,MSOAIZ,RM,6598,2582,5119,1949,2213,1009,2906,940,19,10,686,278,607,248,79,30,30,,,,658,290,586,262,32,9,22,10,18,9,28,116,55
E02004530,Epping Forest 004,Middle Super Output Areas and Intermediate Zones,MSOAIZ,CM,6251,2626,4637,1912,1910,987,2727,925,7,5,1040,431,855,359,185,72,72,,,,522,252,488,234,5,2,24,14,5,2,18,45,26
E02004531,Epping Forest 005,Middle Super Output Areas and Intermediate Zones,MSOAIZ,CM,6169,2663,4500,1879,1757,908,2743,971,21,11,1082,516,806,377,276,139,139,,,,487,215,444,193,17,7,11,7,15,8,22,79,42
E02004532,Epping Forest 006,Middle Super Output Areas and Intermediate Zones,MSOAIZ,CM,6128,2764,4322,1902,1845,987,2477,915,13,3,846,373,568,249,278,124,124,,,,901,453,859,431,13,5,26,14,3,3,22,46,33
E02004533,Epping Forest 007,Middle Super Output Areas and Intermediate Zones,MSOAIZ,EN,7009,2999,4573,1827,1600,811,2973,1016,25,12,1890,933,1506,763,384,170,170,,,,471,195,399,172,7,2,58,19,7,2,23,50,32
E02004534,Epping Forest 008,Middle Super Output Areas and Intermediate Zones,MSOAIZ,EN,8678,3678,5982,2448,1768,913,4214,1535,60,20,1686,762,1320,627,366,135,135,,,,897,415,841,384,0,0,55,30,1,1,31,53,33
E02004535,Epping Forest 009,Middle Super Output Areas and Intermediate Zones,MSOAIZ,IG,5149,2493,3880,1836,1936,1121,1944,715,48,26,407,226,206,118,201,108,108,,,,690,349,635,321,28,11,21,12,6,5,28,124,56
E02004536,Epping Forest 010,Middle Super Output Areas and Intermediate Zones,MSOAIZ,RM,5991,2520,4843,1988,2057,1062,2786,926,11,9,661,298,511,223,150,75,75,,,,428,201,391,184,17,7,20,10,0,0,17,48,24
E02004537,Epping Forest 011,Middle Super Output Areas and Intermediate Zones,MSOAIZ,IG,8550,3805,4928,2061,1439,775,3489,1286,33,13,2562,1257,2119,1076,443,181,181,,,,959,424,914,404,7,2,36,16,2,2,20,68,50
E02004538,Epping Forest 012,Middle Super Output Areas and Intermediate Zones,MSOAIZ,IG,8889,3515,7304,2837,2882,1363,4422,1474,49,27,523,178,379,136,144,42,42,,,,947,441,898,417,6,3,38,19,5,2,24,66,32
E02004539,Epping Forest 013,Middle Super Output Areas and Intermediate Zones,MSOAIZ,IG,7612,3188,5401,2214,1916,978,3485,1236,20,12,1363,630,1290,602,73,28,28,,,,766,292,724,271,1,1,34,16,7,4,21,62,40
E02004540,Epping Forest 014,Middle Super Output Areas and Intermediate Zones,MSOAIZ,IG,5948,2457,4755,1927,1884,925,2871,1002,12,6,533,207,382,151,151,56,56,,,,603,288,559,264,4,3,38,19,2,2,24,45,29
E02004541,Epping Forest 015,Middle Super Output Areas and Intermediate Zones,MSOAIZ,IG,11201,4894,8752,3652,3360,1744,5392,1908,25,17,814,427,658,321,156,106,106,,,,1508,745,1407,697,12,7,82,38,7,3,48,102,53
E02004542,Epping Forest 016,Middle Super Output Areas and Intermediate Zones,MSOAIZ,IG,6323,2396,5295,1974,2200,1007,3095,967,27,11,269,120,198,87,71,33,33,,,,608,242,504,201,69,25,15,8,20,8,41,124,49
E02004543,Epping Forest 017,Middle Super Output Areas and Intermediate Zones,MSOAIZ,IG,6510,2502,4655,1725,1835,843,2820,882,8,4,1042,433,852,336,190,97,97,,,,756,311,726,298,3,1,20,10,7,2,13,49,29
E02004544,Harlow 001,Middle Super Output Areas and Intermediate Zones,MSOAIZ,CM,6949,3012,4451,1833,1475,773,2976,1060,129,70,1502,714,1226,556,276,158,158,,,,808,358,752,332,0,0,41,19,15,7,26,59,37
E02004545,Harlow 002,Middle Super Output Areas and Intermediate Zones,MSOAIZ,CM,7133,3025,3440,1433,1107,591,2333,842,56,26,2805,1230,2705,1154,100,76,76,,,,790,309,717,278,14,4,57,26,2,1,31,42,27
E02004546,Harlow 003,Middle Super Output Areas and Intermediate Zones,MSOAIZ,CM,7396,3260,3575,1490,1060,583,2515,907,28,12,2772,1300,2622,1224,150,76,76,,,,969,419,908,389,1,1,52,26,8,3,30,52,39
E02004547,Harlow 004,Middle Super Output Areas and Intermediate Zones,MSOAIZ,CM,7885,3369,3756,1573,1147,607,2609,966,151,80,2809,1235,2316,995,493,240,240,,,,1089,435,1001,399,14,4,53,25,21,7,36,80,46
E02004548,Harlow 005,Middle Super Output Areas and Intermediate Zones,MSOAIZ,CM,8883,3513,7351,2882,1427,736,5924,2146,76,27,335,151,36,13,299,138,138,,,,1100,438,1030,410,2,1,65,26,3,1,28,21,15
E02004549,Harlow 006,Middle Super Output Areas and Intermediate Zones,MSOAIZ,CM,7622,3244,4162,1731,1372,719,2790,1012,22,9,2753,1225,2685,1197,68,28,28,,,,651,257,577,225,9,5,57,23,8,4,32,34,22
E02004550,Harlow 007,Middle Super Output Areas and Intermediate Zones,MSOAIZ,CM,7577,3331,3808,1618,1264,686,2544,932,50,20,2519,1197,2124,967,395,230,230,,,,1148,464,1113,443,2,1,29,17,4,3,21,52,32
E02004551,Harlow 008,Middle Super Output Areas and Intermediate Zones,MSOAIZ,CM,7188,3180,3833,1673,1245,686,2588,987,13,5,2761,1240,2615,1151,146,89,89,,,,563,246,526,224,2,1,30,17,5,4,22,18,16
E02004552,Harlow 009,Middle Super Output Areas and Intermediate Zones,MSOAIZ,CM,6439,2748,4616,1853,1469,750,3147,1103,18,9,1254,630,1092,535,162,95,95,,,,512,230,478,217,2,1,26,11,6,1,13,39,26
E02004553,Harlow 010,Middle Super Output Areas and Intermediate Zones,MSOAIZ,CM,7264,2949,3796,1563,1155,587,2641,976,108,45,2684,1063,2035,790,649,273,273,,,,638,254,601,235,6,1,31,18,0,0,19,38,24
E02004554,Harlow 011,Middle Super Output Areas and Intermediate Zones,MSOAIZ,CM,7215,2989,4340,1780,1214,633,3126,1147,55,23,1979,823,1759,745,220,78,78,,,,814,346,757,322,4,2,46,19,7,3,24,27,17
E02004555,Maldon 001,Middle Super Output Areas and Intermediate Zones,MSOAIZ,CO,5944,2503,4951,2034,2107,1070,2844,964,24,9,446,211,26,13,420,198,198,,,,456,220,382,188,15,6,54,24,5,2,32,67,29
E02004556,Maldon 002,Middle Super Output Areas and Intermediate Zones,MSOAIZ,CO,7125,2912,6104,2472,2974,1422,3130,1050,1,1,417,183,33,13,384,170,170,,,,517,212,438,180,14,6,59,23,6,3,32,86,44
E02004557,Maldon 003,Middle Super Output Areas and Intermediate Zones,MSOAIZ,CM,8067,3365,6361,2587,2053,1080,4308,1507,62,26,908,417,34,15,874,402,402,,,,698,313,612,276,3,1,73,32,10,4,37,38,22
E02004558,Maldon 004,Middle Super Output Areas and Intermediate Zones,MSOAIZ,CM,6328,3059,3932,1909,1879,1136,2053,773,35,19,1273,604,62,35,1211,569,569,,,,1009,484,940,453,12,5,36,18,21,8,31,79,43
E02004559,Maldon 005,Middle Super Output Areas and Intermediate Zones,MSOAIZ,CM,7759,3147,6539,2628,2577,1309,3962,1319,14,4,682,307,45,22,637,285,285,,,,491,189,445,168,2,1,42,19,2,1,21,33,19
E02004560,Maldon 006,Middle Super Output Areas and Intermediate Zones,MSOAIZ,CM,8225,3383,6525,2634,2371,1232,4154,1402,35,14,734,317,54,21,680,296,296,,,,836,370,759,333,23,10,49,23,5,4,37,95,48
E02004561,Maldon 007,Middle Super Output Areas and Intermediate Zones,MSOAIZ,CM,9990,3929,8675,3342,3362,1629,5313,1713,28,14,526,245,24,12,502,233,233,,,,681,287,566,242,27,7,62,30,26,8,45,80,41
E02004562,Maldon 008,Middle Super Output Areas and Intermediate Zones,MSOAIZ,CM,7659,3519,5860,2645,2629,1436,3231,1209,23,10,803,401,48,26,755,375,375,,,,902,418,795,368,22,9,80,37,5,4,50,71,45
E02004563,Rochford 001,Middle Super Output Areas and Intermediate Zones,MSOAIZ,SS,6523,2786,5931,2528,2929,1560,3002,968,11,8,131,75,10,4,121,71,71,,,,409,157,365,138,7,2,36,16,1,1,19,41,18
E02004564,Rochford 002,Middle Super Output Areas and Intermediate Zones,MSOAIZ,SS,7945,3122,7242,2814,2803,1395,4439,1419,30,13,96,65,13,9,83,56,56,,,,534,207,454,173,4,2,69,29,7,3,34,43,23
E02004565,Rochford 003,Middle Super Output Areas and Intermediate Zones,MSOAIZ,SS,14876,5929,13512,5285,5470,2738,8042,2547,8,4,373,225,85,48,288,177,177,,,,911,377,814,334,14,6,75,33,8,4,43,72,38
E02004566,Rochford 004,Middle Super Output Areas and Intermediate Zones,MSOAIZ,SS,5649,2379,3052,1253,1080,558,1972,695,16,6,1776,767,213,98,1563,669,669,,,,726,319,666,296,19,6,30,13,11,4,23,79,34
E02004567,Rochford 005,Middle Super Output Areas and Intermediate Zones,MSOAIZ,SS,7909,3133,7256,2873,2891,1467,4365,1406,20,5,125,59,16,8,109,51,51,,,,473,176,434,161,1,1,38,14,0,0,15,35,20
E02004568,Rochford 006,Middle Super Output Areas and Intermediate Zones,MSOAIZ,SS,8506,3372,6883,2693,1935,953,4948,1740,14,7,767,335,155,70,612,265,265,,,,793,309,726,277,9,5,50,21,8,6,32,49,28
E02004569,Rochford 007,Middle Super Output Areas and Intermediate Zones,MSOAIZ,SS,7251,3133,5652,2396,2173,1150,3479,1246,22,11,478,219,65,30,413,189,189,,,,1045,475,975,436,3,2,62,35,5,2,39,54,32
E02004570,Rochford 008,Middle Super Output Areas and Intermediate Zones,MSOAIZ,SS,8621,3591,6893,2772,2894,1492,3999,1280,23,13,830,437,86,53,744,384,384,,,,821,340,778,320,3,1,40,19,0,0,20,54,29
E02004571,Rochford 009,Middle Super Output Areas and Intermediate Zones,MSOAIZ,SS,7890,3141,7325,2919,3144,1579,4181,1340,2,2,72,40,16,12,56,28,28,,,,458,162,419,146,3,1,36,15,0,0,16,33,18
E02004572,Rochford 010,Middle Super Output Areas and Intermediate Zones,MSOAIZ,SS,7566,2978,5952,2289,2119,1035,3833,1254,19,10,717,325,158,74,559,251,251,,,,812,322,656,254,7,5,58,25,91,38,68,66,32
E02004573,Tendring 001,Middle Super Output Areas and Intermediate Zones,MSOAIZ,CO,5980,2873,3332,1526,1431,806,1901,720,17,10,777,428,549,299,228,129,129,,,,1798,871,1691,822,13,6,85,39,9,4,49,56,38
E02004574,Tendring 002,Middle Super Output Areas and Intermediate Zones,MSOAIZ,CO,7312,3127,4692,2035,1861,1037,2831,998,60,25,1229,533,821,343,408,190,190,,,,1245,486,1166,450,2,1,65,28,12,7,36,86,48
E02004575,Tendring 003,Middle Super Output Areas and Intermediate Zones,MSOAIZ,CO,10985,4812,8395,3586,3534,1860,4861,1726,36,14,1019,499,844,404,175,95,95,,,,1387,632,1249,582,31,11,66,31,41,8,50,148,81
E02004576,Tendring 004,Middle Super Output Areas and Intermediate Zones,MSOAIZ,CO,8754,3736,7225,3120,3232,1721,3993,1399,35,14,576,225,400,162,176,63,63,,,,824,327,737,288,15,5,70,33,2,1,39,94,50
E02004577,Tendring 005,Middle Super Output Areas and Intermediate Zones,MSOAIZ,CO,5103,2082,4203,1686,1864,909,2339,777,12,7,336,157,252,118,84,39,39,,,,470,197,425,174,11,6,26,12,8,5,23,82,35
E02004578,Tendring 006,Middle Super Output Areas and Intermediate Zones,MSOAIZ,CO,6912,3423,4708,2369,2814,1668,1894,701,15,7,481,270,291,147,190,123,123,,,,1596,712,1488,655,15,9,80,42,13,6,57,112,65
E02004579,Tendring 007,Middle Super Output Areas and Intermediate Zones,MSOAIZ,CO,6810,2992,5712,2506,2803,1503,2909,1003,28,13,331,167,243,141,88,26,26,,,,637,258,519,210,17,11,94,35,7,2,48,102,48
E02004580,Tendring 008,Middle Super Output Areas and Intermediate Zones,MSOAIZ,CO,11574,5535,9454,4619,5465,3181,3989,1438,25,12,491,258,227,115,264,143,143,,,,1501,586,1358,526,8,3,123,51,12,6,60,103,60
E02004581,Tendring 009,Middle Super Output Areas and Intermediate Zones,MSOAIZ,CO,7259,3101,6237,2675,2966,1552,3271,1123,15,5,305,127,221,97,84,30,30,,,,637,262,567,235,4,2,48,19,18,6,27,65,32
E02004582,Tendring 010,Middle Super Output Areas and Intermediate Zones,MSOAIZ,CO,6683,3188,5436,2655,3006,1737,2430,918,22,10,465,186,5,2,460,184,184,,,,690,294,583,241,5,4,88,40,14,9,53,70,43
E02004583,Tendring 011,Middle Super Output Areas and Intermediate Zones,MSOAIZ,CO,8204,3703,6260,2806,2815,1575,3445,1231,21,10,442,228,306,143,136,85,85,,,,1429,622,1321,575,9,2,94,43,5,2,47,52,37
E02004584,Tendring 012,Middle Super Output Areas and Intermediate Zones,MSOAIZ,CO,6385,3205,5546,2819,3550,2053,1996,766,12,8,107,51,57,24,50,27,27,,,,675,300,626,275,1,1,43,21,5,3,25,45,27
E02004585,Tendring 013,Middle Super Output Areas and Intermediate Zones,MSOAIZ,CO,7630,3312,5839,2602,2711,1498,3128,1104,41,19,580,225,195,75,385,150,150,,,,1127,437,1011,384,10,5,98,43,8,5,53,43,29
E02004586,Tendring 014,Middle Super Output Areas and Intermediate Zones,MSOAIZ,CO,7893,3631,5434,2477,2726,1528,2708,949,28,14,483,269,166,89,317,180,180,,,,1892,839,1762,775,5,3,116,57,9,4,64,56,32
E02004587,Tendring 015,Middle Super Output Areas and Intermediate Zones,MSOAIZ,CO,7744,3338,4337,1903,1871,1027,2466,876,42,15,1950,866,1142,513,808,353,353,,,,1340,504,1219,458,5,2,113,41,3,3,46,75,50
E02004588,Tendring 016,Middle Super Output Areas and Intermediate Zones,MSOAIZ,CO,5991,3019,2954,1369,1233,748,1721,621,36,25,517,302,219,127,298,175,175,,,,2425,1285,2314,1227,14,7,71,35,26,16,58,59,38
E02004589,Tendring 017,Middle Super Output Areas and Intermediate Zones,MSOAIZ,CO,7199,3141,5063,2274,2418,1361,2645,913,38,16,549,224,254,113,295,111,111,,,,1487,590,1397,546,2,1,83,39,5,4,44,62,37
E02004590,Tendring 018,Middle Super Output Areas and Intermediate Zones,MSOAIZ,CO,7449,3887,5211,2725,3206,1932,2005,793,29,14,460,228,145,76,315,152,152,,,,1655,862,1502,787,19,9,117,55,17,11,75,94,58
E02004591,Uttlesford 001,Middle Super Output Areas and Intermediate Zones,MSOAIZ,CB,6797,2705,5454,2118,2213,1078,3241,1040,73,32,463,184,359,151,104,33,33,,,,714,318,647,289,9,5,53,21,5,3,29,93,53
E02004592,Uttlesford 002,Middle Super Output Areas and Intermediate Zones,MSOAIZ,CB,11930,5158,7869,3322,3145,1652,4724,1670,113,53,2231,994,1161,530,1070,464,464,,,,1598,715,1414,638,37,12,113,52,34,13,77,119,74
E02004593,Uttlesford 003,Middle Super Output Areas and Intermediate Zones,MSOAIZ,SG,8128,3190,6390,2414,2837,1282,3553,1132,72,26,773,373,589,300,184,73,73,,,,789,320,710,290,30,13,37,14,12,3,30,104,57
E02004594,Uttlesford 004,Middle Super Output Areas and Intermediate Zones,MSOAIZ,CM,7528,2933,5215,2011,2251,1045,2964,966,87,32,849,372,589,274,260,98,98,,,,1290,470,697,281,361,106,39,21,193,62,189,87,48
E02004595,Uttlesford 005,Middle Super Output Areas and Intermediate Zones,MSOAIZ,CM,11811,4711,9464,3659,3427,1609,6037,2050,39,15,845,374,543,259,302,115,115,,,,1331,593,1224,548,15,6,83,34,9,5,45,132,70
E02004596,Uttlesford 006,Middle Super Output Areas and Intermediate Zones,MSOAIZ,CM,7617,2959,5073,1941,1817,846,3256,1095,127,60,1088,447,654,279,434,168,168,,,,1250,467,1166,435,22,7,42,16,20,9,32,79,44
E02004597,Uttlesford 007,Middle Super Output Areas and Intermediate Zones,MSOAIZ,CM,7219,3075,4983,1985,1698,860,3285,1125,157,64,1103,539,725,322,378,217,217,,,,931,455,869,431,12,4,47,19,3,1,24,45,32
E02004598,Uttlesford 008,Middle Super Output Areas and Intermediate Zones,MSOAIZ,CM,9963,3825,7827,2919,2889,1348,4938,1571,48,21,818,360,592,261,226,99,99,,,,1149,463,1046,419,17,8,66,26,20,10,44,121,62
E02004599,Uttlesford 009,Middle Super Output Areas and Intermediate Zones,MSOAIZ,CM,7302,2760,5708,2056,2054,948,3654,1108,47,18,705,318,630,284,75,34,34,,,,717,307,645,277,21,8,42,17,9,5,30,125,61
E02004600,Cheltenham 001,Middle Super Output Areas and Intermediate Zones,MSOAIZ,GL,5693,2451,4118,1799,1624,851,2494,948,26,9,587,247,476,204,111,43,43,,,,916,368,827,335,18,4,65,26,6,3,33,46,28
E02004601,Cheltenham 002,Middle Super Output Areas and Intermediate Zones,MSOAIZ,GL,5101,2341,4439,2017,2227,1233,2212,784,1,1,196,113,131,74,65,39,39,,,,424,185,373,162,8,2,40,19,3,2,23,41,25
E02004602,Cheltenham 003,Middle Super Output Areas and Intermediate Zones,MSOAIZ,GL,6320,2771,3221,1488,1020,572,2201,916,106,50,2013,825,1196,465,817,360,360,,,,947,384,884,356,5,3,38,17,20,8,28,33,24
E02004603,Cheltenham 004,Middle Super Output Areas and Intermediate Zones,MSOAIZ,GL,7202,2958,2501,1208,1083,579,1418,629,61,18,1111,531,627,292,484,239,239,,,,3483,1179,3334,1115,12,4,111,51,26,9,64,46,22
E02004604,Cheltenham 005,Middle Super Output Areas and Intermediate Zones,MSOAIZ,GL,7946,3437,3265,1367,1079,551,2186,816,169,67,3600,1576,2711,1256,889,320,320,,,,859,385,766,339,2,1,83,40,8,5,46,53,42
E02004605,Cheltenham 006,Middle Super Output Areas and Intermediate Zones,MSOAIZ,GL,5717,2443,2936,1273,1041,573,1895,700,26,10,2032,844,1823,739,209,105,105,,,,637,264,594,244,2,1,31,15,10,4,20,86,52
E02004606,Cheltenham 007,Middle Super Output Areas and Intermediate Zones,MSOAIZ,GL,9597,4147,5600,2463,1875,1018,3725,1445,65,23,1205,513,861,391,344,122,122,,,,2661,1109,2475,1033,8,3,152,64,26,9,76,66,39
E02004607,Cheltenham 008,Middle Super Output Areas and Intermediate Zones,MSOAIZ,GL,9360,4794,5332,2575,1993,1128,3339,1447,65,41,452,315,181,115,271,200,200,,,,3430,1810,3287,1740,7,3,120,59,16,8,70,81,53
E02004608,Cheltenham 009,Middle Super Output Areas and Intermediate Zones,MSOAIZ,GL,8890,5072,4122,2200,1930,1158,2192,1042,31,20,496,358,78,51,418,307,307,,,,4126,2430,3906,2330,47,16,123,73,50,11,100,115,64
E02004609,Cheltenham 010,Middle Super Output Areas and Intermediate Zones,MSOAIZ,GL,7251,3125,5749,2512,2330,1252,3419,1260,74,40,328,114,172,63,156,51,51,,,,1049,435,964,395,5,2,67,33,13,5,40,51,24
E02004610,Cheltenham 011,Middle Super Output Areas and Intermediate Zones,MSOAIZ,GL,7339,3618,5336,2613,2520,1476,2816,1137,15,9,220,134,76,37,144,97,97,,,,1651,801,1575,760,9,4,60,34,7,3,41,117,61
E02004611,Cheltenham 012,Middle Super Output Areas and Intermediate Zones,MSOAIZ,GL,10937,4586,8836,3703,3419,1801,5417,1902,75,29,543,262,356,182,187,80,80,,,,1403,552,1290,497,2,1,99,46,12,8,55,80,40
E02004612,Cheltenham 013,Middle Super Output Areas and Intermediate Zones,MSOAIZ,GL,9419,4155,7724,3391,3096,1725,4628,1666,67,38,505,242,381,173,124,69,69,,,,1090,462,1001,422,6,3,79,35,4,2,40,33,22
E02004613,Cheltenham 014,Middle Super Output Areas and Intermediate Zones,MSOAIZ,GL,6175,2755,5298,2328,2475,1361,2823,967,2,1,150,98,24,5,126,93,93,,,,691,306,668,295,8,3,14,7,1,1,11,34,22
E02004614,Cheltenham 015,Middle Super Output Areas and Intermediate Zones,MSOAIZ,GL,5201,2276,4474,1942,1975,1085,2499,857,7,4,119,55,99,44,20,11,11,,,,565,255,527,237,4,1,30,15,4,2,18,36,20
E02004615,Cotswold 001,Middle Super Output Areas and Intermediate Zones,MSOAIZ,WR,7833,3589,5477,2512,2903,1578,2574,934,138,62,1162,518,128,53,1034,465,465,,,,876,401,772,353,49,19,38,20,17,9,48,180,96
E02004616,Cotswold 002,Middle Super Output Areas and Intermediate Zones,MSOAIZ,OX,8540,4055,5488,2590,2829,1613,2659,977,122,48,1344,653,146,70,1198,583,583,,,,1309,620,1091,525,117,48,71,33,30,14,95,277,144
E02004617,Cotswold 003,Middle Super Output Areas and Intermediate Zones,MSOAIZ,OX,7607,3428,5153,2339,2484,1370,2669,969,118,59,996,419,84,31,912,388,388,,,,1100,496,950,429,66,26,63,31,21,10,67,240,115
E02004618,Cotswold 004,Middle Super Output Areas and Intermediate Zones,MSOAIZ,GL,7099,2990,4802,1984,2375,1148,2427,836,9,4,522,204,75,27,447,177,177,,,,1339,600,1182,527,85,36,53,27,19,10,73,427,198
E02004619,Cotswold 005,Middle Super Output Areas and Intermediate Zones,MSOAIZ,SN,7218,3171,4670,2019,2322,1182,2348,837,24,11,861,376,118,53,743,323,323,,,,1324,598,1148,516,65,26,57,27,54,29,82,339,167
E02004620,Cotswold 006,Middle Super Output Areas and Intermediate Zones,MSOAIZ,GL,7685,3149,5794,2353,2227,1153,3567,1200,48,24,1086,479,132,59,954,420,420,,,,704,261,630,231,5,2,53,22,16,6,30,53,32
E02004621,Cotswold 007,Middle Super Output Areas and Intermediate Zones,MSOAIZ,GL,5831,3103,3105,1568,1580,963,1525,605,38,16,1298,785,141,81,1157,704,704,,,,1304,676,1183,616,34,16,72,33,15,11,60,86,58
E02004622,Cotswold 008,Middle Super Output Areas and Intermediate Zones,MSOAIZ,GL,6553,2798,3745,1645,1604,859,2141,786,100,36,1366,572,174,73,1192,499,499,,,,1301,522,899,390,217,66,42,20,143,46,132,41,23
E02004623,Cotswold 009,Middle Super Output Areas and Intermediate Zones,MSOAIZ,GL,7894,3451,5658,2478,2701,1448,2957,1030,104,47,1089,479,164,71,925,408,408,,,,884,365,762,318,47,16,55,24,20,7,47,159,82
E02004624,Cotswold 010,Middle Super Output Areas and Intermediate Zones,MSOAIZ,GL,5872,2488,4087,1707,1776,903,2311,804,179,78,720,305,53,25,667,280,280,,,,822,366,734,326,35,14,40,22,13,4,40,64,32
E02004625,Cotswold 011,Middle Super Output Areas and Intermediate Zones,MSOAIZ,SN,9187,4014,6059,2608,2848,1474,3211,1134,120,56,1419,598,172,80,1247,518,518,,,,1308,613,1138,536,87,36,56,30,27,11,77,281,139
E02004626,Forest of Dean 001,Middle Super Output Areas and Intermediate Zones,MSOAIZ,WR,8736,3645,7146,2931,3684,1768,3462,1163,59,28,501,234,113,47,388,187,187,,,,885,383,756,329,34,11,73,35,22,8,54,145,69
E02004627,Forest of Dean 002,Middle Super Output Areas and Intermediate Zones,MSOAIZ,HR,5276,2302,3690,1605,1777,925,1913,680,31,13,655,298,130,58,525,240,240,,,,828,348,732,310,15,4,77,32,4,2,38,72,38
E02004628,Forest of Dean 003,Middle Super Output Areas and Intermediate Zones,MSOAIZ,HR,7647,3201,5925,2444,2587,1291,3338,1153,114,40,997,438,192,81,805,357,357,,,,541,237,449,195,8,4,69,32,15,6,42,70,42
E02004629,Forest of Dean 004,Middle Super Output Areas and Intermediate Zones,MSOAIZ,GL,12201,5333,8531,3666,3671,1928,4860,1738,31,16,2040,906,399,180,1641,726,726,,,,1484,673,1357,615,20,6,89,42,18,10,58,115,72
E02004630,Forest of Dean 005,Middle Super Output Areas and Intermediate Zones,MSOAIZ,GL,6307,2605,5023,2065,2417,1185,2606,880,24,15,375,164,96,39,279,125,125,,,,744,306,626,262,40,10,67,29,11,5,44,141,55
E02004631,Forest of Dean 006,Middle Super Output Areas and Intermediate Zones,MSOAIZ,NP,4944,2130,4213,1797,2026,1024,2187,773,6,2,262,120,52,24,210,96,96,,,,409,183,331,148,7,4,62,27,9,4,35,54,28
E02004632,Forest of Dean 007,Middle Super Output Areas and Intermediate Zones,MSOAIZ,NP,9957,4362,7081,3011,2931,1558,4150,1453,15,7,1725,759,330,133,1395,626,626,,,,1037,516,947,469,10,3,64,34,16,10,47,99,69
E02004633,Forest of Dean 008,Middle Super Output Areas and Intermediate Zones,MSOAIZ,NP,8144,3423,6294,2626,2820,1425,3474,1201,104,34,1021,439,124,52,897,387,387,,,,655,276,567,240,4,1,76,29,8,6,36,70,48
E02004634,Forest of Dean 009,Middle Super Output Areas and Intermediate Zones,MSOAIZ,GL,9919,4263,7217,3021,3053,1585,4164,1436,41,20,1413,644,255,112,1158,532,532,,,,1128,506,1008,449,12,4,97,48,11,5,57,120,72
E02004635,Forest of Dean 010,Middle Super Output Areas and Intermediate Zones,MSOAIZ,NP,6909,2903,5205,2205,2484,1277,2721,928,30,11,517,235,100,47,417,188,188,,,,1073,407,555,244,273,80,35,18,210,65,163,84,45
E02004636,Gloucester 001,Middle Super Output Areas and Intermediate Zones,MSOAIZ,GL,7882,3272,6884,2858,2703,1409,4181,1449,17,9,158,55,72,30,86,25,25,,,,763,322,674,286,2,1,85,34,2,1,36,60,28
E02004637,Gloucester 002,Middle Super Output Areas and Intermediate Zones,MSOAIZ,GL,8361,3965,4709,2142,2016,1134,2693,1008,83,46,863,548,376,257,487,291,291,,,,2627,1184,2512,1124,11,5,86,44,18,11,60,79,45
E02004638,Gloucester 003,Middle Super Output Areas and Intermediate Zones,MSOAIZ,GL,5670,2285,4773,1936,1760,915,3013,1021,21,7,306,128,228,98,78,30,30,,,,558,206,523,191,3,1,26,11,6,3,15,12,8
E02004639,Gloucester 004,Middle Super Output Areas and Intermediate Zones,MSOAIZ,GL,7842,3935,3552,1613,1398,751,2154,862,135,79,1163,702,448,301,715,401,401,,,,2876,1489,2688,1399,57,22,102,50,29,18,90,116,52
E02004640,Gloucester 005,Middle Super Output Areas and Intermediate Zones,MSOAIZ,GL,7828,2987,4240,1564,1815,734,2425,830,34,12,943,429,256,133,687,296,296,,,,2493,928,2331,868,16,5,118,46,28,9,60,118,54
E02004641,Gloucester 006,Middle Super Output Areas and Intermediate Zones,MSOAIZ,GL,7235,3260,6189,2766,2952,1643,3237,1123,25,14,332,159,238,103,94,56,56,,,,646,295,579,261,5,2,50,29,12,3,34,43,26
E02004642,Gloucester 007,Middle Super Output Areas and Intermediate Zones,MSOAIZ,GL,11853,4580,8817,3434,2627,1332,6190,2102,140,59,1611,560,993,333,618,227,227,,,,1239,502,1085,441,9,3,129,52,16,6,61,46,25
E02004643,Gloucester 008,Middle Super Output Areas and Intermediate Zones,MSOAIZ,GL,7771,3000,4033,1541,1152,554,2881,987,63,24,2010,739,1136,395,874,344,344,,,,1590,659,1492,623,7,2,83,29,8,5,36,75,37
E02004644,Gloucester 009,Middle Super Output Areas and Intermediate Zones,MSOAIZ,GL,8652,3547,5561,2218,1694,862,3867,1356,33,13,1495,707,920,462,575,245,245,,,,1509,578,1375,527,19,6,105,39,10,6,51,54,31
E02004645,Gloucester 010,Middle Super Output Areas and Intermediate Zones,MSOAIZ,GL,9471,3941,8018,3274,2428,1244,5590,2030,58,25,204,116,57,48,147,68,68,,,,1134,499,1038,454,0,0,88,40,8,5,45,57,27
E02004646,Gloucester 011,Middle Super Output Areas and Intermediate Zones,MSOAIZ,GL,8436,3782,4962,2077,1775,935,3187,1142,42,18,2545,1330,2254,1175,291,155,155,,,,797,299,718,266,0,0,71,29,8,4,33,90,58
E02004647,Gloucester 012,Middle Super Output Areas and Intermediate Zones,MSOAIZ,GL,5749,2423,3908,1616,1597,813,2311,803,63,30,1312,585,942,453,370,132,132,,,,412,161,360,138,9,4,39,17,4,2,23,54,31
E02004648,Gloucester 013,Middle Super Output Areas and Intermediate Zones,MSOAIZ,GL,5829,2549,4759,2094,2040,1121,2719,973,49,18,277,119,186,84,91,35,35,,,,708,301,630,268,9,3,62,26,7,4,33,36,17
E02004649,Gloucester 014,Middle Super Output Areas and Intermediate Zones,MSOAIZ,GL,6990,2812,5373,2115,1065,515,4308,1600,66,26,327,107,18,7,309,100,100,,,,1202,549,1091,496,2,2,102,47,7,4,53,22,15
E02004650,Gloucester 015,Middle Super Output Areas and Intermediate Zones,MSOAIZ,GL,10386,4025,6517,2610,1431,767,5086,1843,427,177,1326,430,80,42,1246,388,388,,,,2063,783,1693,670,190,51,68,32,112,30,113,53,25
E02004651,Stroud 001,Middle Super Output Areas and Intermediate Zones,MSOAIZ,GL,7586,3173,5788,2398,2041,1031,3747,1367,102,45,412,179,223,113,189,66,66,,,,1247,529,1140,486,44,14,51,23,12,6,43,37,22
E02004652,Stroud 002,Middle Super Output Areas and Intermediate Zones,MSOAIZ,GL,6299,2828,5072,2247,2915,1498,2157,749,31,14,305,152,242,120,63,32,32,,,,806,365,727,326,25,13,29,16,25,10,39,85,50
E02004653,Stroud 003,Middle Super Output Areas and Intermediate Zones,MSOAIZ,GL,6457,2569,5016,1981,2115,1032,2901,949,52,26,635,248,497,200,138,48,48,,,,654,270,549,233,45,11,47,20,13,6,37,100,44
E02004654,Stroud 004,Middle Super Output Areas and Intermediate Zones,MSOAIZ,GL,11159,4731,7975,3305,3261,1701,4714,1604,28,13,1787,813,1430,673,357,140,140,,,,1293,548,1197,505,10,6,83,36,3,1,43,76,52
E02004655,Stroud 005,Middle Super Output Areas and Intermediate Zones,MSOAIZ,GL,7422,3193,5069,2143,1810,973,3259,1170,20,12,1372,590,1195,525,177,65,65,,,,862,393,804,365,8,3,48,23,2,2,28,99,55
E02004656,Stroud 006,Middle Super Output Areas and Intermediate Zones,MSOAIZ,GL,10917,4967,7167,3117,2847,1500,4320,1617,88,38,1863,851,1139,541,724,310,310,,,,1693,892,1575,832,8,4,92,51,18,5,60,106,69
E02004657,Stroud 007,Middle Super Output Areas and Intermediate Zones,MSOAIZ,GL,6858,2860,5780,2379,2297,1159,3483,1220,18,9,368,142,222,83,146,59,59,,,,659,311,607,287,0,0,47,21,5,3,24,33,19
E02004658,Stroud 008,Middle Super Output Areas and Intermediate Zones,MSOAIZ,GL,6498,2681,5530,2218,2045,1054,3485,1164,13,5,237,108,199,92,38,16,16,,,,675,325,633,300,2,1,34,20,6,4,25,43,25
E02004659,Stroud 009,Middle Super Output Areas and Intermediate Zones,MSOAIZ,GL,6231,2640,4955,2034,2359,1167,2596,867,24,10,760,355,688,324,72,31,31,,,,416,192,379,168,7,4,24,16,6,4,24,76,49
E02004660,Stroud 010,Middle Super Output Areas and Intermediate Zones,MSOAIZ,GL,6306,2760,5045,2189,2657,1380,2388,809,16,6,665,303,541,252,124,51,51,,,,513,222,455,200,7,3,39,14,12,5,22,67,40
E02004661,Stroud 011,Middle Super Output Areas and Intermediate Zones,MSOAIZ,GL,8162,3573,6336,2688,2661,1408,3675,1280,39,23,1199,599,1006,529,193,70,70,,,,525,220,471,191,11,5,42,23,1,1,29,63,43
E02004662,Stroud 012,Middle Super Output Areas and Intermediate Zones,MSOAIZ,GL,5978,2540,4389,1814,1973,989,2416,825,31,14,652,298,551,258,101,40,40,,,,836,375,747,335,14,8,55,22,20,10,40,70,39
E02004663,Stroud 013,Middle Super Output Areas and Intermediate Zones,MSOAIZ,GL,6518,2827,4726,1936,1992,984,2734,952,66,34,855,421,602,278,253,143,143,,,,804,396,729,361,19,8,51,22,5,5,35,67,40
E02004664,Stroud 014,Middle Super Output Areas and Intermediate Zones,MSOAIZ,GL,6605,2909,4378,1887,1669,890,2709,997,60,33,1378,585,1015,448,363,137,137,,,,733,368,670,338,2,1,55,26,6,3,30,56,36
E02004665,Stroud 015,Middle Super Output Areas and Intermediate Zones,MSOAIZ,GL,8507,3543,6684,2652,2914,1421,3770,1231,6,3,885,453,787,387,98,66,66,,,,827,385,771,361,5,3,48,20,3,1,24,105,50
E02004666,Tewkesbury 001,Middle Super Output Areas and Intermediate Zones,MSOAIZ,GL,11464,4600,8371,3348,2232,1146,6139,2202,151,64,1219,471,130,49,1089,422,422,,,,1678,688,1351,558,144,46,109,56,74,28,130,45,29
E02004667,Tewkesbury 002,Middle Super Output Areas and Intermediate Zones,MSOAIZ,WR,10244,4819,6787,3057,3067,1679,3720,1378,103,45,2020,1014,315,148,1705,866,866,,,,1248,650,1085,577,29,9,105,49,29,15,73,86,53
E02004668,Tewkesbury 003,Middle Super Output Areas and Intermediate Zones,MSOAIZ,WR,8242,3684,6115,2671,3188,1661,2927,1010,165,76,800,393,144,64,656,329,329,,,,1009,458,903,410,22,11,58,24,26,13,48,153,86
E02004669,Tewkesbury 004,Middle Super Output Areas and Intermediate Zones,MSOAIZ,GL,6516,2731,5401,2244,2739,1331,2662,913,60,24,287,136,79,36,208,100,100,,,,653,276,580,248,3,1,54,20,16,7,28,115,51
E02004670,Tewkesbury 005,Middle Super Output Areas and Intermediate Zones,MSOAIZ,GL,12647,5574,9592,4278,3955,2191,5637,2087,122,51,1481,611,118,47,1363,564,564,,,,1363,587,1254,530,10,4,87,47,12,6,57,89,47
E02004671,Tewkesbury 006,Middle Super Output Areas and Intermediate Zones,MSOAIZ,GL,5802,2480,4776,1989,2313,1124,2463,865,20,9,285,139,93,37,192,102,102,,,,656,311,609,291,8,4,29,11,10,5,20,65,32
E02004672,Tewkesbury 007,Middle Super Output Areas and Intermediate Zones,MSOAIZ,GL,12249,5251,9031,3890,3543,1892,5488,1998,31,12,1056,465,224,97,832,368,368,,,,2039,837,1231,551,460,153,79,43,269,90,286,92,47
E02004673,Tewkesbury 008,Middle Super Output Areas and Intermediate Zones,MSOAIZ,GL,5323,2351,3987,1755,2170,1135,1817,620,17,9,791,361,172,76,619,285,285,,,,450,185,327,135,65,21,18,13,40,16,50,78,41
E02004674,Tewkesbury 009,Middle Super Output Areas and Intermediate Zones,MSOAIZ,GL,8566,3636,5998,2612,2340,1232,3658,1380,88,40,1507,600,469,173,1038,427,427,,,,926,359,817,311,18,7,77,35,14,6,48,47,25
E02004675,Basingstoke and Deane 001,Middle Super Output Areas and Intermediate Zones,MSOAIZ,RG,7339,3060,5601,2327,1943,1048,3658,1279,64,26,1051,447,52,17,999,430,430,,,,575,233,497,204,15,5,57,22,6,2,29,48,27
E02004676,Basingstoke and Deane 002,Middle Super Output Areas and Intermediate Zones,MSOAIZ,RG,7973,3361,6611,2735,2547,1281,4064,1454,33,15,471,223,11,6,460,217,217,,,,779,346,703,313,7,4,47,20,22,9,33,79,42
E02004677,Basingstoke and Deane 003,Middle Super Output Areas and Intermediate Zones,MSOAIZ,SO,7031,2707,5087,1928,2172,981,2915,947,68,24,971,368,63,25,908,343,343,,,,715,291,625,254,54,23,26,10,10,4,37,190,96
E02004678,Basingstoke and Deane 004,Middle Super Output Areas and Intermediate Zones,MSOAIZ,RG,7374,3127,5669,2325,2310,1162,3359,1163,32,18,772,377,52,33,720,344,344,,,,719,317,633,280,33,16,38,15,15,6,37,182,90
E02004679,Basingstoke and Deane 005,Middle Super Output Areas and Intermediate Zones,MSOAIZ,RG,8318,3430,6184,2480,2143,1039,4041,1441,60,30,1132,482,38,16,1094,466,466,,,,797,370,716,333,32,14,36,16,13,7,37,145,68
E02004680,Basingstoke and Deane 006,Middle Super Output Areas and Intermediate Zones,MSOAIZ,RG,6806,2849,5292,2155,1279,626,4013,1529,102,42,390,160,13,5,377,155,155,,,,1008,482,962,463,4,1,42,18,0,0,19,14,10
E02004681,Basingstoke and Deane 007,Middle Super Output Areas and Intermediate Zones,MSOAIZ,RG,11233,4551,5848,2364,1281,663,4567,1701,356,182,3620,1462,236,84,3384,1378,1378,,,,1340,504,1175,446,24,7,130,45,11,6,58,69,39
E02004682,Basingstoke and Deane 008,Middle Super Output Areas and Intermediate Zones,MSOAIZ,RG,7892,3238,5425,2242,1426,771,3999,1471,77,31,1347,504,64,27,1283,477,477,,,,1027,448,996,432,6,3,25,13,0,0,16,16,13
E02004683,Basingstoke and Deane 009,Middle Super Output Areas and Intermediate Zones,MSOAIZ,RG,6757,2802,3603,1478,1136,605,2467,873,155,58,2150,883,73,35,2077,848,848,,,,787,347,706,317,17,3,59,24,5,3,30,62,36
E02004684,Basingstoke and Deane 010,Middle Super Output Areas and Intermediate Zones,MSOAIZ,RG,8948,3645,5807,2355,1519,779,4288,1576,160,74,2160,875,92,45,2068,830,830,,,,787,319,712,288,0,0,74,30,1,1,31,34,22
E02004685,Basingstoke and Deane 011,Middle Super Output Areas and Intermediate Zones,MSOAIZ,RG,6910,3292,3551,1620,1214,684,2337,936,262,153,1279,671,27,15,1252,656,656,,,,1756,818,1670,780,7,4,62,24,17,10,38,62,30
E02004686,Basingstoke and Deane 012,Middle Super Output Areas and Intermediate Zones,MSOAIZ,RG,7928,3544,4650,2027,1462,816,3188,1211,133,69,1132,596,30,17,1102,579,579,,,,1933,814,1814,760,18,9,99,44,2,1,54,80,38
E02004687,Basingstoke and Deane 013,Middle Super Output Areas and Intermediate Zones,MSOAIZ,RG,7012,2761,3805,1541,1036,530,2769,1011,97,44,2504,941,85,38,2419,903,903,,,,568,211,506,190,6,1,44,16,12,4,21,38,24
E02004688,Basingstoke and Deane 014,Middle Super Output Areas and Intermediate Zones,MSOAIZ,RG,7661,3472,3952,1726,1411,778,2541,948,36,13,2971,1441,141,67,2830,1374,1374,,,,648,252,582,223,0,0,63,27,3,2,29,54,40
E02004689,Basingstoke and Deane 015,Middle Super Output Areas and Intermediate Zones,MSOAIZ,RG,5432,2277,4538,1854,2045,1032,2493,822,8,1,370,197,4,3,366,194,194,,,,453,192,409,173,17,10,17,6,10,3,19,63,33
E02004690,Basingstoke and Deane 016,Middle Super Output Areas and Intermediate Zones,MSOAIZ,RG,7846,3179,6223,2503,1907,964,4316,1539,63,31,749,300,24,11,725,289,289,,,,778,324,725,302,2,1,51,21,0,0,22,33,21
E02004691,Basingstoke and Deane 017,Middle Super Output Areas and Intermediate Zones,MSOAIZ,SO,7691,3232,5811,2376,2638,1309,3173,1067,89,43,670,311,14,8,656,303,303,,,,860,389,774,348,38,20,31,14,17,7,41,261,113
E02004692,Basingstoke and Deane 018,Middle Super Output Areas and Intermediate Zones,MSOAIZ,RG,7274,2996,6813,2775,2981,1519,3832,1256,4,2,222,120,10,4,212,116,116,,,,221,90,203,80,1,1,15,8,2,1,10,14,9
E02004693,Basingstoke and Deane 019,Middle Super Output Areas and Intermediate Zones,MSOAIZ,RG,7164,3041,4219,1722,964,499,3255,1223,53,22,2012,930,56,29,1956,901,901,,,,849,345,783,315,5,1,57,26,4,3,30,31,22
E02004694,Basingstoke and Deane 020,Middle Super Output Areas and Intermediate Zones,MSOAIZ,SP,6689,2872,4702,1976,1841,951,2861,1025,60,23,980,450,58,29,922,421,421,,,,814,361,704,317,44,15,63,27,3,2,44,133,62
E02004695,Basingstoke and Deane 021,Middle Super Output Areas and Intermediate Zones,MSOAIZ,RG,8971,3235,7325,2571,1169,521,6156,2050,52,24,573,219,14,5,559,214,214,,,,1011,414,984,396,8,4,19,14,0,0,18,10,7
E02004696,Basingstoke and Deane 022,Middle Super Output Areas and Intermediate Zones,MSOAIZ,SO,6219,2644,4437,1856,1930,959,2507,897,70,33,894,389,48,21,846,368,368,,,,719,305,593,259,68,23,49,20,9,3,46,99,61
E02004697,East Hampshire 001,Middle Super Output Areas and Intermediate Zones,MSOAIZ,RG,5524,2223,4369,1729,1909,899,2460,830,19,10,306,122,34,16,272,106,106,,,,714,307,577,252,70,28,40,17,27,10,55,116,55
E02004698,East Hampshire 002,Middle Super Output Areas and Intermediate Zones,MSOAIZ,GU,5474,2503,2398,1080,901,517,1497,563,44,21,2190,1016,372,170,1818,846,846,,,,778,343,707,313,16,5,38,18,17,7,30,64,43
E02004699,East Hampshire 003,Middle Super Output Areas and Intermediate Zones,MSOAIZ,GU,10525,4442,8419,3531,3427,1793,4992,1738,106,51,747,289,79,33,668,256,256,,,,1167,531,946,434,70,29,105,48,46,20,97,86,40
E02004700,East Hampshire 004,Middle Super Output Areas and Intermediate Zones,MSOAIZ,GU,5586,2170,2705,1085,629,319,2076,766,112,49,1353,543,210,84,1143,459,459,,,,1362,465,606,233,418,125,32,15,306,92,232,54,28
E02004702,East Hampshire 006,Middle Super Output Areas and Intermediate Zones,MSOAIZ,GU,8129,3241,5773,2391,1731,882,4042,1509,77,35,1445,477,175,65,1270,412,412,,,,776,312,701,282,15,4,48,22,12,4,30,58,26
E02004703,East Hampshire 007,Middle Super Output Areas and Intermediate Zones,MSOAIZ,SO,10582,4175,8734,3393,3798,1787,4936,1606,102,51,711,287,64,27,647,260,260,,,,833,346,715,295,40,19,67,27,11,5,51,202,98
E02004704,East Hampshire 008,Middle Super Output Areas and Intermediate Zones,MSOAIZ,GU,5662,2325,4155,1714,1647,807,2508,907,87,31,638,254,112,39,526,215,215,,,,706,284,515,214,111,39,38,16,42,15,70,76,42
E02004705,East Hampshire 009,Middle Super Output Areas and Intermediate Zones,MSOAIZ,GU,8389,3532,6470,2647,2548,1335,3922,1312,83,36,888,420,103,53,785,367,367,,,,851,380,776,342,22,9,44,23,9,6,38,97,49
E02004706,East Hampshire 010,Middle Super Output Areas and Intermediate Zones,MSOAIZ,SO,7246,3030,5575,2282,2465,1244,3110,1038,27,12,807,344,84,40,723,304,304,,,,764,348,688,318,15,6,36,16,25,8,30,73,44
E02004707,East Hampshire 011,Middle Super Output Areas and Intermediate Zones,MSOAIZ,PO,10972,4529,8126,3333,3624,1799,4502,1534,112,44,1005,417,98,49,907,368,368,,,,1455,609,1190,505,164,55,71,33,30,16,104,274,126
E02004708,East Hampshire 012,Middle Super Output Areas and Intermediate Zones,MSOAIZ,GU,8609,3918,5178,2373,2301,1321,2877,1052,93,49,1817,755,160,74,1657,681,681,,,,1454,696,1343,648,16,7,89,39,6,2,48,67,45
E02004709,East Hampshire 013,Middle Super Output Areas and Intermediate Zones,MSOAIZ,PO,7379,3020,6354,2577,2434,1230,3920,1347,21,7,451,184,55,22,396,162,162,,,,495,222,435,202,4,2,56,18,0,0,20,58,30
E02004710,East Hampshire 014,Middle Super Output Areas and Intermediate Zones,MSOAIZ,PO,6383,2569,5207,2040,1931,950,3276,1090,10,4,625,310,61,37,564,273,273,,,,492,187,446,167,0,0,32,15,14,5,20,49,28
E02004712,Eastleigh 001,Middle Super Output Areas and Intermediate Zones,MSOAIZ,SO,8664,3487,7767,3122,3476,1778,4291,1344,37,17,94,34,0,0,94,34,34,,,,744,297,701,276,2,1,41,20,0,0,21,22,17
E02004713,Eastleigh 002,Middle Super Output Areas and Intermediate Zones,MSOAIZ,SO,7845,3212,6716,2723,2569,1307,4147,1416,20,7,297,165,24,16,273,149,149,,,,773,292,708,266,1,1,62,23,2,2,26,39,25
E02004714,Eastleigh 003,Middle Super Output Areas and Intermediate Zones,MSOAIZ,SO,7632,3371,6380,2758,2595,1406,3785,1352,51,31,309,160,26,13,283,147,147,,,,844,393,772,353,7,4,62,33,3,3,40,48,29
E02004715,Eastleigh 004,Middle Super Output Areas and Intermediate Zones,MSOAIZ,SO,8046,3429,5562,2325,1828,949,3734,1376,103,46,1260,571,83,43,1177,528,528,,,,1072,457,1000,420,0,0,61,32,11,5,37,49,30
E02004716,Eastleigh 005,Middle Super Output Areas and Intermediate Zones,MSOAIZ,SO,8780,3563,6557,2616,2295,1170,4262,1446,79,37,1357,585,95,44,1262,541,541,,,,747,299,678,268,2,1,59,27,8,3,31,40,26
E02004717,Eastleigh 006,Middle Super Output Areas and Intermediate Zones,MSOAIZ,SO,9613,3996,4915,2007,1458,761,3457,1246,247,91,3206,1362,327,152,2879,1210,1210,,,,1178,496,1060,447,7,2,98,41,13,6,49,67,40
E02004718,Eastleigh 007,Middle Super Output Areas and Intermediate Zones,MSOAIZ,SO,8851,3796,4837,2023,1387,712,3450,1311,137,63,1718,757,152,72,1566,685,685,,,,2061,905,1906,837,9,5,134,57,12,6,68,98,48
E02004719,Eastleigh 008,Middle Super Output Areas and Intermediate Zones,MSOAIZ,SO,10033,3977,8886,3473,3113,1566,5773,1907,26,13,253,132,27,11,226,121,121,,,,817,333,727,299,13,2,76,31,1,1,34,51,26
E02004720,Eastleigh 009,Middle Super Output Areas and Intermediate Zones,MSOAIZ,SO,10609,4748,8457,3702,3200,1730,5257,1972,114,55,796,361,59,25,737,336,336,,,,1186,596,1087,543,8,4,84,45,7,4,53,56,34
E02004721,Eastleigh 010,Middle Super Output Areas and Intermediate Zones,MSOAIZ,SO,9204,3569,7046,2673,1552,777,5494,1896,204,96,771,270,47,17,724,253,253,,,,1143,512,1062,471,5,2,75,38,1,1,41,40,18
E02004722,Eastleigh 011,Middle Super Output Areas and Intermediate Zones,MSOAIZ,SO,7135,3098,5335,2218,1994,1083,3341,1135,49,25,1047,538,109,57,938,481,481,,,,671,296,601,264,10,5,60,27,0,0,32,33,21
E02004723,Eastleigh 012,Middle Super Output Areas and Intermediate Zones,MSOAIZ,SO,9282,3816,8296,3386,3126,1596,5170,1790,34,13,118,54,14,6,104,48,48,,,,799,347,722,314,9,3,64,28,4,2,33,35,16
E02004724,Eastleigh 013,Middle Super Output Areas and Intermediate Zones,MSOAIZ,SO,7629,3200,4937,2113,1818,929,3119,1184,72,30,1710,643,82,36,1628,607,607,,,,851,381,770,344,13,4,58,29,10,4,37,59,33
E02004725,Eastleigh 014,Middle Super Output Areas and Intermediate Zones,MSOAIZ,SO,5246,2398,3428,1488,1227,664,2201,824,21,8,994,505,87,50,907,455,455,,,,747,373,658,336,12,5,60,26,17,6,37,56,24
E02004726,Eastleigh 015,Middle Super Output Areas and Intermediate Zones,MSOAIZ,SO,5697,2517,3926,1735,1502,800,2424,935,40,20,630,274,73,31,557,243,243,,,,1056,461,985,426,4,3,43,22,24,10,35,45,27
E02004727,Fareham 001,Middle Super Output Areas and Intermediate Zones,MSOAIZ,SO,8847,3384,7564,2851,2047,986,5517,1865,57,25,424,163,115,41,309,122,122,,,,766,325,640,273,45,21,67,27,14,4,52,36,20
E02004728,Fareham 002,Middle Super Output Areas and Intermediate Zones,MSOAIZ,SO,8480,3472,6460,2585,2036,1034,4424,1551,116,51,784,369,239,139,545,230,230,,,,1061,436,870,368,70,20,63,31,58,17,68,59,31
E02004729,Fareham 003,Middle Super Output Areas and Intermediate Zones,MSOAIZ,PO,7357,3062,5115,2151,1786,951,3329,1200,49,21,1600,637,1066,468,534,169,169,,,,547,221,483,195,16,3,48,23,0,0,26,46,32
E02004730,Fareham 004,Middle Super Output Areas and Intermediate Zones,MSOAIZ,PO,8558,3544,7577,3139,3356,1717,4221,1422,21,10,295,136,44,14,251,122,122,,,,591,224,518,196,10,2,35,18,28,8,28,74,35
E02004731,Fareham 005,Middle Super Output Areas and Intermediate Zones,MSOAIZ,SO,7871,3232,6817,2733,2367,1217,4450,1516,13,8,176,93,70,37,106,56,56,,,,828,380,765,345,4,2,53,30,6,3,35,37,18
E02004732,Fareham 006,Middle Super Output Areas and Intermediate Zones,MSOAIZ,SO,7923,3279,6584,2735,2539,1337,4045,1398,13,8,442,173,337,129,105,44,44,,,,843,338,737,296,15,6,85,32,6,4,42,41,25
E02004733,Fareham 007,Middle Super Output Areas and Intermediate Zones,MSOAIZ,SO,7319,3111,5537,2355,2164,1110,3373,1245,158,61,694,297,408,192,286,105,105,,,,881,367,688,299,95,28,59,25,39,15,68,49,31
E02004734,Fareham 008,Middle Super Output Areas and Intermediate Zones,MSOAIZ,PO,9978,4370,7843,3384,2968,1589,4875,1795,41,19,649,292,288,103,361,189,189,,,,1365,624,1231,569,24,9,100,39,10,7,55,80,51
E02004735,Fareham 009,Middle Super Output Areas and Intermediate Zones,MSOAIZ,PO,7396,3206,6455,2873,2970,1615,3485,1258,26,11,80,29,26,11,54,18,18,,,,807,277,446,168,189,55,53,19,119,35,109,28,16
E02004736,Fareham 010,Middle Super Output Areas and Intermediate Zones,MSOAIZ,PO,7820,3398,7017,3057,2998,1631,4019,1426,13,7,254,112,194,90,60,22,22,,,,506,204,442,177,4,1,55,23,5,3,27,30,18
E02004737,Fareham 011,Middle Super Output Areas and Intermediate Zones,MSOAIZ,PO,7375,3278,4571,1968,1444,818,3127,1150,52,27,1574,764,1141,588,433,176,176,,,,1096,470,982,425,29,8,83,35,2,2,45,82,49
E02004738,Fareham 012,Middle Super Output Areas and Intermediate Zones,MSOAIZ,PO,7362,3212,5905,2560,2410,1315,3495,1245,13,6,792,369,681,312,111,57,57,,,,606,247,521,211,0,0,74,32,11,4,36,46,30
E02004739,Fareham 013,Middle Super Output Areas and Intermediate Zones,MSOAIZ,PO,6727,2913,5620,2404,2568,1390,3052,1014,40,19,527,266,411,223,116,43,43,,,,497,195,450,172,9,4,36,17,2,2,23,43,29
E02004740,Fareham 014,Middle Super Output Areas and Intermediate Zones,MSOAIZ,PO,7112,3118,6003,2665,2858,1569,3145,1096,4,4,132,85,44,23,88,62,62,,,,926,337,506,212,239,69,43,17,138,39,125,47,27
E02004741,Gosport 001,Middle Super Output Areas and Intermediate Zones,MSOAIZ,PO,7755,3161,5384,2195,1915,999,3469,1196,90,32,1633,705,1220,499,413,206,206,,,,594,196,513,170,12,3,65,22,4,1,26,54,33
E02004742,Gosport 002,Middle Super Output Areas and Intermediate Zones,MSOAIZ,PO,7491,3231,4811,2056,1701,909,3110,1147,14,7,1699,829,1343,658,356,171,171,,,,906,303,654,223,99,29,78,29,75,22,80,61,36
E02004743,Gosport 003,Middle Super Output Areas and Intermediate Zones,MSOAIZ,PO,7622,3162,6088,2526,2011,1067,4077,1459,33,10,386,190,247,139,139,51,51,,,,1068,405,832,315,99,33,103,44,34,13,90,47,31
E02004744,Gosport 004,Middle Super Output Areas and Intermediate Zones,MSOAIZ,PO,8605,3251,2979,1331,755,434,2224,897,92,36,2689,910,448,220,2241,690,690,,,,2806,953,1346,499,819,248,99,44,542,162,454,39,21
E02004745,Gosport 005,Middle Super Output Areas and Intermediate Zones,MSOAIZ,PO,8998,3900,5362,2267,1350,737,4012,1530,171,91,1661,758,996,464,665,294,294,,,,1734,746,1598,688,14,6,108,45,14,7,58,70,38
E02004746,Gosport 006,Middle Super Output Areas and Intermediate Zones,MSOAIZ,PO,10746,4616,8142,3555,3188,1804,4954,1751,155,67,734,337,265,110,469,227,227,,,,1657,620,991,435,458,113,75,37,133,35,185,58,37
E02004747,Gosport 007,Middle Super Output Areas and Intermediate Zones,MSOAIZ,PO,6526,2914,4380,1989,1478,847,2902,1142,98,37,629,323,396,230,233,93,93,,,,1379,541,965,409,169,47,114,46,131,39,132,40,24
E02004748,Gosport 008,Middle Super Output Areas and Intermediate Zones,MSOAIZ,PO,9517,4767,3921,1936,1367,845,2554,1091,146,80,2934,1466,1769,884,1165,582,582,,,,2364,1203,2179,1118,19,6,132,61,34,18,85,152,82
E02004749,Gosport 009,Middle Super Output Areas and Intermediate Zones,MSOAIZ,PO,6948,3058,5932,2644,2733,1562,3199,1082,8,4,127,67,14,8,113,59,59,,,,847,325,522,225,227,65,48,22,50,13,100,34,18
E02004750,Gosport 010,Middle Super Output Areas and Intermediate Zones,MSOAIZ,PO,7558,3370,5943,2616,2187,1209,3756,1407,34,17,433,230,184,85,249,145,145,,,,1102,485,950,424,57,18,69,32,26,11,61,46,22
E02004751,Hart 001,Middle Super Output Areas and Intermediate Zones,MSOAIZ,GU,8162,3293,6598,2618,2469,1229,4129,1389,19,9,800,386,41,22,759,364,364,,,,697,251,564,205,60,20,40,17,33,9,46,48,29
E02004752,Hart 002,Middle Super Output Areas and Intermediate Zones,MSOAIZ,RG,8313,3162,7491,2834,2428,1161,5063,1673,28,10,188,81,6,3,182,78,78,,,,583,224,532,205,7,2,42,16,2,1,19,23,13
E02004753,Hart 003,Middle Super Output Areas and Intermediate Zones,MSOAIZ,GU,10003,3851,8238,3209,2838,1408,5400,1801,70,31,659,209,56,21,603,188,188,,,,985,374,832,319,37,12,93,34,23,9,55,51,28
E02004754,Hart 004,Middle Super Output Areas and Intermediate Zones,MSOAIZ,RG,6044,2549,4421,1815,1972,965,2449,850,14,5,766,357,85,36,681,321,321,,,,739,317,656,280,48,21,23,10,12,6,37,104,55
E02004755,Hart 005,Middle Super Output Areas and Intermediate Zones,MSOAIZ,RG,11533,4728,8252,3304,2154,1178,6098,2126,470,202,548,221,19,11,529,210,210,,,,2165,950,2059,906,21,8,79,34,6,2,44,98,51
E02004756,Hart 006,Middle Super Output Areas and Intermediate Zones,MSOAIZ,RG,8220,3214,6555,2475,2170,1002,4385,1473,142,71,649,305,64,26,585,279,279,,,,838,343,736,306,15,5,69,24,18,8,37,36,20
E02004757,Hart 007,Middle Super Output Areas and Intermediate Zones,MSOAIZ,GU,8031,3160,7379,2882,3181,1532,4198,1350,12,7,165,83,12,7,153,76,76,,,,445,171,407,153,10,4,25,12,3,2,18,30,17
E02004758,Hart 008,Middle Super Output Areas and Intermediate Zones,MSOAIZ,RG,7705,3100,6171,2381,2494,1200,3677,1181,50,22,807,395,64,32,743,363,363,,,,616,273,562,250,22,7,27,12,5,4,23,61,29
E02004759,Hart 009,Middle Super Output Areas and Intermediate Zones,MSOAIZ,GU,8007,3239,7006,2814,2498,1305,4508,1509,27,9,297,122,18,10,279,112,112,,,,644,278,591,254,12,5,38,16,3,3,24,33,16
E02004760,Hart 010,Middle Super Output Areas and Intermediate Zones,MSOAIZ,GU,7689,2941,5425,2106,1868,892,3557,1214,71,31,585,246,40,19,545,227,227,,,,1554,535,693,287,554,156,29,13,278,79,248,54,23
E02004761,Hart 011,Middle Super Output Areas and Intermediate Zones,MSOAIZ,RG,5662,2273,3120,1309,1519,738,1601,571,30,9,718,313,50,28,668,285,285,,,,1612,570,508,215,669,206,34,14,401,135,355,182,72
E02004764,Havant 003,Middle Super Output Areas and Intermediate Zones,MSOAIZ,PO,7790,3421,6677,2849,2941,1562,3736,1287,33,16,611,362,163,89,448,273,273,,,,429,161,394,146,2,1,33,14,0,0,15,40,33
E02004765,Havant 004,Middle Super Output Areas and Intermediate Zones,MSOAIZ,PO,6011,2640,5080,2193,1888,1017,3192,1176,7,4,43,20,9,5,34,15,15,,,,847,407,782,380,2,1,62,25,1,1,27,34,16
E02004766,Havant 005,Middle Super Output Areas and Intermediate Zones,MSOAIZ,PO,6304,2632,3845,1530,1416,715,2429,815,13,6,1899,864,282,109,1617,755,755,,,,501,200,447,178,9,2,30,15,15,5,22,46,32
E02004767,Havant 006,Middle Super Output Areas and Intermediate Zones,MSOAIZ,PO,5861,2247,2693,1078,818,411,1875,667,58,21,2511,940,1835,739,676,201,201,,,,532,173,433,136,0,0,97,36,2,1,37,67,35
E02004768,Havant 007,Middle Super Output Areas and Intermediate Zones,MSOAIZ,PO,5562,2274,3445,1409,1069,544,2376,865,32,13,1406,561,130,60,1276,501,501,,,,652,275,581,250,2,2,69,23,0,0,25,27,16
E02004769,Havant 008,Middle Super Output Areas and Intermediate Zones,MSOAIZ,PO,6388,2478,2512,980,727,380,1785,600,71,30,3160,1234,2458,1011,702,223,223,,,,596,207,524,181,4,1,66,24,2,1,26,49,27
E02004770,Havant 009,Middle Super Output Areas and Intermediate Zones,MSOAIZ,PO,6906,2880,3391,1391,992,541,2399,850,36,14,2821,1224,1925,863,896,361,361,,,,586,213,499,179,0,0,73,28,14,6,34,72,38
E02004771,Havant 010,Middle Super Output Areas and Intermediate Zones,MSOAIZ,PO,8968,3621,4347,1749,1336,710,3011,1039,73,35,3492,1429,2386,996,1106,433,433,,,,966,353,870,314,0,0,84,33,12,6,39,90,55
E02004772,Havant 011,Middle Super Output Areas and Intermediate Zones,MSOAIZ,PO,9118,3852,7500,3067,2608,1384,4892,1683,32,22,812,442,676,387,136,55,55,,,,724,290,649,259,2,1,62,28,11,2,31,50,31
E02004774,Havant 013,Middle Super Output Areas and Intermediate Zones,MSOAIZ,PO,9278,4329,7086,3279,3817,2115,3269,1164,28,16,928,434,117,43,811,391,391,,,,1145,542,913,459,95,30,49,25,88,28,83,91,58
E02004775,Havant 014,Middle Super Output Areas and Intermediate Zones,MSOAIZ,PO,8744,3969,6655,2984,2984,1670,3671,1314,37,19,921,435,101,45,820,390,390,,,,1085,498,1008,461,18,8,47,22,12,7,37,46,33
E02004776,Havant 015,Middle Super Output Areas and Intermediate Zones,MSOAIZ,PO,5793,2546,4935,2159,2420,1286,2515,873,15,6,373,171,67,25,306,146,146,,,,416,180,356,150,16,8,35,15,9,7,30,54,30
E02004777,Havant 016,Middle Super Output Areas and Intermediate Zones,MSOAIZ,PO,5275,2608,3653,1784,1941,1101,1712,683,20,10,613,307,50,27,563,280,280,,,,957,484,858,437,1,1,87,41,11,5,47,32,23
E02004778,Havant 017,Middle Super Output Areas and Intermediate Zones,MSOAIZ,PO,5864,2805,4709,2224,2415,1345,2294,879,13,8,265,132,56,29,209,103,103,,,,833,414,754,376,14,6,62,30,3,2,38,44,27
E02004779,New Forest 001,Middle Super Output Areas and Intermediate Zones,MSOAIZ,SP,10679,4691,7808,3405,4034,2082,3774,1323,58,21,1050,485,687,315,363,170,170,,,,1542,670,1365,590,65,27,84,38,28,15,80,221,110
E02004780,New Forest 002,Middle Super Output Areas and Intermediate Zones,MSOAIZ,SO,6000,2550,4217,1779,1608,847,2609,932,30,11,1124,502,859,427,265,75,75,,,,582,229,516,206,10,1,48,19,8,3,23,47,29
E02004781,New Forest 003,Middle Super Output Areas and Intermediate Zones,MSOAIZ,SO,8147,3332,6409,2632,1943,995,4466,1637,67,22,677,236,96,44,581,192,192,,,,938,413,846,371,10,4,82,38,0,0,42,56,29
E02004782,New Forest 004,Middle Super Output Areas and Intermediate Zones,MSOAIZ,SO,7575,3322,5433,2356,2171,1181,3262,1175,82,32,1057,488,605,287,452,201,201,,,,930,401,835,361,15,5,64,28,16,7,40,73,45
E02004783,New Forest 005,Middle Super Output Areas and Intermediate Zones,MSOAIZ,SO,7037,2924,5629,2342,1929,981,3700,1361,22,11,576,222,346,138,230,84,84,,,,766,324,686,290,0,0,77,32,3,2,34,44,25
E02004784,New Forest 006,Middle Super Output Areas and Intermediate Zones,MSOAIZ,SO,5430,2289,4819,2007,2456,1215,2363,792,4,4,177,81,88,39,89,42,42,,,,395,178,353,159,18,6,18,9,6,4,19,35,19
E02004785,New Forest 007,Middle Super Output Areas and Intermediate Zones,MSOAIZ,SP,5344,2422,4128,1812,2252,1146,1876,666,26,10,405,223,281,150,124,73,73,,,,674,323,562,274,42,16,38,20,32,13,49,111,54
E02004786,New Forest 008,Middle Super Output Areas and Intermediate Zones,MSOAIZ,SO,8696,3608,5942,2532,1982,1036,3960,1496,61,27,1128,398,410,148,718,250,250,,,,1524,629,1051,464,293,87,84,44,96,34,165,41,22
E02004787,New Forest 009,Middle Super Output Areas and Intermediate Zones,MSOAIZ,SO,7372,3480,6030,2814,2944,1658,3086,1156,26,16,420,205,219,99,201,106,106,,,,857,418,768,375,13,6,63,30,13,7,43,39,27
E02004788,New Forest 010,Middle Super Output Areas and Intermediate Zones,MSOAIZ,SP,7071,2887,5962,2437,2706,1360,3256,1077,43,19,281,128,142,65,139,63,63,,,,734,276,645,238,17,10,53,20,19,8,38,51,27
E02004789,New Forest 011,Middle Super Output Areas and Intermediate Zones,MSOAIZ,SO,10399,4406,7277,3088,3216,1689,4061,1399,89,49,2042,872,1289,545,753,327,327,,,,931,362,682,279,137,40,54,24,58,19,83,60,35
E02004790,New Forest 012,Middle Super Output Areas and Intermediate Zones,MSOAIZ,BH,7570,3445,4839,2159,2085,1180,2754,979,52,31,1137,530,818,365,319,165,165,,,,1475,690,1345,629,7,3,114,53,9,5,61,67,35
E02004791,New Forest 013,Middle Super Output Areas and Intermediate Zones,MSOAIZ,SO,5594,2201,3327,1364,1242,650,2085,714,26,9,1792,654,701,288,1091,366,366,,,,418,157,351,128,0,0,53,25,14,4,29,31,17
E02004792,New Forest 014,Middle Super Output Areas and Intermediate Zones,MSOAIZ,SO,8640,3723,6805,2973,3183,1689,3622,1284,58,23,778,303,338,117,440,186,186,,,,931,387,763,331,49,12,66,27,53,17,56,68,37
E02004793,New Forest 015,Middle Super Output Areas and Intermediate Zones,MSOAIZ,SO,7100,3081,5766,2525,3325,1691,2441,834,26,11,536,215,344,140,192,75,75,,,,691,286,601,251,58,18,30,15,2,2,35,81,44
E02004794,New Forest 016,Middle Super Output Areas and Intermediate Zones,MSOAIZ,BH,6760,2825,5331,2231,2591,1300,2740,931,15,7,472,194,325,132,147,62,62,,,,804,324,687,278,54,20,34,13,29,13,46,138,69
E02004795,New Forest 017,Middle Super Output Areas and Intermediate Zones,MSOAIZ,SO,8258,4028,5455,2661,3370,1886,2085,775,49,28,763,350,538,256,225,94,94,,,,1723,846,1501,745,123,47,66,35,33,19,101,268,143
E02004796,New Forest 018,Middle Super Output Areas and Intermediate Zones,MSOAIZ,SO,9587,4259,8332,3733,4381,2366,3951,1367,25,16,351,165,131,61,220,104,104,,,,801,308,701,274,9,4,84,28,7,2,34,78,37
E02004797,New Forest 019,Middle Super Output Areas and Intermediate Zones,MSOAIZ,SO,7853,3540,4689,2164,2047,1166,2642,998,91,46,1914,822,1572,690,342,132,132,,,,1073,460,993,427,1,1,70,29,9,3,33,86,48
E02004798,New Forest 020,Middle Super Output Areas and Intermediate Zones,MSOAIZ,BH,6075,2668,3413,1512,1437,801,1976,711,57,27,1861,819,1336,610,525,209,209,,,,688,275,622,250,11,4,55,21,0,0,25,56,35
E02004799,New Forest 021,Middle Super Output Areas and Intermediate Zones,MSOAIZ,SO,7707,3881,5438,2781,3181,1893,2257,888,78,39,729,382,357,178,372,204,204,,,,1393,632,1306,593,8,2,62,28,17,9,39,69,47
E02004800,New Forest 022,Middle Super Output Areas and Intermediate Zones,MSOAIZ,SO,7145,3561,6310,3164,4049,2311,2261,853,15,10,119,66,25,6,94,60,60,,,,653,291,587,260,31,11,31,18,4,2,31,48,30
E02004801,New Forest 023,Middle Super Output Areas and Intermediate Zones,MSOAIZ,SO,7452,3716,6213,3132,4020,2307,2193,825,35,15,231,100,200,85,31,15,15,,,,870,414,788,380,24,6,48,23,10,5,34,103,55
E02004802,Rushmoor 001,Middle Super Output Areas and Intermediate Zones,MSOAIZ,GU,6752,2547,4117,1587,1148,608,2969,979,40,18,1924,717,261,105,1663,612,612,,,,618,198,466,157,16,6,105,29,31,6,41,53,27
E02004803,Rushmoor 002,Middle Super Output Areas and Intermediate Zones,MSOAIZ,GU,7546,2648,3529,1259,672,326,2857,933,102,36,2832,1067,324,134,2508,933,933,,,,1002,262,728,207,5,1,239,46,30,8,55,81,24
E02004804,Rushmoor 003,Middle Super Output Areas and Intermediate Zones,MSOAIZ,GU,7213,2780,6200,2397,1715,879,4485,1518,44,15,264,106,27,15,237,91,91,,,,680,250,543,212,15,3,79,25,43,10,38,25,12
E02004805,Rushmoor 004,Middle Super Output Areas and Intermediate Zones,MSOAIZ,GU,8171,3334,6629,2661,2293,1177,4336,1484,181,110,378,176,21,11,357,165,165,,,,935,364,820,324,36,14,53,18,26,8,40,48,23
E02004806,Rushmoor 005,Middle Super Output Areas and Intermediate Zones,MSOAIZ,GU,8173,3177,6172,2427,1681,823,4491,1604,261,99,782,288,67,30,715,258,258,,,,903,338,647,250,106,33,53,24,97,31,88,55,25
E02004807,Rushmoor 006,Middle Super Output Areas and Intermediate Zones,MSOAIZ,GU,9043,3785,6167,2642,2029,1105,4138,1537,158,57,1428,555,175,75,1253,480,480,,,,1226,499,1064,436,44,18,80,30,38,15,63,64,32
E02004808,Rushmoor 007,Middle Super Output Areas and Intermediate Zones,MSOAIZ,GU,10176,4180,5638,2285,1537,790,4101,1495,115,68,1335,622,108,53,1227,569,569,,,,3014,1169,1732,762,723,218,72,30,487,159,407,74,36
E02004809,Rushmoor 008,Middle Super Output Areas and Intermediate Zones,MSOAIZ,GU,7520,2856,1215,573,304,168,911,405,296,158,1083,477,85,44,998,433,433,,,,4878,1626,1900,744,1628,468,51,22,1299,392,882,48,22
E02004810,Rushmoor 009,Middle Super Output Areas and Intermediate Zones,MSOAIZ,GU,7533,2945,4801,1862,1018,523,3783,1339,66,32,1356,559,221,85,1135,474,474,,,,1261,471,1103,414,23,8,93,36,42,13,57,49,21
E02004811,Rushmoor 010,Middle Super Output Areas and Intermediate Zones,MSOAIZ,GU,7339,3210,4867,2065,1593,852,3274,1213,52,31,723,408,101,57,622,351,351,,,,1645,679,1513,630,18,5,73,32,41,12,49,52,27
E02004812,Rushmoor 011,Middle Super Output Areas and Intermediate Zones,MSOAIZ,GU,6419,2395,5245,1984,1529,735,3716,1249,44,16,159,51,11,3,148,48,48,,,,955,334,878,307,5,2,58,19,14,6,27,16,10
E02004813,Rushmoor 012,Middle Super Output Areas and Intermediate Zones,MSOAIZ,GU,6005,2487,3403,1347,903,448,2500,899,23,7,1991,901,321,159,1670,742,742,,,,514,189,462,164,6,1,43,21,3,3,25,74,43
E02004814,Test Valley 001,Middle Super Output Areas and Intermediate Zones,MSOAIZ,SP,7022,2861,5391,2175,1810,896,3581,1279,34,12,612,266,125,58,487,208,208,,,,845,339,752,303,39,13,46,20,8,3,36,140,69
E02004815,Test Valley 002,Middle Super Output Areas and Intermediate Zones,MSOAIZ,SP,7612,2837,3216,1286,624,331,2592,955,58,17,3635,1269,1478,510,2157,759,759,,,,649,238,538,200,32,6,74,30,5,2,38,54,27
E02004816,Test Valley 003,Middle Super Output Areas and Intermediate Zones,MSOAIZ,SP,8966,3968,5103,2098,1795,925,3308,1173,116,55,2359,1200,599,303,1760,897,897,,,,1296,559,1034,470,150,45,81,32,31,12,89,92,56
E02004817,Test Valley 004,Middle Super Output Areas and Intermediate Zones,MSOAIZ,SP,7616,3259,4841,2015,1620,861,3221,1154,68,34,1513,687,599,245,914,442,442,,,,1125,484,1031,437,20,5,67,37,7,5,47,69,39
E02004818,Test Valley 005,Middle Super Output Areas and Intermediate Zones,MSOAIZ,SP,10070,4092,7094,2917,2650,1377,4444,1540,78,29,1110,466,277,126,833,340,340,,,,1689,630,1055,423,377,120,73,27,184,60,207,99,50
E02004819,Test Valley 006,Middle Super Output Areas and Intermediate Zones,MSOAIZ,SP,7644,3291,5956,2471,2118,1127,3838,1344,36,20,432,234,113,67,319,167,167,,,,1158,533,1075,494,8,3,66,30,9,6,39,62,33
E02004820,Test Valley 007,Middle Super Output Areas and Intermediate Zones,MSOAIZ,SP,7091,2856,4443,1833,1920,942,2523,891,74,29,763,346,254,120,509,226,226,,,,1725,604,612,249,703,222,27,12,383,121,355,86,44
E02004821,Test Valley 008,Middle Super Output Areas and Intermediate Zones,MSOAIZ,SP,5129,2161,3609,1486,1671,818,1938,668,11,4,400,196,102,56,298,140,140,,,,787,336,600,265,94,33,42,19,51,19,71,322,139
E02004822,Test Valley 009,Middle Super Output Areas and Intermediate Zones,MSOAIZ,SP,7794,3255,5329,2170,2613,1271,2716,899,63,25,1015,454,231,110,784,344,344,,,,1068,462,870,385,111,41,51,24,36,12,77,319,144
E02004823,Test Valley 010,Middle Super Output Areas and Intermediate Zones,MSOAIZ,SO,8901,3814,7337,3136,3233,1686,4104,1450,64,27,596,276,164,84,432,192,192,,,,836,345,759,313,12,5,60,26,5,1,32,68,30
E02004824,Test Valley 011,Middle Super Output Areas and Intermediate Zones,MSOAIZ,SO,5714,2864,3504,1798,1958,1184,1546,614,5,5,1250,579,437,186,813,393,393,,,,844,418,725,371,39,12,67,28,13,7,47,111,64
E02004825,Test Valley 012,Middle Super Output Areas and Intermediate Zones,MSOAIZ,SO,10505,4416,8510,3532,3700,1879,4810,1653,73,31,921,427,272,126,649,301,301,,,,924,385,814,340,31,12,71,31,8,2,45,77,41
E02004826,Test Valley 013,Middle Super Output Areas and Intermediate Zones,MSOAIZ,SO,6420,2620,5017,2018,2497,1172,2520,846,38,17,530,226,166,75,364,151,151,,,,712,299,564,249,89,28,49,17,10,5,50,123,60
E02004827,Test Valley 014,Middle Super Output Areas and Intermediate Zones,MSOAIZ,SO,7713,2831,6686,2461,1880,853,4806,1608,5,2,299,99,0,0,299,99,99,,,,701,259,663,245,12,2,19,9,7,3,14,22,10
E02004828,Test Valley 015,Middle Super Output Areas and Intermediate Zones,MSOAIZ,SO,6281,2501,5317,2105,2266,1090,3051,1015,8,4,275,129,107,49,168,80,80,,,,630,237,575,220,8,3,30,10,17,4,17,51,26
E02004829,Winchester 001,Middle Super Output Areas and Intermediate Zones,MSOAIZ,SO,5617,2236,3845,1508,1533,724,2312,784,78,40,479,198,213,99,266,99,99,,,,1099,435,483,223,372,129,38,13,206,70,212,116,55
E02004830,Winchester 002,Middle Super Output Areas and Intermediate Zones,MSOAIZ,SO,6203,2608,4548,1874,1902,943,2646,931,52,21,827,377,640,310,187,67,67,,,,633,267,537,228,17,8,58,22,21,9,39,143,69
E02004831,Winchester 003,Middle Super Output Areas and Intermediate Zones,MSOAIZ,SO,8163,3417,6395,2714,3079,1614,3316,1100,13,9,652,292,355,176,297,116,116,,,,995,342,662,243,194,57,34,12,105,30,99,108,60
E02004832,Winchester 004,Middle Super Output Areas and Intermediate Zones,MSOAIZ,SO,8499,3591,6110,2545,2959,1501,3151,1044,88,40,943,418,728,332,215,86,86,,,,1125,470,998,418,46,17,64,28,17,7,52,233,118
E02004833,Winchester 005,Middle Super Output Areas and Intermediate Zones,MSOAIZ,SO,8537,3428,5724,2289,2400,1189,3324,1100,83,43,1485,648,935,397,550,251,251,,,,1189,411,1088,373,18,6,64,23,19,9,38,56,37
E02004834,Winchester 006,Middle Super Output Areas and Intermediate Zones,MSOAIZ,SO,6843,3167,2651,1194,1007,540,1644,654,42,24,2891,1434,2339,1168,552,266,266,,,,1146,452,1050,415,14,5,50,23,32,9,37,113,63
E02004835,Winchester 007,Middle Super Output Areas and Intermediate Zones,MSOAIZ,SO,8998,4418,4925,2284,2212,1256,2713,1028,129,70,1182,778,432,290,750,488,488,,,,2515,1160,2203,1025,211,76,70,39,31,20,135,247,126
E02004836,Winchester 008,Middle Super Output Areas and Intermediate Zones,MSOAIZ,SO,5886,2177,1689,686,703,349,986,337,20,9,2529,1030,1961,771,568,259,259,,,,1603,423,1481,382,27,9,65,23,30,9,41,45,29
E02004837,Winchester 009,Middle Super Output Areas and Intermediate Zones,MSOAIZ,SO,7554,3092,5744,2405,2517,1296,3227,1109,16,11,544,216,427,169,117,47,47,,,,1177,422,1080,388,31,11,62,22,4,1,34,73,38
E02004838,Winchester 010,Middle Super Output Areas and Intermediate Zones,MSOAIZ,SO,8911,3685,7105,2870,3014,1514,4091,1356,72,40,785,352,554,271,231,81,81,,,,828,354,732,312,33,13,43,23,20,6,42,121,69
E02004839,Winchester 011,Middle Super Output Areas and Intermediate Zones,MSOAIZ,SO,8124,3314,6497,2613,3079,1473,3418,1140,18,10,712,303,443,199,269,104,104,,,,735,306,621,259,32,12,52,24,30,11,47,162,82
E02004840,Winchester 012,Middle Super Output Areas and Intermediate Zones,MSOAIZ,SO,9399,3986,7429,3086,3012,1535,4417,1551,32,15,1000,440,717,298,283,142,142,,,,835,386,729,339,17,6,77,33,12,8,47,103,59
E02004841,Winchester 013,Middle Super Output Areas and Intermediate Zones,MSOAIZ,SO,10833,4517,7702,3118,2629,1271,5073,1847,154,74,1173,480,687,310,486,170,170,,,,1644,751,1515,697,20,8,101,42,8,4,54,160,94
E02004842,Winchester 014,Middle Super Output Areas and Intermediate Zones,MSOAIZ,SO,7975,3229,6079,2460,2309,1180,3770,1280,39,20,635,277,412,180,223,97,97,,,,1132,425,811,315,144,45,42,21,135,44,110,90,47
E02004843,Broxbourne 001,Middle Super Output Areas and Intermediate Zones,MSOAIZ,SG,7107,2648,6089,2299,2344,1125,3745,1174,48,17,412,128,32,13,380,115,115,,,,516,187,482,170,4,2,24,13,6,2,17,42,17
E02004844,Broxbourne 002,Middle Super Output Areas and Intermediate Zones,MSOAIZ,EN,7186,2767,5332,2044,1639,802,3693,1242,44,19,1087,421,165,64,922,357,357,,,,693,265,661,249,3,1,26,14,3,1,16,30,18
E02004845,Broxbourne 003,Middle Super Output Areas and Intermediate Zones,MSOAIZ,EN,7217,3367,4839,2146,1812,995,3027,1151,43,19,1061,563,118,67,943,496,496,,,,1221,602,1124,554,19,6,72,38,6,4,48,53,37
E02004846,Broxbourne 004,Middle Super Output Areas and Intermediate Zones,MSOAIZ,EN,6203,2398,5639,2127,2467,1162,3172,965,2,1,141,73,19,10,122,63,63,,,,401,183,383,174,0,0,16,8,2,1,9,20,14
E02004847,Broxbourne 005,Middle Super Output Areas and Intermediate Zones,MSOAIZ,EN,9674,4040,6450,2658,1936,987,4514,1671,142,65,1898,770,240,115,1658,655,655,,,,1123,514,1052,478,1,1,64,32,6,3,36,61,33
E02004848,Broxbourne 006,Middle Super Output Areas and Intermediate Zones,MSOAIZ,EN,7192,2673,5684,2094,1877,884,3807,1210,36,12,789,302,440,195,349,107,107,,,,642,248,601,231,7,3,30,13,4,1,17,41,17
E02004849,Broxbourne 007,Middle Super Output Areas and Intermediate Zones,MSOAIZ,EN,6836,2486,5950,2142,2030,922,3920,1220,175,67,290,107,37,14,253,93,93,,,,370,145,357,136,0,0,13,9,0,0,9,51,25
E02004850,Broxbourne 008,Middle Super Output Areas and Intermediate Zones,MSOAIZ,EN,7446,3064,5646,2242,1940,983,3706,1259,11,6,1160,537,206,105,954,432,432,,,,605,266,575,249,2,2,28,15,0,0,17,24,13
E02004851,Broxbourne 009,Middle Super Output Areas and Intermediate Zones,MSOAIZ,EN,5749,2315,4385,1720,1421,720,2964,1000,169,65,840,359,130,59,710,300,300,,,,320,155,302,147,3,1,15,7,0,0,8,35,16
E02004852,Broxbourne 010,Middle Super Output Areas and Intermediate Zones,MSOAIZ,EN,7612,3144,5708,2336,2026,1082,3682,1254,29,10,750,329,74,34,676,295,295,,,,1083,443,1033,418,5,2,31,15,14,8,25,42,26
E02004853,Broxbourne 011,Middle Super Output Areas and Intermediate Zones,MSOAIZ,EN,6305,2576,4544,1735,1545,754,2999,981,31,14,1320,661,241,117,1079,544,544,,,,381,148,343,129,14,4,23,14,1,1,19,29,18
E02004854,Broxbourne 012,Middle Super Output Areas and Intermediate Zones,MSOAIZ,EN,7333,3017,5508,2288,2286,1194,3222,1094,60,25,599,240,166,76,433,164,164,,,,1127,440,1082,420,2,1,39,17,4,2,20,39,24
E02004855,Broxbourne 013,Middle Super Output Areas and Intermediate Zones,MSOAIZ,EN,7407,3163,3823,1629,1243,652,2580,977,209,98,1900,807,577,237,1323,570,570,,,,1430,603,1373,579,2,1,37,16,18,7,24,45,26
E02004856,Dacorum 001,Middle Super Output Areas and Intermediate Zones,MSOAIZ,LU,5323,2247,3897,1572,1354,665,2543,907,15,7,766,354,686,323,80,31,31,,,,585,279,545,259,8,4,27,14,5,2,20,60,35
E02004857,Dacorum 002,Middle Super Output Areas and Intermediate Zones,MSOAIZ,HP,5433,2350,4318,1802,1665,863,2653,939,25,10,474,211,429,183,45,28,28,,,,567,303,521,275,14,8,28,16,4,4,28,49,24
E02004858,Dacorum 003,Middle Super Output Areas and Intermediate Zones,MSOAIZ,HP,5072,2069,3576,1412,1098,577,2478,835,25,7,949,428,864,388,85,40,40,,,,485,206,407,175,41,12,28,13,9,6,31,37,16
E02004859,Dacorum 004,Middle Super Output Areas and Intermediate Zones,MSOAIZ,HP,5187,2141,4266,1727,1881,934,2385,793,10,4,391,175,315,136,76,39,39,,,,471,216,417,194,25,11,24,8,5,3,22,49,19
E02004860,Dacorum 005,Middle Super Output Areas and Intermediate Zones,MSOAIZ,HP,5765,2516,3525,1483,959,485,2566,998,23,13,1174,482,399,160,775,322,322,,,,1038,534,988,509,0,0,47,24,3,1,25,5,4
E02004861,Dacorum 006,Middle Super Output Areas and Intermediate Zones,MSOAIZ,HP,5457,2394,4366,1839,2140,1081,2226,758,11,8,527,267,400,184,127,83,83,,,,482,244,450,221,13,9,14,10,5,4,23,71,36
E02004862,Dacorum 007,Middle Super Output Areas and Intermediate Zones,MSOAIZ,HP,7558,3130,4031,1607,1095,549,2936,1058,20,10,2626,1163,1659,782,967,381,381,,,,841,332,786,307,6,2,39,20,10,3,25,40,18
E02004863,Dacorum 008,Middle Super Output Areas and Intermediate Zones,MSOAIZ,HP,7625,3194,3009,1237,937,489,2072,748,142,73,3647,1537,2853,1220,794,317,317,,,,783,315,727,292,0,0,48,20,8,3,23,44,32
E02004864,Dacorum 009,Middle Super Output Areas and Intermediate Zones,MSOAIZ,HP,6243,2852,5069,2208,2131,1129,2938,1079,7,4,205,120,50,37,155,83,83,,,,908,486,814,433,45,25,37,22,12,6,53,54,34
E02004865,Dacorum 010,Middle Super Output Areas and Intermediate Zones,MSOAIZ,HP,5323,2415,3424,1454,1058,573,2366,881,4,2,1182,607,1077,532,105,75,75,,,,668,333,614,304,6,2,38,21,10,6,29,45,19
E02004866,Dacorum 011,Middle Super Output Areas and Intermediate Zones,MSOAIZ,HP,6513,2707,3775,1513,1112,581,2663,932,21,10,2165,928,1996,861,169,67,67,,,,511,234,469,211,0,0,42,23,0,0,23,41,22
E02004867,Dacorum 012,Middle Super Output Areas and Intermediate Zones,MSOAIZ,HP,6042,2401,4451,1664,1646,787,2805,877,46,28,1109,508,961,443,148,65,65,,,,407,183,376,168,2,1,29,14,0,0,15,29,18
E02004868,Dacorum 013,Middle Super Output Areas and Intermediate Zones,MSOAIZ,HP,5679,2387,3169,1297,1147,598,2022,699,86,40,1776,774,1651,726,125,48,48,,,,603,249,541,228,16,4,39,15,7,2,21,45,27
E02004869,Dacorum 014,Middle Super Output Areas and Intermediate Zones,MSOAIZ,HP,5579,2293,4066,1606,1510,745,2556,861,14,6,817,350,776,326,41,24,24,,,,650,314,625,299,5,2,20,13,0,0,15,32,17
E02004870,Dacorum 015,Middle Super Output Areas and Intermediate Zones,MSOAIZ,HP,9238,4059,5225,2153,1682,869,3543,1284,123,68,2481,1176,1879,841,602,335,335,,,,1314,614,1247,580,13,5,49,26,5,3,34,95,48
E02004871,Dacorum 016,Middle Super Output Areas and Intermediate Zones,MSOAIZ,HP,5068,2064,3269,1290,1065,540,2204,750,5,2,1376,582,1341,566,35,16,16,,,,389,173,352,156,4,2,30,14,3,1,17,29,17
E02004872,Dacorum 017,Middle Super Output Areas and Intermediate Zones,MSOAIZ,HP,6955,2801,5131,2071,2104,1068,3027,1003,12,5,1305,522,1137,461,168,61,61,,,,468,182,431,165,3,1,34,16,0,0,17,39,21
E02004873,Dacorum 018,Middle Super Output Areas and Intermediate Zones,MSOAIZ,HP,10024,4440,7357,3085,2528,1309,4829,1776,37,21,929,492,571,311,358,181,181,,,,1655,811,1558,754,15,9,65,36,17,12,57,46,31
E02004874,Dacorum 019,Middle Super Output Areas and Intermediate Zones,MSOAIZ,HP,6127,2421,3864,1505,1274,618,2590,887,37,13,1571,629,1001,434,570,195,195,,,,619,258,568,233,1,1,38,17,12,7,25,36,16
E02004875,Dacorum 020,Middle Super Output Areas and Intermediate Zones,MSOAIZ,HP,9237,3541,5576,2077,1669,812,3907,1265,56,24,2791,1122,2361,971,430,151,151,,,,759,289,682,259,16,5,48,21,13,4,30,55,29
E02004876,Dacorum 021,Middle Super Output Areas and Intermediate Zones,MSOAIZ,WD,8216,3381,6720,2685,2799,1389,3921,1296,18,13,671,316,498,243,173,73,73,,,,748,334,688,306,26,11,27,12,7,5,28,59,33
E02004877,Dacorum 022,Middle Super Output Areas and Intermediate Zones,MSOAIZ,WD,5181,2135,3991,1590,1604,797,2387,793,9,5,648,302,595,279,53,23,23,,,,485,218,416,188,36,15,25,11,8,4,30,48,20
E02004878,East Hertfordshire 001,Middle Super Output Areas and Intermediate Zones,MSOAIZ,SG,6662,2653,5407,2110,2107,1026,3300,1084,6,4,653,277,132,51,521,226,226,,,,526,220,480,204,0,0,37,13,9,3,16,70,42
E02004879,East Hertfordshire 002,Middle Super Output Areas and Intermediate Zones,MSOAIZ,SG,7678,3084,5652,2233,2412,1141,3240,1092,53,18,1188,481,213,94,975,387,387,,,,658,279,579,240,28,14,42,19,9,6,39,127,73
E02004880,East Hertfordshire 003,Middle Super Output Areas and Intermediate Zones,MSOAIZ,SG,9052,3492,7447,2782,2589,1240,4858,1542,141,67,556,238,106,45,450,193,193,,,,799,349,713,315,39,14,29,14,18,6,34,109,56
E02004881,East Hertfordshire 004,Middle Super Output Areas and Intermediate Zones,MSOAIZ,CM,5660,2587,4205,1810,1727,911,2478,899,54,36,327,191,24,12,303,179,179,,,,1035,523,972,494,11,6,46,22,6,1,29,39,27
E02004882,East Hertfordshire 005,Middle Super Output Areas and Intermediate Zones,MSOAIZ,CM,7730,3023,5622,2149,2053,996,3569,1153,102,50,748,330,171,69,577,261,261,,,,1190,462,1122,434,16,6,39,18,13,4,28,68,32
E02004883,East Hertfordshire 006,Middle Super Output Areas and Intermediate Zones,MSOAIZ,SG,5628,2308,4445,1749,1578,772,2867,977,9,5,624,293,83,40,541,253,253,,,,446,212,398,187,23,9,15,11,10,5,25,104,49
E02004884,East Hertfordshire 007,Middle Super Output Areas and Intermediate Zones,MSOAIZ,CM,9794,4233,5953,2461,1755,950,4198,1511,138,68,1979,880,265,112,1714,768,768,,,,1668,783,1583,743,8,3,70,35,7,2,40,56,41
E02004885,East Hertfordshire 008,Middle Super Output Areas and Intermediate Zones,MSOAIZ,CM,8757,3222,7828,2841,2309,1084,5519,1757,41,14,146,50,35,12,111,38,38,,,,714,303,664,280,8,3,39,18,3,2,23,28,14
E02004886,East Hertfordshire 009,Middle Super Output Areas and Intermediate Zones,MSOAIZ,SG,5428,2204,3879,1497,1608,742,2271,755,20,8,823,383,151,72,672,311,311,,,,608,260,557,235,21,12,13,7,17,6,25,98,56
E02004887,East Hertfordshire 010,Middle Super Output Areas and Intermediate Zones,MSOAIZ,SG,7119,2914,5399,2127,2278,1067,3121,1060,30,13,757,367,94,49,663,318,318,,,,847,366,787,345,32,10,7,4,21,7,21,86,41
E02004888,East Hertfordshire 011,Middle Super Output Areas and Intermediate Zones,MSOAIZ,CM,8324,3587,6627,2754,2664,1358,3963,1396,49,28,657,298,179,73,478,225,225,,,,927,473,872,447,6,3,41,18,8,5,26,64,34
E02004889,East Hertfordshire 012,Middle Super Output Areas and Intermediate Zones,MSOAIZ,SG,10333,4368,7125,2986,2514,1311,4611,1675,61,27,1841,713,327,133,1514,580,580,,,,1233,600,1164,564,6,3,50,27,13,6,36,73,42
E02004890,East Hertfordshire 013,Middle Super Output Areas and Intermediate Zones,MSOAIZ,SG,8220,3643,6178,2587,2180,1082,3998,1505,69,37,735,391,108,53,627,338,338,,,,1197,600,1136,564,15,6,35,24,11,6,36,41,28
E02004891,East Hertfordshire 014,Middle Super Output Areas and Intermediate Zones,MSOAIZ,SG,7403,3270,5784,2448,2241,1166,3543,1282,7,5,690,334,72,37,618,297,297,,,,863,452,811,423,15,7,23,15,14,7,29,59,31
E02004892,East Hertfordshire 015,Middle Super Output Areas and Intermediate Zones,MSOAIZ,SG,5547,2449,3413,1471,1195,626,2218,845,52,20,1675,746,257,113,1418,633,633,,,,356,177,327,164,3,1,21,10,5,2,13,51,35
E02004893,East Hertfordshire 016,Middle Super Output Areas and Intermediate Zones,MSOAIZ,SG,5453,2129,4327,1635,1025,504,3302,1131,73,25,541,232,79,33,462,199,199,,,,498,224,465,210,4,2,27,10,2,2,14,14,13
E02004894,East Hertfordshire 017,Middle Super Output Areas and Intermediate Zones,MSOAIZ,SG,8297,3810,5705,2494,2049,1063,3656,1431,90,52,1017,472,117,57,900,415,415,,,,1381,739,1267,686,20,9,79,38,15,6,53,104,53
E02004895,East Hertfordshire 018,Middle Super Output Areas and Intermediate Zones,MSOAIZ,SG,8677,3601,6308,2531,2342,1147,3966,1384,66,31,1129,509,148,74,981,435,435,,,,924,424,789,371,69,23,38,19,28,11,53,250,106
E02004896,Hertsmere 001,Middle Super Output Areas and Intermediate Zones,MSOAIZ,EN,7725,3263,6148,2614,3015,1594,3133,1020,21,9,217,118,10,5,207,113,113,,,,1267,484,1189,451,11,5,62,25,5,3,33,72,38
E02004897,Hertsmere 002,Middle Super Output Areas and Intermediate Zones,MSOAIZ,EN,6654,2588,5287,2045,2019,1019,3268,1026,35,13,722,312,16,6,706,306,306,,,,567,196,506,176,8,3,41,15,12,2,20,43,22
E02004898,Hertsmere 003,Middle Super Output Areas and Intermediate Zones,MSOAIZ,EN,7215,3040,4908,2018,1882,969,3026,1049,44,20,1436,704,339,157,1097,547,547,,,,788,276,711,251,4,1,68,22,5,2,25,39,22
E02004899,Hertsmere 004,Middle Super Output Areas and Intermediate Zones,MSOAIZ,WD,5345,2101,3763,1420,1086,522,2677,898,91,35,915,402,116,48,799,354,354,,,,490,203,460,190,7,2,9,5,14,6,13,86,41
E02004900,Hertsmere 005,Middle Super Output Areas and Intermediate Zones,MSOAIZ,WD,8148,3143,6693,2481,2925,1307,3768,1174,44,16,492,252,17,11,475,241,241,,,,850,357,821,345,6,1,13,7,10,4,12,69,37
E02004901,Hertsmere 006,Middle Super Output Areas and Intermediate Zones,MSOAIZ,WD,8354,3485,3897,1501,1096,562,2801,939,131,50,3474,1615,464,212,3010,1403,1403,,,,769,264,732,249,6,2,29,12,2,1,15,83,55
E02004902,Hertsmere 007,Middle Super Output Areas and Intermediate Zones,MSOAIZ,WD,7916,3173,4501,1763,1338,683,3163,1080,66,30,2008,864,181,85,1827,779,779,,,,1253,468,1210,450,9,2,31,15,3,1,18,88,48
E02004903,Hertsmere 008,Middle Super Output Areas and Intermediate Zones,MSOAIZ,WD,6482,2591,4338,1688,1496,748,2842,940,98,43,1065,422,81,29,984,393,393,,,,920,410,873,390,22,8,13,6,12,6,20,61,28
E02004904,Hertsmere 009,Middle Super Output Areas and Intermediate Zones,MSOAIZ,WD,5868,2486,3266,1372,941,495,2325,877,231,87,1557,693,146,72,1411,621,621,,,,764,308,717,283,2,1,39,21,6,3,25,50,26
E02004905,Hertsmere 010,Middle Super Output Areas and Intermediate Zones,MSOAIZ,WD,6453,2405,4911,1825,1730,776,3181,1049,40,17,397,138,29,12,368,126,126,,,,932,365,816,320,63,22,44,21,9,2,45,173,60
E02004906,Hertsmere 011,Middle Super Output Areas and Intermediate Zones,MSOAIZ,WD,9541,3738,6030,2309,1733,880,4297,1429,299,117,1617,695,176,75,1441,620,620,,,,1510,578,1454,553,8,3,40,19,8,3,25,85,39
E02004907,Hertsmere 012,Middle Super Output Areas and Intermediate Zones,MSOAIZ,WD,9140,3774,6698,2717,2450,1290,4248,1427,44,19,1106,514,55,29,1051,485,485,,,,1203,486,1037,435,66,19,41,15,59,17,51,89,38
E02004908,Hertsmere 013,Middle Super Output Areas and Intermediate Zones,MSOAIZ,WD,9637,3991,7635,3144,3122,1644,4513,1500,31,15,432,203,35,15,397,188,188,,,,1470,586,983,407,271,92,50,25,166,62,179,69,43
E02004909,North Hertfordshire 001,Middle Super Output Areas and Intermediate Zones,MSOAIZ,SG,5070,2175,3422,1409,1109,560,2313,849,13,5,865,391,344,144,521,247,247,,,,737,348,691,324,8,3,36,19,2,2,24,33,22
E02004910,North Hertfordshire 002,Middle Super Output Areas and Intermediate Zones,MSOAIZ,SG,10642,4431,8468,3479,3188,1626,5280,1853,6,3,957,381,454,165,503,216,216,,,,1161,539,1073,500,13,6,52,25,23,8,39,50,29
E02004911,North Hertfordshire 003,Middle Super Output Areas and Intermediate Zones,MSOAIZ,SG,6538,2935,3741,1555,1273,696,2468,859,31,17,2344,1149,923,429,1421,720,720,,,,379,183,303,145,12,3,50,25,14,10,38,43,31
E02004912,North Hertfordshire 004,Middle Super Output Areas and Intermediate Zones,MSOAIZ,SG,10090,4375,7030,2956,2428,1320,4602,1636,115,58,1737,737,762,306,975,431,431,,,,1139,579,1044,530,4,3,71,33,20,13,49,69,45
E02004913,North Hertfordshire 005,Middle Super Output Areas and Intermediate Zones,MSOAIZ,SG,14600,5796,10574,4091,3303,1558,7271,2533,229,110,1737,703,579,227,1158,476,476,,,,1869,798,1717,728,58,24,63,30,31,16,70,191,94
E02004914,North Hertfordshire 006,Middle Super Output Areas and Intermediate Zones,MSOAIZ,SG,7261,3115,4130,1705,1549,752,2581,953,10,5,2303,976,434,171,1869,805,805,,,,758,403,706,374,6,4,34,21,12,4,29,60,26
E02004915,North Hertfordshire 007,Middle Super Output Areas and Intermediate Zones,MSOAIZ,SG,5411,2335,2731,1157,1039,530,1692,627,132,57,1873,793,422,178,1451,615,615,,,,643,307,605,288,1,1,19,12,18,6,19,32,21
E02004916,North Hertfordshire 008,Middle Super Output Areas and Intermediate Zones,MSOAIZ,SG,7183,2933,4997,2010,2385,1173,2612,837,21,10,1471,599,521,193,950,406,406,,,,616,280,572,256,13,5,20,13,11,6,24,78,34
E02004917,North Hertfordshire 009,Middle Super Output Areas and Intermediate Zones,MSOAIZ,SG,6504,2672,4218,1671,1695,814,2523,857,8,5,1849,828,861,371,988,457,457,,,,409,157,371,140,11,3,20,9,7,5,17,20,11
E02004918,North Hertfordshire 010,Middle Super Output Areas and Intermediate Zones,MSOAIZ,SG,8073,3615,5285,2151,1713,823,3572,1328,166,100,837,411,215,112,622,299,299,,,,1719,917,1652,875,6,2,54,35,7,5,42,66,36
E02004919,North Hertfordshire 011,Middle Super Output Areas and Intermediate Zones,MSOAIZ,SG,7288,3073,4954,2011,1698,855,3256,1156,58,37,1359,603,683,283,676,320,320,,,,869,401,824,382,7,2,29,12,9,5,19,48,21
E02004920,North Hertfordshire 012,Middle Super Output Areas and Intermediate Zones,MSOAIZ,SG,10466,4660,6868,2939,2910,1530,3958,1409,71,39,2301,1049,1136,496,1165,553,553,,,,1134,578,1047,535,17,6,59,29,11,8,43,92,55
E02004921,North Hertfordshire 013,Middle Super Output Areas and Intermediate Zones,MSOAIZ,SG,7499,3216,5924,2483,2344,1250,3580,1233,16,6,518,230,281,118,237,112,112,,,,984,466,921,439,22,7,39,19,2,1,27,57,31
E02004922,North Hertfordshire 014,Middle Super Output Areas and Intermediate Zones,MSOAIZ,SG,9296,3859,6054,2406,2494,1197,3560,1209,17,6,1857,821,863,346,994,475,475,,,,1228,553,1116,500,31,16,42,19,39,18,53,140,73
E02004923,North Hertfordshire 015,Middle Super Output Areas and Intermediate Zones,MSOAIZ,SG,9896,4236,7418,3049,3011,1517,4407,1532,25,14,1344,633,547,235,797,398,398,,,,986,484,911,444,29,12,39,23,7,5,40,123,56
E02004924,St Albans 001,Middle Super Output Areas and Intermediate Zones,MSOAIZ,AL,7049,2644,6013,2222,2140,1026,3873,1196,9,5,454,184,404,153,50,31,31,,,,535,214,506,198,4,2,19,11,6,3,16,38,19
E02004925,St Albans 002,Middle Super Output Areas and Intermediate Zones,MSOAIZ,AL,7489,2907,5611,2091,2000,948,3611,1143,25,9,1022,431,827,326,195,105,105,,,,774,346,715,317,17,8,37,17,5,4,29,57,30
E02004926,St Albans 003,Middle Super Output Areas and Intermediate Zones,MSOAIZ,AL,7615,3114,6068,2392,2717,1342,3351,1050,0,0,273,135,160,84,113,51,51,,,,1230,561,1143,516,44,20,34,20,9,5,45,44,26
E02004927,St Albans 004,Middle Super Output Areas and Intermediate Zones,MSOAIZ,LU,6397,2582,4890,1954,2029,1027,2861,927,24,10,976,387,847,341,129,46,46,,,,439,188,389,167,20,9,25,9,5,3,21,68,43
E02004928,St Albans 005,Middle Super Output Areas and Intermediate Zones,MSOAIZ,AL,6775,2639,5986,2317,2648,1265,3338,1052,5,2,287,107,258,97,29,10,10,,,,460,192,436,182,2,1,20,8,2,1,10,37,21
E02004929,St Albans 006,Middle Super Output Areas and Intermediate Zones,MSOAIZ,HP,6156,2534,4685,1879,1868,939,2817,940,26,14,804,347,594,262,210,85,85,,,,574,255,507,225,16,7,25,12,26,11,30,67,39
E02004930,St Albans 007,Middle Super Output Areas and Intermediate Zones,MSOAIZ,AL,6758,2778,5342,2147,1899,971,3443,1176,5,1,660,287,540,237,120,50,50,,,,709,319,658,292,3,2,43,22,5,3,27,42,24
E02004931,St Albans 008,Middle Super Output Areas and Intermediate Zones,MSOAIZ,AL,6497,2613,5220,2028,2090,1029,3130,999,13,7,612,303,488,217,124,86,86,,,,601,246,545,221,8,2,39,19,9,4,25,51,29
E02004932,St Albans 009,Middle Super Output Areas and Intermediate Zones,MSOAIZ,AL,7523,2880,4900,1806,1501,698,3399,1108,21,8,2040,814,1250,484,790,330,330,,,,526,227,499,214,0,0,27,13,0,0,13,36,25
E02004933,St Albans 010,Middle Super Output Areas and Intermediate Zones,MSOAIZ,AL,6887,2505,5867,2110,2335,1048,3532,1062,15,7,241,86,197,69,44,17,17,,,,727,283,678,263,8,4,32,12,9,4,20,37,19
E02004934,St Albans 011,Middle Super Output Areas and Intermediate Zones,MSOAIZ,AL,7126,2997,4634,1803,1718,781,2916,1022,78,59,729,321,489,201,240,120,120,,,,1617,782,1573,753,5,3,34,22,5,4,29,68,32
E02004935,St Albans 012,Middle Super Output Areas and Intermediate Zones,MSOAIZ,AL,7489,3661,4161,1875,1396,757,2765,1118,66,35,917,496,444,224,473,272,272,,,,2277,1212,2156,1148,20,8,73,37,28,19,64,68,43
E02004936,St Albans 013,Middle Super Output Areas and Intermediate Zones,MSOAIZ,AL,6159,2284,4960,1787,1516,697,3444,1090,10,6,248,97,116,46,132,51,51,,,,917,382,879,363,12,5,25,13,1,1,19,24,12
E02004937,St Albans 014,Middle Super Output Areas and Intermediate Zones,MSOAIZ,AL,6339,2707,5402,2265,2654,1348,2748,917,8,2,65,30,30,15,35,15,15,,,,782,369,745,347,13,7,19,12,5,3,22,82,41
E02004938,St Albans 015,Middle Super Output Areas and Intermediate Zones,MSOAIZ,AL,5873,2282,4311,1614,1391,665,2920,949,19,9,982,415,430,189,552,226,226,,,,525,224,437,182,59,27,14,9,15,6,42,36,20
E02004939,St Albans 016,Middle Super Output Areas and Intermediate Zones,MSOAIZ,AL,6569,2682,4250,1708,1815,890,2435,818,8,6,1494,643,1173,510,321,133,133,,,,757,290,691,264,24,8,32,12,10,6,26,60,35
E02004940,St Albans 017,Middle Super Output Areas and Intermediate Zones,MSOAIZ,AL,7252,2975,4316,1716,1338,661,2978,1055,20,6,1827,762,1593,643,234,119,119,,,,1026,457,957,425,13,4,49,22,7,6,32,63,34
E02004941,St Albans 018,Middle Super Output Areas and Intermediate Zones,MSOAIZ,WD,9440,3763,6395,2530,1885,936,4510,1594,103,48,1585,599,945,394,640,205,205,,,,1293,551,1210,508,14,6,45,21,24,16,43,64,35
E02004942,St Albans 019,Middle Super Output Areas and Intermediate Zones,MSOAIZ,WD,6034,2513,4685,1917,1892,964,2793,953,31,11,695,302,460,194,235,108,108,,,,568,250,534,233,7,3,21,12,6,2,17,55,33
E02004943,St Albans 020,Middle Super Output Areas and Intermediate Zones,MSOAIZ,WD,7631,3080,6753,2670,2814,1417,3939,1253,30,16,179,86,135,67,44,19,19,,,,622,276,569,247,9,5,26,12,18,12,29,47,32
E02004944,Stevenage 001,Middle Super Output Areas and Intermediate Zones,MSOAIZ,SG,6725,2559,3953,1495,878,442,3075,1053,49,20,1768,709,1526,631,242,78,78,,,,917,315,847,288,0,0,64,25,6,2,27,38,20
E02004945,Stevenage 002,Middle Super Output Areas and Intermediate Zones,MSOAIZ,SG,11614,4756,7230,2913,2312,1171,4918,1742,287,152,2638,1054,1528,622,1110,432,432,,,,1401,605,1301,552,11,4,81,45,8,4,53,58,32
E02004946,Stevenage 003,Middle Super Output Areas and Intermediate Zones,MSOAIZ,SG,6238,2632,3651,1472,1102,556,2549,916,101,47,1711,761,943,413,768,348,348,,,,724,331,634,295,0,0,86,35,4,1,36,51,21
E02004947,Stevenage 004,Middle Super Output Areas and Intermediate Zones,MSOAIZ,SG,6290,2632,5102,2054,1420,723,3682,1331,15,6,485,235,391,182,94,53,53,,,,670,323,615,299,0,0,54,23,1,1,24,18,14
E02004948,Stevenage 005,Middle Super Output Areas and Intermediate Zones,MSOAIZ,SG,5780,2611,3275,1365,1020,510,2255,855,13,6,1606,807,1312,637,294,170,170,,,,872,422,819,399,2,1,48,20,3,2,23,14,11
E02004949,Stevenage 006,Middle Super Output Areas and Intermediate Zones,MSOAIZ,SG,7968,3689,4317,1857,1473,793,2844,1064,100,57,2438,1259,1848,970,590,289,289,,,,1043,471,945,428,6,2,78,35,14,6,43,70,45
E02004950,Stevenage 007,Middle Super Output Areas and Intermediate Zones,MSOAIZ,SG,6774,2710,4205,1695,1227,662,2978,1033,159,68,1706,674,1459,587,247,87,87,,,,674,258,577,222,0,0,88,33,9,3,36,30,15
E02004951,Stevenage 008,Middle Super Output Areas and Intermediate Zones,MSOAIZ,SG,7009,3041,3122,1330,1049,591,2073,739,47,22,2943,1317,2724,1181,219,136,136,,,,841,341,776,314,2,1,63,26,0,0,27,56,31
E02004952,Stevenage 009,Middle Super Output Areas and Intermediate Zones,MSOAIZ,SG,6564,2694,4348,1704,1102,562,3246,1142,26,9,1557,692,1500,667,57,25,25,,,,619,278,577,257,1,1,41,20,0,0,21,14,11
E02004953,Stevenage 010,Middle Super Output Areas and Intermediate Zones,MSOAIZ,SG,6210,2467,3291,1327,913,501,2378,826,26,9,2318,916,2189,848,129,68,68,,,,545,196,490,175,9,3,42,14,4,4,21,30,19
E02004954,Stevenage 011,Middle Super Output Areas and Intermediate Zones,MSOAIZ,SG,6344,2673,3695,1500,1081,559,2614,941,36,18,1928,870,1590,689,338,181,181,,,,642,269,568,238,12,4,59,25,3,2,31,43,16
E02004955,Stevenage 012,Middle Super Output Areas and Intermediate Zones,MSOAIZ,SG,5889,2434,4038,1627,1304,666,2734,961,22,8,1392,608,1259,537,133,71,71,,,,402,171,385,163,0,0,17,8,0,0,8,35,20
E02004956,Three Rivers 001,Middle Super Output Areas and Intermediate Zones,MSOAIZ,WD,8761,3738,6562,2731,2487,1344,4075,1387,94,45,1184,514,304,117,880,397,397,,,,855,413,812,389,2,2,30,16,11,6,24,66,35
E02004957,Three Rivers 002,Middle Super Output Areas and Intermediate Zones,MSOAIZ,WD,8680,3536,6089,2466,1725,882,4364,1584,37,14,1696,685,570,201,1126,484,484,,,,820,351,769,327,2,1,39,18,10,5,24,38,20
E02004958,Three Rivers 003,Middle Super Output Areas and Intermediate Zones,MSOAIZ,WD,7149,2861,5890,2303,2297,1136,3593,1167,68,27,621,290,184,88,437,202,202,,,,507,207,422,177,27,9,56,20,2,1,30,63,34
E02004959,Three Rivers 004,Middle Super Output Areas and Intermediate Zones,MSOAIZ,WD,5533,2237,4624,1794,2061,996,2563,798,9,3,95,60,31,14,64,46,46,,,,697,322,636,293,39,16,17,9,5,4,29,108,58
E02004960,Three Rivers 005,Middle Super Output Areas and Intermediate Zones,MSOAIZ,WD,5560,2184,4657,1761,2073,965,2584,796,6,3,316,147,83,34,233,113,113,,,,532,250,508,235,6,3,13,9,5,3,15,49,23
E02004961,Three Rivers 006,Middle Super Output Areas and Intermediate Zones,MSOAIZ,WD,9241,3681,7932,3079,2877,1446,5055,1633,18,11,347,187,95,30,252,157,157,,,,898,374,835,347,9,4,51,20,3,3,27,46,30
E02004962,Three Rivers 007,Middle Super Output Areas and Intermediate Zones,MSOAIZ,WD,8369,3517,6271,2525,2197,1117,4074,1408,29,11,949,475,314,126,635,349,349,,,,1046,465,974,429,18,11,52,24,2,1,36,74,41
E02004963,Three Rivers 008,Middle Super Output Areas and Intermediate Zones,MSOAIZ,WD,6991,2736,4644,1771,1440,721,3204,1050,49,27,1731,725,613,260,1118,465,465,,,,542,200,478,177,11,3,53,20,0,0,23,25,13
E02004964,Three Rivers 009,Middle Super Output Areas and Intermediate Zones,MSOAIZ,WD,5582,2314,3535,1432,1088,561,2447,871,14,8,1392,602,427,183,965,419,419,,,,613,256,550,230,2,1,50,21,11,4,26,28,16
E02004965,Three Rivers 010,Middle Super Output Areas and Intermediate Zones,MSOAIZ,WD,6504,2754,5208,2215,2179,1175,3029,1040,29,8,682,279,229,97,453,182,182,,,,541,226,473,195,14,4,40,22,14,5,31,44,26
E02004966,Three Rivers 011,Middle Super Output Areas and Intermediate Zones,MSOAIZ,WD,6712,2465,5494,2003,2719,1183,2775,820,19,5,90,49,26,9,64,40,40,,,,1022,373,617,217,277,111,18,9,110,36,156,87,35
E02004967,Three Rivers 012,Middle Super Output Areas and Intermediate Zones,MSOAIZ,WD,7242,3085,3693,1452,873,462,2820,990,83,32,2763,1305,1118,521,1645,784,784,,,,661,271,587,237,5,2,55,22,14,10,34,42,25
E02004968,Watford 001,Middle Super Output Areas and Intermediate Zones,MSOAIZ,WD,7041,3002,4455,1863,1227,665,3228,1198,53,22,1806,773,555,201,1251,572,572,,,,700,325,653,299,3,2,39,22,5,2,26,27,19
E02004969,Watford 002,Middle Super Output Areas and Intermediate Zones,MSOAIZ,WD,7156,2792,5160,2013,1725,862,3435,1151,27,14,1226,445,413,133,813,312,312,,,,711,303,612,260,38,12,55,28,6,3,43,32,17
E02004970,Watford 003,Middle Super Output Areas and Intermediate Zones,MSOAIZ,WD,7817,3229,4690,1836,1444,748,3246,1088,70,41,2489,1089,866,352,1623,737,737,,,,542,247,505,224,2,1,25,17,10,5,23,26,16
E02004971,Watford 004,Middle Super Output Areas and Intermediate Zones,MSOAIZ,WD,7417,2774,4624,1718,1246,600,3378,1118,49,14,1648,615,527,158,1121,457,457,,,,1046,404,986,381,10,3,36,17,14,3,23,50,23
E02004972,Watford 005,Middle Super Output Areas and Intermediate Zones,MSOAIZ,WD,6100,2456,4894,1865,1764,862,3130,1003,14,5,190,124,45,26,145,98,98,,,,966,443,930,426,7,3,29,14,0,0,17,36,19
E02004973,Watford 006,Middle Super Output Areas and Intermediate Zones,MSOAIZ,WD,7444,3161,4510,1943,1011,532,3499,1411,38,15,547,211,217,72,330,139,139,,,,2316,974,2193,922,16,7,96,42,11,3,52,33,18
E02004974,Watford 007,Middle Super Output Areas and Intermediate Zones,MSOAIZ,WD,7358,3173,5265,2200,1981,1022,3284,1178,57,33,391,202,65,29,326,173,173,,,,1579,706,1480,654,13,6,65,34,21,12,52,66,32
E02004975,Watford 008,Middle Super Output Areas and Intermediate Zones,MSOAIZ,WD,7761,2938,6125,2269,2374,1105,3751,1164,99,51,477,181,72,24,405,157,157,,,,1001,411,928,379,20,8,38,18,15,6,32,59,26
E02004976,Watford 009,Middle Super Output Areas and Intermediate Zones,MSOAIZ,WD,8053,3948,3613,1719,1087,604,2526,1115,122,82,1225,710,216,103,1009,607,607,,,,3011,1385,2888,1317,22,10,90,49,11,9,68,82,52
E02004977,Watford 010,Middle Super Output Areas and Intermediate Zones,MSOAIZ,WD,8202,2971,5059,1767,1428,600,3631,1167,55,18,408,250,47,36,361,214,214,,,,2608,913,2500,867,16,9,74,27,18,10,46,72,23
E02004978,Watford 011,Middle Super Output Areas and Intermediate Zones,MSOAIZ,WD,8494,3460,3774,1459,1097,520,2677,939,227,120,2451,1003,609,233,1842,770,770,,,,1990,860,1899,816,16,7,52,29,23,8,44,52,18
E02004979,Watford 012,Middle Super Output Areas and Intermediate Zones,MSOAIZ,WD,6722,2777,4910,1956,1623,834,3287,1122,36,11,848,384,267,102,581,282,282,,,,868,400,836,385,0,0,24,8,8,7,15,60,26
E02004980,Welwyn Hatfield 001,Middle Super Output Areas and Intermediate Zones,MSOAIZ,SG,5932,2387,5183,2057,2168,1053,3015,1004,15,6,300,133,262,111,38,22,22,,,,394,172,368,159,4,1,18,9,4,3,13,40,19
E02004981,Welwyn Hatfield 002,Middle Super Output Areas and Intermediate Zones,MSOAIZ,SG,7141,2883,5144,2023,1766,910,3378,1113,28,12,1109,487,712,308,397,179,179,,,,794,326,745,300,12,6,32,16,5,4,26,66,35
E02004982,Welwyn Hatfield 003,Middle Super Output Areas and Intermediate Zones,MSOAIZ,AL,5917,2408,4152,1674,1706,873,2446,801,29,13,1310,549,1246,520,64,29,29,,,,385,147,356,134,1,1,25,10,3,2,13,41,25
E02004983,Welwyn Hatfield 004,Middle Super Output Areas and Intermediate Zones,MSOAIZ,AL,5964,2581,3718,1496,1176,615,2542,881,26,9,1619,803,1364,682,255,121,121,,,,547,237,509,217,4,2,32,17,2,1,20,54,36
E02004984,Welwyn Hatfield 005,Middle Super Output Areas and Intermediate Zones,MSOAIZ,AL,6261,2878,4007,1679,1264,647,2743,1032,16,5,1475,834,863,483,612,351,351,,,,725,335,703,322,2,2,18,10,2,1,13,38,25
E02004985,Welwyn Hatfield 006,Middle Super Output Areas and Intermediate Zones,MSOAIZ,AL,6745,2997,4734,1934,1965,1046,2769,888,50,19,1296,717,968,469,328,248,248,,,,605,289,589,279,0,0,12,7,4,3,10,60,38
E02004986,Welwyn Hatfield 007,Middle Super Output Areas and Intermediate Zones,MSOAIZ,AL,7331,2935,2394,1004,550,303,1844,701,92,41,4131,1594,3249,1256,882,338,338,,,,657,263,638,253,0,0,15,8,4,2,10,57,33
E02004987,Welwyn Hatfield 008,Middle Super Output Areas and Intermediate Zones,MSOAIZ,AL,6734,2732,3930,1544,1184,620,2746,924,63,26,2279,968,1533,613,746,355,355,,,,417,164,373,146,12,4,16,7,16,7,18,45,30
E02004988,Welwyn Hatfield 009,Middle Super Output Areas and Intermediate Zones,MSOAIZ,AL,7384,3018,3824,1524,931,496,2893,1028,93,41,2592,1092,2052,832,540,260,260,,,,818,329,727,294,37,13,32,15,22,7,35,57,32
E02004989,Welwyn Hatfield 010,Middle Super Output Areas and Intermediate Zones,MSOAIZ,AL,9883,3831,4383,1700,1262,634,3121,1066,176,77,2447,1117,1604,739,843,378,378,,,,2800,893,2639,842,24,7,65,24,72,20,51,77,44
E02004990,Welwyn Hatfield 011,Middle Super Output Areas and Intermediate Zones,MSOAIZ,SG,6276,2613,3058,1288,1224,628,1834,660,78,39,1473,696,1088,483,385,213,213,,,,1554,526,1479,495,9,4,50,19,16,8,31,113,64
E02004991,Welwyn Hatfield 012,Middle Super Output Areas and Intermediate Zones,MSOAIZ,AL,7244,2965,2139,951,775,435,1364,516,79,39,2520,1197,1925,896,595,301,301,,,,2435,733,2332,700,17,7,63,20,23,6,33,71,45
E02004992,Welwyn Hatfield 013,Middle Super Output Areas and Intermediate Zones,MSOAIZ,AL,8017,2795,2550,1077,984,511,1566,566,121,52,2175,859,1765,706,410,153,153,,,,3122,777,3039,748,4,2,46,20,33,7,29,49,30
E02004993,Welwyn Hatfield 014,Middle Super Output Areas and Intermediate Zones,MSOAIZ,AL,5157,2273,2993,1319,1258,666,1735,653,28,9,1114,546,1030,490,84,56,56,,,,939,356,869,328,22,7,30,13,18,8,28,83,43
E02004994,Welwyn Hatfield 015,Middle Super Output Areas and Intermediate Zones,MSOAIZ,SG,5664,2224,4897,1906,2237,1056,2660,850,5,3,189,67,179,63,10,4,4,,,,465,200,388,163,40,22,28,11,9,4,37,108,48
E02004995,Welwyn Hatfield 016,Middle Super Output Areas and Intermediate Zones,MSOAIZ,EN,5180,2093,4597,1819,2202,1068,2395,751,10,4,171,82,120,42,51,40,40,,,,357,164,325,152,4,2,23,8,5,2,12,45,24
E02004996,Ashford 001,Middle Super Output Areas and Intermediate Zones,MSOAIZ,TN,7917,3331,5326,2207,2202,1138,3124,1069,80,28,1069,470,737,348,332,122,122,,,,1277,547,1160,497,60,24,46,20,11,6,50,165,79
E02004997,Ashford 002,Middle Super Output Areas and Intermediate Zones,MSOAIZ,TN,7478,3161,5787,2381,2683,1306,3104,1075,45,19,958,447,715,350,243,97,97,,,,587,257,507,224,5,3,64,26,11,4,33,101,57
E02004998,Ashford 003,Middle Super Output Areas and Intermediate Zones,MSOAIZ,TN,6634,2669,5211,2103,1974,1034,3237,1069,79,33,497,192,232,108,265,84,84,,,,797,305,736,278,4,2,51,22,6,3,27,50,36
E02004999,Ashford 004,Middle Super Output Areas and Intermediate Zones,MSOAIZ,TN,12482,5136,8374,3386,2659,1417,5715,1969,145,75,1780,796,1027,465,753,331,331,,,,2089,829,1838,740,59,18,141,55,51,16,89,94,50
E02005000,Ashford 005,Middle Super Output Areas and Intermediate Zones,MSOAIZ,TN,9385,3922,5061,2049,1497,805,3564,1244,43,26,1837,881,1093,549,744,332,332,,,,2327,906,2074,811,28,10,175,70,50,15,95,117,60
E02005001,Ashford 006,Middle Super Output Areas and Intermediate Zones,MSOAIZ,TN,8777,3575,6758,2714,2420,1261,4338,1453,40,23,758,350,509,243,249,107,107,,,,1141,446,1010,380,40,25,75,31,16,10,66,80,42
E02005002,Ashford 007,Middle Super Output Areas and Intermediate Zones,MSOAIZ,TN,8920,3795,5163,2174,1516,811,3647,1363,64,31,2101,881,1775,749,326,132,132,,,,1526,664,1412,624,0,0,105,35,9,5,40,66,45
E02005003,Ashford 008,Middle Super Output Areas and Intermediate Zones,MSOAIZ,TN,8525,3069,4621,1707,1000,510,3621,1197,174,81,2479,869,1237,413,1242,456,456,,,,1179,374,1057,336,3,1,104,33,15,4,38,72,38
E02005004,Ashford 009,Middle Super Output Areas and Intermediate Zones,MSOAIZ,TN,12001,4473,7905,2868,1655,798,6250,2070,323,119,1239,505,706,324,533,181,181,,,,2463,934,2273,868,11,6,119,42,60,18,66,71,47
E02005005,Ashford 010,Middle Super Output Areas and Intermediate Zones,MSOAIZ,TN,7340,2952,5953,2392,2457,1211,3496,1181,72,31,449,189,287,137,162,52,52,,,,780,295,700,259,13,7,49,23,18,6,36,86,45
E02005006,Ashford 011,Middle Super Output Areas and Intermediate Zones,MSOAIZ,TN,5444,2193,4251,1703,2044,960,2207,743,48,22,613,250,431,187,182,63,63,,,,449,179,382,147,7,3,51,25,9,4,32,83,39
E02005007,Ashford 012,Middle Super Output Areas and Intermediate Zones,MSOAIZ,TN,8493,3494,6368,2590,2482,1275,3886,1315,218,98,574,256,437,204,137,52,52,,,,1223,489,1121,451,16,6,79,29,7,3,38,110,61
E02005008,Ashford 013,Middle Super Output Areas and Intermediate Zones,MSOAIZ,TN,8012,3686,5838,2667,3076,1699,2762,968,93,38,1054,507,746,357,308,150,150,,,,914,412,842,377,6,4,61,29,5,2,35,113,62
E02005009,Ashford 014,Middle Super Output Areas and Intermediate Zones,MSOAIZ,TN,5585,2331,4222,1744,1923,975,2299,769,36,14,741,322,609,268,132,54,54,,,,504,212,427,181,16,6,46,20,15,5,31,82,39
E02005010,Canterbury 001,Middle Super Output Areas and Intermediate Zones,MSOAIZ,CT,7088,3522,4097,1828,1586,920,2511,908,20,12,440,279,250,142,190,137,137,,,,2433,1350,2326,1294,10,5,83,45,14,6,56,98,53
E02005011,Canterbury 002,Middle Super Output Areas and Intermediate Zones,MSOAIZ,CT,7175,3152,6130,2668,2950,1602,3180,1066,142,66,273,168,138,94,135,74,74,,,,569,211,498,183,7,3,62,24,2,1,28,61,39
E02005012,Canterbury 003,Middle Super Output Areas and Intermediate Zones,MSOAIZ,CT,8574,3603,6194,2592,2399,1300,3795,1292,38,16,1192,535,908,397,284,138,138,,,,1080,418,986,372,6,2,78,38,10,6,46,70,42
E02005013,Canterbury 004,Middle Super Output Areas and Intermediate Zones,MSOAIZ,CT,8101,3558,6126,2677,2673,1487,3453,1190,48,21,804,410,742,384,62,26,26,,,,1070,413,939,351,14,5,111,53,6,4,62,53,37
E02005014,Canterbury 005,Middle Super Output Areas and Intermediate Zones,MSOAIZ,CT,8427,3688,7635,3326,3682,1961,3953,1365,33,15,45,16,25,9,20,7,7,,,,661,297,584,257,1,1,75,38,1,1,40,53,34
E02005015,Canterbury 006,Middle Super Output Areas and Intermediate Zones,MSOAIZ,CT,8329,3352,6873,2760,2443,1245,4430,1515,102,47,235,97,83,31,152,66,66,,,,1065,415,941,364,7,3,102,42,15,6,51,54,33
E02005016,Canterbury 007,Middle Super Output Areas and Intermediate Zones,MSOAIZ,CT,7686,3317,5567,2389,2373,1290,3194,1099,34,17,1154,512,753,347,401,165,165,,,,886,370,781,323,5,1,88,41,12,5,47,45,29
E02005017,Canterbury 008,Middle Super Output Areas and Intermediate Zones,MSOAIZ,CT,7050,3303,4935,2240,2034,1134,2901,1106,27,11,216,114,169,90,47,24,24,,,,1780,883,1637,821,8,3,117,50,18,9,62,92,55
E02005018,Canterbury 009,Middle Super Output Areas and Intermediate Zones,MSOAIZ,CT,7923,3393,6530,2836,2955,1606,3575,1230,54,25,645,250,457,188,188,62,62,,,,631,248,531,207,8,5,81,31,11,5,41,63,34
E02005019,Canterbury 010,Middle Super Output Areas and Intermediate Zones,MSOAIZ,CT,5832,2380,4142,1678,1687,825,2455,853,30,16,697,279,493,198,204,81,81,,,,870,361,758,316,31,13,71,26,10,6,45,93,46
E02005020,Canterbury 011,Middle Super Output Areas and Intermediate Zones,MSOAIZ,CT,7042,2865,4878,2065,2021,1080,2857,985,61,25,1149,412,1052,357,97,55,55,,,,874,319,743,269,36,11,66,30,29,9,50,80,44
E02005021,Canterbury 012,Middle Super Output Areas and Intermediate Zones,MSOAIZ,CT,6296,2635,4939,2100,2352,1227,2587,873,12,5,206,108,140,69,66,39,39,,,,1016,362,909,322,23,7,49,20,35,13,40,123,60
E02005022,Canterbury 013,Middle Super Output Areas and Intermediate Zones,MSOAIZ,CT,8306,2959,2730,1173,1424,724,1306,449,73,28,1863,782,708,302,1155,480,480,,,,3595,955,3487,911,13,6,88,33,7,5,44,45,21
E02005023,Canterbury 014,Middle Super Output Areas and Intermediate Zones,MSOAIZ,CT,7819,3158,1561,739,659,377,902,362,154,59,2844,1302,2131,992,713,310,310,,,,3161,1000,2334,753,319,94,90,32,418,121,247,99,58
E02005025,Canterbury 016,Middle Super Output Areas and Intermediate Zones,MSOAIZ,CT,8173,3495,4424,1992,2120,1165,2304,827,54,26,876,377,618,234,258,143,143,,,,2692,1037,2462,933,58,30,108,49,64,25,104,127,63
E02005026,Canterbury 017,Middle Super Output Areas and Intermediate Zones,MSOAIZ,CT,7417,3046,5555,2273,2186,1079,3369,1194,24,8,738,305,478,208,260,97,97,,,,1035,426,930,385,35,13,62,26,8,2,41,65,34
E02005027,Canterbury 018,Middle Super Output Areas and Intermediate Zones,MSOAIZ,CT,5306,2203,4221,1728,1862,963,2359,765,20,6,353,147,235,113,118,34,34,,,,608,270,516,237,39,14,33,14,20,5,33,104,52
E02005028,Dartford 001,Middle Super Output Areas and Intermediate Zones,MSOAIZ,DA,7380,3156,3202,1317,833,451,2369,866,232,94,3191,1409,2386,1138,805,271,271,,,,681,286,617,263,2,1,62,22,0,0,23,74,50
E02005029,Dartford 002,Middle Super Output Areas and Intermediate Zones,MSOAIZ,DA,9268,4021,5595,2341,1225,628,4370,1713,210,113,917,377,445,173,472,204,204,,,,2488,1162,2383,1114,16,6,81,38,8,4,48,58,28
E02005030,Dartford 003,Middle Super Output Areas and Intermediate Zones,MSOAIZ,DA,9774,4093,6626,2693,1975,1004,4651,1689,214,110,658,335,202,116,456,219,219,,,,2217,924,2106,873,12,4,87,42,12,5,51,59,31
E02005031,Dartford 004,Middle Super Output Areas and Intermediate Zones,MSOAIZ,DA,7436,3258,3774,1600,994,528,2780,1072,164,84,2088,896,1580,688,508,208,208,,,,1352,640,1287,610,26,9,30,17,9,4,30,58,38
E02005032,Dartford 005,Middle Super Output Areas and Intermediate Zones,MSOAIZ,DA,8896,3931,6056,2628,1761,914,4295,1714,52,20,521,198,396,143,125,55,55,,,,2220,1054,2040,976,16,5,107,53,57,20,78,47,31
E02005033,Dartford 006,Middle Super Output Areas and Intermediate Zones,MSOAIZ,DA,6529,2897,3679,1546,1034,534,2645,1012,66,35,1438,641,1247,562,191,79,79,,,,1277,636,1231,612,1,1,42,20,3,3,24,69,39
E02005034,Dartford 007,Middle Super Output Areas and Intermediate Zones,MSOAIZ,DA,7644,2843,6953,2586,2423,1196,4530,1390,1,1,45,14,30,9,15,5,5,,,,615,226,565,204,3,2,42,18,5,2,22,30,16
E02005035,Dartford 008,Middle Super Output Areas and Intermediate Zones,MSOAIZ,DA,7762,3038,6346,2444,2246,1094,4100,1350,40,23,369,163,219,101,150,62,62,,,,952,378,889,348,4,1,53,26,6,3,30,55,30
E02005036,Dartford 009,Middle Super Output Areas and Intermediate Zones,MSOAIZ,DA,6304,2556,3440,1330,949,472,2491,858,16,7,2034,884,1556,613,478,271,271,,,,753,298,675,268,8,4,65,23,5,3,30,61,37
E02005037,Dartford 010,Middle Super Output Areas and Intermediate Zones,MSOAIZ,DA,6955,2742,6085,2390,2392,1235,3693,1155,37,17,363,130,118,50,245,80,80,,,,427,185,408,178,3,1,11,5,5,1,7,43,20
E02005038,Dartford 011,Middle Super Output Areas and Intermediate Zones,MSOAIZ,DA,5666,2333,4916,1961,1872,954,3044,1007,12,5,372,195,307,149,65,46,46,,,,339,156,317,146,0,0,18,7,4,3,10,27,16
E02005039,Dartford 012,Middle Super Output Areas and Intermediate Zones,MSOAIZ,DA,6665,2692,4676,1831,1498,755,3178,1076,56,20,1335,584,1139,485,196,99,99,,,,540,232,489,213,12,5,37,13,2,1,19,58,25
E02005040,Dartford 013,Middle Super Output Areas and Intermediate Zones,MSOAIZ,DA,6097,2521,5257,2152,2500,1247,2757,905,10,8,282,121,262,111,20,10,10,,,,479,208,459,198,5,2,13,7,2,1,10,69,32
E02005041,Dover 001,Middle Super Output Areas and Intermediate Zones,MSOAIZ,CT,6906,2851,4968,2034,2234,1105,2734,929,39,24,928,360,501,216,427,144,144,,,,875,380,743,328,82,31,34,15,16,6,52,96,53
E02005042,Dover 002,Middle Super Output Areas and Intermediate Zones,MSOAIZ,CT,8806,3999,6113,2766,2873,1595,3240,1171,17,10,1216,557,845,419,371,138,138,,,,1272,562,1150,509,20,6,91,43,11,4,53,188,104
E02005043,Dover 003,Middle Super Output Areas and Intermediate Zones,MSOAIZ,CT,7249,3353,5403,2457,2445,1353,2958,1104,78,48,613,305,444,215,169,90,90,,,,1079,494,976,442,12,7,83,39,8,6,52,76,49
E02005044,Dover 004,Middle Super Output Areas and Intermediate Zones,MSOAIZ,CT,6759,3446,4544,2291,2294,1359,2250,932,40,19,195,97,72,37,123,60,60,,,,1898,986,1772,928,10,6,102,44,14,8,58,82,53
E02005045,Dover 005,Middle Super Output Areas and Intermediate Zones,MSOAIZ,CT,7905,3298,5471,2309,2054,1107,3417,1202,30,12,1108,466,812,341,296,125,125,,,,1173,445,1018,383,31,10,116,48,8,4,62,123,66
E02005046,Dover 006,Middle Super Output Areas and Intermediate Zones,MSOAIZ,CT,6485,2619,3892,1616,1486,756,2406,860,26,8,1726,660,1295,495,431,165,165,,,,594,252,506,215,8,3,73,31,7,3,37,247,83
E02005047,Dover 007,Middle Super Output Areas and Intermediate Zones,MSOAIZ,CT,7463,3354,5176,2241,2225,1179,2951,1062,13,5,1336,686,887,399,449,287,287,,,,833,361,745,324,2,1,68,27,18,9,37,105,61
E02005048,Dover 008,Middle Super Output Areas and Intermediate Zones,MSOAIZ,CT,6381,2678,5270,2221,2424,1234,2846,987,24,11,385,152,339,138,46,14,14,,,,635,262,527,220,23,8,76,31,9,3,42,67,32
E02005049,Dover 009,Middle Super Output Areas and Intermediate Zones,MSOAIZ,CT,6798,3200,5654,2625,3243,1753,2411,872,38,16,372,174,265,114,107,60,60,,,,658,337,575,296,15,5,62,31,6,5,41,76,48
E02005050,Dover 010,Middle Super Output Areas and Intermediate Zones,MSOAIZ,CT,8883,3719,7320,3128,3083,1620,4237,1508,56,25,705,236,123,47,582,189,189,,,,735,298,551,230,47,16,49,29,88,23,68,67,32
E02005051,Dover 011,Middle Super Output Areas and Intermediate Zones,MSOAIZ,CT,13293,5514,6155,2615,1878,1018,4277,1597,69,27,4280,1729,2831,1097,1449,632,632,,,,2674,1072,2483,997,8,3,163,61,20,11,75,115,71
E02005052,Dover 012,Middle Super Output Areas and Intermediate Zones,MSOAIZ,CT,7322,3590,3478,1614,1550,877,1928,737,34,12,1010,629,508,306,502,323,323,,,,2626,1252,2124,1064,155,55,104,55,243,78,188,174,83
E02005053,Dover 013,Middle Super Output Areas and Intermediate Zones,MSOAIZ,CT,8625,3813,4170,1777,1357,731,2813,1046,43,19,1374,684,904,381,470,303,303,,,,2967,1292,2821,1223,15,5,107,55,24,9,69,71,41
E02005054,Dover 014,Middle Super Output Areas and Intermediate Zones,MSOAIZ,CT,6587,2876,5686,2448,2578,1347,3108,1101,18,9,222,129,120,72,102,57,57,,,,597,261,546,235,10,4,34,17,7,5,26,64,29
E02005055,Gravesham 001,Middle Super Output Areas and Intermediate Zones,MSOAIZ,DA,7743,3167,3667,1428,1222,536,2445,892,84,42,1953,868,1647,714,306,154,154,,,,1965,794,1891,761,4,2,52,24,18,7,33,74,35
E02005056,Gravesham 002,Middle Super Output Areas and Intermediate Zones,MSOAIZ,DA,9815,4550,3964,1610,1667,774,2297,836,138,61,1590,917,1098,650,492,267,267,,,,3991,1885,3831,1816,18,6,93,48,49,15,69,132,77
E02005057,Gravesham 003,Middle Super Output Areas and Intermediate Zones,MSOAIZ,DA,10572,4146,6262,2435,2345,1098,3917,1337,133,63,1621,621,1148,423,473,198,198,,,,2473,978,2340,924,11,3,101,42,21,9,54,83,49
E02005058,Gravesham 004,Middle Super Output Areas and Intermediate Zones,MSOAIZ,DA,7682,2974,4563,1723,1463,684,3100,1039,51,20,1234,551,903,416,331,135,135,,,,1761,639,1687,606,11,4,52,23,11,6,33,73,41
E02005059,Gravesham 005,Middle Super Output Areas and Intermediate Zones,MSOAIZ,DA,9822,3819,7698,2915,2931,1382,4767,1533,58,20,330,202,106,61,224,141,141,,,,1670,646,1556,600,13,4,92,39,9,3,46,66,36
E02005060,Gravesham 006,Middle Super Output Areas and Intermediate Zones,MSOAIZ,DA,7205,2879,4917,1911,1918,934,2999,977,63,34,1524,663,1144,529,380,134,134,,,,643,236,587,217,0,0,50,15,6,4,19,58,35
E02005061,Gravesham 007,Middle Super Output Areas and Intermediate Zones,MSOAIZ,DA,7126,2777,4121,1546,1444,696,2677,850,50,17,2268,961,2194,924,74,37,37,,,,580,193,512,170,12,2,42,15,14,6,23,107,60
E02005062,Gravesham 008,Middle Super Output Areas and Intermediate Zones,MSOAIZ,DA,6982,2606,5658,2152,2047,1008,3611,1144,11,5,738,254,673,235,65,19,19,,,,537,177,498,163,0,0,37,13,2,1,14,38,18
E02005063,Gravesham 009,Middle Super Output Areas and Intermediate Zones,MSOAIZ,DA,6566,2469,4824,1782,1815,859,3009,923,35,16,1186,484,921,388,265,96,96,,,,497,171,460,153,9,3,24,13,4,2,18,24,16
E02005064,Gravesham 010,Middle Super Output Areas and Intermediate Zones,MSOAIZ,ME,6581,2702,5436,2213,2399,1225,3037,988,17,6,568,251,458,209,110,42,42,,,,506,200,421,167,15,7,43,16,27,10,33,54,32
E02005065,Gravesham 011,Middle Super Output Areas and Intermediate Zones,MSOAIZ,DA,7221,2904,3853,1585,1236,649,2617,936,16,5,2585,1006,2276,905,309,101,101,,,,693,261,627,235,10,5,47,18,9,3,26,74,47
E02005066,Gravesham 012,Middle Super Output Areas and Intermediate Zones,MSOAIZ,DA,7765,3146,6882,2781,3132,1583,3750,1198,16,6,297,134,244,116,53,18,18,,,,519,195,462,168,17,5,37,20,3,2,27,51,30
E02005067,Gravesham 013,Middle Super Output Areas and Intermediate Zones,MSOAIZ,TN,5896,2292,5237,2018,2057,980,3180,1038,20,10,215,96,149,58,66,38,38,,,,389,149,327,128,12,3,46,16,4,2,21,35,19
E02005068,Maidstone 001,Middle Super Output Areas and Intermediate Zones,MSOAIZ,ME,6967,2706,5982,2283,1815,857,4167,1426,55,29,172,72,53,20,119,52,52,,,,719,301,643,269,11,4,47,22,18,6,32,39,21
E02005069,Maidstone 002,Middle Super Output Areas and Intermediate Zones,MSOAIZ,ME,8462,3465,6655,2721,2568,1307,4087,1414,72,35,346,133,13,7,333,126,126,,,,1343,554,1251,509,5,3,80,38,7,4,45,46,22
E02005070,Maidstone 003,Middle Super Output Areas and Intermediate Zones,MSOAIZ,ME,8483,3650,7667,3312,3416,1884,4251,1428,40,23,51,19,11,4,40,15,15,,,,677,270,599,235,14,6,58,26,6,3,35,48,26
E02005071,Maidstone 004,Middle Super Output Areas and Intermediate Zones,MSOAIZ,ME,9486,4423,4036,1899,1186,686,2850,1213,166,93,1840,891,311,142,1529,749,749,,,,3358,1492,2653,1263,248,74,159,60,298,95,229,86,48
E02005072,Maidstone 005,Middle Super Output Areas and Intermediate Zones,MSOAIZ,ME,7613,3055,6688,2646,2452,1241,4236,1405,25,9,103,70,7,2,96,68,68,,,,770,313,704,285,2,1,55,22,9,5,28,27,17
E02005073,Maidstone 006,Middle Super Output Areas and Intermediate Zones,MSOAIZ,ME,10279,4713,5579,2400,1707,874,3872,1526,219,120,1067,575,146,71,921,504,504,,,,3359,1585,3152,1490,20,7,159,74,28,14,95,55,33
E02005074,Maidstone 007,Middle Super Output Areas and Intermediate Zones,MSOAIZ,ME,7903,3336,6811,2829,2742,1430,4069,1399,39,15,162,72,22,8,140,64,64,,,,835,383,769,348,3,2,56,29,7,4,35,56,37
E02005075,Maidstone 008,Middle Super Output Areas and Intermediate Zones,MSOAIZ,ME,9274,3700,5826,2318,1687,868,4139,1450,158,64,1427,580,241,97,1186,483,483,,,,1785,700,1551,611,111,35,91,41,32,13,89,78,38
E02005076,Maidstone 009,Middle Super Output Areas and Intermediate Zones,MSOAIZ,ME,8460,3434,4921,2087,1286,693,3635,1394,55,21,1528,549,287,103,1241,446,446,,,,1896,749,1791,707,3,1,85,36,17,5,42,60,28
E02005077,Maidstone 010,Middle Super Output Areas and Intermediate Zones,MSOAIZ,ME,7795,3021,5118,1965,1678,848,3440,1117,90,39,1970,779,453,170,1517,609,609,,,,557,206,470,172,16,6,60,25,11,3,34,60,32
E02005078,Maidstone 011,Middle Super Output Areas and Intermediate Zones,MSOAIZ,TN,7876,3230,6165,2500,2569,1273,3596,1227,68,26,637,265,115,40,522,225,225,,,,895,388,809,350,31,9,42,20,13,9,38,111,51
E02005079,Maidstone 012,Middle Super Output Areas and Intermediate Zones,MSOAIZ,ME,7819,3241,6870,2787,2853,1473,4017,1314,33,18,235,147,37,19,198,128,128,,,,616,260,545,233,7,4,58,21,6,2,27,65,29
E02005080,Maidstone 013,Middle Super Output Areas and Intermediate Zones,MSOAIZ,ME,10909,4530,4637,1890,1619,862,3018,1028,76,30,5461,2299,1361,536,4100,1763,1763,,,,599,231,530,202,1,1,41,15,27,13,29,136,80
E02005081,Maidstone 014,Middle Super Output Areas and Intermediate Zones,MSOAIZ,TN,6594,2861,5237,2202,2424,1262,2813,940,13,8,528,279,99,47,429,232,232,,,,739,328,672,300,18,7,39,15,10,6,28,77,44
E02005082,Maidstone 015,Middle Super Output Areas and Intermediate Zones,MSOAIZ,TN,9465,3820,7161,2856,2600,1264,4561,1592,203,67,1149,488,146,65,1003,423,423,,,,857,362,741,314,46,14,56,27,14,7,48,95,47
E02005083,Maidstone 016,Middle Super Output Areas and Intermediate Zones,MSOAIZ,ME,6669,2808,5601,2308,2280,1170,3321,1138,64,28,540,257,104,50,436,207,207,,,,401,181,355,161,9,2,32,15,5,3,20,63,34
E02005084,Maidstone 017,Middle Super Output Areas and Intermediate Zones,MSOAIZ,TN,6230,2579,4805,1951,2263,1083,2542,868,31,11,486,218,92,44,394,174,174,,,,745,327,614,267,83,31,44,25,4,4,60,163,72
E02005085,Maidstone 018,Middle Super Output Areas and Intermediate Zones,MSOAIZ,TN,6356,2564,4846,1905,1918,909,2928,996,41,18,592,254,118,50,474,204,204,,,,743,326,624,279,54,18,54,24,11,5,47,134,61
E02005086,Maidstone 019,Middle Super Output Areas and Intermediate Zones,MSOAIZ,TN,5805,2311,4668,1841,1833,901,2835,940,38,17,256,119,40,20,216,99,99,,,,772,300,694,269,22,7,48,21,8,3,31,71,34
E02005087,Sevenoaks 001,Middle Super Output Areas and Intermediate Zones,MSOAIZ,DA,6970,2804,5806,2349,2357,1194,3449,1155,91,37,551,214,115,45,436,169,169,,,,458,177,395,154,23,8,38,13,2,2,23,64,27
E02005088,Sevenoaks 002,Middle Super Output Areas and Intermediate Zones,MSOAIZ,BR,8998,3916,4663,1973,1571,849,3092,1124,215,96,3518,1551,583,272,2935,1279,1279,,,,499,233,457,217,0,0,36,14,6,2,16,103,63
E02005089,Sevenoaks 003,Middle Super Output Areas and Intermediate Zones,MSOAIZ,TN,6256,2533,5122,2037,2056,1018,3066,1019,86,28,456,207,86,33,370,174,174,,,,532,235,475,208,19,5,29,18,9,4,27,60,26
E02005090,Sevenoaks 004,Middle Super Output Areas and Intermediate Zones,MSOAIZ,TN,5723,2405,4809,2008,2357,1199,2452,809,52,29,507,213,55,27,452,186,186,,,,278,115,245,96,3,2,22,12,8,5,19,77,40
E02005091,Sevenoaks 005,Middle Super Output Areas and Intermediate Zones,MSOAIZ,TN,6579,2896,5031,2215,2034,1099,2997,1116,187,78,703,302,71,33,632,269,269,,,,574,257,495,225,22,9,40,16,17,7,32,84,44
E02005093,Sevenoaks 007,Middle Super Output Areas and Intermediate Zones,MSOAIZ,TN,6029,2505,5219,2132,2268,1182,2951,950,96,37,301,151,37,25,264,126,126,,,,371,160,309,134,27,9,25,13,10,4,26,42,25
E02005094,Sevenoaks 008,Middle Super Output Areas and Intermediate Zones,MSOAIZ,TN,8436,3514,6046,2488,2420,1249,3626,1239,159,71,799,334,68,33,731,301,301,,,,1337,568,1201,511,39,16,77,32,20,9,57,95,53
E02005095,Sevenoaks 009,Middle Super Output Areas and Intermediate Zones,MSOAIZ,TN,7373,2950,6021,2416,2748,1360,3273,1056,135,55,715,283,90,34,625,249,249,,,,440,163,379,140,14,4,46,18,1,1,23,62,33
E02005096,Sevenoaks 010,Middle Super Output Areas and Intermediate Zones,MSOAIZ,TN,9400,4009,5921,2473,2300,1184,3621,1289,339,142,1736,758,138,64,1598,694,694,,,,1320,589,1219,541,27,13,63,28,11,7,48,84,47
E02005097,Sevenoaks 011,Middle Super Output Areas and Intermediate Zones,MSOAIZ,TN,9206,3362,7721,2851,3448,1580,4273,1271,71,22,382,145,25,10,357,135,135,,,,874,286,797,260,36,14,29,8,12,4,26,158,58
E02005098,Sevenoaks 012,Middle Super Output Areas and Intermediate Zones,MSOAIZ,TN,9267,3914,6651,2591,3197,1488,3454,1103,18,10,704,452,39,18,665,434,434,,,,1652,752,1501,677,100,48,19,9,32,18,75,242,109
E02005099,Sevenoaks 013,Middle Super Output Areas and Intermediate Zones,MSOAIZ,TN,7718,3265,5534,2298,2428,1194,3106,1104,66,27,964,415,88,44,876,371,371,,,,997,448,867,397,61,21,29,17,40,13,51,157,77
E02005100,Sevenoaks 014,Middle Super Output Areas and Intermediate Zones,MSOAIZ,TN,8811,3785,5923,2568,2296,1240,3627,1328,291,119,1625,660,268,117,1357,543,543,,,,897,388,835,362,18,4,36,17,8,5,26,75,50
E02005101,Sevenoaks 015,Middle Super Output Areas and Intermediate Zones,MSOAIZ,TN,6695,2694,4711,1830,2204,1006,2507,824,64,24,769,355,67,35,702,320,320,,,,966,403,885,371,30,11,31,14,20,7,32,185,82
E02005102,Shepway 001,Middle Super Output Areas and Intermediate Zones,MSOAIZ,TN,6251,2695,5218,2223,2634,1340,2584,883,34,13,238,125,190,104,48,21,21,,,,665,278,584,244,19,8,43,17,19,9,34,96,56
E02005103,Shepway 002,Middle Super Output Areas and Intermediate Zones,MSOAIZ,CT,9507,3602,6556,2540,1967,983,4589,1557,96,38,1250,450,537,212,713,238,238,,,,1537,543,1226,436,94,33,134,49,83,25,107,68,31
E02005104,Shepway 003,Middle Super Output Areas and Intermediate Zones,MSOAIZ,CT,8348,3388,4991,2017,1873,966,3118,1051,16,7,2211,952,1661,688,550,264,264,,,,1063,372,998,345,4,3,56,22,5,2,27,67,40
E02005105,Shepway 004,Middle Super Output Areas and Intermediate Zones,MSOAIZ,CT,7695,3254,3866,1656,1134,630,2732,1026,15,7,1113,526,531,275,582,251,251,,,,2634,1035,2469,973,2,2,144,54,19,6,62,67,30
E02005106,Shepway 005,Middle Super Output Areas and Intermediate Zones,MSOAIZ,CT,9093,3608,5312,2162,1731,916,3581,1246,68,30,1577,685,1061,449,516,236,236,,,,2035,686,1430,507,161,43,120,45,324,91,179,101,45
E02005107,Shepway 006,Middle Super Output Areas and Intermediate Zones,MSOAIZ,CT,11874,5068,8610,3720,3923,2076,4687,1644,39,14,479,172,89,41,390,131,131,,,,2663,1122,2407,1023,44,14,179,69,33,16,99,83,40
E02005109,Shepway 008,Middle Super Output Areas and Intermediate Zones,MSOAIZ,CT,6306,2893,5473,2480,2962,1588,2511,892,27,16,81,49,65,36,16,13,13,,,,674,315,597,284,9,4,56,24,12,3,31,51,33
E02005110,Shepway 009,Middle Super Output Areas and Intermediate Zones,MSOAIZ,TN,6709,2853,5777,2480,2682,1403,3095,1077,11,5,281,113,139,64,142,49,49,,,,551,214,422,163,47,15,54,25,28,11,51,89,41
E02005111,Shepway 010,Middle Super Output Areas and Intermediate Zones,MSOAIZ,CT,7157,3648,4490,2265,2435,1457,2055,808,24,16,1142,632,913,491,229,141,141,,,,1404,665,1291,606,32,13,67,40,14,6,59,97,70
E02005112,Shepway 011,Middle Super Output Areas and Intermediate Zones,MSOAIZ,TN,6836,3047,5086,2287,2585,1402,2501,885,19,7,866,362,665,297,201,65,65,,,,758,330,607,265,21,10,109,44,21,11,65,107,61
E02005113,Shepway 012,Middle Super Output Areas and Intermediate Zones,MSOAIZ,TN,6781,2984,5263,2309,2566,1361,2697,948,37,13,565,269,274,143,291,126,126,,,,843,348,705,294,6,3,115,43,17,8,54,73,45
E02005114,Shepway 013,Middle Super Output Areas and Intermediate Zones,MSOAIZ,TN,6487,2814,4619,2048,2047,1138,2572,910,17,7,651,253,511,208,140,45,45,,,,1125,465,1002,412,29,15,65,26,29,12,53,75,41
E02005115,Swale 001,Middle Super Output Areas and Intermediate Zones,MSOAIZ,ME,5773,2441,2746,1147,915,485,1831,662,30,20,272,149,41,25,231,124,124,,,,2681,1104,2574,1064,16,7,80,28,11,5,40,44,21
E02005116,Swale 002,Middle Super Output Areas and Intermediate Zones,MSOAIZ,ME,6076,2567,2484,1034,873,472,1611,562,36,15,2397,1040,440,173,1957,867,867,,,,1099,445,1015,413,3,1,70,26,11,5,32,60,33
E02005117,Swale 003,Middle Super Output Areas and Intermediate Zones,MSOAIZ,ME,5805,2492,4646,1968,2145,1120,2501,848,27,13,578,271,56,33,522,238,238,,,,517,215,457,184,2,1,49,25,9,5,31,37,25
E02005118,Swale 004,Middle Super Output Areas and Intermediate Zones,MSOAIZ,ME,9030,3696,6505,2638,2051,1080,4454,1558,172,78,915,382,140,57,775,325,325,,,,1382,565,1276,517,13,5,80,38,13,5,48,56,33
E02005119,Swale 005,Middle Super Output Areas and Intermediate Zones,MSOAIZ,ME,5690,2438,3768,1671,1682,902,2086,769,6,3,830,323,136,55,694,268,268,,,,1051,415,954,375,11,7,84,31,2,2,40,35,26
E02005120,Swale 006,Middle Super Output Areas and Intermediate Zones,MSOAIZ,ME,6369,2729,4706,2025,2038,1067,2668,958,27,12,478,178,54,20,424,158,158,,,,1053,458,980,423,10,5,47,20,16,10,35,105,56
E02005121,Swale 007,Middle Super Output Areas and Intermediate Zones,MSOAIZ,ME,12334,4706,8700,3356,1648,866,7052,2490,116,50,1815,619,330,117,1485,502,502,,,,1655,654,1535,602,4,1,110,46,6,5,52,48,27
E02005122,Swale 008,Middle Super Output Areas and Intermediate Zones,MSOAIZ,ME,6886,2795,5555,2228,2287,1116,3268,1112,42,17,644,271,45,22,599,249,249,,,,598,253,525,218,9,2,56,27,8,6,35,47,26
E02005123,Swale 009,Middle Super Output Areas and Intermediate Zones,MSOAIZ,ME,10809,4328,7994,3194,2505,1258,5489,1936,192,84,1052,394,159,65,893,329,329,,,,1506,622,1404,575,14,7,65,31,23,9,47,65,34
E02005124,Swale 010,Middle Super Output Areas and Intermediate Zones,MSOAIZ,ME,8174,3692,3990,1776,1376,805,2614,971,75,38,2026,984,310,167,1716,817,817,,,,1994,842,1895,789,9,4,71,38,19,11,53,89,52
E02005125,Swale 011,Middle Super Output Areas and Intermediate Zones,MSOAIZ,ME,7534,3120,5027,2070,1646,860,3381,1210,52,26,1254,584,214,99,1040,485,485,,,,1147,401,1038,361,12,4,95,34,2,2,40,54,39
E02005126,Swale 012,Middle Super Output Areas and Intermediate Zones,MSOAIZ,ME,7644,3184,6019,2542,2443,1323,3576,1219,29,11,612,245,121,45,491,200,200,,,,941,355,864,324,3,2,68,27,6,2,31,43,31
E02005127,Swale 013,Middle Super Output Areas and Intermediate Zones,MSOAIZ,ME,8594,3406,7060,2736,2606,1313,4454,1423,172,90,584,255,105,41,479,214,214,,,,714,291,634,259,12,3,55,24,13,5,32,64,34
E02005128,Swale 014,Middle Super Output Areas and Intermediate Zones,MSOAIZ,ME,8254,3449,5861,2502,2258,1212,3603,1290,86,34,1426,535,178,65,1248,470,470,,,,826,344,745,311,11,4,58,24,12,5,33,55,34
E02005129,Swale 015,Middle Super Output Areas and Intermediate Zones,MSOAIZ,ME,10897,4896,7020,3109,2717,1495,4303,1614,112,49,1980,894,276,116,1704,778,778,,,,1676,766,1532,698,23,8,107,51,14,9,68,109,78
E02005130,Swale 016,Middle Super Output Areas and Intermediate Zones,MSOAIZ,TN,8015,3358,5391,2258,2316,1155,3075,1103,69,23,1298,535,179,80,1119,455,455,,,,1117,475,978,420,60,21,66,27,13,7,55,140,67
E02005131,Swale 017,Middle Super Output Areas and Intermediate Zones,MSOAIZ,ME,5496,2288,4101,1697,1792,915,2309,782,16,6,708,283,81,36,627,247,247,,,,551,241,457,202,36,14,41,18,17,7,39,120,61
E02005132,Thanet 001,Middle Super Output Areas and Intermediate Zones,MSOAIZ,CT,9172,4393,2680,1247,1080,642,1600,605,51,25,933,523,189,113,744,410,410,,,,5444,2558,5302,2482,20,6,92,55,30,15,76,64,40
E02005133,Thanet 002,Middle Super Output Areas and Intermediate Zones,MSOAIZ,CT,8283,3739,6752,3046,3330,1867,3422,1179,14,10,155,98,24,8,131,90,90,,,,1274,536,1167,487,10,3,89,41,8,5,49,88,49
E02005134,Thanet 003,Middle Super Output Areas and Intermediate Zones,MSOAIZ,CT,6963,3079,2980,1258,806,464,2174,794,16,7,913,416,339,144,574,272,272,,,,3009,1368,2851,1300,18,9,133,56,7,3,68,45,30
E02005135,Thanet 004,Middle Super Output Areas and Intermediate Zones,MSOAIZ,CT,7582,3222,4481,1864,1484,795,2997,1069,32,13,938,470,263,121,675,349,349,,,,2081,836,1770,675,125,81,158,59,28,21,161,50,39
E02005136,Thanet 005,Middle Super Output Areas and Intermediate Zones,MSOAIZ,CT,7751,3176,5912,2400,2214,1171,3698,1229,12,6,804,369,288,111,516,258,258,,,,961,365,861,329,2,1,93,32,5,3,36,62,36
E02005137,Thanet 006,Middle Super Output Areas and Intermediate Zones,MSOAIZ,CT,7769,3205,3701,1532,1292,686,2409,846,18,8,3066,1327,1925,787,1141,540,540,,,,922,303,838,276,0,0,84,27,0,0,27,62,35
E02005138,Thanet 007,Middle Super Output Areas and Intermediate Zones,MSOAIZ,CT,8162,3985,4962,2369,2191,1294,2771,1075,19,11,1089,532,466,196,623,336,336,,,,2012,1022,1900,964,9,5,98,49,5,4,58,80,51
E02005139,Thanet 008,Middle Super Output Areas and Intermediate Zones,MSOAIZ,CT,8409,4214,6848,3468,3904,2353,2944,1115,24,12,266,120,117,41,149,79,79,,,,1186,559,1076,505,17,6,83,44,10,4,54,85,55
E02005140,Thanet 009,Middle Super Output Areas and Intermediate Zones,MSOAIZ,CT,7386,3429,5922,2763,2999,1697,2923,1066,8,7,245,147,79,32,166,115,115,,,,1153,481,1059,434,4,1,83,41,7,5,47,58,31
E02005141,Thanet 010,Middle Super Output Areas and Intermediate Zones,MSOAIZ,CT,6587,3133,4782,2178,2321,1294,2461,884,41,26,140,87,34,18,106,69,69,,,,1538,793,1411,730,19,5,92,50,16,8,63,86,49
E02005142,Thanet 011,Middle Super Output Areas and Intermediate Zones,MSOAIZ,CT,7069,3108,5330,2377,2459,1379,2871,998,11,5,815,353,297,128,518,225,225,,,,847,326,756,289,3,2,74,29,14,6,37,66,47
E02005143,Thanet 012,Middle Super Output Areas and Intermediate Zones,MSOAIZ,CT,8104,3450,5219,2287,2066,1146,3153,1141,32,12,975,413,306,111,669,302,302,,,,1816,700,1683,640,4,1,116,55,13,4,60,62,38
E02005144,Thanet 013,Middle Super Output Areas and Intermediate Zones,MSOAIZ,CT,8343,3440,3943,1674,1359,746,2584,928,19,7,3080,1296,1803,717,1277,579,579,,,,1237,425,1128,376,0,0,94,41,15,8,49,64,38
E02005145,Thanet 014,Middle Super Output Areas and Intermediate Zones,MSOAIZ,CT,6714,2948,4901,2152,2103,1154,2798,998,20,13,616,304,211,83,405,221,221,,,,1070,421,862,344,69,26,70,31,69,20,77,107,58
E02005146,Thanet 015,Middle Super Output Areas and Intermediate Zones,MSOAIZ,CT,7510,3130,4437,1841,1376,742,3061,1099,23,10,398,198,142,60,256,138,138,,,,2582,1041,2409,958,14,8,145,66,14,9,83,70,40
E02005147,Thanet 016,Middle Super Output Areas and Intermediate Zones,MSOAIZ,CT,8443,4455,3416,1686,1476,890,1940,796,31,21,1211,732,581,327,630,405,405,,,,3711,1972,3538,1881,24,11,127,65,22,15,91,74,44
E02005148,Thanet 017,Middle Super Output Areas and Intermediate Zones,MSOAIZ,CT,7508,3407,6123,2765,2827,1583,3296,1182,24,13,282,152,35,22,247,130,130,,,,1021,445,929,402,8,2,74,36,10,5,43,58,32
E02005149,Tonbridge and Malling 001,Middle Super Output Areas and Intermediate Zones,MSOAIZ,ME,10252,4167,8410,3396,2742,1370,5668,2026,109,47,757,310,76,33,681,277,277,,,,919,382,826,344,9,3,71,29,13,6,38,57,32
E02005150,Tonbridge and Malling 002,Middle Super Output Areas and Intermediate Zones,MSOAIZ,ME,10122,4288,6387,2740,1960,1053,4427,1687,265,104,2352,931,310,121,2042,810,810,,,,1069,485,967,439,5,3,86,38,11,5,46,49,28
E02005151,Tonbridge and Malling 003,Middle Super Output Areas and Intermediate Zones,MSOAIZ,ME,12557,4932,9546,3722,3003,1488,6543,2234,243,92,1823,724,311,106,1512,618,618,,,,863,352,768,313,12,3,67,30,16,6,39,82,42
E02005153,Tonbridge and Malling 005,Middle Super Output Areas and Intermediate Zones,MSOAIZ,ME,8483,3460,5969,2356,2253,1115,3716,1241,132,49,1692,772,165,65,1527,707,707,,,,649,254,532,208,41,19,26,11,50,16,46,41,29
E02005154,Tonbridge and Malling 006,Middle Super Output Areas and Intermediate Zones,MSOAIZ,TN,10835,4333,8417,3306,3473,1701,4944,1605,63,24,1132,512,142,63,990,449,449,,,,1067,421,958,377,36,12,54,23,19,9,44,156,70
E02005155,Tonbridge and Malling 007,Middle Super Output Areas and Intermediate Zones,MSOAIZ,TN,10915,3920,8570,2987,2101,952,6469,2035,247,108,973,355,180,57,793,298,298,,,,1062,437,1004,409,16,9,33,15,9,4,28,63,33
E02005156,Tonbridge and Malling 008,Middle Super Output Areas and Intermediate Zones,MSOAIZ,TN,7154,2915,5007,2025,2205,1070,2802,955,70,26,1294,526,136,49,1158,477,477,,,,670,285,554,234,52,19,46,22,18,10,51,113,53
E02005157,Tonbridge and Malling 009,Middle Super Output Areas and Intermediate Zones,MSOAIZ,TN,6555,2677,4198,1677,1812,925,2386,752,93,34,1977,853,225,90,1752,763,763,,,,245,91,192,73,6,3,47,15,0,0,18,42,22
E02005158,Tonbridge and Malling 010,Middle Super Output Areas and Intermediate Zones,MSOAIZ,TN,6477,2550,5501,2114,2245,1110,3256,1004,32,9,446,214,75,34,371,180,180,,,,447,178,368,148,52,17,19,10,8,3,30,51,35
E02005159,Tonbridge and Malling 011,Middle Super Output Areas and Intermediate Zones,MSOAIZ,TN,7766,3145,5787,2304,2635,1341,3152,963,62,24,1579,674,213,77,1366,597,597,,,,284,110,258,99,9,3,16,7,1,1,11,54,33
E02005160,Tonbridge and Malling 012,Middle Super Output Areas and Intermediate Zones,MSOAIZ,TN,9985,4210,5918,2477,2224,1163,3694,1314,274,116,1722,688,268,95,1454,593,593,,,,1944,863,1723,756,123,57,80,39,18,11,107,127,66
E02005161,Tonbridge and Malling 013,Middle Super Output Areas and Intermediate Zones,MSOAIZ,TN,8193,3332,5414,2177,1783,892,3631,1285,161,61,1187,470,147,52,1040,418,418,,,,1370,589,1260,541,4,2,100,41,6,5,48,61,35
E02005162,Tunbridge Wells 001,Middle Super Output Areas and Intermediate Zones,MSOAIZ,TN,10670,4198,7848,3039,3041,1483,4807,1556,81,25,1551,631,127,59,1424,572,572,,,,1100,456,981,407,43,14,61,28,15,7,49,90,47
E02005163,Tunbridge Wells 002,Middle Super Output Areas and Intermediate Zones,MSOAIZ,TN,8174,3097,6099,2278,2015,993,4084,1285,56,18,986,373,45,19,941,354,354,,,,941,390,849,349,12,5,66,31,14,5,41,92,38
E02005164,Tunbridge Wells 003,Middle Super Output Areas and Intermediate Zones,MSOAIZ,TN,7752,3318,5162,2134,1843,932,3319,1202,100,35,1512,721,111,49,1401,672,672,,,,911,393,838,363,0,0,59,23,14,7,30,67,35
E02005165,Tunbridge Wells 004,Middle Super Output Areas and Intermediate Zones,MSOAIZ,TN,7606,3077,5910,2298,2393,1166,3517,1132,39,12,943,464,66,33,877,431,431,,,,644,267,580,246,25,6,25,11,14,4,21,70,36
E02005166,Tunbridge Wells 005,Middle Super Output Areas and Intermediate Zones,MSOAIZ,TN,6986,2839,3013,1262,1037,536,1976,726,102,41,3214,1242,330,135,2884,1107,1107,,,,610,271,557,247,4,2,36,16,13,6,24,47,23
E02005167,Tunbridge Wells 006,Middle Super Output Areas and Intermediate Zones,MSOAIZ,TN,7657,2957,6380,2389,2738,1263,3642,1126,11,7,411,214,24,11,387,203,203,,,,745,298,641,256,48,21,45,16,11,5,42,110,49
E02005168,Tunbridge Wells 007,Middle Super Output Areas and Intermediate Zones,MSOAIZ,TN,7414,3097,5653,2267,2138,1073,3515,1194,104,52,123,64,4,3,119,61,61,,,,1487,690,1416,656,7,3,54,27,10,4,34,47,24
E02005169,Tunbridge Wells 008,Middle Super Output Areas and Intermediate Zones,MSOAIZ,TN,8779,4630,3909,1919,1315,753,2594,1166,96,56,906,509,86,47,820,462,462,,,,3789,2101,3608,2016,66,18,94,57,21,10,85,79,45
E02005170,Tunbridge Wells 009,Middle Super Output Areas and Intermediate Zones,MSOAIZ,TN,9158,4028,6558,2824,2613,1391,3945,1433,89,36,784,389,26,15,758,374,374,,,,1665,744,1559,697,16,6,80,37,10,4,47,62,35
E02005171,Tunbridge Wells 010,Middle Super Output Areas and Intermediate Zones,MSOAIZ,TN,6101,2642,3010,1361,1147,623,1863,738,35,12,2272,910,204,96,2068,814,814,,,,728,326,692,302,10,5,24,18,2,1,24,56,33
E02005172,Tunbridge Wells 011,Middle Super Output Areas and Intermediate Zones,MSOAIZ,TN,8372,3213,6074,2280,2551,1169,3523,1111,27,10,849,379,62,26,787,353,353,,,,1238,469,1093,412,56,26,65,22,24,9,57,184,75
E02005173,Tunbridge Wells 012,Middle Super Output Areas and Intermediate Zones,MSOAIZ,TN,8477,3734,6320,2654,2815,1427,3505,1227,41,14,472,242,29,13,443,229,229,,,,1579,789,1518,760,0,0,53,25,8,4,29,65,35
E02005174,Tunbridge Wells 013,Middle Super Output Areas and Intermediate Zones,MSOAIZ,TN,7290,2961,4819,1956,2154,1088,2665,868,107,39,1346,549,99,33,1247,516,516,,,,811,326,719,291,42,13,48,21,2,1,35,207,91
E02005175,Tunbridge Wells 014,Middle Super Output Areas and Intermediate Zones,MSOAIZ,TN,8186,3383,5831,2338,2447,1214,3384,1124,39,19,1059,461,57,27,1002,434,434,,,,1082,475,903,410,78,23,87,35,14,7,65,175,90
E02005176,Burnley 001,Middle Super Output Areas and Intermediate Zones,MSOAIZ,BB,8776,3681,6867,2856,2627,1361,4240,1495,16,8,868,381,272,111,596,270,270,,,,971,401,849,351,6,2,110,44,6,4,50,54,35
E02005177,Burnley 002,Middle Super Output Areas and Intermediate Zones,MSOAIZ,BB,5674,2482,4014,1645,1751,846,2263,799,17,4,217,122,58,34,159,88,88,,,,1386,687,1263,628,15,6,92,41,16,12,59,40,24
E02005178,Burnley 003,Middle Super Output Areas and Intermediate Zones,MSOAIZ,BB,8894,3019,5772,1655,3143,976,2629,679,23,7,664,293,102,36,562,257,257,,,,2196,981,1946,881,11,9,219,83,20,8,100,239,83
E02005179,Burnley 004,Middle Super Output Areas and Intermediate Zones,MSOAIZ,BB,8802,4114,5231,2329,2023,1118,3208,1211,26,14,1423,707,434,211,989,496,496,,,,2033,1004,1890,937,2,1,125,58,16,8,67,89,60
E02005180,Burnley 005,Middle Super Output Areas and Intermediate Zones,MSOAIZ,BB,6909,2906,5875,2423,2176,1117,3699,1306,0,0,413,228,116,67,297,161,161,,,,587,228,505,193,0,0,74,30,8,5,35,34,27
E02005181,Burnley 006,Middle Super Output Areas and Intermediate Zones,MSOAIZ,BB,6146,2845,3973,1784,1375,761,2598,1023,34,13,673,341,108,60,565,281,281,,,,1403,667,1316,622,13,6,71,37,3,2,45,63,40
E02005182,Burnley 007,Middle Super Output Areas and Intermediate Zones,MSOAIZ,BB,5767,2790,3224,1359,1276,641,1948,718,12,6,885,578,164,97,721,481,481,,,,1582,805,1466,747,1,1,108,51,7,6,58,64,42
E02005183,Burnley 008,Middle Super Output Areas and Intermediate Zones,MSOAIZ,BB,6079,2844,4154,1758,1646,857,2508,901,10,4,1368,825,438,246,930,579,579,,,,489,215,428,186,0,0,49,22,12,7,29,58,42
E02005184,Burnley 009,Middle Super Output Areas and Intermediate Zones,MSOAIZ,OL,5009,2211,4366,1898,2023,1036,2343,862,9,5,116,71,49,23,67,48,48,,,,457,206,402,180,0,0,48,24,7,2,26,61,31
E02005185,Burnley 010,Middle Super Output Areas and Intermediate Zones,MSOAIZ,BB,8319,3864,3851,1710,1464,795,2387,915,12,4,2368,1122,829,371,1539,751,751,,,,1969,957,1849,895,10,6,84,42,26,14,62,119,71
E02005186,Burnley 011,Middle Super Output Areas and Intermediate Zones,MSOAIZ,BB,5986,2524,4989,2074,1758,880,3231,1194,8,3,304,119,88,33,216,86,86,,,,667,317,601,287,0,0,59,26,7,4,30,18,11
E02005189,Chorley 001,Middle Super Output Areas and Intermediate Zones,MSOAIZ,PR,5138,2360,2346,1041,744,407,1602,634,12,5,2330,1129,100,48,2230,1081,1081,,,,435,174,382,151,0,0,37,16,16,7,23,15,11
E02005190,Chorley 002,Middle Super Output Areas and Intermediate Zones,MSOAIZ,PR,6173,2602,5219,2195,2359,1160,2860,1035,29,18,351,133,60,22,291,111,111,,,,524,229,473,202,6,2,34,20,11,5,27,50,27
E02005191,Chorley 003,Middle Super Output Areas and Intermediate Zones,MSOAIZ,PR,8237,3457,7220,3002,2590,1341,4630,1661,37,19,473,204,25,7,448,197,197,,,,482,216,402,184,2,1,70,28,8,3,32,25,16
E02005192,Chorley 004,Middle Super Output Areas and Intermediate Zones,MSOAIZ,PR,7312,3073,6250,2561,1922,980,4328,1581,41,20,375,186,94,45,281,141,141,,,,617,286,576,263,1,1,36,19,4,3,23,29,20
E02005193,Chorley 005,Middle Super Output Areas and Intermediate Zones,MSOAIZ,PR,8422,3506,7495,3069,2864,1473,4631,1596,23,14,343,162,92,50,251,112,112,,,,508,229,442,194,5,2,59,31,2,2,35,53,32
E02005194,Chorley 006,Middle Super Output Areas and Intermediate Zones,MSOAIZ,PR,8034,3528,5748,2522,2434,1289,3314,1233,54,19,1190,537,324,123,866,414,414,,,,978,412,882,362,5,5,75,34,16,11,50,64,38
E02005195,Chorley 007,Middle Super Output Areas and Intermediate Zones,MSOAIZ,PR,5793,2456,4892,2014,2117,1047,2775,967,68,26,280,155,73,48,207,107,107,,,,498,235,423,203,16,6,58,25,1,1,32,55,26
E02005196,Chorley 008,Middle Super Output Areas and Intermediate Zones,MSOAIZ,PR,7303,3281,5579,2405,2334,1226,3245,1179,53,34,989,493,36,17,953,476,476,,,,630,324,581,297,6,2,33,18,10,7,27,52,25
E02005197,Chorley 009,Middle Super Output Areas and Intermediate Zones,MSOAIZ,PR,6792,3003,4437,1833,1643,812,2794,1021,43,21,1367,703,351,178,1016,525,525,,,,882,401,770,343,0,0,95,51,17,7,58,63,45
E02005198,Chorley 010,Middle Super Output Areas and Intermediate Zones,MSOAIZ,PR,8170,3747,5924,2541,2256,1218,3668,1323,24,14,862,521,294,163,568,358,358,,,,1299,630,1171,566,9,5,116,56,3,3,64,61,41
E02005199,Chorley 011,Middle Super Output Areas and Intermediate Zones,MSOAIZ,WN,7137,3023,6348,2631,2907,1457,3441,1174,69,40,224,131,85,50,139,81,81,,,,449,194,399,171,10,3,36,18,4,2,23,47,27
E02005200,Chorley 012,Middle Super Output Areas and Intermediate Zones,MSOAIZ,PR,8542,3523,5546,2189,1364,684,4182,1505,48,24,1765,775,656,309,1109,466,466,,,,1115,500,1015,452,0,0,85,41,15,7,48,68,35
E02005201,Chorley 013,Middle Super Output Areas and Intermediate Zones,MSOAIZ,PR,7846,3264,6161,2482,2306,1155,3855,1327,23,8,887,414,410,188,477,226,226,,,,724,328,639,290,7,3,62,29,16,6,38,51,32
E02005202,Chorley 014,Middle Super Output Areas and Intermediate Zones,MSOAIZ,PR,9378,4096,7687,3298,3161,1657,4526,1641,38,21,633,300,257,128,376,172,172,,,,927,429,842,388,5,2,52,28,28,11,41,93,48
E02005203,Fylde 001,Middle Super Output Areas and Intermediate Zones,MSOAIZ,PR,7077,2968,5491,2326,2610,1313,2881,1013,12,6,458,193,75,35,383,158,158,,,,1011,396,559,256,256,70,54,24,142,46,140,105,47
E02005204,Fylde 002,Middle Super Output Areas and Intermediate Zones,MSOAIZ,PR,10217,4533,7641,3321,2982,1611,4659,1710,98,45,991,486,185,88,806,398,398,,,,1382,620,1226,546,20,8,104,53,32,13,74,105,61
E02005205,Fylde 003,Middle Super Output Areas and Intermediate Zones,MSOAIZ,PR,6279,2564,4882,2048,2019,1042,2863,1006,3,3,808,277,316,109,492,168,168,,,,523,205,433,170,12,5,43,20,35,10,35,63,31
E02005206,Fylde 004,Middle Super Output Areas and Intermediate Zones,MSOAIZ,FY,6756,3265,4933,2349,2075,1199,2858,1150,32,17,724,348,122,60,602,288,288,,,,1011,512,906,460,0,0,93,46,12,6,52,56,39
E02005207,Fylde 005,Middle Super Output Areas and Intermediate Zones,MSOAIZ,FY,8044,3782,6448,3026,3159,1798,3289,1228,9,6,454,226,115,49,339,177,177,,,,1070,483,961,429,16,5,82,44,11,5,54,63,41
E02005208,Fylde 006,Middle Super Output Areas and Intermediate Zones,MSOAIZ,FY,9581,5105,6376,3038,2922,1758,3454,1280,21,14,278,180,31,19,247,161,161,,,,2789,1803,2651,1722,12,8,118,66,8,7,81,117,70
E02005209,Fylde 007,Middle Super Output Areas and Intermediate Zones,MSOAIZ,PR,7763,3565,6103,2816,2785,1539,3318,1277,17,12,586,275,141,64,445,211,211,,,,993,423,794,351,55,19,96,39,48,14,72,64,39
E02005210,Fylde 008,Middle Super Output Areas and Intermediate Zones,MSOAIZ,FY,9925,4923,8014,3731,3894,2229,4120,1502,28,18,508,366,56,41,452,325,325,,,,1276,740,1151,670,8,3,112,65,5,2,70,99,68
E02005211,Fylde 009,Middle Super Output Areas and Intermediate Zones,MSOAIZ,FY,8393,4180,6144,2967,3040,1725,3104,1242,28,14,448,256,57,34,391,222,222,,,,1698,884,1564,807,13,9,104,60,17,8,77,75,59
E02005212,Hyndburn 001,Middle Super Output Areas and Intermediate Zones,MSOAIZ,BB,10752,4788,7974,3366,3532,1757,4442,1609,39,27,724,448,194,111,530,337,337,,,,1942,901,1817,839,2,1,116,57,7,4,62,73,46
E02005213,Hyndburn 002,Middle Super Output Areas and Intermediate Zones,MSOAIZ,BB,11559,4891,8615,3561,2896,1463,5719,2098,32,14,939,453,411,164,528,289,289,,,,1881,816,1703,734,6,2,158,72,14,8,82,92,47
E02005214,Hyndburn 003,Middle Super Output Areas and Intermediate Zones,MSOAIZ,BB,6623,2912,4765,2037,1949,1016,2816,1021,5,3,460,224,120,54,340,170,170,,,,1359,628,1267,586,5,2,84,39,3,1,42,34,20
E02005215,Hyndburn 004,Middle Super Output Areas and Intermediate Zones,MSOAIZ,BB,11659,5338,7862,3421,3165,1679,4697,1742,22,9,1367,783,541,289,826,494,494,,,,2275,1055,2114,972,1,1,152,77,8,5,83,133,70
E02005216,Hyndburn 005,Middle Super Output Areas and Intermediate Zones,MSOAIZ,BB,5386,2304,3388,1374,1304,652,2084,722,9,3,960,490,449,188,511,302,302,,,,984,410,879,371,1,1,95,35,9,3,39,45,27
E02005217,Hyndburn 006,Middle Super Output Areas and Intermediate Zones,MSOAIZ,BB,12034,4185,7488,2280,4517,1387,2971,893,31,13,2050,882,604,244,1446,638,638,,,,2299,937,2068,856,3,2,214,69,14,10,81,166,73
E02005218,Hyndburn 007,Middle Super Output Areas and Intermediate Zones,MSOAIZ,BB,7379,3387,5142,2199,1813,976,3329,1223,10,6,854,532,236,144,618,388,388,,,,1291,603,1129,536,12,3,135,58,15,6,67,82,47
E02005219,Hyndburn 008,Middle Super Output Areas and Intermediate Zones,MSOAIZ,BB,8413,3770,6434,2710,2664,1353,3770,1357,2,1,651,393,143,97,508,296,296,,,,1252,629,1156,589,4,1,75,30,17,9,40,74,37
E02005220,Hyndburn 009,Middle Super Output Areas and Intermediate Zones,MSOAIZ,BB,6283,2766,5390,2290,2318,1181,3072,1109,19,8,280,184,116,76,164,108,108,,,,545,256,483,228,0,0,57,26,5,2,28,49,28
E02005221,Lancaster 001,Middle Super Output Areas and Intermediate Zones,MSOAIZ,LA,9806,4379,7979,3518,3605,1932,4374,1586,56,26,616,291,519,251,97,40,40,,,,1076,490,932,424,16,8,108,51,20,7,66,79,54
E02005222,Lancaster 002,Middle Super Output Areas and Intermediate Zones,MSOAIZ,LA,5880,2565,4681,2032,2725,1335,1956,697,25,12,229,105,167,82,62,23,23,,,,789,340,621,278,46,15,109,41,13,6,62,156,76
E02005223,Lancaster 003,Middle Super Output Areas and Intermediate Zones,MSOAIZ,LA,7091,3164,6417,2830,3266,1743,3151,1087,6,4,128,73,98,60,30,13,13,,,,498,235,456,214,1,1,37,18,4,2,21,42,22
E02005224,Lancaster 004,Middle Super Output Areas and Intermediate Zones,MSOAIZ,LA,4961,2570,4132,2078,2331,1402,1801,676,19,9,55,29,7,3,48,26,26,,,,707,423,654,393,6,2,42,25,5,3,30,48,31
E02005225,Lancaster 005,Middle Super Output Areas and Intermediate Zones,MSOAIZ,LA,5198,2310,4255,1870,2080,1115,2175,755,36,13,379,174,286,135,93,39,39,,,,474,223,393,185,30,11,43,23,8,4,38,54,30
E02005226,Lancaster 006,Middle Super Output Areas and Intermediate Zones,MSOAIZ,LA,7581,3576,3810,1657,1411,764,2399,893,144,57,889,491,42,21,847,470,470,,,,2636,1326,2453,1245,24,9,130,59,29,13,81,102,45
E02005228,Lancaster 008,Middle Super Output Areas and Intermediate Zones,MSOAIZ,LA,5681,2422,4442,1895,1620,867,2822,1028,26,9,147,54,78,28,69,26,26,,,,1032,444,923,396,6,2,101,45,2,1,48,34,20
E02005229,Lancaster 009,Middle Super Output Areas and Intermediate Zones,MSOAIZ,LA,5485,2636,2531,1125,942,521,1589,604,133,52,280,168,23,15,257,153,153,,,,2497,1268,2367,1222,25,5,98,37,7,4,46,44,23
E02005230,Lancaster 010,Middle Super Output Areas and Intermediate Zones,MSOAIZ,LA,6538,3059,4189,2014,1973,1125,2216,889,17,10,1308,579,901,414,407,165,165,,,,959,418,866,369,1,1,76,42,16,6,49,65,38
E02005231,Lancaster 011,Middle Super Output Areas and Intermediate Zones,MSOAIZ,LA,8000,3605,4837,2084,1447,785,3390,1299,99,39,1720,906,1500,760,220,146,146,,,,1240,512,1094,445,2,1,137,61,7,5,67,104,64
E02005233,Lancaster 013,Middle Super Output Areas and Intermediate Zones,MSOAIZ,LA,5692,2421,4056,1673,1353,683,2703,990,16,9,760,389,712,369,48,20,20,,,,815,318,748,288,0,0,63,28,4,2,30,45,32
E02005234,Lancaster 014,Middle Super Output Areas and Intermediate Zones,MSOAIZ,LA,6871,3377,2546,1311,1129,639,1417,672,67,36,720,454,232,175,488,279,279,,,,3453,1523,3236,1415,10,5,116,54,91,49,108,85,53
E02005235,Lancaster 015,Middle Super Output Areas and Intermediate Zones,MSOAIZ,LA,4984,2105,2377,1155,941,531,1436,624,19,7,229,105,44,22,185,83,83,,,,2310,818,2199,771,10,4,91,40,10,3,47,49,20
E02005236,Lancaster 016,Middle Super Output Areas and Intermediate Zones,MSOAIZ,LA,12691,5512,9934,4288,3767,2057,6167,2231,34,17,1002,420,719,315,283,105,105,,,,1617,719,1405,615,5,4,202,97,5,3,104,104,68
E02005237,Lancaster 017,Middle Super Output Areas and Intermediate Zones,MSOAIZ,LA,9288,3933,6325,2652,2503,1263,3822,1389,86,38,998,502,679,351,319,151,151,,,,1806,704,1656,638,8,4,127,56,15,6,66,73,37
E02005238,Lancaster 018,Middle Super Output Areas and Intermediate Zones,MSOAIZ,LA,5714,2459,4122,1765,1671,901,2451,864,7,3,602,319,414,215,188,104,104,,,,942,344,849,304,2,1,78,35,13,4,40,41,28
E02005239,Lancaster 019,Middle Super Output Areas and Intermediate Zones,MSOAIZ,PR,6108,2571,4851,2041,2345,1158,2506,883,34,17,140,65,110,52,30,13,13,,,,931,385,815,336,41,12,54,30,21,7,49,152,63
E02005240,Pendle 001,Middle Super Output Areas and Intermediate Zones,MSOAIZ,BB,5401,2366,4068,1725,1491,804,2577,921,18,6,393,216,180,92,213,124,124,,,,877,392,806,353,5,4,63,32,3,3,39,45,27
E02005241,Pendle 002,Middle Super Output Areas and Intermediate Zones,MSOAIZ,BD,5514,2499,4139,1841,1748,937,2391,904,2,1,189,111,101,51,88,60,60,,,,1117,511,1038,475,4,1,65,31,10,4,36,67,35
E02005242,Pendle 003,Middle Super Output Areas and Intermediate Zones,MSOAIZ,BD,6180,2678,4703,2003,2076,1059,2627,944,14,6,516,242,260,118,256,124,124,,,,893,395,823,363,8,3,57,28,5,1,32,54,32
E02005243,Pendle 004,Middle Super Output Areas and Intermediate Zones,MSOAIZ,BB,5022,2462,3241,1459,1332,728,1909,731,11,7,643,448,372,264,271,184,184,,,,1055,501,977,460,0,0,67,35,11,6,41,72,47
E02005244,Pendle 005,Middle Super Output Areas and Intermediate Zones,MSOAIZ,BB,5750,2413,3494,1455,1299,678,2195,777,8,2,1349,579,847,322,502,257,257,,,,850,346,791,318,0,0,56,27,3,1,28,49,31
E02005245,Pendle 006,Middle Super Output Areas and Intermediate Zones,MSOAIZ,BB,6924,3016,5839,2479,2412,1240,3427,1239,9,5,204,124,84,54,120,70,70,,,,811,373,714,329,7,2,83,40,7,2,44,61,35
E02005246,Pendle 007,Middle Super Output Areas and Intermediate Zones,MSOAIZ,BB,5153,2409,3057,1327,1244,631,1813,696,14,7,644,388,200,127,444,261,261,,,,1382,656,1283,610,6,4,82,38,11,4,46,56,31
E02005247,Pendle 008,Middle Super Output Areas and Intermediate Zones,MSOAIZ,BB,9861,4459,8262,3584,3592,1858,4670,1726,12,6,348,234,152,105,196,129,129,,,,1135,567,1024,509,4,2,97,51,10,5,58,104,68
E02005248,Pendle 009,Middle Super Output Areas and Intermediate Zones,MSOAIZ,BB,6466,2451,3906,1246,2333,777,1573,469,35,9,1084,536,655,310,429,226,226,,,,1338,604,1215,554,5,2,108,44,10,4,50,103,56
E02005249,Pendle 010,Middle Super Output Areas and Intermediate Zones,MSOAIZ,BB,9405,4058,5481,2126,2741,1170,2740,956,29,13,1215,697,452,276,763,421,421,,,,2535,1139,2370,1075,14,6,133,50,18,8,64,145,83
E02005250,Pendle 011,Middle Super Output Areas and Intermediate Zones,MSOAIZ,BB,7702,2627,5869,1808,3341,1121,2528,687,7,2,363,192,144,89,219,103,103,,,,1308,560,1204,513,2,2,84,38,18,7,47,155,65
E02005251,Pendle 012,Middle Super Output Areas and Intermediate Zones,MSOAIZ,BB,6807,2629,5150,1968,1983,961,3167,1007,11,5,892,366,520,217,372,149,149,,,,693,248,593,209,5,1,80,32,15,6,39,61,42
E02005252,Pendle 013,Middle Super Output Areas and Intermediate Zones,MSOAIZ,BB,8661,3281,7112,2559,3639,1471,3473,1088,5,4,354,200,115,79,239,121,121,,,,1040,468,936,424,4,2,90,40,10,2,44,150,50
E02005253,Preston 001,Middle Super Output Areas and Intermediate Zones,MSOAIZ,PR,5798,2293,5158,2011,2320,1086,2838,925,39,17,72,27,15,8,57,19,19,,,,470,209,390,171,5,1,59,29,16,8,38,59,29
E02005254,Preston 002,Middle Super Output Areas and Intermediate Zones,MSOAIZ,PR,6353,2528,5800,2265,2572,1241,3228,1024,8,6,143,71,29,12,114,59,59,,,,323,140,274,115,7,3,37,19,5,3,25,79,46
E02005255,Preston 003,Middle Super Output Areas and Intermediate Zones,MSOAIZ,PR,8840,3742,7852,3285,3305,1762,4547,1523,41,20,223,120,1,1,222,119,119,,,,676,288,615,256,5,2,48,27,8,3,32,48,29
E02005256,Preston 004,Middle Super Output Areas and Intermediate Zones,MSOAIZ,PR,6888,2915,5820,2350,1743,907,4077,1443,106,43,266,190,15,10,251,180,180,,,,659,311,597,277,25,9,35,24,2,1,34,37,21
E02005257,Preston 005,Middle Super Output Areas and Intermediate Zones,MSOAIZ,PR,5827,2776,2749,1235,927,513,1822,722,38,26,2466,1249,290,168,2176,1081,1081,,,,535,234,471,208,6,1,31,14,27,11,26,39,32
E02005258,Preston 006,Middle Super Output Areas and Intermediate Zones,MSOAIZ,PR,7961,3299,6399,2511,2938,1418,3461,1093,69,44,530,315,65,29,465,286,286,,,,875,384,736,329,68,24,29,17,42,14,55,88,45
E02005259,Preston 007,Middle Super Output Areas and Intermediate Zones,MSOAIZ,PR,10109,4099,6448,2546,2260,1118,4188,1428,23,8,2653,1136,826,317,1827,819,819,,,,856,326,746,280,2,1,78,31,30,14,46,129,83
E02005260,Preston 008,Middle Super Output Areas and Intermediate Zones,MSOAIZ,PR,6708,2860,5900,2518,2425,1306,3475,1212,19,14,204,82,72,26,132,56,56,,,,549,224,496,199,2,1,47,22,4,2,25,36,22
E02005261,Preston 009,Middle Super Output Areas and Intermediate Zones,MSOAIZ,PR,9939,4054,4714,1846,1401,685,3313,1161,96,61,4258,1768,1547,629,2711,1139,1139,,,,711,293,625,250,4,2,64,31,18,10,43,160,86
E02005262,Preston 010,Middle Super Output Areas and Intermediate Zones,MSOAIZ,PR,6163,2682,4674,1940,1329,684,3345,1256,13,7,478,211,37,17,441,194,194,,,,954,501,902,473,5,2,40,21,7,5,28,44,23
E02005263,Preston 011,Middle Super Output Areas and Intermediate Zones,MSOAIZ,PR,6962,2788,3782,1411,1585,626,2197,785,40,15,683,404,73,42,610,362,362,,,,2379,924,2234,863,6,2,125,53,14,6,61,78,34
E02005264,Preston 012,Middle Super Output Areas and Intermediate Zones,MSOAIZ,PR,10768,5005,5565,2652,1818,1010,3747,1642,36,14,967,549,119,64,848,485,485,,,,4097,1736,3827,1611,28,10,204,99,38,16,125,103,54
E02005265,Preston 013,Middle Super Output Areas and Intermediate Zones,MSOAIZ,PR,10770,4706,6993,2925,2316,1227,4677,1698,64,29,2195,1048,550,243,1645,805,805,,,,1419,642,1309,587,8,4,92,46,10,5,55,99,62
E02005266,Preston 014,Middle Super Output Areas and Intermediate Zones,MSOAIZ,PR,7614,3295,3729,1398,1328,587,2401,811,34,17,1847,936,433,240,1414,696,696,,,,1890,880,1769,818,12,4,94,50,15,8,62,114,64
E02005267,Preston 015,Middle Super Output Areas and Intermediate Zones,MSOAIZ,PR,5091,2188,2180,705,1156,408,1024,297,18,8,1508,827,229,136,1279,691,691,,,,1281,591,1193,551,8,3,50,21,30,16,40,104,57
E02005268,Preston 016,Middle Super Output Areas and Intermediate Zones,MSOAIZ,PR,9230,3529,5486,1945,2679,1047,2807,898,15,10,1999,815,431,184,1568,631,631,,,,1614,710,1501,661,3,2,87,39,23,8,49,116,49
E02005269,Preston 017,Middle Super Output Areas and Intermediate Zones,MSOAIZ,PR,9371,4808,3156,1366,1571,730,1585,636,89,58,2297,1313,224,133,2073,1180,1180,,,,3650,1972,3493,1891,49,13,87,55,21,13,81,179,99
E02005270,Ribble Valley 001,Middle Super Output Areas and Intermediate Zones,MSOAIZ,PR,7006,2944,5193,2128,2817,1324,2376,804,46,23,198,120,26,10,172,110,110,,,,1414,607,1195,510,128,49,49,30,42,18,97,155,66
E02005271,Ribble Valley 002,Middle Super Output Areas and Intermediate Zones,MSOAIZ,BB,7446,3266,5581,2381,2430,1288,3151,1093,38,15,577,285,66,37,511,248,248,,,,1170,538,1074,487,19,9,72,40,5,2,51,80,47
E02005272,Ribble Valley 003,Middle Super Output Areas and Intermediate Zones,MSOAIZ,BB,7130,3295,5067,2174,2116,1156,2951,1018,37,21,1112,648,292,165,820,483,483,,,,825,389,719,335,6,1,93,47,7,6,54,89,63
E02005273,Ribble Valley 004,Middle Super Output Areas and Intermediate Zones,MSOAIZ,PR,5674,2381,4549,1890,2257,1096,2292,794,18,7,220,119,50,22,170,97,97,,,,799,320,709,277,11,7,49,23,30,13,43,88,45
E02005274,Ribble Valley 005,Middle Super Output Areas and Intermediate Zones,MSOAIZ,BB,6573,2842,5241,2223,2336,1213,2905,1010,8,7,327,174,47,27,280,147,147,,,,938,405,849,367,21,7,52,26,16,5,38,59,33
E02005275,Ribble Valley 006,Middle Super Output Areas and Intermediate Zones,MSOAIZ,PR,5336,2291,4073,1698,1694,876,2379,822,25,12,334,205,98,47,236,158,158,,,,874,363,786,321,14,3,71,37,3,2,42,30,13
E02005276,Ribble Valley 007,Middle Super Output Areas and Intermediate Zones,MSOAIZ,BB,8041,3332,6747,2696,2614,1330,4133,1366,62,35,296,172,62,27,234,145,145,,,,851,385,670,316,69,25,93,34,19,10,69,85,44
E02005277,Ribble Valley 008,Middle Super Output Areas and Intermediate Zones,MSOAIZ,PR,8745,3694,7799,3233,3553,1803,4246,1430,47,25,185,113,48,30,137,83,83,,,,622,271,504,217,22,8,75,37,21,9,54,92,52
E02005278,Rossendale 001,Middle Super Output Areas and Intermediate Zones,MSOAIZ,OL,7632,3162,6557,2596,2181,1054,4376,1542,29,11,326,209,67,44,259,165,165,,,,675,311,598,272,6,2,64,31,7,6,39,45,35
E02005279,Rossendale 002,Middle Super Output Areas and Intermediate Zones,MSOAIZ,BB,10140,4263,7000,2737,2806,1283,4194,1454,14,7,1357,728,364,190,993,538,538,,,,1655,730,1470,656,8,4,152,59,25,11,74,114,61
E02005280,Rossendale 003,Middle Super Output Areas and Intermediate Zones,MSOAIZ,OL,10026,4281,6938,2807,2313,1174,4625,1633,18,9,1461,707,634,289,827,418,418,,,,1525,710,1382,635,4,2,123,63,16,10,75,84,48
E02005281,Rossendale 004,Middle Super Output Areas and Intermediate Zones,MSOAIZ,BB,8178,3503,5639,2257,2158,1065,3481,1192,28,14,1213,634,444,237,769,397,397,,,,1207,544,1088,501,8,2,110,40,1,1,43,91,54
E02005284,Rossendale 007,Middle Super Output Areas and Intermediate Zones,MSOAIZ,BL,5679,2405,4729,1920,1832,919,2897,1001,28,13,411,236,133,71,278,165,165,,,,472,210,403,174,0,0,65,34,4,2,36,39,26
E02005285,Rossendale 008,Middle Super Output Areas and Intermediate Zones,MSOAIZ,BL,6164,2740,5182,2249,2038,1074,3144,1175,27,15,235,144,71,40,164,104,104,,,,669,299,598,266,6,3,56,26,9,4,33,51,33
E02005286,Rossendale 009,Middle Super Output Areas and Intermediate Zones,MSOAIZ,OL,7466,3292,5485,2273,2001,1003,3484,1270,8,5,921,509,373,185,548,324,324,,,,995,469,890,415,2,2,101,50,2,2,54,57,36
E02005287,South Ribble 001,Middle Super Output Areas and Intermediate Zones,MSOAIZ,PR,5298,2158,4922,1987,2002,1003,2920,984,7,4,40,33,2,2,38,31,31,,,,292,117,251,101,14,4,18,9,9,3,16,37,17
E02005288,South Ribble 002,Middle Super Output Areas and Intermediate Zones,MSOAIZ,PR,5979,2596,5236,2216,2376,1201,2860,1015,12,4,275,148,29,13,246,135,135,,,,421,200,386,184,3,1,24,12,8,3,16,35,28
E02005289,South Ribble 003,Middle Super Output Areas and Intermediate Zones,MSOAIZ,PR,6172,2615,5660,2392,2473,1310,3187,1082,10,6,59,22,0,0,59,22,22,,,,414,178,369,154,0,0,38,21,7,3,24,29,17
E02005290,South Ribble 004,Middle Super Output Areas and Intermediate Zones,MSOAIZ,PR,7168,2992,6345,2616,2141,1117,4204,1499,16,7,132,61,10,7,122,54,54,,,,645,290,578,257,8,3,56,28,3,2,33,30,18
E02005291,South Ribble 005,Middle Super Output Areas and Intermediate Zones,MSOAIZ,PR,5694,2418,4596,1931,1725,900,2871,1031,51,37,333,160,11,5,322,155,155,,,,673,267,617,247,10,2,45,17,1,1,20,41,23
E02005292,South Ribble 006,Middle Super Output Areas and Intermediate Zones,MSOAIZ,PR,5742,2664,3645,1601,1247,670,2398,931,58,26,1482,780,132,56,1350,724,724,,,,517,230,470,207,6,2,33,17,8,4,23,40,27
E02005293,South Ribble 007,Middle Super Output Areas and Intermediate Zones,MSOAIZ,PR,5524,2521,4039,1802,1692,945,2347,857,7,3,660,342,42,19,618,323,323,,,,776,350,731,326,4,2,41,22,0,0,24,42,24
E02005294,South Ribble 008,Middle Super Output Areas and Intermediate Zones,MSOAIZ,PR,6290,2589,4586,1922,1582,831,3004,1091,62,29,834,306,63,24,771,282,282,,,,759,306,657,266,20,5,73,32,9,3,40,49,26
E02005295,South Ribble 009,Middle Super Output Areas and Intermediate Zones,MSOAIZ,PR,7371,3125,6366,2654,2207,1153,4159,1501,24,12,228,130,16,10,212,120,120,,,,727,311,607,264,17,4,93,40,10,3,47,26,18
E02005296,South Ribble 010,Middle Super Output Areas and Intermediate Zones,MSOAIZ,PR,5725,2397,5158,2141,2471,1248,2687,893,26,14,138,67,17,5,121,62,62,,,,374,153,321,127,16,7,30,15,7,4,26,29,22
E02005297,South Ribble 011,Middle Super Output Areas and Intermediate Zones,MSOAIZ,PR,8154,3481,7248,3045,3258,1677,3990,1368,23,10,211,127,2,2,209,125,125,,,,590,251,532,222,7,2,42,22,9,5,29,82,48
E02005298,South Ribble 012,Middle Super Output Areas and Intermediate Zones,MSOAIZ,PR,7136,2955,6104,2473,2169,1100,3935,1373,8,5,452,236,28,14,424,222,222,,,,536,219,470,191,7,3,51,21,8,4,28,36,22
E02005299,South Ribble 013,Middle Super Output Areas and Intermediate Zones,MSOAIZ,PR,7185,3076,5320,2256,1436,789,3884,1467,9,5,735,305,57,24,678,281,281,,,,1088,492,999,451,6,4,77,32,6,5,41,33,18
E02005300,South Ribble 014,Middle Super Output Areas and Intermediate Zones,MSOAIZ,PR,5184,2081,4019,1604,1221,621,2798,983,16,6,790,331,37,13,753,318,318,,,,330,124,309,114,3,2,18,8,0,0,10,29,16
E02005301,South Ribble 015,Middle Super Output Areas and Intermediate Zones,MSOAIZ,PR,6354,2787,4446,1874,1635,863,2811,1011,25,16,1260,613,114,56,1146,557,557,,,,572,252,502,216,0,0,58,29,12,7,36,51,32
E02005302,South Ribble 016,Middle Super Output Areas and Intermediate Zones,MSOAIZ,PR,6968,2946,5675,2384,2195,1149,3480,1235,42,19,405,162,28,11,377,151,151,,,,796,354,757,334,5,2,33,17,1,1,20,50,27
E02005303,South Ribble 017,Middle Super Output Areas and Intermediate Zones,MSOAIZ,PR,6281,2701,3389,1439,1152,612,2237,827,25,12,2375,1022,208,92,2167,930,930,,,,469,214,405,184,0,0,58,27,6,3,30,23,14
E02005304,West Lancashire 001,Middle Super Output Areas and Intermediate Zones,MSOAIZ,PR,8559,3493,7489,2986,3007,1477,4482,1509,48,24,268,150,229,131,39,19,19,,,,712,301,638,265,12,8,50,21,12,7,36,42,32
E02005305,West Lancashire 002,Middle Super Output Areas and Intermediate Zones,MSOAIZ,PR,7245,3157,6020,2613,2922,1488,3098,1125,54,26,434,195,244,116,190,79,79,,,,651,277,547,228,20,11,75,32,9,6,49,86,46
E02005306,West Lancashire 003,Middle Super Output Areas and Intermediate Zones,MSOAIZ,PR,6960,2971,5772,2447,2763,1398,3009,1049,22,14,351,157,297,130,54,27,27,,,,739,315,602,255,26,9,89,41,22,10,60,76,38
E02005307,West Lancashire 004,Middle Super Output Areas and Intermediate Zones,MSOAIZ,L,9073,3729,7223,2848,2628,1313,4595,1535,33,13,880,425,595,283,285,142,142,,,,865,398,775,355,3,1,73,35,14,7,43,72,45
E02005308,West Lancashire 005,Middle Super Output Areas and Intermediate Zones,MSOAIZ,WN,6561,2766,5773,2402,2801,1372,2972,1030,47,25,202,100,183,92,19,8,8,,,,449,191,390,165,0,0,56,24,3,2,26,90,48
E02005309,West Lancashire 006,Middle Super Output Areas and Intermediate Zones,MSOAIZ,L,8283,3459,6839,2874,3131,1625,3708,1249,40,18,574,239,525,221,49,18,18,,,,770,295,720,269,4,1,38,21,8,4,26,60,33
E02005310,West Lancashire 007,Middle Super Output Areas and Intermediate Zones,MSOAIZ,L,7261,3036,4125,1749,1715,914,2410,835,96,66,764,460,462,286,302,174,174,,,,2221,718,2146,678,10,6,51,26,14,8,40,55,43
E02005311,West Lancashire 008,Middle Super Output Areas and Intermediate Zones,MSOAIZ,WN,5294,2254,4547,1896,2193,1073,2354,823,10,8,173,100,151,81,22,19,19,,,,496,213,449,190,16,6,28,15,3,2,23,68,37
E02005312,West Lancashire 009,Middle Super Output Areas and Intermediate Zones,MSOAIZ,WN,5927,2405,4812,1810,1261,618,3551,1192,33,14,626,388,530,320,96,68,68,,,,440,183,396,160,3,1,34,19,7,3,23,16,10
E02005313,West Lancashire 010,Middle Super Output Areas and Intermediate Zones,MSOAIZ,WN,8679,3476,4690,1768,1078,530,3612,1238,12,7,2909,1282,2818,1244,91,38,38,,,,1008,380,968,363,0,0,39,16,1,1,17,60,39
E02005314,West Lancashire 011,Middle Super Output Areas and Intermediate Zones,MSOAIZ,WN,6393,2834,4207,1743,1309,692,2898,1051,5,2,1318,680,1165,618,153,62,62,,,,800,365,745,336,1,1,52,27,2,1,29,63,44
E02005315,West Lancashire 012,Middle Super Output Areas and Intermediate Zones,MSOAIZ,L,7868,3259,7074,2878,3260,1615,3814,1263,49,29,259,135,239,124,20,11,11,,,,422,178,373,159,0,0,45,18,4,1,19,64,39
E02005316,West Lancashire 013,Middle Super Output Areas and Intermediate Zones,MSOAIZ,WN,6210,2518,3601,1402,996,494,2605,908,31,9,1761,801,1543,680,218,121,121,,,,734,269,667,245,10,2,52,21,5,1,24,83,37
E02005317,West Lancashire 014,Middle Super Output Areas and Intermediate Zones,MSOAIZ,WN,7078,2939,3296,1326,976,511,2320,815,15,4,2540,1134,2362,1054,178,80,80,,,,1131,426,1051,391,4,2,64,30,12,3,35,96,49
E02005318,West Lancashire 015,Middle Super Output Areas and Intermediate Zones,MSOAIZ,WN,7298,3085,5857,2380,2252,1152,3605,1228,26,12,841,410,667,331,174,79,79,,,,492,235,420,204,0,0,56,25,16,6,31,82,48
E02005319,Wyre 001,Middle Super Output Areas and Intermediate Zones,MSOAIZ,FY,8284,3952,5110,2271,1942,1069,3168,1202,20,11,619,417,69,44,550,373,373,,,,2428,1189,2268,1111,8,2,145,72,7,4,78,107,64
E02005320,Wyre 002,Middle Super Output Areas and Intermediate Zones,MSOAIZ,FY,5787,2369,4564,1873,1756,924,2808,949,30,12,561,236,109,45,452,191,191,,,,590,226,556,206,9,6,22,13,3,1,20,42,22
E02005321,Wyre 003,Middle Super Output Areas and Intermediate Zones,MSOAIZ,FY,5998,2662,3786,1734,1887,1028,1899,706,41,18,1587,674,374,167,1213,507,507,,,,522,195,420,151,44,20,49,19,9,5,44,62,41
E02005322,Wyre 004,Middle Super Output Areas and Intermediate Zones,MSOAIZ,PR,9723,4418,8163,3682,4236,2251,3927,1431,64,31,366,164,18,9,348,155,155,,,,1049,491,906,424,12,5,118,55,13,7,67,81,50
E02005323,Wyre 005,Middle Super Output Areas and Intermediate Zones,MSOAIZ,PR,6813,2873,4454,1893,1717,913,2737,980,40,19,1461,634,288,118,1173,516,516,,,,797,296,737,266,5,5,52,23,3,2,30,61,31
E02005324,Wyre 006,Middle Super Output Areas and Intermediate Zones,MSOAIZ,PR,5670,2337,4450,1809,2181,1039,2269,770,57,25,297,128,15,4,282,124,124,,,,774,330,692,288,30,12,41,26,11,4,42,92,45
E02005325,Wyre 007,Middle Super Output Areas and Intermediate Zones,MSOAIZ,PR,8916,4023,7392,3282,3991,2113,3401,1169,93,45,438,231,55,29,383,202,202,,,,892,413,787,372,11,4,83,32,11,5,41,101,52
E02005326,Wyre 008,Middle Super Output Areas and Intermediate Zones,MSOAIZ,FY,8389,3961,6259,2893,3016,1711,3243,1182,14,5,403,182,53,24,350,158,158,,,,1650,841,1538,784,12,6,88,42,12,9,57,63,40
E02005327,Wyre 009,Middle Super Output Areas and Intermediate Zones,MSOAIZ,PR,5822,2352,4933,1976,2387,1134,2546,842,34,13,268,115,23,11,245,104,104,,,,507,208,431,178,11,3,55,24,10,3,30,80,40
E02005328,Wyre 010,Middle Super Output Areas and Intermediate Zones,MSOAIZ,FY,7454,3391,6483,2952,3053,1673,3430,1279,29,13,67,31,1,1,66,30,30,,,,832,369,755,327,0,0,73,40,4,2,42,43,26
E02005329,Wyre 011,Middle Super Output Areas and Intermediate Zones,MSOAIZ,PR,8713,3910,6613,2924,2424,1355,4189,1569,50,22,548,284,52,33,496,251,251,,,,1441,643,1342,592,7,2,82,39,10,10,51,61,37
E02005330,Wyre 012,Middle Super Output Areas and Intermediate Zones,MSOAIZ,FY,8860,3840,7919,3438,3440,1860,4479,1578,39,16,109,39,6,2,103,37,37,,,,734,318,674,291,3,2,49,23,8,2,27,59,29
E02005331,Wyre 013,Middle Super Output Areas and Intermediate Zones,MSOAIZ,FY,7465,3578,5796,2690,2614,1464,3182,1226,26,12,389,241,46,31,343,210,210,,,,1177,584,1074,534,4,2,94,44,5,4,50,77,51
E02005332,Wyre 014,Middle Super Output Areas and Intermediate Zones,MSOAIZ,FY,8068,3615,7256,3259,3449,1889,3807,1370,7,4,64,25,17,4,47,21,21,,,,690,294,635,267,2,2,50,23,3,2,27,51,33
E02005334,Blaby 002,Middle Super Output Areas and Intermediate Zones,MSOAIZ,LE,5554,2161,5042,1957,1742,860,3300,1097,16,6,32,19,6,4,26,15,15,,,,451,171,403,153,5,1,38,14,5,3,18,13,8
E02005335,Blaby 003,Middle Super Output Areas and Intermediate Zones,MSOAIZ,LE,6794,2824,5886,2372,2577,1289,3309,1083,3,3,241,160,74,45,167,115,115,,,,600,259,535,236,3,2,56,19,6,2,23,64,30
E02005336,Blaby 004,Middle Super Output Areas and Intermediate Zones,MSOAIZ,LE,7106,2903,5368,2115,1301,645,4067,1470,16,7,365,198,120,66,245,132,132,,,,1314,560,1221,525,18,6,65,26,10,3,35,43,23
E02005337,Blaby 005,Middle Super Output Areas and Intermediate Zones,MSOAIZ,LE,9734,3961,7926,3196,3294,1692,4632,1504,55,28,337,212,50,31,287,181,181,,,,1352,489,1225,445,20,6,106,37,1,1,44,64,36
E02005338,Blaby 006,Middle Super Output Areas and Intermediate Zones,MSOAIZ,LE,9755,4167,7755,3179,2733,1428,5022,1751,78,39,889,492,191,121,698,371,371,,,,980,420,830,361,14,4,111,46,25,9,59,53,37
E02005339,Blaby 007,Middle Super Output Areas and Intermediate Zones,MSOAIZ,LE,8442,3502,7277,2926,2404,1236,4873,1690,38,12,349,185,73,37,276,148,148,,,,748,364,699,339,0,0,41,21,8,4,25,30,15
E02005340,Blaby 008,Middle Super Output Areas and Intermediate Zones,MSOAIZ,LE,8289,3553,6653,2770,2585,1363,4068,1407,63,34,693,351,188,92,505,259,259,,,,816,366,739,326,6,5,64,30,7,5,40,64,32
E02005341,Blaby 009,Middle Super Output Areas and Intermediate Zones,MSOAIZ,LE,6865,2753,5661,2158,1575,783,4086,1375,58,32,596,306,77,51,519,255,255,,,,517,235,461,209,6,2,47,22,3,2,26,33,22
E02005342,Blaby 010,Middle Super Output Areas and Intermediate Zones,MSOAIZ,LE,6708,2802,5496,2247,2202,1094,3294,1153,39,17,589,285,174,87,415,198,198,,,,550,231,454,195,4,4,74,26,18,6,36,34,22
E02005343,Blaby 011,Middle Super Output Areas and Intermediate Zones,MSOAIZ,LE,6614,2797,5723,2368,2315,1221,3408,1147,42,21,332,168,93,39,239,129,129,,,,472,217,404,179,0,0,62,35,6,3,38,45,23
E02005344,Blaby 012,Middle Super Output Areas and Intermediate Zones,MSOAIZ,LE,7411,3146,6091,2508,2433,1207,3658,1301,54,29,700,340,214,85,486,255,255,,,,534,245,450,214,24,5,55,24,5,2,31,32,24
E02005345,Charnwood 001,Middle Super Output Areas and Intermediate Zones,MSOAIZ,LE,6054,2600,4693,1963,1961,958,2732,1005,60,32,565,271,112,59,453,212,212,,,,702,314,646,284,7,3,41,21,8,6,30,34,20
E02005346,Charnwood 002,Middle Super Output Areas and Intermediate Zones,MSOAIZ,LE,11013,4925,5197,2083,1724,851,3473,1232,118,71,2645,1441,1113,744,1532,697,697,,,,2915,1250,2754,1172,15,6,107,54,39,18,78,138,80
E02005347,Charnwood 003,Middle Super Output Areas and Intermediate Zones,MSOAIZ,LE,9064,3449,2891,1257,1340,691,1551,566,71,31,1450,704,1001,479,449,225,225,,,,4554,1404,4385,1337,20,8,137,51,12,8,67,98,53
E02005348,Charnwood 004,Middle Super Output Areas and Intermediate Zones,MSOAIZ,LE,5766,2540,4396,1837,1905,945,2491,892,17,10,516,309,296,181,220,128,128,,,,803,368,740,338,4,2,46,23,13,5,30,34,16
E02005349,Charnwood 005,Middle Super Output Areas and Intermediate Zones,MSOAIZ,LE,6906,2980,5467,2315,2155,1123,3312,1192,34,18,688,313,532,248,156,65,65,,,,665,299,608,277,7,3,32,14,18,5,22,52,35
E02005350,Charnwood 006,Middle Super Output Areas and Intermediate Zones,MSOAIZ,LE,6315,2813,4886,2098,1802,917,3084,1181,66,34,657,322,439,220,218,102,102,,,,670,335,610,300,5,2,51,30,4,3,35,36,24
E02005351,Charnwood 007,Middle Super Output Areas and Intermediate Zones,MSOAIZ,LE,6065,2328,3202,1285,1417,712,1785,573,27,12,1235,522,1002,414,233,108,108,,,,1510,469,1402,431,9,3,73,26,26,9,38,91,40
E02005352,Charnwood 008,Middle Super Output Areas and Intermediate Zones,MSOAIZ,LE,6023,2421,5166,2041,2198,1060,2968,981,17,9,270,105,211,83,59,22,22,,,,481,226,416,197,12,5,47,19,6,5,29,89,40
E02005353,Charnwood 009,Middle Super Output Areas and Intermediate Zones,MSOAIZ,LE,9369,3824,5348,2232,1943,1014,3405,1218,48,20,2287,884,1911,712,376,172,172,,,,1601,642,1493,593,3,3,93,40,12,6,49,85,46
E02005354,Charnwood 010,Middle Super Output Areas and Intermediate Zones,MSOAIZ,LE,8755,3542,7794,3186,3515,1785,4279,1401,47,22,135,48,34,12,101,36,36,,,,733,265,681,241,8,4,40,18,4,2,24,46,21
E02005355,Charnwood 011,Middle Super Output Areas and Intermediate Zones,MSOAIZ,LE,6508,2766,5294,2163,2011,1040,3283,1123,63,33,481,233,346,181,135,52,52,,,,625,308,547,273,14,6,55,24,9,5,35,45,29
E02005356,Charnwood 012,Middle Super Output Areas and Intermediate Zones,MSOAIZ,LE,6392,2873,5195,2227,2199,1141,2996,1086,31,23,383,212,275,151,108,61,61,,,,725,381,658,347,8,3,52,27,7,4,34,58,30
E02005357,Charnwood 013,Middle Super Output Areas and Intermediate Zones,MSOAIZ,LE,7196,3036,5620,2325,1908,971,3712,1354,15,8,682,282,588,249,94,33,33,,,,838,395,764,362,20,6,50,23,4,4,33,41,26
E02005358,Charnwood 014,Middle Super Output Areas and Intermediate Zones,MSOAIZ,LE,10127,4281,7876,3295,2713,1426,5163,1869,75,33,1215,486,986,387,229,99,99,,,,893,420,796,375,4,3,83,37,10,5,45,68,47
E02005359,Charnwood 015,Middle Super Output Areas and Intermediate Zones,MSOAIZ,LE,5827,2390,5092,2053,2133,1073,2959,980,29,13,159,81,135,75,24,6,6,,,,478,211,442,195,2,1,33,14,1,1,16,69,32
E02005360,Charnwood 016,Middle Super Output Areas and Intermediate Zones,MSOAIZ,LE,5984,2546,5039,2108,2529,1264,2510,844,15,10,260,117,240,108,20,9,9,,,,556,254,424,204,67,23,25,12,40,15,50,114,57
E02005361,Charnwood 017,Middle Super Output Areas and Intermediate Zones,MSOAIZ,LE,6490,2778,4993,1985,1678,838,3315,1147,54,29,414,251,212,163,202,88,88,,,,985,486,883,438,14,5,80,40,8,3,48,44,27
E02005362,Charnwood 018,Middle Super Output Areas and Intermediate Zones,MSOAIZ,LE,6232,2627,5080,2078,1959,1005,3121,1073,33,18,570,286,355,202,215,84,84,,,,505,217,441,187,8,4,56,26,0,0,30,44,28
E02005363,Charnwood 019,Middle Super Output Areas and Intermediate Zones,MSOAIZ,LE,7203,2944,6196,2536,2803,1443,3393,1093,49,23,377,134,124,57,253,77,77,,,,533,225,487,200,8,3,37,21,1,1,25,48,26
E02005364,Charnwood 020,Middle Super Output Areas and Intermediate Zones,MSOAIZ,LE,5300,2098,4555,1756,1636,828,2919,928,14,7,245,125,174,89,71,36,36,,,,456,191,411,172,10,3,30,13,5,3,19,30,19
E02005365,Charnwood 021,Middle Super Output Areas and Intermediate Zones,MSOAIZ,LE,9609,3944,7536,3003,3289,1592,4247,1411,106,71,840,383,390,204,450,179,179,,,,1067,450,969,410,12,4,80,34,6,2,40,60,37
E02005366,Charnwood 022,Middle Super Output Areas and Intermediate Zones,MSOAIZ,LE,6521,2811,5172,2135,2063,1052,3109,1083,18,12,677,342,539,288,138,54,54,,,,600,286,540,257,4,2,51,23,5,4,29,54,36
E02005368,Harborough 002,Middle Super Output Areas and Intermediate Zones,MSOAIZ,LE,6168,2581,4863,1932,2263,1062,2600,870,44,17,337,194,58,25,279,169,169,,,,789,372,689,325,44,18,44,24,12,5,47,135,66
E02005369,Harborough 003,Middle Super Output Areas and Intermediate Zones,MSOAIZ,LE,9729,4128,7910,3227,3387,1711,4523,1516,40,24,763,374,96,47,667,327,327,,,,950,459,867,418,10,4,60,29,13,8,41,66,44
E02005370,Harborough 004,Middle Super Output Areas and Intermediate Zones,MSOAIZ,LE,8907,3422,7759,2906,2210,1075,5549,1831,62,29,331,174,57,33,274,141,141,,,,706,293,630,261,6,3,60,24,10,5,32,49,20
E02005371,Harborough 005,Middle Super Output Areas and Intermediate Zones,MSOAIZ,NN,9882,3970,8264,3235,3081,1497,5183,1738,110,39,545,246,111,49,434,197,197,,,,886,408,809,365,17,9,57,32,3,2,43,77,42
E02005372,Harborough 006,Middle Super Output Areas and Intermediate Zones,MSOAIZ,LE,9330,3749,7962,3131,3360,1594,4602,1537,36,13,495,222,173,58,322,164,164,,,,722,331,620,293,12,3,68,26,22,9,38,115,52
E02005373,Harborough 007,Middle Super Output Areas and Intermediate Zones,MSOAIZ,LE,9064,3773,7938,3245,3286,1705,4652,1540,30,15,240,129,58,29,182,100,100,,,,773,345,668,301,24,7,74,33,7,4,44,83,39
E02005374,Harborough 008,Middle Super Output Areas and Intermediate Zones,MSOAIZ,LE,6315,3008,3722,1655,1418,810,2304,845,144,78,1440,752,236,111,1204,641,641,,,,945,485,870,442,13,7,56,32,6,4,43,64,38
E02005375,Harborough 009,Middle Super Output Areas and Intermediate Zones,MSOAIZ,LE,8346,3518,6520,2636,2282,1200,4238,1436,154,74,332,168,32,19,300,149,149,,,,1300,612,1233,578,6,3,55,27,6,4,34,40,28
E02005376,Harborough 010,Middle Super Output Areas and Intermediate Zones,MSOAIZ,LE,9320,3940,7143,2881,2711,1415,4432,1466,157,65,1035,538,210,93,825,445,445,,,,913,408,838,371,3,2,59,29,13,6,37,72,48
E02005377,Hinckley and Bosworth 001,Middle Super Output Areas and Intermediate Zones,MSOAIZ,LE,8217,3568,6801,2891,2722,1463,4079,1428,53,21,675,322,499,254,176,68,68,,,,635,305,570,271,10,3,49,26,6,5,34,53,29
E02005378,Hinckley and Bosworth 002,Middle Super Output Areas and Intermediate Zones,MSOAIZ,LE,5199,2183,4540,1876,1714,885,2826,991,9,3,224,111,127,70,97,41,41,,,,404,179,386,172,4,1,14,6,0,0,7,22,14
E02005379,Hinckley and Bosworth 003,Middle Super Output Areas and Intermediate Zones,MSOAIZ,LE,6065,2532,5037,2055,2021,1028,3016,1027,37,15,469,223,333,159,136,64,64,,,,485,222,428,197,8,4,46,19,3,2,25,37,17
E02005380,Hinckley and Bosworth 004,Middle Super Output Areas and Intermediate Zones,MSOAIZ,LE,8312,3562,6571,2733,2832,1422,3739,1311,44,16,767,367,517,260,250,107,107,,,,847,394,684,317,42,26,68,28,53,23,77,83,52
E02005381,Hinckley and Bosworth 005,Middle Super Output Areas and Intermediate Zones,MSOAIZ,LE,7917,3378,6488,2734,2938,1499,3550,1235,19,11,866,365,731,299,135,66,66,,,,463,224,405,190,4,2,38,22,16,10,34,81,44
E02005382,Hinckley and Bosworth 006,Middle Super Output Areas and Intermediate Zones,MSOAIZ,LE,9952,4390,6888,3029,2557,1363,4331,1666,108,48,1786,720,1143,470,643,250,250,,,,1105,555,1004,508,14,5,75,35,12,7,47,65,38
E02005383,Hinckley and Bosworth 007,Middle Super Output Areas and Intermediate Zones,MSOAIZ,LE,8927,3908,6537,2826,2282,1216,4255,1610,75,30,1278,559,761,363,517,196,196,,,,987,452,936,425,0,0,51,27,0,0,27,50,41
E02005384,Hinckley and Bosworth 008,Middle Super Output Areas and Intermediate Zones,MSOAIZ,LE,6271,2646,5262,2187,2136,1091,3126,1096,16,7,352,147,252,101,100,46,46,,,,575,265,511,233,5,3,52,25,7,4,32,66,40
E02005385,Hinckley and Bosworth 009,Middle Super Output Areas and Intermediate Zones,MSOAIZ,LE,5942,2525,5335,2252,2290,1185,3045,1067,26,9,59,34,27,11,32,23,23,,,,489,215,454,199,2,2,30,13,3,1,16,33,15
E02005386,Hinckley and Bosworth 010,Middle Super Output Areas and Intermediate Zones,MSOAIZ,LE,8228,3870,5451,2466,1953,1077,3498,1389,53,26,808,372,543,250,265,122,122,,,,1855,969,1721,903,15,8,107,53,12,5,66,61,37
E02005387,Hinckley and Bosworth 011,Middle Super Output Areas and Intermediate Zones,MSOAIZ,LE,9049,3858,6827,2894,2147,1127,4680,1767,110,50,867,365,458,207,409,158,158,,,,1208,531,1099,485,9,3,80,37,20,6,46,37,18
E02005388,Hinckley and Bosworth 012,Middle Super Output Areas and Intermediate Zones,MSOAIZ,LE,5675,2564,4150,1767,1523,813,2627,954,24,16,723,403,433,243,290,160,160,,,,713,346,636,311,8,4,63,28,6,3,35,65,32
E02005389,Hinckley and Bosworth 013,Middle Super Output Areas and Intermediate Zones,MSOAIZ,LE,5666,2619,4136,1812,1870,1018,2266,794,9,5,1106,591,967,510,139,81,81,,,,366,172,330,153,2,2,30,15,4,2,19,49,39
E02005390,Hinckley and Bosworth 014,Middle Super Output Areas and Intermediate Zones,MSOAIZ,LE,8855,3774,7878,3304,3248,1672,4630,1632,20,10,197,106,101,41,96,65,65,,,,707,327,622,293,5,2,71,30,9,2,34,53,27
E02005391,Melton 001,Middle Super Output Areas and Intermediate Zones,MSOAIZ,NG,9616,4087,7433,3034,3256,1599,4177,1435,64,37,655,320,570,272,85,48,48,,,,1286,599,1162,539,32,13,64,36,28,11,60,178,97
E02005392,Melton 002,Middle Super Output Areas and Intermediate Zones,MSOAIZ,LE,8850,3815,7466,3163,2906,1568,4560,1595,74,34,270,145,105,70,165,75,75,,,,1002,449,914,408,19,6,63,31,6,4,41,38,24
E02005393,Melton 003,Middle Super Output Areas and Intermediate Zones,MSOAIZ,LE,6939,3001,5437,2280,2251,1101,3186,1179,49,23,595,294,492,252,103,42,42,,,,780,354,657,307,46,15,37,17,40,15,47,78,50
E02005394,Melton 004,Middle Super Output Areas and Intermediate Zones,MSOAIZ,LE,9252,3961,5621,2351,2120,1108,3501,1243,166,88,2067,919,1335,604,732,315,315,,,,1332,568,1163,504,46,15,82,34,41,15,64,66,35
E02005395,Melton 005,Middle Super Output Areas and Intermediate Zones,MSOAIZ,LE,8764,3837,6497,2723,2482,1312,4015,1411,10,6,1116,550,994,502,122,48,48,,,,1075,516,978,466,8,4,78,41,11,5,50,66,42
E02005396,Melton 006,Middle Super Output Areas and Intermediate Zones,MSOAIZ,NG,6495,2789,4693,1947,2114,1040,2579,907,25,10,395,174,262,114,133,60,60,,,,1206,568,1084,514,52,23,57,24,13,7,54,176,90
E02005397,North West Leicestershire 001,Middle Super Output Areas and Intermediate Zones,MSOAIZ,NG,8215,3576,6165,2585,2432,1233,3733,1352,23,13,870,369,795,325,75,44,44,,,,1098,568,986,519,19,8,71,32,22,9,49,59,41
E02005398,North West Leicestershire 002,Middle Super Output Areas and Intermediate Zones,MSOAIZ,LE,6034,2598,4402,1862,1892,969,2510,893,37,19,504,243,433,205,71,38,38,,,,1017,431,900,385,9,3,100,38,8,5,46,74,43
E02005399,North West Leicestershire 003,Middle Super Output Areas and Intermediate Zones,MSOAIZ,LE,6304,2752,4525,1875,1788,907,2737,968,68,34,793,385,256,143,537,242,242,,,,878,431,802,392,11,3,58,33,7,3,39,40,27
E02005400,North West Leicestershire 004,Middle Super Output Areas and Intermediate Zones,MSOAIZ,LE,5587,2438,4418,1879,2051,1041,2367,838,59,25,639,302,562,260,77,42,42,,,,430,209,389,194,9,3,29,11,3,1,15,41,23
E02005401,North West Leicestershire 005,Middle Super Output Areas and Intermediate Zones,MSOAIZ,LE,5684,2345,4697,1883,2014,972,2683,911,23,9,502,229,467,199,35,30,30,,,,398,185,356,165,11,3,26,15,5,2,20,64,39
E02005402,North West Leicestershire 006,Middle Super Output Areas and Intermediate Zones,MSOAIZ,LE,6033,2498,4622,1841,1969,984,2653,857,66,42,924,407,840,356,84,51,51,,,,364,180,336,166,0,0,18,12,10,2,14,57,28
E02005403,North West Leicestershire 007,Middle Super Output Areas and Intermediate Zones,MSOAIZ,LE,6841,2966,5538,2344,2203,1151,3335,1193,53,26,638,310,531,263,107,47,47,,,,556,247,494,223,2,1,57,22,3,1,24,56,39
E02005404,North West Leicestershire 008,Middle Super Output Areas and Intermediate Zones,MSOAIZ,LE,7539,3145,5669,2295,2142,1078,3527,1217,11,7,1232,551,1089,476,143,75,75,,,,571,258,541,242,1,1,29,15,0,0,16,56,34
E02005405,North West Leicestershire 009,Middle Super Output Areas and Intermediate Zones,MSOAIZ,LE,6816,2828,3800,1574,1644,828,2156,746,9,7,2592,1078,1808,750,784,328,328,,,,350,127,306,110,0,0,33,13,11,4,17,65,42
E02005406,North West Leicestershire 010,Middle Super Output Areas and Intermediate Zones,MSOAIZ,LE,7270,3125,4851,1982,1550,789,3301,1193,85,35,968,463,401,191,567,272,272,,,,1295,604,1207,562,8,5,72,32,8,5,42,71,41
E02005407,North West Leicestershire 011,Middle Super Output Areas and Intermediate Zones,MSOAIZ,LE,8676,3481,7183,2828,2198,1079,4985,1749,121,55,370,184,179,85,191,99,99,,,,945,383,850,339,4,1,90,42,1,1,44,57,31
E02005408,North West Leicestershire 012,Middle Super Output Areas and Intermediate Zones,MSOAIZ,LE,7413,3074,5356,2162,2179,1091,3177,1071,15,11,1150,496,1011,421,139,75,75,,,,828,367,766,330,10,4,49,30,3,3,37,64,38
E02005409,North West Leicestershire 013,Middle Super Output Areas and Intermediate Zones,MSOAIZ,LE,10285,4302,8015,3250,2943,1459,5072,1791,40,19,1197,581,1027,507,170,74,74,,,,979,421,867,370,9,3,85,41,18,7,51,54,31
E02005412,Oadby and Wigston 003,Middle Super Output Areas and Intermediate Zones,MSOAIZ,LE,8063,3310,6505,2605,3065,1550,3440,1055,39,16,533,291,429,228,104,63,63,,,,900,344,810,308,12,4,71,28,7,4,36,86,54
E02005414,Oadby and Wigston 005,Middle Super Output Areas and Intermediate Zones,MSOAIZ,LE,7544,3245,5154,2142,1895,1011,3259,1131,52,33,1581,728,1374,607,207,121,121,,,,678,293,597,263,8,3,46,19,27,8,30,79,49
E02005415,Oadby and Wigston 006,Middle Super Output Areas and Intermediate Zones,MSOAIZ,LE,7373,3256,5248,2301,1968,1067,3280,1234,83,39,903,371,427,183,476,188,188,,,,1096,518,991,467,11,4,80,41,14,6,51,43,27
E02005416,Oadby and Wigston 007,Middle Super Output Areas and Intermediate Zones,MSOAIZ,LE,8796,3613,7897,3248,3454,1738,4443,1510,70,29,178,66,76,28,102,38,38,,,,608,247,566,230,0,0,38,16,4,1,17,43,23
E02005417,Boston 001,Middle Super Output Areas and Intermediate Zones,MSOAIZ,PE,6943,2935,5263,2217,2490,1244,2773,973,50,16,951,427,328,127,623,300,300,,,,565,218,445,163,66,28,29,15,25,12,55,114,57
E02005418,Boston 002,Middle Super Output Areas and Intermediate Zones,MSOAIZ,PE,9997,4119,3711,1624,1426,774,2285,850,89,30,3283,1471,1504,603,1779,868,868,,,,2799,926,2663,873,13,5,93,35,30,13,53,115,68
E02005419,Boston 003,Middle Super Output Areas and Intermediate Zones,MSOAIZ,PE,7978,3591,3552,1689,1595,900,1957,789,125,51,772,439,256,132,516,307,307,,,,3454,1366,3316,1305,31,9,58,32,49,20,61,75,46
E02005420,Boston 004,Middle Super Output Areas and Intermediate Zones,MSOAIZ,PE,8187,3623,4830,2106,1858,1021,2972,1085,115,51,2021,956,715,291,1306,665,665,,,,1140,451,1058,414,3,1,67,32,12,4,37,81,59
E02005422,Boston 006,Middle Super Output Areas and Intermediate Zones,MSOAIZ,PE,6085,2569,4483,1900,1987,1024,2496,876,32,17,841,367,314,117,527,250,250,,,,660,250,573,221,31,9,38,14,18,6,29,69,35
E02005423,Boston 007,Middle Super Output Areas and Intermediate Zones,MSOAIZ,PE,9466,4106,5957,2557,2601,1334,3356,1223,74,31,2215,1034,778,327,1437,707,707,,,,1124,436,1001,378,43,19,62,30,18,9,58,96,48
E02005424,East Lindsey 001,Middle Super Output Areas and Intermediate Zones,MSOAIZ,LN,9778,4281,8197,3530,3793,1940,4404,1590,25,12,455,237,126,56,329,181,181,,,,985,439,842,374,43,18,77,38,23,9,65,116,63
E02005425,East Lindsey 002,Middle Super Output Areas and Intermediate Zones,MSOAIZ,LN,6338,2688,5174,2191,2449,1247,2725,944,24,9,418,175,86,36,332,139,139,,,,658,277,554,235,28,10,63,25,13,7,42,64,36
E02005426,East Lindsey 003,Middle Super Output Areas and Intermediate Zones,MSOAIZ,LN,9469,4151,5899,2534,2499,1323,3400,1211,101,45,2240,1040,687,281,1553,759,759,,,,1147,481,1030,437,2,1,115,43,0,0,44,82,51
E02005427,East Lindsey 004,Middle Super Output Areas and Intermediate Zones,MSOAIZ,LN,6697,3379,4424,2143,2004,1171,2420,972,22,12,431,257,106,53,325,204,204,,,,1747,927,1640,874,4,2,84,42,19,9,53,73,40
E02005428,East Lindsey 005,Middle Super Output Areas and Intermediate Zones,MSOAIZ,LN,7890,3686,5383,2521,3176,1691,2207,830,59,26,1098,531,171,85,927,446,446,,,,1236,556,1134,511,7,5,85,35,10,5,45,114,52
E02005429,East Lindsey 006,Middle Super Output Areas and Intermediate Zones,MSOAIZ,LN,6385,3244,4891,2540,3429,1961,1462,579,35,18,390,169,48,17,342,152,152,,,,1007,476,943,446,13,6,45,21,6,3,30,62,41
E02005430,East Lindsey 007,Middle Super Output Areas and Intermediate Zones,MSOAIZ,LN,6820,3059,5178,2337,2973,1503,2205,834,31,20,498,193,83,38,415,155,155,,,,969,441,868,390,38,17,46,26,17,8,51,144,68
E02005431,East Lindsey 008,Middle Super Output Areas and Intermediate Zones,MSOAIZ,PE,8261,3643,5960,2630,3268,1664,2692,966,36,15,856,384,219,94,637,290,290,,,,1277,544,1100,467,56,21,109,50,12,6,77,132,70
E02005432,East Lindsey 009,Middle Super Output Areas and Intermediate Zones,MSOAIZ,PE,7418,3303,5447,2420,3027,1528,2420,892,25,11,372,163,100,40,272,123,123,,,,1342,591,1156,515,90,32,67,28,29,16,76,232,118
E02005433,East Lindsey 010,Middle Super Output Areas and Intermediate Zones,MSOAIZ,PE,6613,3259,4605,2306,3089,1717,1516,589,78,38,664,283,178,74,486,209,209,,,,1166,571,1046,515,24,11,87,40,9,5,56,100,61
E02005434,East Lindsey 011,Middle Super Output Areas and Intermediate Zones,MSOAIZ,LN,6984,3291,4834,2199,2347,1285,2487,914,41,16,834,428,192,94,642,334,334,,,,1206,600,1094,553,9,4,92,40,11,3,47,69,48
E02005435,East Lindsey 012,Middle Super Output Areas and Intermediate Zones,MSOAIZ,PE,7096,3292,4562,2137,2446,1354,2116,783,125,61,741,303,215,81,526,222,222,,,,1635,773,1513,727,21,9,85,34,16,3,46,33,18
E02005436,East Lindsey 013,Middle Super Output Areas and Intermediate Zones,MSOAIZ,PE,7515,3454,5283,2408,2745,1472,2538,936,80,32,802,392,222,107,580,285,285,,,,1248,563,1099,500,14,7,115,52,20,4,63,102,59
E02005437,East Lindsey 014,Middle Super Output Areas and Intermediate Zones,MSOAIZ,PE,5529,2695,2691,1137,1138,601,1553,536,16,11,278,173,49,24,229,149,149,,,,2503,1348,2375,1281,19,10,99,52,10,5,67,41,26
E02005438,East Lindsey 015,Middle Super Output Areas and Intermediate Zones,MSOAIZ,PE,6387,3016,3586,1648,1736,975,1850,673,90,40,1851,934,521,251,1330,683,683,,,,809,355,745,325,13,5,44,21,7,4,30,51,39
E02005439,East Lindsey 016,Middle Super Output Areas and Intermediate Zones,MSOAIZ,PE,10541,4599,7048,3168,3424,1869,3624,1299,146,74,788,373,191,81,597,292,292,,,,2423,908,1415,593,583,173,128,50,297,92,315,136,76
E02005440,East Lindsey 017,Middle Super Output Areas and Intermediate Zones,MSOAIZ,PE,5322,2272,3521,1468,1720,857,1801,611,39,21,901,390,292,116,609,274,274,,,,734,330,601,269,55,23,70,33,8,5,61,127,63
E02005441,East Lindsey 018,Middle Super Output Areas and Intermediate Zones,MSOAIZ,PE,8357,3578,6560,2820,3306,1668,3254,1152,44,21,673,280,195,77,478,203,203,,,,926,374,792,322,66,23,65,27,3,2,52,154,83
E02005442,Lincoln 001,Middle Super Output Areas and Intermediate Zones,MSOAIZ,LN,5665,2710,2458,1082,855,484,1603,598,6,3,2712,1366,2552,1307,160,59,59,,,,359,166,316,143,11,6,30,16,2,1,23,130,93
E02005443,Lincoln 002,Middle Super Output Areas and Intermediate Zones,MSOAIZ,LN,6714,3177,4167,1926,1513,862,2654,1064,21,12,1384,673,1223,567,161,106,106,,,,1077,526,998,484,2,1,73,39,4,2,42,65,40
E02005444,Lincoln 003,Middle Super Output Areas and Intermediate Zones,MSOAIZ,LN,11113,5257,6653,3157,2723,1558,3930,1599,75,43,806,472,647,391,159,81,81,,,,3419,1491,3216,1387,12,6,138,74,53,24,104,160,94
E02005445,Lincoln 004,Middle Super Output Areas and Intermediate Zones,MSOAIZ,LN,11186,4806,4285,1892,1345,721,2940,1171,88,47,4102,1713,3653,1518,449,195,195,,,,2584,1072,2414,990,16,6,138,67,16,9,82,127,82
E02005446,Lincoln 005,Middle Super Output Areas and Intermediate Zones,MSOAIZ,LN,6039,2840,2062,1012,816,463,1246,549,42,15,698,472,537,379,161,93,93,,,,3176,1293,3079,1242,4,4,83,40,10,7,51,61,48
E02005447,Lincoln 006,Middle Super Output Areas and Intermediate Zones,MSOAIZ,LN,6629,3202,2352,1194,807,470,1545,724,18,9,770,523,524,360,246,163,163,,,,3414,1428,3220,1340,19,8,147,71,28,9,88,75,48
E02005448,Lincoln 007,Middle Super Output Areas and Intermediate Zones,MSOAIZ,LN,7192,3126,3511,1566,950,549,2561,1017,100,44,2642,1094,2224,924,418,170,170,,,,844,363,762,324,7,4,70,32,5,3,39,95,59
E02005449,Lincoln 008,Middle Super Output Areas and Intermediate Zones,MSOAIZ,LN,6563,2891,4434,1931,1682,901,2752,1030,28,13,470,231,186,103,284,128,128,,,,1603,699,1474,646,8,3,107,43,14,7,53,28,17
E02005450,Lincoln 009,Middle Super Output Areas and Intermediate Zones,MSOAIZ,LN,8339,3708,6829,3056,2549,1388,4280,1668,36,13,364,147,247,97,117,50,50,,,,1086,478,971,418,5,4,108,55,2,1,60,24,14
E02005451,Lincoln 010,Middle Super Output Areas and Intermediate Zones,MSOAIZ,LN,7553,3421,3287,1430,1053,571,2234,859,30,13,3130,1454,2869,1342,261,112,112,,,,1020,463,907,416,4,4,109,43,0,0,47,86,61
E02005452,Lincoln 011,Middle Super Output Areas and Intermediate Zones,MSOAIZ,LN,10887,4687,8681,3686,3231,1750,5450,1936,21,8,1200,584,864,393,336,191,191,,,,921,366,811,319,4,2,104,44,2,1,47,64,43
E02005453,North Kesteven 001,Middle Super Output Areas and Intermediate Zones,MSOAIZ,LN,10543,4569,9276,4011,3914,2105,5362,1906,11,5,109,50,79,38,30,12,12,,,,1054,457,912,391,31,11,93,47,18,8,66,93,46
E02005455,North Kesteven 003,Middle Super Output Areas and Intermediate Zones,MSOAIZ,NG,12098,5113,9860,4050,3597,1814,6263,2236,31,18,536,276,487,253,49,23,23,,,,1545,695,1413,630,32,13,91,47,9,5,65,126,74
E02005456,North Kesteven 004,Middle Super Output Areas and Intermediate Zones,MSOAIZ,LN,9283,4023,6018,2637,2421,1327,3597,1310,35,22,1108,570,711,399,397,171,171,,,,2034,738,906,380,732,222,77,36,319,100,358,88,56
E02005457,North Kesteven 005,Middle Super Output Areas and Intermediate Zones,MSOAIZ,LN,8207,3565,6142,2643,2504,1318,3638,1325,31,16,1118,495,924,419,194,76,76,,,,807,350,723,313,22,7,49,23,13,7,37,109,61
E02005458,North Kesteven 006,Middle Super Output Areas and Intermediate Zones,MSOAIZ,NG,6405,2764,4993,2105,2199,1112,2794,993,12,5,537,273,494,249,43,24,24,,,,759,314,661,270,25,10,53,27,20,7,44,104,67
E02005459,North Kesteven 007,Middle Super Output Areas and Intermediate Zones,MSOAIZ,NG,7891,3420,5258,2230,2263,1143,2995,1087,12,7,1635,714,1580,688,55,26,26,,,,825,375,699,319,40,17,76,35,10,4,56,161,94
E02005460,North Kesteven 008,Middle Super Output Areas and Intermediate Zones,MSOAIZ,NG,5915,2387,3650,1547,1321,703,2329,844,10,4,293,131,191,97,102,34,34,,,,1902,673,602,254,909,289,33,19,358,111,419,60,32
E02005461,North Kesteven 009,Middle Super Output Areas and Intermediate Zones,MSOAIZ,NG,6221,2817,4751,2119,2276,1238,2475,881,18,8,506,245,467,219,39,26,26,,,,848,394,734,341,27,13,54,25,33,15,53,98,51
E02005462,North Kesteven 010,Middle Super Output Areas and Intermediate Zones,MSOAIZ,NG,8948,4123,5510,2438,1909,1090,3601,1348,26,16,1778,843,1327,612,451,231,231,,,,1528,747,1426,699,12,5,85,41,5,2,48,106,79
E02005463,North Kesteven 011,Middle Super Output Areas and Intermediate Zones,MSOAIZ,NG,8594,3530,6853,2807,2300,1208,4553,1599,71,38,489,195,151,56,338,139,139,,,,1124,464,1051,433,16,6,50,22,7,3,31,57,26
E02005464,North Kesteven 012,Middle Super Output Areas and Intermediate Zones,MSOAIZ,PE,8105,3591,6219,2738,2765,1463,3454,1275,31,14,930,418,804,359,126,59,59,,,,807,366,745,333,14,5,35,22,13,6,33,118,55
E02005465,South Holland 001,Middle Super Output Areas and Intermediate Zones,MSOAIZ,PE,8344,3523,6604,2782,3056,1552,3548,1230,25,12,950,407,869,371,81,36,36,,,,699,283,615,245,43,19,40,18,1,1,38,66,39
E02005466,South Holland 002,Middle Super Output Areas and Intermediate Zones,MSOAIZ,PE,6423,2699,5015,2165,2421,1261,2594,904,16,6,776,276,674,234,102,42,42,,,,539,219,424,169,43,19,32,13,40,18,50,77,33
E02005467,South Holland 003,Middle Super Output Areas and Intermediate Zones,MSOAIZ,PE,7050,3209,5000,2237,2256,1257,2744,980,56,25,848,429,601,325,247,104,104,,,,1064,458,980,418,6,3,69,33,9,4,40,82,60
E02005468,South Holland 004,Middle Super Output Areas and Intermediate Zones,MSOAIZ,PE,7467,3084,5822,2406,2651,1348,3171,1058,21,12,913,371,799,331,114,40,40,,,,614,242,539,210,26,10,37,17,12,5,32,97,53
E02005469,South Holland 005,Middle Super Output Areas and Intermediate Zones,MSOAIZ,PE,7384,3079,5511,2289,2241,1169,3270,1120,22,11,1020,421,887,367,133,54,54,,,,738,306,579,232,99,48,50,22,10,4,74,93,52
E02005470,South Holland 006,Middle Super Output Areas and Intermediate Zones,MSOAIZ,PE,10285,4483,6818,2992,2822,1558,3996,1434,153,64,762,423,401,255,361,168,168,,,,2475,954,2319,887,30,13,108,45,18,9,67,77,50
E02005471,South Holland 007,Middle Super Output Areas and Intermediate Zones,MSOAIZ,PE,9029,3857,5205,2244,2388,1250,2817,994,59,19,1897,913,1575,778,322,135,135,,,,1755,609,1603,555,22,7,113,41,17,6,54,113,72
E02005472,South Holland 008,Middle Super Output Areas and Intermediate Zones,MSOAIZ,PE,9691,4314,6577,2919,3165,1673,3412,1246,40,22,1477,691,1103,523,374,168,168,,,,1467,606,1293,546,60,18,86,31,28,11,60,130,76
E02005473,South Holland 009,Middle Super Output Areas and Intermediate Zones,MSOAIZ,PE,9106,3767,6497,2805,2581,1369,3916,1436,177,81,654,272,431,173,223,99,99,,,,1717,575,1541,512,21,6,125,50,30,7,63,61,34
E02005474,South Holland 010,Middle Super Output Areas and Intermediate Zones,MSOAIZ,PE,6445,2726,5291,2244,2513,1261,2778,983,16,7,488,224,459,210,29,14,14,,,,576,218,508,184,25,10,34,18,9,6,34,74,33
E02005475,South Holland 011,Middle Super Output Areas and Intermediate Zones,MSOAIZ,PE,6185,2523,4834,1952,1831,925,3003,1027,3,1,735,301,650,261,85,40,40,,,,571,244,511,215,9,6,41,20,10,3,29,42,25
E02005476,South Kesteven 001,Middle Super Output Areas and Intermediate Zones,MSOAIZ,NG,7209,3017,5738,2339,2210,1120,3528,1219,33,12,633,299,516,255,117,44,44,,,,714,315,617,270,28,12,58,27,11,6,45,91,52
E02005477,South Kesteven 002,Middle Super Output Areas and Intermediate Zones,MSOAIZ,NG,8811,3798,7124,2981,3386,1731,3738,1250,77,36,796,409,588,316,208,93,93,,,,697,309,607,263,16,7,63,31,11,8,46,117,63
E02005478,South Kesteven 003,Middle Super Output Areas and Intermediate Zones,MSOAIZ,NG,9773,4339,6186,2716,2601,1434,3585,1282,34,18,2256,1036,2064,907,192,129,129,,,,1168,494,1035,442,18,3,104,43,11,6,52,129,75
E02005479,South Kesteven 004,Middle Super Output Areas and Intermediate Zones,MSOAIZ,NG,8097,3558,6383,2651,2297,1215,4086,1436,25,12,416,287,239,186,177,101,101,,,,1223,571,1158,539,7,4,42,21,16,7,32,50,37
E02005480,South Kesteven 005,Middle Super Output Areas and Intermediate Zones,MSOAIZ,NG,7331,2861,3293,1372,1014,542,2279,830,47,19,3092,1096,2782,985,310,111,111,,,,836,338,763,307,13,4,57,25,3,2,31,63,36
E02005481,South Kesteven 006,Middle Super Output Areas and Intermediate Zones,MSOAIZ,NG,10838,4985,6027,2672,2059,1148,3968,1524,125,63,1205,596,706,338,499,258,258,,,,3390,1603,3222,1517,18,9,139,72,11,5,86,91,51
E02005482,South Kesteven 007,Middle Super Output Areas and Intermediate Zones,MSOAIZ,PE,9752,4092,7421,3066,2643,1350,4778,1716,52,31,499,225,312,158,187,67,67,,,,1554,650,1349,573,98,32,42,25,65,20,77,226,120
E02005483,South Kesteven 008,Middle Super Output Areas and Intermediate Zones,MSOAIZ,PE,7753,3224,5910,2418,2323,1158,3587,1260,22,11,914,379,794,337,120,42,42,,,,813,366,710,315,27,10,46,24,30,17,51,94,50
E02005484,South Kesteven 009,Middle Super Output Areas and Intermediate Zones,MSOAIZ,NG,6951,3030,4430,1883,1786,916,2644,967,49,21,1077,483,649,306,428,177,177,,,,1191,539,1103,493,17,8,55,28,16,10,46,204,104
E02005485,South Kesteven 010,Middle Super Output Areas and Intermediate Zones,MSOAIZ,PE,5944,2531,4857,2067,1968,1080,2889,987,40,24,403,159,295,126,108,33,33,,,,586,239,510,210,14,4,53,22,9,3,29,58,42
E02005486,South Kesteven 011,Middle Super Output Areas and Intermediate Zones,MSOAIZ,PE,8306,3580,5632,2358,1997,1076,3635,1282,225,113,1129,520,707,352,422,168,168,,,,1251,545,1157,495,36,14,53,33,5,3,50,69,44
E02005487,South Kesteven 012,Middle Super Output Areas and Intermediate Zones,MSOAIZ,PE,9097,3664,7604,3027,3028,1479,4576,1548,38,15,581,245,494,210,87,35,35,,,,735,309,654,275,33,11,37,19,11,4,34,139,68
E02005488,South Kesteven 013,Middle Super Output Areas and Intermediate Zones,MSOAIZ,PE,6198,2686,4826,2033,1981,1043,2845,990,8,5,752,359,377,171,375,188,188,,,,561,255,502,223,7,3,47,25,5,4,32,51,34
E02005489,South Kesteven 014,Middle Super Output Areas and Intermediate Zones,MSOAIZ,PE,7029,2985,5645,2345,1894,974,3751,1371,90,43,444,209,273,132,171,77,77,,,,803,359,736,326,0,0,65,31,2,2,33,47,29
E02005490,South Kesteven 015,Middle Super Output Areas and Intermediate Zones,MSOAIZ,PE,9047,4046,5649,2537,2194,1194,3455,1343,117,61,2045,883,1778,772,267,111,111,,,,1159,509,1082,473,0,0,67,32,10,4,36,77,56
E02005491,South Kesteven 016,Middle Super Output Areas and Intermediate Zones,MSOAIZ,PE,10357,4948,7326,3344,3245,1798,4081,1546,34,18,957,516,795,398,162,118,118,,,,1911,988,1788,932,33,12,77,38,13,6,56,129,82
E02005492,West Lindsey 001,Middle Super Output Areas and Intermediate Zones,MSOAIZ,LN,9332,4067,7019,2965,3251,1631,3768,1334,32,19,873,442,139,67,734,375,375,,,,1162,527,1015,461,51,22,86,37,10,7,66,246,114
E02005493,West Lindsey 002,Middle Super Output Areas and Intermediate Zones,MSOAIZ,DN,9113,3881,7465,3140,3023,1549,4442,1591,93,43,666,314,179,80,487,234,234,,,,807,341,715,302,18,9,57,22,17,8,39,82,43
E02005494,West Lindsey 003,Middle Super Output Areas and Intermediate Zones,MSOAIZ,LN,9158,4130,6616,2906,3029,1604,3587,1302,56,25,850,414,146,63,704,351,351,,,,1460,702,1322,641,34,13,92,43,12,5,61,176,83
E02005495,West Lindsey 004,Middle Super Output Areas and Intermediate Zones,MSOAIZ,DN,9570,4499,5897,2643,2216,1238,3681,1405,59,29,1008,535,228,102,780,433,433,,,,2536,1240,2351,1150,43,17,135,68,7,5,90,70,52
E02005496,West Lindsey 005,Middle Super Output Areas and Intermediate Zones,MSOAIZ,LN,6375,2685,4501,1881,1883,933,2618,948,48,24,316,155,53,27,263,128,128,,,,1343,547,1191,486,105,35,33,19,14,7,61,167,78
E02005497,West Lindsey 006,Middle Super Output Areas and Intermediate Zones,MSOAIZ,DN,6924,2981,3196,1349,1068,576,2128,773,125,58,2976,1315,973,399,2003,916,916,,,,558,221,509,200,9,3,32,16,8,2,21,69,38
E02005498,West Lindsey 007,Middle Super Output Areas and Intermediate Zones,MSOAIZ,LN,7090,3152,5941,2619,2975,1541,2966,1078,32,14,442,202,113,43,329,159,159,,,,571,267,468,221,27,11,62,27,14,8,46,104,50
E02005499,West Lindsey 008,Middle Super Output Areas and Intermediate Zones,MSOAIZ,LN,8021,3317,6592,2686,2785,1413,3807,1273,108,53,457,223,74,39,383,184,184,,,,767,311,667,262,20,9,76,36,4,4,49,97,44
E02005500,West Lindsey 009,Middle Super Output Areas and Intermediate Zones,MSOAIZ,NG,6695,2867,4915,2094,1960,1011,2955,1083,83,47,335,168,43,18,292,150,150,,,,1270,510,851,369,248,79,55,22,116,40,141,92,48
E02005501,West Lindsey 010,Middle Super Output Areas and Intermediate Zones,MSOAIZ,LN,7210,3112,6216,2628,3007,1537,3209,1091,51,26,238,148,44,21,194,127,127,,,,618,261,567,230,6,4,27,17,18,10,31,87,49
E02005502,West Lindsey 011,Middle Super Output Areas and Intermediate Zones,MSOAIZ,LN,8362,3694,6742,2948,3103,1639,3639,1309,45,27,665,330,116,52,549,278,278,,,,793,326,643,272,48,14,79,29,23,11,54,117,63
E02005503,Breckland 001,Middle Super Output Areas and Intermediate Zones,MSOAIZ,NR,6724,2896,4727,2070,2292,1186,2435,884,21,9,713,276,109,49,604,227,227,,,,1143,482,744,339,211,69,49,26,139,48,143,120,59
E02005504,Breckland 002,Middle Super Output Areas and Intermediate Zones,MSOAIZ,PE,8643,3694,6112,2646,3171,1592,2941,1054,22,11,1185,490,207,80,978,410,410,,,,1132,453,970,394,84,26,73,31,5,2,59,192,94
E02005505,Breckland 003,Middle Super Output Areas and Intermediate Zones,MSOAIZ,NR,6971,2955,5018,2080,2018,1068,3000,1012,38,14,947,451,228,84,719,367,367,,,,888,367,784,329,33,8,59,26,12,4,38,80,43
E02005506,Breckland 004,Middle Super Output Areas and Intermediate Zones,MSOAIZ,PE,6758,2843,5201,2197,2230,1174,2971,1023,15,7,595,267,65,38,530,229,229,,,,869,332,747,284,20,7,100,40,2,1,48,78,40
E02005507,Breckland 005,Middle Super Output Areas and Intermediate Zones,MSOAIZ,NR,11349,5130,7427,3316,3164,1759,4263,1557,51,21,1791,803,281,122,1510,681,681,,,,1982,919,1827,851,13,5,137,60,5,3,68,98,71
E02005508,Breckland 006,Middle Super Output Areas and Intermediate Zones,MSOAIZ,NR,6587,2814,5209,2198,2424,1225,2785,973,47,23,689,299,134,60,555,239,239,,,,533,236,445,197,23,7,65,32,0,0,39,109,58
E02005509,Breckland 007,Middle Super Output Areas and Intermediate Zones,MSOAIZ,PE,7001,3258,4400,2107,2490,1380,1910,727,42,25,1372,632,234,111,1138,521,521,,,,1090,446,971,398,35,12,79,32,5,4,48,97,48
E02005510,Breckland 008,Middle Super Output Areas and Intermediate Zones,MSOAIZ,PE,6587,2931,4927,2211,2614,1379,2313,832,22,11,802,346,97,42,705,304,304,,,,715,305,625,272,20,6,62,25,8,2,33,121,58
E02005511,Breckland 009,Middle Super Output Areas and Intermediate Zones,MSOAIZ,IP,7069,3226,4920,2310,2585,1442,2335,868,32,13,735,328,121,52,614,276,276,,,,1318,540,1098,464,113,29,77,34,30,13,76,64,35
E02005512,Breckland 010,Middle Super Output Areas and Intermediate Zones,MSOAIZ,NR,7894,3155,5607,2277,2334,1113,3273,1164,84,39,942,308,91,34,851,274,274,,,,1060,447,936,395,44,17,71,29,9,6,52,201,84
E02005513,Breckland 011,Middle Super Output Areas and Intermediate Zones,MSOAIZ,NR,8860,3893,6154,2683,2523,1362,3631,1321,72,33,941,482,156,76,785,406,406,,,,1566,632,1413,571,12,6,119,45,22,10,61,127,63
E02005514,Breckland 012,Middle Super Output Areas and Intermediate Zones,MSOAIZ,PE,6462,2840,4504,1981,2131,1110,2373,871,14,5,668,309,84,36,584,273,273,,,,1141,474,1034,427,38,16,50,23,19,8,47,135,71
E02005515,Breckland 013,Middle Super Output Areas and Intermediate Zones,MSOAIZ,NR,6104,2471,4669,1853,1937,943,2732,910,12,7,454,173,63,26,391,147,147,,,,864,382,773,335,43,22,41,21,7,4,47,105,56
E02005516,Breckland 014,Middle Super Output Areas and Intermediate Zones,MSOAIZ,NR,6459,2742,4748,2002,2354,1154,2394,848,10,5,572,257,82,43,490,214,214,,,,897,375,788,328,63,25,40,19,6,3,47,232,103
E02005517,Breckland 015,Middle Super Output Areas and Intermediate Zones,MSOAIZ,IP,5899,2255,2398,948,676,356,1722,592,23,10,2243,872,527,190,1716,682,682,,,,1182,398,1103,372,17,4,27,12,35,10,26,53,27
E02005518,Breckland 016,Middle Super Output Areas and Intermediate Zones,MSOAIZ,IP,10494,4329,6967,2905,2310,1216,4657,1689,161,69,367,206,44,24,323,182,182,,,,2932,1113,2657,1011,93,30,130,58,52,14,102,67,36
E02005519,Breckland 017,Middle Super Output Areas and Intermediate Zones,MSOAIZ,IP,7771,3087,3999,1643,1336,708,2663,935,26,8,2466,1012,514,220,1952,792,792,,,,1205,393,1058,339,28,8,77,33,42,13,54,75,31
E02005520,Broadland 001,Middle Super Output Areas and Intermediate Zones,MSOAIZ,NR,7254,3347,5416,2461,2937,1575,2479,886,32,17,844,423,106,55,738,368,368,,,,865,397,759,342,19,9,67,33,20,13,55,97,49
E02005521,Broadland 002,Middle Super Output Areas and Intermediate Zones,MSOAIZ,NR,8503,3600,6138,2541,2858,1399,3280,1142,36,15,934,403,111,49,823,354,354,,,,1244,571,1097,502,69,32,61,30,17,7,69,151,70
E02005522,Broadland 003,Middle Super Output Areas and Intermediate Zones,MSOAIZ,NR,5184,2246,3780,1622,1715,884,2065,738,30,15,548,236,36,18,512,218,218,,,,759,334,665,292,27,7,50,24,17,11,42,67,39
E02005523,Broadland 004,Middle Super Output Areas and Intermediate Zones,MSOAIZ,NR,7612,3038,6095,2442,2384,1180,3711,1262,41,18,565,200,46,19,519,181,181,,,,826,338,738,302,21,6,61,27,6,3,36,85,40
E02005524,Broadland 005,Middle Super Output Areas and Intermediate Zones,MSOAIZ,NR,5374,2336,4530,1946,2060,1072,2470,874,38,13,343,171,27,15,316,156,156,,,,416,180,351,154,0,0,57,22,8,4,26,47,26
E02005525,Broadland 006,Middle Super Output Areas and Intermediate Zones,MSOAIZ,NR,9898,4101,8236,3406,2953,1524,5283,1882,90,33,560,212,35,15,525,197,197,,,,962,426,889,387,4,2,69,37,0,0,39,50,24
E02005526,Broadland 007,Middle Super Output Areas and Intermediate Zones,MSOAIZ,NR,5354,2278,4187,1760,1606,837,2581,923,52,18,377,177,20,11,357,166,166,,,,705,304,650,279,9,4,40,18,6,3,25,33,19
E02005527,Broadland 008,Middle Super Output Areas and Intermediate Zones,MSOAIZ,NR,8034,3336,6590,2721,2854,1442,3736,1279,59,27,653,273,51,25,602,248,248,,,,676,282,624,253,2,1,48,26,2,2,29,56,33
E02005528,Broadland 009,Middle Super Output Areas and Intermediate Zones,MSOAIZ,NR,8418,3678,6662,2920,2859,1534,3803,1386,40,19,814,352,87,47,727,305,305,,,,874,367,738,307,52,20,73,34,11,6,60,28,20
E02005529,Broadland 010,Middle Super Output Areas and Intermediate Zones,MSOAIZ,NR,5729,2637,4806,2178,2553,1389,2253,789,12,6,503,274,32,18,471,256,256,,,,379,160,344,144,3,1,27,12,5,3,16,29,19
E02005530,Broadland 011,Middle Super Output Areas and Intermediate Zones,MSOAIZ,NR,5084,2233,4454,1958,2120,1135,2334,823,26,12,141,57,8,3,133,54,54,,,,443,193,384,166,5,2,54,25,0,0,27,20,13
E02005531,Broadland 012,Middle Super Output Areas and Intermediate Zones,MSOAIZ,NR,5444,2364,4213,1811,1836,955,2377,856,20,10,770,323,64,36,706,287,287,,,,400,190,345,160,1,1,47,26,7,3,30,41,30
E02005532,Broadland 013,Middle Super Output Areas and Intermediate Zones,MSOAIZ,NR,6829,3160,6173,2839,3269,1792,2904,1047,43,19,90,46,10,4,80,42,42,,,,470,221,418,198,0,0,50,22,2,1,23,53,35
E02005533,Broadland 014,Middle Super Output Areas and Intermediate Zones,MSOAIZ,NR,8169,3521,6506,2772,2989,1512,3517,1260,31,14,855,399,111,50,744,349,349,,,,699,290,582,240,45,15,46,24,26,11,50,78,46
E02005534,Broadland 015,Middle Super Output Areas and Intermediate Zones,MSOAIZ,NR,7296,3362,6115,2738,2824,1562,3291,1176,22,11,580,333,65,35,515,298,298,,,,514,234,460,207,8,2,45,24,1,1,27,65,46
E02005535,Broadland 016,Middle Super Output Areas and Intermediate Zones,MSOAIZ,NR,7087,2998,5368,2247,1883,983,3485,1264,54,21,570,219,35,16,535,203,203,,,,1062,492,974,446,2,1,84,43,2,2,46,33,19
E02005536,Broadland 017,Middle Super Output Areas and Intermediate Zones,MSOAIZ,NR,5671,2492,4568,2020,2204,1150,2364,870,16,5,407,170,58,25,349,145,145,,,,622,261,561,233,18,8,40,18,3,2,28,58,36
E02005537,Broadland 018,Middle Super Output Areas and Intermediate Zones,MSOAIZ,NR,5991,2609,4522,1961,2196,1155,2326,806,84,31,646,299,79,39,567,260,260,,,,658,279,597,248,14,6,42,21,5,4,31,81,39
E02005538,Great Yarmouth 001,Middle Super Output Areas and Intermediate Zones,MSOAIZ,NR,8955,3959,7589,3323,3998,2080,3591,1243,20,11,459,223,407,207,52,16,16,,,,781,338,651,280,31,12,80,38,19,8,58,106,64
E02005539,Great Yarmouth 002,Middle Super Output Areas and Intermediate Zones,MSOAIZ,NR,7478,3153,5846,2454,2792,1407,3054,1047,24,9,628,278,561,253,67,25,25,,,,839,334,723,289,19,8,76,31,21,6,45,141,78
E02005540,Great Yarmouth 003,Middle Super Output Areas and Intermediate Zones,MSOAIZ,NR,9022,4138,7225,3319,3773,2033,3452,1286,40,22,576,277,433,234,143,43,43,,,,1104,466,992,419,24,9,87,37,1,1,47,77,54
E02005541,Great Yarmouth 004,Middle Super Output Areas and Intermediate Zones,MSOAIZ,NR,6028,2553,3586,1496,1642,844,1944,652,13,7,1263,575,1138,517,125,58,58,,,,1080,425,1013,395,3,1,57,26,7,3,30,86,50
E02005542,Great Yarmouth 005,Middle Super Output Areas and Intermediate Zones,MSOAIZ,NR,6683,3067,2716,1226,1254,675,1462,551,47,17,1441,719,931,464,510,255,255,,,,2385,1057,2267,997,15,9,79,40,24,11,60,94,48
E02005543,Great Yarmouth 006,Middle Super Output Areas and Intermediate Zones,MSOAIZ,NR,8518,3763,2504,1159,1137,627,1367,532,31,16,3235,1330,2613,1092,622,238,238,,,,2667,1205,2542,1152,24,7,56,29,45,17,53,81,53
E02005544,Great Yarmouth 007,Middle Super Output Areas and Intermediate Zones,MSOAIZ,NR,7105,2927,3491,1474,1233,646,2258,828,20,9,1496,595,856,382,640,213,213,,,,2026,815,1896,764,10,5,102,38,18,8,51,72,34
E02005545,Great Yarmouth 008,Middle Super Output Areas and Intermediate Zones,MSOAIZ,NR,6394,2732,5569,2377,2396,1277,3173,1100,38,22,236,109,168,84,68,25,25,,,,485,189,436,165,1,1,47,22,1,1,24,66,35
E02005546,Great Yarmouth 009,Middle Super Output Areas and Intermediate Zones,MSOAIZ,NR,7858,3620,4106,1862,1737,955,2369,907,8,4,2435,1169,2226,1086,209,83,83,,,,1213,519,1085,459,6,2,106,51,16,7,60,96,66
E02005547,Great Yarmouth 010,Middle Super Output Areas and Intermediate Zones,MSOAIZ,NR,8859,3826,6039,2641,2665,1429,3374,1212,18,8,747,273,630,203,117,70,70,,,,1990,870,1802,792,48,16,107,49,33,13,78,65,34
E02005548,Great Yarmouth 011,Middle Super Output Areas and Intermediate Zones,MSOAIZ,NR,7193,3056,3594,1509,1442,762,2152,747,11,6,2823,1216,2281,958,542,258,258,,,,637,240,472,165,60,26,58,29,47,20,75,128,85
E02005549,Great Yarmouth 012,Middle Super Output Areas and Intermediate Zones,MSOAIZ,NR,5449,2323,4673,1980,2091,1070,2582,910,11,6,273,128,255,122,18,6,6,,,,441,183,388,162,11,5,36,13,6,3,21,51,26
E02005550,Great Yarmouth 013,Middle Super Output Areas and Intermediate Zones,MSOAIZ,NR,6688,2962,5174,2253,2306,1219,2868,1034,18,9,698,363,399,222,299,141,141,,,,718,285,639,241,24,16,51,24,4,4,44,80,52
E02005551,King's Lynn and West Norfolk 001,Middle Super Output Areas and Intermediate Zones,MSOAIZ,PE,5231,2661,3712,1887,2467,1407,1245,480,19,6,479,268,86,44,393,224,224,,,,943,454,836,409,35,12,64,29,8,4,45,78,46
E02005552,King's Lynn and West Norfolk 002,Middle Super Output Areas and Intermediate Zones,MSOAIZ,PE,7015,3330,4441,2153,2806,1514,1635,639,33,12,1137,500,224,99,913,401,401,,,,1122,524,966,457,65,24,61,29,30,14,67,282,141
E02005553,King's Lynn and West Norfolk 003,Middle Super Output Areas and Intermediate Zones,MSOAIZ,PE,8625,4228,6627,3256,4058,2300,2569,956,52,22,787,393,117,58,670,335,335,,,,1018,474,915,428,13,5,74,34,16,7,46,141,83
E02005554,King's Lynn and West Norfolk 004,Middle Super Output Areas and Intermediate Zones,MSOAIZ,PE,6874,3248,4774,2261,2706,1487,2068,774,19,9,700,331,116,58,584,273,273,,,,1122,517,981,455,52,20,53,27,36,15,62,259,130
E02005555,King's Lynn and West Norfolk 005,Middle Super Output Areas and Intermediate Zones,MSOAIZ,PE,6814,2777,5840,2434,2730,1384,3110,1050,29,11,248,78,26,9,222,69,69,,,,648,231,583,207,8,3,44,17,13,4,24,49,23
E02005556,King's Lynn and West Norfolk 006,Middle Super Output Areas and Intermediate Zones,MSOAIZ,PE,7581,3122,6223,2566,2467,1247,3756,1319,49,17,453,193,58,32,395,161,161,,,,817,321,731,284,8,3,71,30,7,4,37,39,25
E02005557,King's Lynn and West Norfolk 007,Middle Super Output Areas and Intermediate Zones,MSOAIZ,PE,6031,2413,2374,962,778,398,1596,564,16,4,2397,973,844,326,1553,647,647,,,,1120,407,979,357,14,5,98,34,29,11,50,124,67
E02005558,King's Lynn and West Norfolk 008,Middle Super Output Areas and Intermediate Zones,MSOAIZ,PE,6832,2846,5414,2233,2405,1211,3009,1022,12,5,724,336,117,61,607,275,275,,,,614,232,515,195,38,13,48,19,13,5,37,68,40
E02005559,King's Lynn and West Norfolk 009,Middle Super Output Areas and Intermediate Zones,MSOAIZ,PE,6872,2847,4476,1852,1733,896,2743,956,13,8,1197,485,401,157,796,328,328,,,,1126,465,1031,419,1,1,69,32,25,13,46,60,37
E02005560,King's Lynn and West Norfolk 010,Middle Super Output Areas and Intermediate Zones,MSOAIZ,PE,8418,3379,4676,1853,1357,691,3319,1162,160,67,1955,809,514,188,1441,621,621,,,,1559,613,1433,566,23,8,70,30,33,9,47,68,37
E02005561,King's Lynn and West Norfolk 011,Middle Super Output Areas and Intermediate Zones,MSOAIZ,PE,9771,4518,4293,1937,1868,1020,2425,917,89,34,2506,1268,631,277,1875,991,991,,,,2735,1196,2558,1114,24,11,100,48,53,23,82,148,83
E02005562,King's Lynn and West Norfolk 012,Middle Super Output Areas and Intermediate Zones,MSOAIZ,PE,6978,3052,5162,2214,2550,1287,2612,927,22,9,733,359,216,120,517,239,239,,,,885,380,775,334,52,17,57,28,1,1,46,176,90
E02005563,King's Lynn and West Norfolk 013,Middle Super Output Areas and Intermediate Zones,MSOAIZ,PE,7377,2961,6111,2433,2643,1275,3468,1158,6,3,612,266,134,55,478,211,211,,,,554,211,457,171,21,9,55,21,21,10,40,94,48
E02005564,King's Lynn and West Norfolk 014,Middle Super Output Areas and Intermediate Zones,MSOAIZ,PE,9392,3801,6091,2627,2985,1526,3106,1101,18,7,713,272,130,46,583,226,226,,,,2462,839,897,344,999,310,56,22,510,163,495,108,56
E02005565,King's Lynn and West Norfolk 015,Middle Super Output Areas and Intermediate Zones,MSOAIZ,PE,6982,2878,5421,2224,2264,1112,3157,1112,24,10,622,265,114,56,508,209,209,,,,792,317,695,277,17,6,68,29,12,5,40,123,62
E02005566,King's Lynn and West Norfolk 016,Middle Super Output Areas and Intermediate Zones,MSOAIZ,PE,9503,3969,7321,3051,3321,1650,4000,1401,34,14,932,419,213,96,719,323,323,,,,1071,415,890,345,27,11,134,51,20,8,70,145,70
E02005567,King's Lynn and West Norfolk 017,Middle Super Output Areas and Intermediate Zones,MSOAIZ,PE,9871,4637,6886,3296,3645,2089,3241,1207,51,25,1181,521,319,107,862,414,414,,,,1647,724,1545,672,18,7,76,41,8,4,52,106,71
E02005568,King's Lynn and West Norfolk 018,Middle Super Output Areas and Intermediate Zones,MSOAIZ,PE,7188,3059,5341,2245,2479,1228,2862,1017,6,2,649,326,175,83,474,243,243,,,,1030,410,903,362,45,14,62,25,20,9,48,162,76
E02005569,King's Lynn and West Norfolk 019,Middle Super Output Areas and Intermediate Zones,MSOAIZ,PE,7898,3251,5298,2223,2375,1186,2923,1037,25,10,784,331,177,74,607,257,257,,,,1412,548,1075,436,194,56,91,35,52,21,112,379,139
E02005570,North Norfolk 001,Middle Super Output Areas and Intermediate Zones,MSOAIZ,NR,7158,3487,5158,2544,3213,1811,1945,733,24,11,640,295,100,46,540,249,249,,,,1233,576,1089,505,12,8,130,62,2,1,71,103,61
E02005571,North Norfolk 002,Middle Super Output Areas and Intermediate Zones,MSOAIZ,NR,5867,2858,3440,1737,2424,1336,1016,401,22,12,1220,531,302,119,918,412,412,,,,949,458,807,393,52,23,70,29,20,13,65,236,120
E02005572,North Norfolk 003,Middle Super Output Areas and Intermediate Zones,MSOAIZ,NR,7423,3723,4681,2329,2874,1630,1807,699,36,18,1056,502,172,75,884,427,427,,,,1563,822,1453,772,12,6,93,40,5,4,50,87,52
E02005573,North Norfolk 004,Middle Super Output Areas and Intermediate Zones,MSOAIZ,NR,5341,2734,3608,1924,2570,1503,1038,421,12,7,1001,456,223,91,778,365,365,,,,586,284,495,245,50,17,33,16,8,6,39,134,63
E02005574,North Norfolk 005,Middle Super Output Areas and Intermediate Zones,MSOAIZ,NR,6633,3013,5175,2377,2944,1576,2231,801,30,14,524,206,109,37,415,169,169,,,,797,352,718,317,9,4,66,28,4,3,35,107,64
E02005575,North Norfolk 006,Middle Super Output Areas and Intermediate Zones,MSOAIZ,NR,6872,3103,4951,2265,2867,1512,2084,753,24,14,867,341,92,39,775,302,302,,,,896,419,767,366,41,15,68,29,20,9,53,134,64
E02005576,North Norfolk 007,Middle Super Output Areas and Intermediate Zones,MSOAIZ,NR,6560,3020,4843,2244,2805,1500,2038,744,53,20,816,353,139,62,677,291,291,,,,786,364,720,329,8,4,53,27,5,4,35,62,39
E02005577,North Norfolk 008,Middle Super Output Areas and Intermediate Zones,MSOAIZ,NR,5888,2570,4177,1825,2202,1090,1975,735,27,12,689,286,145,63,544,223,223,,,,875,387,774,346,12,6,82,32,7,3,41,120,60
E02005578,North Norfolk 009,Middle Super Output Areas and Intermediate Zones,MSOAIZ,PE,5715,2573,3509,1605,1782,970,1727,635,15,8,773,310,209,75,564,235,235,,,,1180,537,1061,488,64,25,24,13,31,11,49,238,113
E02005579,North Norfolk 010,Middle Super Output Areas and Intermediate Zones,MSOAIZ,NR,12380,5597,8556,3854,4121,2237,4435,1617,103,39,2061,903,399,156,1662,747,747,,,,1535,730,1389,664,17,8,112,51,17,7,66,125,71
E02005580,North Norfolk 011,Middle Super Output Areas and Intermediate Zones,MSOAIZ,NR,7512,3484,5216,2404,2622,1447,2594,957,13,6,1228,582,247,119,981,463,463,,,,937,416,856,374,13,8,60,31,8,3,42,118,76
E02005581,North Norfolk 012,Middle Super Output Areas and Intermediate Zones,MSOAIZ,NR,7089,3095,5084,2242,2397,1240,2687,1002,10,3,693,283,167,68,526,215,215,,,,1160,496,1082,461,32,13,41,18,5,4,35,142,71
E02005582,North Norfolk 013,Middle Super Output Areas and Intermediate Zones,MSOAIZ,NR,6422,2948,4532,2070,2295,1221,2237,849,18,12,761,345,132,57,629,288,288,,,,1000,465,911,423,11,4,60,30,18,8,42,111,56
E02005583,North Norfolk 014,Middle Super Output Areas and Intermediate Zones,MSOAIZ,NR,8163,3841,6120,2873,3748,2010,2372,863,33,23,1081,511,258,116,823,395,395,,,,804,358,699,314,25,10,62,27,18,7,44,125,76
E02005584,Norwich 001,Middle Super Output Areas and Intermediate Zones,MSOAIZ,NR,10479,4736,5066,2251,1634,895,3432,1356,38,17,3442,1575,2792,1271,650,304,304,,,,1868,855,1753,796,14,6,85,45,16,8,59,65,38
E02005585,Norwich 002,Middle Super Output Areas and Intermediate Zones,MSOAIZ,NR,10601,4673,3404,1542,1005,551,2399,991,122,51,5389,2350,4489,1977,900,373,373,,,,1613,695,1504,647,11,2,85,40,13,6,48,73,35
E02005586,Norwich 003,Middle Super Output Areas and Intermediate Zones,MSOAIZ,NR,9838,4866,4865,2469,1492,857,3373,1612,80,34,1629,788,1408,697,221,91,91,,,,3182,1534,2958,1428,13,5,198,95,13,6,106,82,41
E02005587,Norwich 004,Middle Super Output Areas and Intermediate Zones,MSOAIZ,NR,9420,4219,5021,2287,2121,1176,2900,1111,47,23,3615,1590,3351,1500,264,90,90,,,,671,280,600,241,0,0,66,35,5,4,39,66,39
E02005588,Norwich 005,Middle Super Output Areas and Intermediate Zones,MSOAIZ,NR,11622,4708,4493,1906,1391,726,3102,1180,93,37,4612,1921,3178,1302,1434,619,619,,,,2326,795,2180,732,6,2,117,49,23,12,63,98,49
E02005589,Norwich 006,Middle Super Output Areas and Intermediate Zones,MSOAIZ,NR,11499,4784,4135,1852,1492,817,2643,1035,139,67,4875,1997,4143,1699,732,298,298,,,,2231,811,2015,726,15,6,195,74,6,5,85,119,57
E02005590,Norwich 007,Middle Super Output Areas and Intermediate Zones,MSOAIZ,NR,9412,5708,2517,1485,1125,729,1392,756,52,25,4000,2649,2811,1808,1189,841,841,,,,2714,1472,2520,1369,18,11,153,80,23,12,103,129,77
E02005592,Norwich 009,Middle Super Output Areas and Intermediate Zones,MSOAIZ,NR,9214,4096,5021,2248,1991,1059,3030,1189,27,11,377,223,183,93,194,130,130,,,,3712,1574,3508,1488,8,3,190,79,6,4,86,77,40
E02005593,Norwich 010,Middle Super Output Areas and Intermediate Zones,MSOAIZ,NR,7060,2901,2478,1076,1195,633,1283,443,145,66,2964,1285,1808,827,1156,458,458,,,,1413,436,1238,373,20,6,107,40,48,17,63,60,38
E02005594,Norwich 011,Middle Super Output Areas and Intermediate Zones,MSOAIZ,NR,10290,5381,4621,2364,2167,1276,2454,1088,88,47,2142,1367,1785,1107,357,260,260,,,,3331,1535,3130,1434,15,8,179,88,7,5,101,108,68
E02005595,Norwich 012,Middle Super Output Areas and Intermediate Zones,MSOAIZ,NR,8702,3933,6472,2956,3443,1871,3029,1085,28,14,946,459,790,387,156,72,72,,,,1178,460,1083,421,15,5,71,32,9,2,39,78,44
E02005596,Norwich 013,Middle Super Output Areas and Intermediate Zones,MSOAIZ,NR,9284,4358,3911,1841,1491,863,2420,978,15,7,4150,1940,3754,1691,396,249,249,,,,1116,517,1004,460,3,2,95,49,14,6,57,92,53
E02005597,South Norfolk 001,Middle Super Output Areas and Intermediate Zones,MSOAIZ,NR,12448,5457,9042,3944,3676,1943,5366,2001,241,99,1904,839,393,166,1511,673,673,,,,1178,526,1068,476,10,3,92,44,8,3,50,83,49
E02005598,South Norfolk 002,Middle Super Output Areas and Intermediate Zones,MSOAIZ,NR,7629,3245,6119,2577,2678,1358,3441,1219,67,35,602,238,155,55,447,183,183,,,,761,349,702,321,22,10,35,16,2,2,28,80,46
E02005599,South Norfolk 003,Middle Super Output Areas and Intermediate Zones,MSOAIZ,NR,5607,2507,4383,1913,1907,1012,2476,901,36,15,529,277,163,74,366,203,203,,,,608,271,565,249,5,4,38,18,0,0,22,51,31
E02005600,South Norfolk 004,Middle Super Output Areas and Intermediate Zones,MSOAIZ,NR,5461,2294,4278,1772,1979,993,2299,779,17,10,602,255,140,56,462,199,199,,,,504,225,420,190,36,12,41,19,7,4,35,60,32
E02005601,South Norfolk 005,Middle Super Output Areas and Intermediate Zones,MSOAIZ,NR,5674,2763,4030,1839,2025,1103,2005,736,102,49,690,429,208,122,482,307,307,,,,808,414,712,370,18,7,69,34,9,3,44,44,32
E02005602,South Norfolk 006,Middle Super Output Areas and Intermediate Zones,MSOAIZ,NR,10296,4433,8358,3515,3921,1989,4437,1526,24,13,775,399,202,91,573,308,308,,,,993,432,883,379,22,9,78,39,10,5,53,146,74
E02005603,South Norfolk 007,Middle Super Output Areas and Intermediate Zones,MSOAIZ,NR,8640,3520,6630,2683,2534,1304,4096,1379,157,66,821,312,180,70,641,242,242,,,,957,419,858,376,19,6,78,35,2,2,43,75,40
E02005604,South Norfolk 008,Middle Super Output Areas and Intermediate Zones,MSOAIZ,NR,8043,3451,6227,2626,3023,1532,3204,1094,36,14,891,411,196,102,695,309,309,,,,742,319,669,289,18,6,49,21,6,3,30,147,81
E02005605,South Norfolk 009,Middle Super Output Areas and Intermediate Zones,MSOAIZ,NR,10057,4173,8171,3316,3441,1673,4730,1643,40,22,888,392,179,71,709,321,321,,,,863,393,757,343,15,7,82,38,9,5,50,95,50
E02005606,South Norfolk 010,Middle Super Output Areas and Intermediate Zones,MSOAIZ,NR,5579,2318,4285,1801,2057,1039,2228,762,5,4,449,183,111,46,338,137,137,,,,735,283,688,260,14,8,29,13,4,2,23,105,47
E02005607,South Norfolk 011,Middle Super Output Areas and Intermediate Zones,MSOAIZ,NR,10904,4484,8512,3466,3446,1701,5066,1765,157,58,1141,463,268,108,873,355,355,,,,933,411,788,350,15,6,116,48,14,7,61,161,86
E02005608,South Norfolk 012,Middle Super Output Areas and Intermediate Zones,MSOAIZ,NR,7254,3092,5615,2376,2830,1405,2785,971,15,6,740,322,231,101,509,221,221,,,,732,311,624,269,29,11,70,28,9,3,42,152,77
E02005609,South Norfolk 013,Middle Super Output Areas and Intermediate Zones,MSOAIZ,NR,6805,3156,4680,2154,2402,1287,2278,867,183,79,1041,464,216,97,825,367,367,,,,811,411,716,363,18,9,68,34,9,5,48,90,48
E02005610,South Norfolk 014,Middle Super Output Areas and Intermediate Zones,MSOAIZ,NR,7897,3321,6051,2507,2859,1401,3192,1106,84,34,780,320,215,91,565,229,229,,,,824,389,736,352,13,5,65,27,10,5,37,158,71
E02005611,South Norfolk 015,Middle Super Output Areas and Intermediate Zones,MSOAIZ,IP,9925,4595,6739,3066,3266,1823,3473,1243,63,33,1280,661,381,190,899,471,471,,,,1713,763,1577,691,5,3,108,54,23,15,72,130,72
E02005612,Corby 001,Middle Super Output Areas and Intermediate Zones,MSOAIZ,NN,6633,2744,4511,1806,1536,783,2975,1023,59,22,1066,500,699,360,367,140,140,,,,922,367,850,334,12,5,48,19,12,9,33,75,49
E02005613,Corby 002,Middle Super Output Areas and Intermediate Zones,MSOAIZ,NN,8777,3712,5716,2342,1672,897,4044,1445,20,8,1751,838,1678,813,73,25,25,,,,1207,471,1146,441,8,4,53,26,0,0,30,83,53
E02005614,Corby 003,Middle Super Output Areas and Intermediate Zones,MSOAIZ,NN,6620,2907,4343,1862,1416,755,2927,1107,28,16,1156,536,932,440,224,96,96,,,,1036,450,981,424,2,1,52,24,1,1,26,57,43
E02005615,Corby 004,Middle Super Output Areas and Intermediate Zones,MSOAIZ,NN,8496,3699,5922,2500,2205,1191,3717,1309,24,9,1521,759,1441,733,80,26,26,,,,958,382,859,334,4,1,83,42,12,5,48,71,49
E02005616,Corby 005,Middle Super Output Areas and Intermediate Zones,MSOAIZ,NN,5286,2221,2912,1192,978,504,1934,688,10,5,1461,654,1208,516,253,138,138,,,,848,337,794,316,2,1,52,20,0,0,21,55,33
E02005617,Corby 006,Middle Super Output Areas and Intermediate Zones,MSOAIZ,NN,9734,4051,4875,2015,1608,842,3267,1173,25,8,3028,1318,2859,1230,169,88,88,,,,1703,656,1630,622,0,0,67,28,6,6,34,103,54
E02005619,Daventry 001,Middle Super Output Areas and Intermediate Zones,MSOAIZ,NN,5720,2348,4499,1802,1931,935,2568,867,13,7,474,203,140,55,334,148,148,,,,623,278,554,252,36,12,25,10,8,4,26,111,58
E02005620,Daventry 002,Middle Super Output Areas and Intermediate Zones,MSOAIZ,NN,7803,3094,6317,2442,2118,1042,4199,1400,28,8,601,250,141,69,460,181,181,,,,734,323,649,286,20,9,48,20,17,8,37,123,71
E02005621,Daventry 003,Middle Super Output Areas and Intermediate Zones,MSOAIZ,NN,6832,2883,5430,2257,2347,1179,3083,1078,40,17,790,357,187,96,603,261,261,,,,505,220,445,190,16,6,30,18,14,6,30,67,32
E02005622,Daventry 004,Middle Super Output Areas and Intermediate Zones,MSOAIZ,NN,8746,3551,7061,2795,2916,1407,4145,1388,63,30,443,199,121,60,322,139,139,,,,1066,468,958,421,41,15,53,26,14,6,47,113,59
E02005623,Daventry 005,Middle Super Output Areas and Intermediate Zones,MSOAIZ,NN,7799,3316,6264,2606,2719,1392,3545,1214,58,28,742,322,309,127,433,195,195,,,,649,309,571,269,10,6,58,27,10,7,40,86,51
E02005624,Daventry 006,Middle Super Output Areas and Intermediate Zones,MSOAIZ,NN,9242,3702,6516,2537,1750,851,4766,1686,204,109,1277,521,198,89,1079,432,432,,,,1206,512,1147,488,0,0,59,24,0,0,24,39,23
E02005625,Daventry 007,Middle Super Output Areas and Intermediate Zones,MSOAIZ,NN,8979,3909,5577,2341,1965,1074,3612,1267,57,26,1936,899,552,236,1384,663,663,,,,1335,599,1239,552,14,5,70,32,12,10,47,74,44
E02005626,Daventry 008,Middle Super Output Areas and Intermediate Zones,MSOAIZ,NN,6624,2734,3576,1467,927,502,2649,965,56,26,1870,776,692,297,1178,479,479,,,,1072,438,956,390,7,3,99,42,10,3,48,50,27
E02005627,Daventry 009,Middle Super Output Areas and Intermediate Zones,MSOAIZ,NN,6711,2955,4871,2037,2025,1009,2846,1028,14,10,1081,531,310,145,771,386,386,,,,678,335,626,308,4,1,36,21,12,5,27,67,42
E02005628,Daventry 010,Middle Super Output Areas and Intermediate Zones,MSOAIZ,NN,7430,3155,5756,2404,2278,1142,3478,1262,21,10,841,354,245,108,596,246,246,,,,755,350,697,315,10,6,42,23,6,6,35,57,37
E02005629,East Northamptonshire 001,Middle Super Output Areas and Intermediate Zones,MSOAIZ,PE,5652,2398,3951,1652,1843,911,2108,741,66,25,825,349,155,68,670,281,281,,,,702,317,627,284,22,10,44,18,9,5,33,108,55
E02005630,East Northamptonshire 002,Middle Super Output Areas and Intermediate Zones,MSOAIZ,PE,8915,3798,6402,2634,2931,1454,3471,1180,70,28,867,444,143,68,724,376,376,,,,1413,604,1193,512,142,58,63,26,15,8,92,163,88
E02005631,East Northamptonshire 003,Middle Super Output Areas and Intermediate Zones,MSOAIZ,PE,9977,4064,7536,2928,2444,1195,5092,1733,23,10,911,462,150,67,761,395,395,,,,1404,607,1317,564,11,3,63,33,13,7,43,103,57
E02005632,East Northamptonshire 004,Middle Super Output Areas and Intermediate Zones,MSOAIZ,NN,5929,2464,4685,1908,1800,903,2885,1005,28,17,737,312,112,54,625,258,258,,,,426,196,370,169,3,2,43,21,10,4,27,53,31
E02005633,East Northamptonshire 005,Middle Super Output Areas and Intermediate Zones,MSOAIZ,NN,8528,3555,6452,2676,2275,1168,4177,1508,21,8,1094,454,228,94,866,360,360,,,,911,389,831,352,10,5,66,30,4,2,37,50,28
E02005634,East Northamptonshire 006,Middle Super Output Areas and Intermediate Zones,MSOAIZ,NN,8410,3568,5821,2409,1750,882,4071,1527,28,14,1559,659,197,84,1362,575,575,,,,946,448,869,415,15,5,62,28,0,0,33,56,38
E02005635,East Northamptonshire 007,Middle Super Output Areas and Intermediate Zones,MSOAIZ,NN,8578,3511,6603,2642,1967,1028,4636,1614,13,6,875,410,135,71,740,339,339,,,,1039,417,933,379,17,5,83,30,6,3,38,48,36
E02005636,East Northamptonshire 008,Middle Super Output Areas and Intermediate Zones,MSOAIZ,PE,10987,4554,7876,3278,2657,1417,5219,1861,37,19,1964,777,367,145,1597,632,632,,,,1046,439,929,382,4,2,107,51,6,4,57,64,41
E02005637,East Northamptonshire 009,Middle Super Output Areas and Intermediate Zones,MSOAIZ,NN,8159,3869,4963,2259,1669,957,3294,1302,69,32,1603,817,319,148,1284,669,669,,,,1463,717,1346,665,9,4,103,45,5,3,52,61,44
E02005638,East Northamptonshire 010,Middle Super Output Areas and Intermediate Zones,MSOAIZ,NN,9775,3881,8753,3451,2948,1504,5805,1947,35,16,91,53,9,6,82,47,47,,,,847,337,783,310,6,2,54,22,4,3,27,49,24
E02005639,Kettering 001,Middle Super Output Areas and Intermediate Zones,MSOAIZ,NN,5195,2246,3935,1652,1829,894,2106,758,5,4,406,196,329,163,77,33,33,,,,719,321,666,297,18,7,35,17,0,0,24,130,73
E02005640,Kettering 002,Middle Super Output Areas and Intermediate Zones,MSOAIZ,NN,10549,4390,8104,3343,2645,1396,5459,1947,148,69,1008,425,582,267,426,158,158,,,,1211,502,1111,457,6,4,88,38,6,3,45,78,51
E02005641,Kettering 003,Middle Super Output Areas and Intermediate Zones,MSOAIZ,NN,7688,3366,5515,2346,2102,1106,3413,1240,17,9,1071,478,702,308,369,170,170,,,,1027,489,942,448,14,8,70,32,1,1,41,58,44
E02005642,Kettering 004,Middle Super Output Areas and Intermediate Zones,MSOAIZ,NN,8131,3277,6755,2700,2156,1101,4599,1599,32,15,273,115,82,45,191,70,70,,,,1027,417,934,373,9,4,65,32,19,8,44,44,30
E02005643,Kettering 005,Middle Super Output Areas and Intermediate Zones,MSOAIZ,NN,8047,3420,3862,1620,1088,592,2774,1028,25,14,3074,1298,2594,1100,480,198,198,,,,984,424,891,376,7,3,84,44,2,1,48,102,64
E02005644,Kettering 006,Middle Super Output Areas and Intermediate Zones,MSOAIZ,NN,8112,3645,4439,1952,1239,673,3200,1279,65,36,517,247,209,95,308,152,152,,,,3028,1376,2841,1288,4,2,178,83,5,3,88,63,34
E02005645,Kettering 007,Middle Super Output Areas and Intermediate Zones,MSOAIZ,NN,10722,5081,6763,2881,2420,1310,4343,1571,111,67,1330,932,699,532,631,400,400,,,,2368,1094,2219,1017,27,16,104,52,18,9,77,150,107
E02005646,Kettering 008,Middle Super Output Areas and Intermediate Zones,MSOAIZ,NN,6423,2700,5634,2363,2322,1234,3312,1129,22,13,77,43,22,6,55,37,37,,,,641,258,575,229,0,0,50,22,16,7,29,49,23
E02005647,Kettering 009,Middle Super Output Areas and Intermediate Zones,MSOAIZ,NN,6950,3145,4614,2002,1568,875,3046,1127,42,25,1435,717,990,480,445,237,237,,,,787,361,717,327,8,3,55,27,7,4,34,72,40
E02005648,Kettering 010,Middle Super Output Areas and Intermediate Zones,MSOAIZ,NN,7167,2897,6368,2573,2461,1262,3907,1311,26,9,193,75,142,57,51,18,18,,,,542,218,490,196,10,4,32,14,10,4,22,38,22
E02005649,Kettering 011,Middle Super Output Areas and Intermediate Zones,MSOAIZ,NN,13537,5534,10386,4130,3172,1627,7214,2503,185,81,1402,661,877,453,525,208,208,,,,1446,588,1315,525,4,2,119,57,8,4,63,118,74
E02005650,Northampton 001,Middle Super Output Areas and Intermediate Zones,MSOAIZ,NN,5731,2373,4531,1883,1741,915,2790,968,3,2,386,189,354,178,32,11,11,,,,783,278,704,246,4,1,64,27,11,4,32,28,21
E02005651,Northampton 002,Middle Super Output Areas and Intermediate Zones,MSOAIZ,NN,6213,2744,5529,2454,2343,1308,3186,1146,57,18,94,38,23,9,71,29,29,,,,497,214,420,175,10,5,66,33,1,1,39,36,20
E02005652,Northampton 003,Middle Super Output Areas and Intermediate Zones,MSOAIZ,NN,5879,2609,4754,2057,1978,1066,2776,991,18,9,481,280,318,198,163,82,82,,,,556,219,493,188,4,2,56,27,3,2,31,70,44
E02005653,Northampton 004,Middle Super Output Areas and Intermediate Zones,MSOAIZ,NN,8025,3162,4341,1746,1003,511,3338,1235,60,24,1993,848,1735,711,258,137,137,,,,1512,500,1405,458,3,1,80,34,24,7,42,119,44
E02005654,Northampton 005,Middle Super Output Areas and Intermediate Zones,MSOAIZ,NN,8223,3228,4543,1813,995,516,3548,1297,243,118,2338,883,1939,750,399,133,133,,,,1069,396,973,353,0,0,90,41,6,2,43,30,18
E02005655,Northampton 006,Middle Super Output Areas and Intermediate Zones,MSOAIZ,NN,5769,2560,4776,2068,1969,1090,2807,978,39,21,370,231,338,209,32,22,22,,,,534,211,499,191,1,1,33,18,1,1,20,50,29
E02005656,Northampton 007,Middle Super Output Areas and Intermediate Zones,MSOAIZ,NN,5901,2286,2873,1089,796,384,2077,705,17,8,2065,869,1887,767,178,102,102,,,,901,295,806,260,6,2,61,24,28,9,35,45,25
E02005657,Northampton 008,Middle Super Output Areas and Intermediate Zones,MSOAIZ,NN,6082,2784,4690,2118,1947,1082,2743,1036,78,39,380,216,77,35,303,181,181,,,,895,390,847,365,0,0,44,22,4,3,25,39,21
E02005658,Northampton 009,Middle Super Output Areas and Intermediate Zones,MSOAIZ,NN,6273,2569,2817,1154,685,378,2132,776,17,8,1843,835,1685,773,158,62,62,,,,1506,525,1430,488,3,1,68,31,5,5,37,90,47
E02005659,Northampton 010,Middle Super Output Areas and Intermediate Zones,MSOAIZ,NN,5014,2247,3884,1692,1508,879,2376,813,15,7,659,355,522,261,137,94,94,,,,397,160,331,125,3,1,54,29,9,5,35,59,33
E02005660,Northampton 011,Middle Super Output Areas and Intermediate Zones,MSOAIZ,NN,5613,2294,3100,1268,823,421,2277,847,52,26,1687,706,1583,647,104,59,59,,,,696,250,636,228,2,1,56,20,2,1,22,78,44
E02005661,Northampton 012,Middle Super Output Areas and Intermediate Zones,MSOAIZ,NN,6447,2534,3577,1351,952,467,2625,884,17,6,1906,812,1763,728,143,84,84,,,,877,327,784,293,2,1,81,29,10,4,34,70,38
E02005662,Northampton 013,Middle Super Output Areas and Intermediate Zones,MSOAIZ,NN,6568,2772,4816,2007,1619,876,3197,1131,7,3,528,253,480,219,48,34,34,,,,1161,476,1089,441,7,3,55,26,10,6,35,56,33
E02005663,Northampton 014,Middle Super Output Areas and Intermediate Zones,MSOAIZ,NN,5446,2348,4580,1954,1576,827,3004,1127,14,7,68,31,55,25,13,6,6,,,,751,339,675,307,0,0,74,31,2,1,32,33,17
E02005664,Northampton 015,Middle Super Output Areas and Intermediate Zones,MSOAIZ,NN,5526,2493,3122,1397,954,541,2168,856,63,32,646,365,452,229,194,136,136,,,,1634,671,1534,629,15,6,79,33,6,3,42,61,28
E02005665,Northampton 016,Middle Super Output Areas and Intermediate Zones,MSOAIZ,NN,7358,3003,5529,2216,1559,790,3970,1426,69,31,681,323,426,202,255,121,121,,,,1034,406,951,370,5,2,76,33,2,1,36,45,27
E02005666,Northampton 017,Middle Super Output Areas and Intermediate Zones,MSOAIZ,NN,8173,3330,3152,1244,731,382,2421,862,144,60,3605,1540,2967,1309,638,231,231,,,,1155,417,1111,396,1,1,41,18,2,2,21,117,69
E02005667,Northampton 018,Middle Super Output Areas and Intermediate Zones,MSOAIZ,NN,5927,2676,4010,1752,1523,834,2487,918,39,18,1192,584,878,453,314,131,131,,,,641,287,583,259,0,0,51,26,7,2,28,45,35
E02005668,Northampton 019,Middle Super Output Areas and Intermediate Zones,MSOAIZ,NN,6070,2598,5220,2231,2184,1170,3036,1061,18,10,354,156,234,114,120,42,42,,,,454,183,389,153,2,2,49,23,14,5,30,24,18
E02005669,Northampton 020,Middle Super Output Areas and Intermediate Zones,MSOAIZ,NN,5640,2251,5100,2039,2115,1059,2985,980,10,10,75,33,53,25,22,8,8,,,,423,153,396,139,0,0,19,10,8,4,14,32,16
E02005670,Northampton 021,Middle Super Output Areas and Intermediate Zones,MSOAIZ,NN,7938,4056,1929,927,519,294,1410,633,205,112,2826,1685,1900,1157,926,528,528,,,,2847,1246,2698,1174,21,11,109,52,19,9,72,131,86
E02005671,Northampton 022,Middle Super Output Areas and Intermediate Zones,MSOAIZ,NN,7230,3102,4131,1806,1229,655,2902,1151,59,27,336,196,100,51,236,145,145,,,,2659,1047,2536,992,6,3,102,47,15,5,55,45,26
E02005672,Northampton 023,Middle Super Output Areas and Intermediate Zones,MSOAIZ,NN,7326,3292,2630,1207,750,385,1880,822,95,48,758,385,244,158,514,227,227,,,,3788,1622,3631,1547,19,7,103,50,35,18,75,55,30
E02005673,Northampton 024,Middle Super Output Areas and Intermediate Zones,MSOAIZ,NN,6990,3249,3960,1864,1415,801,2545,1063,68,38,725,442,517,343,208,99,99,,,,2150,855,2047,802,2,1,96,48,5,4,53,87,50
E02005674,Northampton 025,Middle Super Output Areas and Intermediate Zones,MSOAIZ,NN,6497,3341,2751,1304,1046,596,1705,708,127,79,1231,757,604,411,627,346,346,,,,2308,1146,2200,1090,19,7,67,40,22,9,56,80,55
E02005675,Northampton 026,Middle Super Output Areas and Intermediate Zones,MSOAIZ,NN,5727,2340,3263,1304,619,337,2644,967,63,36,1505,663,1226,564,279,99,99,,,,856,308,779,278,5,2,62,24,10,4,30,40,29
E02005676,Northampton 027,Middle Super Output Areas and Intermediate Zones,MSOAIZ,NN,5898,2389,3769,1480,974,506,2795,974,48,26,1293,562,1020,455,273,107,107,,,,707,280,639,255,0,0,62,23,6,2,25,81,41
E02005677,Northampton 028,Middle Super Output Areas and Intermediate Zones,MSOAIZ,NN,8044,3601,4871,2115,1534,820,3337,1295,89,48,774,353,365,168,409,185,185,,,,2238,1043,2101,976,19,8,100,49,18,10,67,72,42
E02005678,Northampton 029,Middle Super Output Areas and Intermediate Zones,MSOAIZ,NN,9673,3986,7150,2833,1876,909,5274,1924,463,251,748,303,67,30,681,273,273,,,,1263,575,1192,540,2,1,63,31,6,3,35,49,24
E02005679,Northampton 030,Middle Super Output Areas and Intermediate Zones,MSOAIZ,NN,8822,3565,7018,2752,1649,827,5369,1925,14,7,150,89,115,73,35,16,16,,,,1607,697,1512,654,5,2,80,38,10,3,43,33,20
E02005680,Northampton 031,Middle Super Output Areas and Intermediate Zones,MSOAIZ,NN,8440,2949,7283,2497,1506,681,5777,1816,14,5,328,131,151,67,177,64,64,,,,783,301,739,285,0,0,41,14,3,2,16,32,15
E02005681,South Northamptonshire 001,Middle Super Output Areas and Intermediate Zones,MSOAIZ,NN,8086,3286,6457,2604,2771,1393,3686,1211,46,15,879,368,269,110,610,258,258,,,,617,250,548,213,9,5,42,22,18,10,37,87,49
E02005682,South Northamptonshire 002,Middle Super Output Areas and Intermediate Zones,MSOAIZ,NN,6354,2673,4860,1994,2019,1032,2841,962,24,13,624,279,189,80,435,199,199,,,,760,341,715,322,10,5,13,6,22,8,19,86,46
E02005683,South Northamptonshire 003,Middle Super Output Areas and Intermediate Zones,MSOAIZ,NN,13084,5212,10400,4025,3165,1590,7235,2435,127,58,1096,477,273,128,823,349,349,,,,1360,593,1251,538,20,11,78,39,11,5,55,101,59
E02005684,South Northamptonshire 004,Middle Super Output Areas and Intermediate Zones,MSOAIZ,NN,7939,3311,6502,2626,2545,1243,3957,1383,44,19,516,254,158,78,358,176,176,,,,791,367,701,329,13,8,62,26,15,4,38,86,45
E02005685,South Northamptonshire 005,Middle Super Output Areas and Intermediate Zones,MSOAIZ,NN,8034,3408,5670,2289,1928,982,3742,1307,285,129,1139,546,305,148,834,398,398,,,,877,409,802,376,15,6,53,24,7,3,33,63,35
E02005686,South Northamptonshire 006,Middle Super Output Areas and Intermediate Zones,MSOAIZ,OX,7350,3037,5981,2389,2416,1214,3565,1175,7,3,567,276,139,65,428,211,211,,,,683,299,573,254,25,12,66,26,19,7,45,112,70
E02005687,South Northamptonshire 007,Middle Super Output Areas and Intermediate Zones,MSOAIZ,OX,5861,2356,4654,1810,1819,855,2835,955,18,8,510,225,150,65,360,160,160,,,,592,267,520,234,25,10,31,17,16,6,33,87,46
E02005688,South Northamptonshire 008,Middle Super Output Areas and Intermediate Zones,MSOAIZ,NN,8667,3453,7051,2739,2464,1205,4587,1534,150,58,626,289,135,72,491,217,217,,,,767,329,707,299,3,2,40,21,17,7,30,73,38
E02005689,South Northamptonshire 009,Middle Super Output Areas and Intermediate Zones,MSOAIZ,NN,7606,2951,6711,2552,1784,912,4927,1640,25,13,125,59,7,5,118,54,54,,,,718,310,655,282,3,1,54,25,6,2,28,27,17
E02005690,South Northamptonshire 010,Middle Super Output Areas and Intermediate Zones,MSOAIZ,NN,5266,2363,3686,1548,1145,619,2541,929,54,23,755,402,126,62,629,340,340,,,,715,360,626,318,25,9,55,27,9,6,42,56,30
E02005691,South Northamptonshire 011,Middle Super Output Areas and Intermediate Zones,MSOAIZ,OX,6250,2667,4496,1909,1898,984,2598,925,49,18,766,330,227,88,539,242,242,,,,704,315,600,274,43,15,31,13,30,13,41,235,95
E02005692,Wellingborough 001,Middle Super Output Areas and Intermediate Zones,MSOAIZ,NN,6565,2981,4765,2067,1960,1031,2805,1036,66,35,967,509,312,144,655,365,365,,,,673,318,604,284,13,4,42,24,14,6,34,94,52
E02005693,Wellingborough 002,Middle Super Output Areas and Intermediate Zones,MSOAIZ,NN,8272,3276,5264,2077,1754,913,3510,1164,47,22,1886,752,757,287,1129,465,465,,,,986,382,916,352,2,1,58,25,10,4,30,89,43
E02005694,Wellingborough 003,Middle Super Output Areas and Intermediate Zones,MSOAIZ,NN,7630,3059,6747,2694,2185,1098,4562,1596,22,10,101,59,15,5,86,54,54,,,,730,280,659,249,3,1,57,23,11,7,31,30,16
E02005695,Wellingborough 004,Middle Super Output Areas and Intermediate Zones,MSOAIZ,NN,7241,3248,3801,1637,1385,716,2416,921,128,70,644,386,81,47,563,339,339,,,,2585,1109,2431,1037,18,9,129,58,7,5,72,83,46
E02005696,Wellingborough 005,Middle Super Output Areas and Intermediate Zones,MSOAIZ,NN,5773,2458,2865,1228,851,472,2014,756,95,51,2148,916,584,242,1564,674,674,,,,619,231,556,205,4,1,49,20,10,5,26,46,32
E02005697,Wellingborough 006,Middle Super Output Areas and Intermediate Zones,MSOAIZ,NN,5904,2964,3224,1410,1227,659,1997,751,81,40,1193,832,384,259,809,573,573,,,,1329,632,1231,585,11,7,66,32,21,8,47,77,50
E02005698,Wellingborough 007,Middle Super Output Areas and Intermediate Zones,MSOAIZ,NN,5681,2368,3804,1565,1387,724,2417,841,39,17,1203,539,501,225,702,314,314,,,,574,213,507,185,5,2,52,20,10,6,28,61,34
E02005699,Wellingborough 008,Middle Super Output Areas and Intermediate Zones,MSOAIZ,NN,7947,3164,4889,1920,1236,612,3653,1308,74,27,2168,896,746,293,1422,603,603,,,,761,289,688,262,8,2,52,21,13,4,27,55,32
E02005700,Wellingborough 009,Middle Super Output Areas and Intermediate Zones,MSOAIZ,NN,8839,3860,7080,3067,3108,1631,3972,1436,32,15,721,343,243,99,478,244,244,,,,932,396,843,357,9,4,67,31,13,4,39,74,39
E02005701,Wellingborough 010,Middle Super Output Areas and Intermediate Zones,MSOAIZ,NN,10731,4679,8525,3621,3287,1728,5238,1893,50,28,875,444,235,119,640,325,325,,,,1150,510,1017,449,15,6,94,46,24,9,61,131,76
E02005702,Northumberland 004,Middle Super Output Areas and Intermediate Zones,MSOAIZ,NE,6170,2690,3926,1704,1908,1018,2018,686,22,8,557,260,305,136,252,124,124,,,,1502,634,997,456,273,93,28,14,204,71,178,163,84
E02005703,Northumberland 005,Middle Super Output Areas and Intermediate Zones,MSOAIZ,NE,6664,3150,3716,1677,1582,873,2134,804,27,10,1869,934,1484,645,385,289,289,,,,868,437,780,397,8,4,53,24,27,12,40,184,92
E02005704,Northumberland 006,Middle Super Output Areas and Intermediate Zones,MSOAIZ,NE,12338,5508,8830,3855,3988,2073,4842,1782,36,18,1976,933,1534,683,442,250,250,,,,1356,626,1175,547,29,12,130,56,22,11,79,140,76
E02005705,Northumberland 007,Middle Super Output Areas and Intermediate Zones,MSOAIZ,NE,7438,3407,5002,2211,2587,1329,2415,882,25,14,698,367,399,217,299,150,150,,,,1422,661,1175,550,103,39,93,48,51,24,111,291,154
E02005706,Northumberland 001,Middle Super Output Areas and Intermediate Zones,MSOAIZ,TD,9340,4329,5072,2253,2167,1168,2905,1085,22,14,2681,1293,777,351,1904,942,942,,,,1442,694,1302,623,30,13,103,55,7,3,71,123,75
E02005707,Northumberland 002,Middle Super Output Areas and Intermediate Zones,MSOAIZ,TD,6809,3123,4897,2222,2626,1391,2271,831,21,12,723,334,143,69,580,265,265,,,,1008,463,893,404,45,24,43,26,27,9,59,160,92
E02005708,Northumberland 003,Middle Super Output Areas and Intermediate Zones,MSOAIZ,TD,10396,5013,5974,2865,3399,1853,2575,1012,29,18,1444,717,435,223,1009,494,494,,,,2321,1110,2066,989,109,43,122,64,24,14,121,628,303
E02005709,Northumberland 022,Middle Super Output Areas and Intermediate Zones,MSOAIZ,NE,6671,2984,2494,1079,797,439,1697,640,20,8,3364,1561,2880,1261,484,300,300,,,,695,271,611,239,12,6,55,18,17,8,32,98,65
E02005710,Northumberland 023,Middle Super Output Areas and Intermediate Zones,MSOAIZ,NE,8309,4067,5211,2339,1911,1055,3300,1284,16,9,1202,730,688,397,514,333,333,,,,1786,930,1619,831,8,6,146,85,13,8,99,94,59
E02005711,Northumberland 024,Middle Super Output Areas and Intermediate Zones,MSOAIZ,NE,8296,3680,4334,1865,1596,884,2738,981,10,5,3197,1468,2656,1223,541,245,245,,,,693,300,615,264,2,1,69,31,7,4,36,62,42
E02005712,Northumberland 025,Middle Super Output Areas and Intermediate Zones,MSOAIZ,NE,7010,2914,4670,1908,1497,780,3173,1128,11,8,1512,621,1380,537,132,84,84,,,,749,344,665,308,9,4,65,27,10,5,36,68,33
E02005713,Northumberland 026,Middle Super Output Areas and Intermediate Zones,MSOAIZ,NE,6677,2736,6200,2536,2086,1069,4114,1467,20,8,52,16,27,8,25,8,8,,,,386,166,326,137,3,2,52,25,5,2,29,19,10
E02005714,Northumberland 027,Middle Super Output Areas and Intermediate Zones,MSOAIZ,NE,5380,2003,5157,1915,1306,624,3851,1291,21,13,21,7,7,2,14,5,5,,,,174,64,157,58,0,0,17,6,0,0,6,7,4
E02005715,Northumberland 029,Middle Super Output Areas and Intermediate Zones,MSOAIZ,NE,8442,3714,4257,1890,1501,817,2756,1073,40,24,3261,1387,1888,772,1373,615,615,,,,794,361,718,322,8,4,62,32,6,3,39,90,52
E02005716,Northumberland 028,Middle Super Output Areas and Intermediate Zones,MSOAIZ,NE,8641,3732,6366,2646,1903,990,4463,1656,1,1,1458,710,1359,634,99,76,76,,,,753,331,651,284,8,3,88,41,6,3,47,63,44
E02005717,Northumberland 030,Middle Super Output Areas and Intermediate Zones,MSOAIZ,NE,7746,3598,5837,2575,2398,1280,3439,1295,9,4,1282,720,1155,635,127,85,85,,,,509,241,433,202,2,1,62,32,12,6,39,109,58
E02005718,Northumberland 031,Middle Super Output Areas and Intermediate Zones,MSOAIZ,NE,6617,3085,5673,2583,2560,1373,3113,1210,7,3,286,153,233,112,53,41,41,,,,611,322,537,281,1,1,67,38,6,2,41,40,24
E02005719,Northumberland 032,Middle Super Output Areas and Intermediate Zones,MSOAIZ,NE,7604,3536,4939,2149,1734,914,3205,1235,64,31,1771,890,1413,701,358,189,189,,,,756,418,665,374,17,5,68,35,6,4,44,74,48
E02005720,Northumberland 008,Middle Super Output Areas and Intermediate Zones,MSOAIZ,NE,10911,4822,7610,3270,2959,1534,4651,1736,13,6,1880,924,1126,531,754,393,393,,,,1315,567,1193,510,15,6,93,44,14,7,57,93,55
E02005721,Northumberland 011,Middle Super Output Areas and Intermediate Zones,MSOAIZ,NE,4838,2140,3406,1429,1195,613,2211,816,2,1,845,411,390,185,455,226,226,,,,536,273,467,243,10,4,53,23,6,3,30,49,26
E02005722,Northumberland 015,Middle Super Output Areas and Intermediate Zones,MSOAIZ,NE,7070,2990,5091,2059,2260,1082,2831,977,8,4,359,174,158,71,201,103,103,,,,1320,618,1219,572,33,16,48,22,20,8,46,292,135
E02005723,Northumberland 016,Middle Super Output Areas and Intermediate Zones,MSOAIZ,NE,6214,3124,3880,1870,1755,1030,2125,840,27,19,1528,817,845,407,683,410,410,,,,689,353,603,301,9,5,69,41,8,6,52,90,65
E02005724,Northumberland 018,Middle Super Output Areas and Intermediate Zones,MSOAIZ,NE,6099,2548,5628,2343,2705,1373,2923,970,3,2,114,49,70,27,44,22,22,,,,309,131,277,116,4,2,22,10,6,3,15,45,23
E02005725,Northumberland 033,Middle Super Output Areas and Intermediate Zones,MSOAIZ,NE,6393,2792,5270,2261,2633,1360,2637,901,14,7,414,209,217,105,197,104,104,,,,604,266,550,242,7,3,40,19,7,2,24,91,49
E02005726,Northumberland 034,Middle Super Output Areas and Intermediate Zones,MSOAIZ,NE,7539,3008,6227,2477,3015,1452,3212,1025,15,4,272,128,105,49,167,79,79,,,,910,339,692,266,107,34,30,12,81,27,73,115,60
E02005727,Northumberland 019,Middle Super Output Areas and Intermediate Zones,MSOAIZ,NE,6375,2839,4040,1749,2011,1003,2029,746,56,23,727,345,218,98,509,247,247,,,,1331,617,1133,522,67,28,89,47,42,20,95,221,105
E02005728,Northumberland 037,Middle Super Output Areas and Intermediate Zones,MSOAIZ,NE,7028,3172,4780,2097,2593,1301,2187,796,11,7,973,459,390,171,583,288,288,,,,1092,516,981,465,20,8,67,31,24,12,51,172,93
E02005729,Northumberland 036,Middle Super Output Areas and Intermediate Zones,MSOAIZ,NE,5467,2395,4244,1804,1911,959,2333,845,30,8,472,249,176,89,296,160,160,,,,615,284,549,253,19,6,39,22,8,3,31,106,50
E02005730,Northumberland 035,Middle Super Output Areas and Intermediate Zones,MSOAIZ,NE,12757,5725,8955,3838,4248,2183,4707,1655,81,49,1961,984,825,387,1136,597,597,,,,1587,765,1421,677,22,10,120,68,24,10,88,173,89
E02005731,Northumberland 038,Middle Super Output Areas and Intermediate Zones,MSOAIZ,NE,10758,4533,7687,3098,2387,1253,5300,1845,45,23,2117,1022,1225,544,892,478,478,,,,828,350,731,305,7,2,88,42,2,1,45,81,40
E02005732,Northumberland 039,Middle Super Output Areas and Intermediate Zones,MSOAIZ,NE,8808,3905,6828,2917,3386,1716,3442,1201,49,29,629,332,191,91,438,241,241,,,,1145,551,1037,502,36,12,57,27,15,10,49,157,76
E02005733,Northumberland 040,Middle Super Output Areas and Intermediate Zones,MSOAIZ,NE,7994,3487,5559,2346,2843,1385,2716,961,69,37,817,375,225,104,592,271,271,,,,1354,628,1187,555,29,9,96,47,42,17,73,195,101
E02005734,Northumberland 009,Middle Super Output Areas and Intermediate Zones,MSOAIZ,NE,6242,2853,3643,1634,1619,871,2024,763,38,17,1619,772,881,413,738,359,359,,,,899,398,830,366,8,4,52,25,9,3,32,43,32
E02005735,Northumberland 010,Middle Super Output Areas and Intermediate Zones,MSOAIZ,NE,7876,3621,4447,2021,1846,1011,2601,1010,13,3,1137,525,252,93,885,432,432,,,,2222,1037,2091,966,13,5,98,53,20,13,71,57,35
E02005736,Northumberland 013,Middle Super Output Areas and Intermediate Zones,MSOAIZ,NE,7508,3369,3901,1620,1280,672,2621,948,26,12,2642,1280,1744,797,898,483,483,,,,880,418,784,379,17,5,64,24,15,10,39,59,39
E02005737,Northumberland 012,Middle Super Output Areas and Intermediate Zones,MSOAIZ,NE,7122,3232,4999,2105,1668,892,3331,1213,7,4,1395,787,800,413,595,374,374,,,,682,311,606,277,1,1,70,30,5,3,34,39,25
E02005738,Northumberland 014,Middle Super Output Areas and Intermediate Zones,MSOAIZ,NE,5067,2188,4202,1777,1551,806,2651,971,13,7,368,184,211,92,157,92,92,,,,457,202,397,175,5,3,52,22,3,2,27,27,18
E02005739,Northumberland 017,Middle Super Output Areas and Intermediate Zones,MSOAIZ,NE,9403,4257,6526,2915,2479,1358,4047,1557,13,8,1897,862,1103,468,794,394,394,,,,896,429,830,396,1,1,57,27,8,5,33,71,43
E02005740,Northumberland 020,Middle Super Output Areas and Intermediate Zones,MSOAIZ,NE,10175,4677,6007,2676,2057,1122,3950,1554,17,8,2753,1273,1800,775,953,498,498,,,,1333,675,1173,602,3,2,144,63,13,8,73,65,45
E02005741,Northumberland 021,Middle Super Output Areas and Intermediate Zones,MSOAIZ,NE,8399,3588,6479,2629,2321,1180,4158,1449,41,24,1103,579,599,304,504,275,275,,,,705,316,601,269,20,7,72,32,12,8,47,71,40
E02005742,Craven 001,Middle Super Output Areas and Intermediate Zones,MSOAIZ,LA,7336,3314,5669,2512,3001,1569,2668,943,29,16,398,221,133,73,265,148,148,,,,1097,498,968,440,19,10,88,41,22,7,58,143,67
E02005743,Craven 002,Middle Super Output Areas and Intermediate Zones,MSOAIZ,BD,4956,2290,3781,1718,2290,1204,1491,514,49,29,253,139,27,19,226,120,120,,,,739,340,627,291,52,21,23,13,37,15,49,134,64
E02005744,Craven 003,Middle Super Output Areas and Intermediate Zones,MSOAIZ,BD,7418,3421,5643,2549,3017,1598,2626,951,11,4,603,314,157,69,446,245,245,,,,1020,485,890,421,26,12,86,44,18,8,64,141,69
E02005745,Craven 004,Middle Super Output Areas and Intermediate Zones,MSOAIZ,LS,5032,2154,3999,1689,2110,1071,1889,618,7,5,124,71,42,20,82,51,51,,,,778,334,701,303,33,14,26,9,18,8,31,124,55
E02005746,Craven 005,Middle Super Output Areas and Intermediate Zones,MSOAIZ,BD,6402,2987,4743,2108,2096,1148,2647,960,16,9,719,406,232,120,487,286,286,,,,828,403,755,369,7,4,54,23,12,7,34,96,61
E02005747,Craven 006,Middle Super Output Areas and Intermediate Zones,MSOAIZ,BD,6601,3042,4024,1818,1738,944,2286,874,29,16,914,442,270,113,644,329,329,,,,1551,707,1413,641,23,13,92,42,23,11,66,83,59
E02005748,Craven 007,Middle Super Output Areas and Intermediate Zones,MSOAIZ,BD,7288,3215,5705,2423,2450,1238,3255,1185,19,13,444,230,101,54,343,176,176,,,,1011,487,901,435,22,11,66,33,22,8,52,109,62
E02005749,Craven 008,Middle Super Output Areas and Intermediate Zones,MSOAIZ,BD,9342,4160,7373,3156,3010,1624,4363,1532,48,24,657,389,177,90,480,299,299,,,,1162,528,1023,460,16,4,109,56,14,8,68,102,63
E02005750,Hambleton 001,Middle Super Output Areas and Intermediate Zones,MSOAIZ,YO,7837,3574,5472,2382,2761,1429,2711,953,15,7,1397,705,173,70,1224,635,635,,,,826,410,755,376,17,6,47,26,7,2,34,127,70
E02005751,Hambleton 002,Middle Super Output Areas and Intermediate Zones,MSOAIZ,TS,8581,3811,7407,3230,3992,2020,3415,1210,19,10,296,168,29,14,267,154,154,,,,721,333,642,298,28,11,51,24,0,0,35,138,70
E02005752,Hambleton 003,Middle Super Output Areas and Intermediate Zones,MSOAIZ,YO,6660,2958,4855,2050,2596,1232,2259,818,27,14,600,331,39,16,561,315,315,,,,1028,486,927,438,24,12,60,27,17,9,48,150,77
E02005753,Hambleton 004,Middle Super Output Areas and Intermediate Zones,MSOAIZ,DL,12744,5775,7792,3468,3092,1721,4700,1747,75,31,3047,1430,258,112,2789,1318,1318,,,,1733,785,1541,708,44,13,111,49,37,15,77,97,61
E02005754,Hambleton 005,Middle Super Output Areas and Intermediate Zones,MSOAIZ,DL,7393,3170,6089,2617,3175,1604,2914,1013,16,7,315,147,17,7,298,140,140,,,,865,347,655,278,118,32,57,26,35,11,69,108,52
E02005755,Hambleton 006,Middle Super Output Areas and Intermediate Zones,MSOAIZ,HG,6248,2765,4448,1878,1926,1010,2522,868,15,10,708,380,53,23,655,357,357,,,,959,433,852,384,21,10,74,35,12,4,49,118,64
E02005756,Hambleton 007,Middle Super Output Areas and Intermediate Zones,MSOAIZ,YO,6580,2575,3845,1597,1911,921,1934,676,19,7,368,159,11,6,357,153,153,,,,2206,745,865,352,914,261,72,31,355,101,393,142,67
E02005757,Hambleton 008,Middle Super Output Areas and Intermediate Zones,MSOAIZ,YO,8379,3772,5912,2605,2703,1459,3209,1146,26,14,642,309,43,16,599,293,293,,,,1649,766,1488,682,46,23,95,50,20,11,84,150,78
E02005758,Hambleton 009,Middle Super Output Areas and Intermediate Zones,MSOAIZ,YO,8030,3410,5232,2212,2546,1269,2686,943,22,11,1308,585,146,67,1162,518,518,,,,1286,509,855,363,244,81,41,22,146,43,146,182,93
E02005759,Hambleton 010,Middle Super Output Areas and Intermediate Zones,MSOAIZ,YO,8464,3797,6194,2668,3014,1585,3180,1083,63,31,974,495,69,33,905,462,462,,,,1091,527,958,472,37,13,71,31,25,11,55,142,76
E02005760,Hambleton 011,Middle Super Output Areas and Intermediate Zones,MSOAIZ,YO,6405,2510,4601,1801,1897,885,2704,916,31,14,461,214,17,8,444,206,206,,,,1191,429,682,271,272,84,41,19,196,55,158,121,52
E02005761,Harrogate 001,Middle Super Output Areas and Intermediate Zones,MSOAIZ,HG,5408,2336,3714,1577,1989,987,1725,590,42,17,374,196,239,137,135,59,59,,,,1130,474,941,399,88,36,79,31,22,8,75,148,72
E02005762,Harrogate 002,Middle Super Output Areas and Intermediate Zones,MSOAIZ,HG,5671,2410,3793,1613,1610,862,2183,751,45,24,383,214,98,68,285,146,146,,,,1389,526,860,358,272,83,39,18,218,67,168,61,33
E02005763,Harrogate 003,Middle Super Output Areas and Intermediate Zones,MSOAIZ,YO,6175,2576,4020,1687,1922,949,2098,738,21,8,492,226,343,172,149,54,54,,,,1422,559,828,363,342,109,43,21,209,66,196,220,96
E02005764,Harrogate 004,Middle Super Output Areas and Intermediate Zones,MSOAIZ,HG,10277,4549,6819,2981,2843,1524,3976,1457,48,24,1554,760,1085,519,469,241,241,,,,1718,714,1474,619,90,30,111,48,43,17,95,138,70
E02005765,Harrogate 005,Middle Super Output Areas and Intermediate Zones,MSOAIZ,YO,6110,2635,4566,1920,1997,1009,2569,911,34,13,410,207,314,151,96,56,56,,,,995,437,887,390,26,12,56,23,26,12,47,105,58
E02005766,Harrogate 006,Middle Super Output Areas and Intermediate Zones,MSOAIZ,HG,6089,2645,4480,1904,2288,1115,2192,789,16,9,433,209,290,149,143,60,60,,,,1048,461,943,416,26,9,60,29,19,7,45,112,62
E02005767,Harrogate 007,Middle Super Output Areas and Intermediate Zones,MSOAIZ,HG,6675,2749,5762,2364,2615,1315,3147,1049,38,16,213,84,81,37,132,47,47,,,,597,250,553,227,17,7,18,12,9,4,23,65,35
E02005768,Harrogate 008,Middle Super Output Areas and Intermediate Zones,MSOAIZ,HG,5921,2357,4443,1791,1689,871,2754,920,12,6,152,72,89,45,63,27,27,,,,1224,449,853,339,189,51,50,20,132,39,110,90,39
E02005769,Harrogate 009,Middle Super Output Areas and Intermediate Zones,MSOAIZ,HG,6892,3173,4456,1974,1827,1006,2629,968,25,11,1106,593,712,388,394,205,205,,,,1213,547,1085,493,17,7,104,44,7,3,54,92,48
E02005770,Harrogate 010,Middle Super Output Areas and Intermediate Zones,MSOAIZ,HG,9320,4092,7551,3350,3031,1660,4520,1690,31,15,391,180,250,118,141,62,62,,,,1266,505,1095,434,18,7,139,60,14,4,71,81,42
E02005771,Harrogate 011,Middle Super Output Areas and Intermediate Zones,MSOAIZ,HG,7363,3336,4993,2254,1573,876,3420,1378,55,22,992,509,537,253,455,256,256,,,,1279,524,1198,486,5,2,70,32,6,4,38,44,27
E02005772,Harrogate 012,Middle Super Output Areas and Intermediate Zones,MSOAIZ,HG,6056,2481,5398,2222,2511,1263,2887,959,29,17,99,35,48,20,51,15,15,,,,485,184,437,164,9,4,32,14,7,2,20,45,23
E02005773,Harrogate 013,Middle Super Output Areas and Intermediate Zones,MSOAIZ,HG,8668,4101,4447,1948,1391,770,3056,1178,55,36,1970,1124,1469,889,501,235,235,,,,2060,904,1930,846,17,6,98,45,15,7,58,136,89
E02005774,Harrogate 014,Middle Super Output Areas and Intermediate Zones,MSOAIZ,HG,9164,3945,6495,2846,2433,1351,4062,1495,86,38,1106,471,413,195,693,276,276,,,,1372,536,1264,489,14,5,77,35,17,7,47,105,54
E02005775,Harrogate 015,Middle Super Output Areas and Intermediate Zones,MSOAIZ,HG,8764,4497,4671,2165,1944,1059,2727,1106,40,23,490,376,53,31,437,345,345,,,,3478,1885,3340,1814,26,11,94,51,18,9,71,85,48
E02005776,Harrogate 016,Middle Super Output Areas and Intermediate Zones,MSOAIZ,YO,7733,3185,6009,2426,2676,1276,3333,1150,36,14,496,229,339,165,157,64,64,,,,1006,434,867,387,47,17,48,22,44,8,47,186,82
E02005777,Harrogate 017,Middle Super Output Areas and Intermediate Zones,MSOAIZ,HG,8265,3429,7051,2934,2974,1576,4077,1358,59,34,367,158,171,76,196,82,82,,,,727,268,646,237,9,3,69,26,3,2,31,61,35
E02005778,Harrogate 018,Middle Super Output Areas and Intermediate Zones,MSOAIZ,LS,6056,2466,4505,1836,2299,1090,2206,746,32,9,191,95,130,67,61,28,28,,,,1104,436,924,375,62,18,50,22,68,21,61,224,90
E02005779,Harrogate 019,Middle Super Output Areas and Intermediate Zones,MSOAIZ,HG,7375,3548,5212,2428,2511,1417,2701,1011,14,9,127,89,41,33,86,56,56,,,,1926,966,1835,919,5,3,79,39,7,5,47,96,56
E02005780,Harrogate 020,Middle Super Output Areas and Intermediate Zones,MSOAIZ,HG,10279,4362,8442,3600,3869,2062,4573,1538,82,37,374,178,12,5,362,173,173,,,,1313,513,1201,463,23,10,73,34,16,6,50,68,34
E02005781,Harrogate 021,Middle Super Output Areas and Intermediate Zones,MSOAIZ,LS,5560,2297,4700,1918,2202,1080,2498,838,26,13,257,133,165,90,92,43,43,,,,509,199,439,176,26,8,34,12,10,3,23,68,34
E02005782,Richmondshire 001,Middle Super Output Areas and Intermediate Zones,MSOAIZ,DL,7492,3325,5572,2409,2800,1413,2772,996,25,11,414,221,346,192,68,29,29,,,,1252,568,1094,502,39,16,85,38,34,12,66,229,116
E02005783,Richmondshire 002,Middle Super Output Areas and Intermediate Zones,MSOAIZ,DL,8316,3775,5805,2546,2827,1472,2978,1074,44,31,1067,537,820,389,247,148,148,,,,1290,599,1196,556,17,6,69,32,8,5,43,110,62
E02005784,Richmondshire 003,Middle Super Output Areas and Intermediate Zones,MSOAIZ,DL,5526,2382,3842,1634,1482,774,2360,860,10,7,551,270,247,153,304,117,117,,,,1051,434,593,244,258,107,72,30,128,53,190,72,37
E02005785,Richmondshire 004,Middle Super Output Areas and Intermediate Zones,MSOAIZ,DL,11730,4183,4489,1798,1161,611,3328,1187,20,7,1625,660,1028,442,597,218,218,,,,5479,1663,1599,572,2183,604,92,34,1605,453,1091,117,55
E02005786,Richmondshire 005,Middle Super Output Areas and Intermediate Zones,MSOAIZ,LA,6097,2822,4323,1991,2851,1430,1472,561,36,20,417,220,159,89,258,131,131,,,,1132,498,857,379,63,27,131,58,81,34,119,189,93
E02005787,Richmondshire 006,Middle Super Output Areas and Intermediate Zones,MSOAIZ,HG,8183,3720,5546,2532,3032,1595,2514,937,63,28,590,275,349,186,241,89,89,,,,1720,757,1397,624,135,50,90,48,98,35,133,264,128
E02005788,Ryedale 001,Middle Super Output Areas and Intermediate Zones,MSOAIZ,YO,6369,2846,4575,2064,2674,1388,1901,676,15,6,578,256,38,16,540,240,240,,,,1030,443,901,390,22,11,81,32,26,10,53,171,77
E02005789,Ryedale 002,Middle Super Output Areas and Intermediate Zones,MSOAIZ,YO,9956,4593,7228,3290,4082,2170,3146,1120,34,26,1197,577,84,49,1113,528,528,,,,1330,609,1174,536,23,8,101,49,32,16,73,167,91
E02005790,Ryedale 003,Middle Super Output Areas and Intermediate Zones,MSOAIZ,YO,6198,2788,4076,1856,2473,1276,1603,580,19,11,616,280,72,32,544,248,248,,,,1208,512,1004,432,111,39,58,27,35,14,80,279,129
E02005791,Ryedale 004,Middle Super Output Areas and Intermediate Zones,MSOAIZ,YO,6678,2792,4018,1680,1896,917,2122,763,17,10,970,408,56,22,914,386,386,,,,1380,559,1253,505,69,29,47,19,11,6,54,293,135
E02005794,Ryedale 007,Middle Super Output Areas and Intermediate Zones,MSOAIZ,YO,9357,4076,6557,2793,3466,1700,3091,1093,31,15,753,340,36,18,717,322,322,,,,1737,788,1478,679,131,57,85,32,43,20,109,279,140
E02005795,Scarborough 001,Middle Super Output Areas and Intermediate Zones,MSOAIZ,YO,6756,3382,4304,2028,2265,1283,2039,745,28,12,990,561,140,74,850,487,487,,,,1321,704,1159,642,54,15,69,34,39,13,62,113,77
E02005796,Scarborough 002,Middle Super Output Areas and Intermediate Zones,MSOAIZ,YO,6853,3007,4672,2064,2663,1337,2009,727,49,22,753,319,161,71,592,248,248,,,,1199,512,1042,451,29,11,97,37,31,13,61,180,90
E02005797,Scarborough 003,Middle Super Output Areas and Intermediate Zones,MSOAIZ,YO,6119,2715,4112,1805,2021,1051,2091,754,25,10,1034,448,187,78,847,370,370,,,,859,401,731,348,3,2,117,44,8,7,53,89,51
E02005798,Scarborough 004,Middle Super Output Areas and Intermediate Zones,MSOAIZ,YO,8281,3802,6647,3016,3803,1997,2844,1019,27,21,555,282,89,35,466,247,247,,,,897,398,758,332,31,15,76,37,32,14,66,155,85
E02005799,Scarborough 005,Middle Super Output Areas and Intermediate Zones,MSOAIZ,YO,8931,3950,7432,3259,3812,2035,3620,1224,69,45,617,299,188,84,429,215,215,,,,709,289,639,255,9,2,53,27,8,5,34,104,58
E02005800,Scarborough 006,Middle Super Output Areas and Intermediate Zones,MSOAIZ,YO,7773,3924,3632,1655,1503,851,2129,804,33,13,939,611,182,101,757,510,510,,,,3055,1575,2836,1476,32,14,117,56,70,29,99,114,70
E02005801,Scarborough 007,Middle Super Output Areas and Intermediate Zones,MSOAIZ,YO,5515,2364,3054,1291,1218,662,1836,629,11,9,1853,810,515,218,1338,592,592,,,,530,213,479,193,1,1,42,16,8,3,20,67,41
E02005802,Scarborough 008,Middle Super Output Areas and Intermediate Zones,MSOAIZ,YO,8290,3468,4928,2096,1727,917,3201,1179,21,9,273,163,15,7,258,156,156,,,,3022,1175,2868,1096,12,5,129,66,13,8,79,46,25
E02005803,Scarborough 009,Middle Super Output Areas and Intermediate Zones,MSOAIZ,YO,8851,4161,5842,2645,2545,1407,3297,1238,73,49,1257,707,224,98,1033,609,609,,,,1600,713,1426,635,36,14,97,45,41,19,78,79,47
E02005804,Scarborough 010,Middle Super Output Areas and Intermediate Zones,MSOAIZ,YO,7485,4433,3579,2064,2153,1383,1426,681,17,11,316,201,44,22,272,179,179,,,,3467,2091,3276,1983,18,9,125,75,48,24,108,106,66
E02005805,Scarborough 011,Middle Super Output Areas and Intermediate Zones,MSOAIZ,YO,6873,3182,5764,2683,2909,1591,2855,1092,67,30,353,172,32,17,321,155,155,,,,632,262,549,228,15,4,53,22,15,8,34,57,35
E02005806,Scarborough 012,Middle Super Output Areas and Intermediate Zones,MSOAIZ,YO,7133,2926,4189,1732,1536,809,2653,923,82,30,2236,923,603,249,1633,674,674,,,,535,191,472,169,2,1,54,19,7,2,22,91,50
E02005807,Scarborough 013,Middle Super Output Areas and Intermediate Zones,MSOAIZ,YO,6178,2687,4948,2155,2402,1267,2546,888,14,8,305,133,66,24,239,109,109,,,,813,334,714,294,22,8,58,25,19,7,40,98,57
E02005808,Scarborough 014,Middle Super Output Areas and Intermediate Zones,MSOAIZ,YO,11389,5434,8354,4027,4863,2733,3491,1294,74,33,1110,505,191,85,919,420,420,,,,1686,782,1523,710,19,7,121,56,23,9,72,165,87
E02005809,Selby 001,Middle Super Output Areas and Intermediate Zones,MSOAIZ,LS,7252,3184,5582,2299,2214,1111,3368,1188,9,6,765,455,730,437,35,18,18,,,,762,354,640,299,69,30,45,21,8,4,55,134,70
E02005810,Selby 002,Middle Super Output Areas and Intermediate Zones,MSOAIZ,YO,8811,3526,7164,2802,2790,1275,4374,1527,42,22,495,212,378,156,117,56,56,,,,965,421,871,379,27,11,48,23,19,8,42,145,69
E02005811,Selby 003,Middle Super Output Areas and Intermediate Zones,MSOAIZ,YO,8818,3560,7238,2879,2717,1312,4521,1567,36,15,532,242,365,183,167,59,59,,,,911,376,787,330,27,8,82,30,15,8,46,101,48
E02005812,Selby 004,Middle Super Output Areas and Intermediate Zones,MSOAIZ,LS,8992,3734,7042,2831,2389,1210,4653,1621,43,17,1041,504,807,384,234,120,120,,,,783,340,702,305,18,6,58,27,5,2,35,83,42
E02005813,Selby 005,Middle Super Output Areas and Intermediate Zones,MSOAIZ,YO,10797,4809,5202,2286,1644,874,3558,1412,97,49,3093,1438,1822,809,1271,629,629,,,,2309,979,2174,918,23,7,104,49,8,5,61,96,57
E02005814,Selby 006,Middle Super Output Areas and Intermediate Zones,MSOAIZ,YO,6291,2705,4899,2068,2171,1120,2728,948,27,21,829,372,471,221,358,151,151,,,,483,210,435,183,4,1,41,23,3,3,27,53,34
E02005815,Selby 007,Middle Super Output Areas and Intermediate Zones,MSOAIZ,YO,8211,3339,7298,2951,2878,1416,4420,1535,41,26,214,94,82,43,132,51,51,,,,582,231,538,208,3,2,35,18,6,3,23,76,37
E02005816,Selby 008,Middle Super Output Areas and Intermediate Zones,MSOAIZ,YO,8341,3370,6932,2772,2524,1237,4408,1535,21,9,475,201,301,143,174,58,58,,,,834,349,749,311,12,5,57,28,16,5,38,79,39
E02005817,Selby 009,Middle Super Output Areas and Intermediate Zones,MSOAIZ,YO,7100,3029,5705,2367,2236,1109,3469,1258,41,16,680,340,546,277,134,63,63,,,,609,265,543,237,10,3,51,23,5,2,28,65,41
E02005818,Selby 010,Middle Super Output Areas and Intermediate Zones,MSOAIZ,YO,8112,3303,6640,2656,2653,1265,3987,1391,39,20,681,303,514,249,167,54,54,,,,650,271,541,230,10,5,81,27,18,9,41,102,53
E02005819,Ashfield 001,Middle Super Output Areas and Intermediate Zones,MSOAIZ,NG,6141,2668,4299,1871,2073,1054,2226,817,11,7,932,391,684,300,248,91,91,,,,837,370,768,338,11,5,55,25,3,2,32,62,29
E02005820,Ashfield 002,Middle Super Output Areas and Intermediate Zones,MSOAIZ,NG,5695,2513,4678,2032,2067,1075,2611,957,23,9,285,151,249,130,36,21,21,,,,644,280,591,256,1,1,52,23,0,0,24,65,41
E02005821,Ashfield 003,Middle Super Output Areas and Intermediate Zones,MSOAIZ,NG,6343,2795,3890,1636,1347,712,2543,924,7,2,1630,770,1263,623,367,147,147,,,,755,353,683,320,0,0,65,29,7,4,33,61,34
E02005822,Ashfield 004,Middle Super Output Areas and Intermediate Zones,MSOAIZ,NG,9422,3974,5673,2312,1806,923,3867,1389,73,33,1370,613,831,373,539,240,240,,,,2203,955,2049,895,11,4,121,47,22,9,60,103,61
E02005823,Ashfield 005,Middle Super Output Areas and Intermediate Zones,MSOAIZ,NG,7243,3214,3344,1395,1256,655,2088,740,41,18,2748,1312,2435,1161,313,151,151,,,,1004,422,900,379,19,7,79,31,6,5,43,106,67
E02005824,Ashfield 006,Middle Super Output Areas and Intermediate Zones,MSOAIZ,NG,9684,4097,7564,3156,2988,1529,4576,1627,117,52,800,359,519,242,281,117,117,,,,1132,486,1036,438,7,3,82,41,7,4,48,71,44
E02005825,Ashfield 007,Middle Super Output Areas and Intermediate Zones,MSOAIZ,NG,7847,3241,5678,2336,2461,1212,3217,1124,7,4,1306,530,991,396,315,134,134,,,,818,343,747,313,5,2,62,25,4,3,30,38,28
E02005826,Ashfield 008,Middle Super Output Areas and Intermediate Zones,MSOAIZ,NG,5972,2602,3160,1318,1036,531,2124,787,19,10,1890,861,1522,693,368,168,168,,,,844,371,771,335,0,0,63,30,10,6,36,59,42
E02005827,Ashfield 009,Middle Super Output Areas and Intermediate Zones,MSOAIZ,NG,8268,3453,6706,2769,2463,1282,4243,1487,22,11,693,281,469,202,224,79,79,,,,796,358,708,324,0,0,78,30,10,4,34,51,34
E02005828,Ashfield 010,Middle Super Output Areas and Intermediate Zones,MSOAIZ,NG,7072,3116,5525,2434,2458,1302,3067,1132,37,17,720,318,575,262,145,56,56,,,,745,317,680,285,4,2,48,25,13,5,32,45,30
E02005829,Ashfield 011,Middle Super Output Areas and Intermediate Zones,MSOAIZ,NG,6665,2785,5156,2124,2187,1072,2969,1052,9,4,934,394,836,350,98,44,44,,,,510,220,448,195,4,1,57,23,1,1,25,56,43
E02005830,Ashfield 012,Middle Super Output Areas and Intermediate Zones,MSOAIZ,NG,6092,2642,4931,2099,2197,1120,2734,979,24,10,453,209,333,147,120,62,62,,,,626,291,562,252,1,1,58,35,5,3,39,58,33
E02005831,Ashfield 013,Middle Super Output Areas and Intermediate Zones,MSOAIZ,NG,8450,3686,6548,2789,2343,1221,4205,1568,50,27,1053,491,657,329,396,162,162,,,,742,341,703,322,0,0,30,16,9,3,19,57,38
E02005832,Ashfield 014,Middle Super Output Areas and Intermediate Zones,MSOAIZ,NG,8829,4034,5585,2425,1864,989,3721,1436,39,21,1138,606,796,437,342,169,169,,,,1977,922,1797,841,4,2,165,71,11,8,81,90,60
E02005833,Ashfield 015,Middle Super Output Areas and Intermediate Zones,MSOAIZ,NG,7392,3041,6486,2666,2626,1325,3860,1341,8,5,291,120,177,77,114,43,43,,,,554,225,487,194,1,1,63,28,3,2,31,53,25
E02005834,Ashfield 016,Middle Super Output Areas and Intermediate Zones,MSOAIZ,NG,7098,3070,4348,1899,1802,950,2546,949,8,5,2036,852,1714,738,322,114,114,,,,609,250,549,221,6,2,42,22,12,5,29,97,64
E02005835,Bassetlaw 001,Middle Super Output Areas and Intermediate Zones,MSOAIZ,S,10035,4289,7208,2993,2929,1476,4279,1517,24,10,1504,716,1203,587,301,129,129,,,,1196,504,1055,442,11,5,117,52,13,5,62,103,66
E02005836,Bassetlaw 002,Middle Super Output Areas and Intermediate Zones,MSOAIZ,DN,8892,3809,7347,3090,3272,1653,4075,1437,34,17,707,363,467,248,240,115,115,,,,684,282,575,234,5,4,87,37,17,7,48,120,57
E02005837,Bassetlaw 003,Middle Super Output Areas and Intermediate Zones,MSOAIZ,S,6593,2825,5197,2190,2410,1204,2787,986,9,4,533,274,445,236,88,38,38,,,,720,296,618,252,41,15,41,18,20,11,44,134,61
E02005838,Bassetlaw 004,Middle Super Output Areas and Intermediate Zones,MSOAIZ,S,8054,3495,5852,2480,2575,1316,3277,1164,16,9,1329,646,1206,591,123,55,55,,,,758,308,654,269,15,5,84,32,5,2,39,99,52
E02005839,Bassetlaw 005,Middle Super Output Areas and Intermediate Zones,MSOAIZ,DN,6083,2793,4213,1854,1728,940,2485,914,16,8,1114,604,989,524,125,80,80,,,,647,261,585,235,0,0,54,23,8,3,26,93,66
E02005840,Bassetlaw 006,Middle Super Output Areas and Intermediate Zones,MSOAIZ,S,8974,3501,7274,2777,2073,1007,5201,1770,32,19,601,295,416,225,185,70,70,,,,1020,387,952,356,3,3,65,28,0,0,31,47,23
E02005842,Bassetlaw 008,Middle Super Output Areas and Intermediate Zones,MSOAIZ,DN,8470,3756,5789,2510,2434,1271,3355,1239,10,4,1386,649,1143,524,243,125,125,,,,1187,538,1106,497,18,7,56,28,7,6,41,98,55
E02005843,Bassetlaw 009,Middle Super Output Areas and Intermediate Zones,MSOAIZ,S,6328,2662,4592,1820,1409,693,3183,1127,23,10,755,405,593,315,162,90,90,,,,903,398,853,374,2,1,48,23,0,0,24,55,29
E02005844,Bassetlaw 010,Middle Super Output Areas and Intermediate Zones,MSOAIZ,DN,7516,3411,4991,2124,1888,1007,3103,1117,16,8,1163,645,886,458,277,187,187,,,,1290,595,1133,536,26,8,116,42,15,9,59,56,39
E02005846,Bassetlaw 012,Middle Super Output Areas and Intermediate Zones,MSOAIZ,S,6347,2835,2609,1137,803,447,1806,690,29,18,2076,940,1619,712,457,228,228,,,,1537,688,1428,636,28,9,61,29,20,14,52,96,52
E02005847,Bassetlaw 013,Middle Super Output Areas and Intermediate Zones,MSOAIZ,S,6567,2921,4688,2052,2030,1069,2658,983,64,28,587,255,452,184,135,71,71,,,,1141,541,1069,504,7,2,52,26,13,9,37,87,45
E02005848,Bassetlaw 014,Middle Super Output Areas and Intermediate Zones,MSOAIZ,S,6591,2751,4687,1916,1967,998,2720,918,11,5,593,281,415,205,178,76,76,,,,977,396,855,349,53,18,40,15,29,14,47,323,153
E02005849,Bassetlaw 015,Middle Super Output Areas and Intermediate Zones,MSOAIZ,NG,8582,3662,6709,2822,3066,1523,3643,1299,49,22,736,378,577,293,159,85,85,,,,992,388,851,332,73,28,47,19,21,9,56,96,52
E02005850,Broxtowe 001,Middle Super Output Areas and Intermediate Zones,MSOAIZ,NG,6776,2942,5652,2454,2581,1346,3071,1108,15,10,382,161,281,109,101,52,52,,,,675,286,596,253,19,7,54,24,6,2,33,52,31
E02005851,Broxtowe 002,Middle Super Output Areas and Intermediate Zones,MSOAIZ,NG,5863,2614,3391,1462,1314,688,2077,774,25,13,1647,751,1299,593,348,158,158,,,,703,321,626,281,0,0,70,36,7,4,40,97,67
E02005852,Broxtowe 003,Middle Super Output Areas and Intermediate Zones,MSOAIZ,NG,7907,3426,6880,2953,3121,1616,3759,1337,21,10,314,151,225,108,89,43,43,,,,616,270,539,237,10,2,64,29,3,2,33,76,42
E02005853,Broxtowe 004,Middle Super Output Areas and Intermediate Zones,MSOAIZ,NG,8959,3876,7004,2902,2740,1385,4264,1517,19,14,980,547,783,432,197,115,115,,,,878,368,794,331,10,5,64,27,10,5,37,78,45
E02005856,Broxtowe 007,Middle Super Output Areas and Intermediate Zones,MSOAIZ,NG,7246,3104,6226,2633,3265,1630,2961,1003,5,3,248,152,229,144,19,8,8,,,,703,281,648,253,5,2,35,17,15,9,28,64,35
E02005857,Broxtowe 008,Middle Super Output Areas and Intermediate Zones,MSOAIZ,NG,6238,2666,4152,1782,1565,831,2587,951,21,12,1128,467,1012,428,116,39,39,,,,878,368,784,327,5,2,82,37,7,2,41,59,37
E02005858,Broxtowe 009,Middle Super Output Areas and Intermediate Zones,MSOAIZ,NG,7449,3085,4513,1936,1817,969,2696,967,36,15,1077,454,854,327,223,127,127,,,,1752,642,1658,606,11,4,73,28,10,4,36,71,38
E02005859,Broxtowe 010,Middle Super Output Areas and Intermediate Zones,MSOAIZ,NG,8975,3853,6629,2780,2529,1301,4100,1479,21,9,1081,517,944,447,137,70,70,,,,1172,502,1053,448,19,7,96,45,4,2,54,72,45
E02005860,Broxtowe 011,Middle Super Output Areas and Intermediate Zones,MSOAIZ,NG,8179,3809,4003,1853,1757,959,2246,894,40,20,858,621,644,461,214,160,160,,,,3186,1256,3016,1188,9,3,118,51,43,14,68,92,59
E02005861,Broxtowe 012,Middle Super Output Areas and Intermediate Zones,MSOAIZ,NG,5424,2453,3707,1660,1478,758,2229,902,32,12,520,261,248,109,272,152,152,,,,1151,510,1087,480,4,1,58,27,2,2,30,14,10
E02005862,Broxtowe 013,Middle Super Output Areas and Intermediate Zones,MSOAIZ,NG,7668,3356,4917,2179,2088,1116,2829,1063,16,15,1448,694,1388,674,60,20,20,,,,1208,417,666,242,327,100,53,25,162,50,175,79,51
E02005863,Broxtowe 014,Middle Super Output Areas and Intermediate Zones,MSOAIZ,NG,7181,3132,5929,2505,2679,1381,3250,1124,14,6,265,178,219,157,46,21,21,,,,919,410,855,384,12,4,37,18,15,4,26,54,33
E02005864,Broxtowe 015,Middle Super Output Areas and Intermediate Zones,MSOAIZ,NG,8200,3350,6992,2797,2518,1279,4474,1518,35,25,150,76,119,55,31,21,21,,,,973,424,898,391,20,4,37,22,18,7,33,50,28
E02005865,Gedling 001,Middle Super Output Areas and Intermediate Zones,MSOAIZ,NG,7906,3414,6898,2966,3447,1730,3451,1236,6,5,370,150,142,51,228,99,99,,,,533,232,479,203,6,3,42,22,6,4,29,99,61
E02005866,Gedling 002,Middle Super Output Areas and Intermediate Zones,MSOAIZ,NG,8882,3873,6940,2937,3058,1588,3882,1349,35,16,851,365,243,117,608,248,248,,,,961,504,845,446,7,4,86,41,23,13,58,95,51
E02005868,Gedling 004,Middle Super Output Areas and Intermediate Zones,MSOAIZ,NG,6425,2798,5008,2141,2134,1130,2874,1011,41,18,717,347,284,140,433,207,207,,,,600,257,527,224,0,0,58,28,15,5,33,59,35
E02005869,Gedling 005,Middle Super Output Areas and Intermediate Zones,MSOAIZ,NG,5790,2446,3394,1431,1223,665,2171,766,32,16,1589,680,687,261,902,419,419,,,,706,282,611,243,6,2,55,26,34,11,39,69,37
E02005870,Gedling 006,Middle Super Output Areas and Intermediate Zones,MSOAIZ,NG,6510,2957,4111,1809,1524,810,2587,999,57,30,1034,523,472,237,562,286,286,,,,1251,558,1167,514,12,4,55,31,17,9,44,57,37
E02005871,Gedling 007,Middle Super Output Areas and Intermediate Zones,MSOAIZ,NG,7117,3153,5946,2613,2614,1407,3332,1206,21,13,288,136,107,41,181,95,95,,,,825,371,742,336,2,1,74,31,7,3,35,37,20
E02005872,Gedling 008,Middle Super Output Areas and Intermediate Zones,MSOAIZ,NG,5701,2512,4943,2117,2432,1260,2511,857,27,12,186,102,67,31,119,71,71,,,,497,251,411,210,18,9,57,26,11,6,41,48,30
E02005873,Gedling 009,Middle Super Output Areas and Intermediate Zones,MSOAIZ,NG,9942,4272,8758,3685,3863,2059,4895,1626,11,5,57,24,32,11,25,13,13,,,,1064,529,971,490,7,3,84,34,2,2,39,52,29
E02005874,Gedling 010,Middle Super Output Areas and Intermediate Zones,MSOAIZ,NG,8353,3708,6958,2991,2797,1473,4161,1518,43,21,320,216,133,85,187,131,131,,,,993,455,914,415,4,2,73,36,2,2,40,39,25
E02005875,Gedling 011,Middle Super Output Areas and Intermediate Zones,MSOAIZ,NG,7172,2983,5497,2306,2078,1095,3419,1211,51,20,911,369,341,129,570,240,240,,,,657,254,588,220,12,3,56,30,1,1,34,56,34
E02005876,Gedling 012,Middle Super Output Areas and Intermediate Zones,MSOAIZ,NG,8869,3700,6956,2864,2610,1346,4346,1518,21,9,747,314,315,115,432,199,199,,,,1072,471,953,417,0,0,108,48,11,6,54,73,42
E02005877,Gedling 013,Middle Super Output Areas and Intermediate Zones,MSOAIZ,NG,7327,3169,5585,2448,2141,1136,3444,1312,25,8,535,204,243,89,292,115,115,,,,1154,490,1075,456,3,1,74,32,2,1,34,28,19
E02005878,Gedling 014,Middle Super Output Areas and Intermediate Zones,MSOAIZ,NG,9548,4393,6556,2822,2583,1349,3973,1473,89,45,1295,741,552,297,743,444,444,,,,1505,721,1384,662,16,7,98,48,7,4,59,103,64
E02005879,Gedling 015,Middle Super Output Areas and Intermediate Zones,MSOAIZ,NG,7398,3451,4585,2072,1332,688,3253,1384,71,41,947,477,310,155,637,322,322,,,,1760,840,1639,777,4,3,109,55,8,5,63,35,21
E02005880,Mansfield 001,Middle Super Output Areas and Intermediate Zones,MSOAIZ,NG,6235,2527,4042,1650,1870,931,2172,719,36,14,1360,566,767,339,593,227,227,,,,739,263,678,243,0,0,56,18,5,2,20,58,34
E02005881,Mansfield 002,Middle Super Output Areas and Intermediate Zones,MSOAIZ,NG,5669,2408,3725,1547,1606,811,2119,736,28,12,1005,459,614,330,391,129,129,,,,831,347,743,309,0,0,76,32,12,6,38,80,43
E02005882,Mansfield 003,Middle Super Output Areas and Intermediate Zones,MSOAIZ,NG,7883,3355,6639,2765,2752,1427,3887,1338,4,3,712,356,555,292,157,64,64,,,,464,193,401,161,2,1,58,29,3,2,32,64,38
E02005883,Mansfield 004,Middle Super Output Areas and Intermediate Zones,MSOAIZ,NG,7683,3347,4462,1869,1610,823,2852,1046,54,26,1975,957,1603,790,372,167,167,,,,1105,446,1004,406,1,1,95,37,5,2,40,87,49
E02005884,Mansfield 005,Middle Super Output Areas and Intermediate Zones,MSOAIZ,NG,6055,2653,4753,2051,1871,965,2882,1086,69,47,220,98,147,56,73,42,42,,,,978,442,917,413,2,1,57,27,2,1,29,35,15
E02005885,Mansfield 006,Middle Super Output Areas and Intermediate Zones,MSOAIZ,NG,8206,3577,5312,2240,2315,1178,2997,1062,11,5,1887,917,1663,827,224,90,90,,,,903,352,813,314,6,1,81,35,3,2,38,93,63
E02005886,Mansfield 007,Middle Super Output Areas and Intermediate Zones,MSOAIZ,NG,10278,4231,8223,3408,3124,1618,5099,1790,1,1,884,386,481,242,403,144,144,,,,1111,404,1010,364,0,0,97,38,4,2,40,59,32
E02005887,Mansfield 008,Middle Super Output Areas and Intermediate Zones,MSOAIZ,NG,8802,4048,4310,1943,1748,957,2562,986,27,15,1179,602,580,289,599,313,313,,,,3199,1434,3049,1372,12,7,104,40,34,15,62,87,54
E02005888,Mansfield 009,Middle Super Output Areas and Intermediate Zones,MSOAIZ,NG,8037,3726,3438,1515,1117,620,2321,895,31,20,2720,1366,2059,1009,661,357,357,,,,1753,771,1644,720,15,6,84,41,10,4,51,95,54
E02005889,Mansfield 010,Middle Super Output Areas and Intermediate Zones,MSOAIZ,NG,10174,4406,7032,3003,2756,1461,4276,1542,20,7,1917,901,1774,823,143,78,78,,,,1078,418,939,360,3,2,123,48,13,8,58,127,77
E02005890,Mansfield 011,Middle Super Output Areas and Intermediate Zones,MSOAIZ,NG,6694,2790,6001,2509,2409,1229,3592,1280,2,1,124,47,103,37,21,10,10,,,,552,224,508,202,2,1,42,21,0,0,22,15,9
E02005891,Mansfield 012,Middle Super Output Areas and Intermediate Zones,MSOAIZ,NG,6205,2839,2779,1137,1070,529,1709,608,24,10,2876,1474,2113,1136,763,338,338,,,,469,181,434,167,10,2,16,9,9,3,14,57,37
E02005892,Mansfield 013,Middle Super Output Areas and Intermediate Zones,MSOAIZ,NG,11566,5021,9945,4271,4063,2109,5882,2162,9,8,136,70,69,38,67,32,32,,,,1420,640,1310,585,3,1,102,50,5,4,55,56,32
E02005893,Newark and Sherwood 001,Middle Super Output Areas and Intermediate Zones,MSOAIZ,NG,9906,4277,6328,2643,2651,1343,3677,1300,23,11,2052,943,1377,637,675,306,306,,,,1318,578,1214,525,14,6,75,38,15,9,53,185,102
E02005894,Newark and Sherwood 002,Middle Super Output Areas and Intermediate Zones,MSOAIZ,NG,9706,4095,7102,2887,2581,1332,4521,1555,32,18,1451,717,967,501,484,216,216,,,,1039,425,898,364,23,11,113,46,5,4,61,82,48
E02005895,Newark and Sherwood 003,Middle Super Output Areas and Intermediate Zones,MSOAIZ,NG,7958,3356,6496,2692,3172,1548,3324,1144,9,5,467,237,397,199,70,38,38,,,,872,362,736,306,38,15,51,24,47,17,56,114,60
E02005896,Newark and Sherwood 004,Middle Super Output Areas and Intermediate Zones,MSOAIZ,NG,7228,3156,5965,2549,2842,1449,3123,1100,8,7,514,274,400,220,114,54,54,,,,676,288,573,244,13,6,78,34,12,4,44,65,38
E02005897,Newark and Sherwood 005,Middle Super Output Areas and Intermediate Zones,MSOAIZ,NG,8812,3652,6772,2768,3040,1501,3732,1267,11,8,1132,501,732,335,400,166,166,,,,786,318,685,274,31,13,59,25,11,6,44,111,57
E02005898,Newark and Sherwood 006,Middle Super Output Areas and Intermediate Zones,MSOAIZ,NG,10659,4555,7754,3242,2722,1424,5032,1818,21,12,1467,692,718,373,749,319,319,,,,1320,544,1164,477,8,3,142,60,6,4,67,97,65
E02005899,Newark and Sherwood 007,Middle Super Output Areas and Intermediate Zones,MSOAIZ,NG,10562,4955,5553,2497,1974,1073,3579,1424,112,54,2120,1086,1282,611,838,475,475,,,,2661,1245,2510,1172,24,11,105,52,22,10,73,116,73
E02005900,Newark and Sherwood 008,Middle Super Output Areas and Intermediate Zones,MSOAIZ,NG,6932,3069,5384,2280,2655,1376,2729,904,27,17,562,300,431,223,131,77,77,,,,863,418,752,368,18,9,81,34,12,7,50,96,54
E02005901,Newark and Sherwood 009,Middle Super Output Areas and Intermediate Zones,MSOAIZ,NG,8775,3827,6019,2599,2246,1221,3773,1378,33,14,1039,425,878,347,161,78,78,,,,1592,739,1494,695,1,1,86,38,11,5,44,92,50
E02005902,Newark and Sherwood 010,Middle Super Output Areas and Intermediate Zones,MSOAIZ,NG,8123,3602,4952,2184,2077,1128,2875,1056,26,16,2363,1048,2146,935,217,113,113,,,,666,283,565,240,2,2,89,37,10,4,43,116,71
E02005903,Newark and Sherwood 011,Middle Super Output Areas and Intermediate Zones,MSOAIZ,NG,9757,4303,7686,3320,3032,1624,4654,1696,52,24,855,432,753,377,102,55,55,,,,1083,472,976,428,8,2,92,38,7,4,44,81,55
E02005904,Newark and Sherwood 012,Middle Super Output Areas and Intermediate Zones,MSOAIZ,NG,8158,3466,6508,2692,2346,1186,4162,1506,102,50,468,240,378,191,90,49,49,,,,1016,443,949,416,9,3,53,21,5,3,27,64,41
E02005905,Newark and Sherwood 013,Middle Super Output Areas and Intermediate Zones,MSOAIZ,NG,5950,2460,5213,2102,2481,1194,2732,908,34,17,306,155,275,138,31,17,17,,,,359,163,298,139,13,5,35,15,13,4,24,38,23
E02005906,Rushcliffe 001,Middle Super Output Areas and Intermediate Zones,MSOAIZ,NG,6161,2615,5122,2122,2269,1136,2853,986,21,11,376,187,90,46,286,141,141,,,,581,260,513,233,27,8,33,16,8,3,27,61,35
E02005907,Rushcliffe 002,Middle Super Output Areas and Intermediate Zones,MSOAIZ,NG,9100,3889,7057,2969,2576,1357,4481,1612,73,40,997,444,259,119,738,325,325,,,,929,414,855,381,6,3,42,18,26,12,33,44,22
E02005908,Rushcliffe 003,Middle Super Output Areas and Intermediate Zones,MSOAIZ,NG,8751,3840,7251,3128,3356,1766,3895,1362,37,19,604,303,158,76,446,227,227,,,,792,356,712,315,8,3,64,33,8,5,41,67,34
E02005909,Rushcliffe 004,Middle Super Output Areas and Intermediate Zones,MSOAIZ,NG,8152,3229,6550,2525,2298,1084,4252,1441,18,10,214,120,64,33,150,87,87,,,,1333,556,1233,514,2,1,88,37,10,4,42,37,18
E02005910,Rushcliffe 005,Middle Super Output Areas and Intermediate Zones,MSOAIZ,NG,8856,3821,4934,1984,1642,828,3292,1156,19,11,456,343,45,27,411,316,316,,,,3391,1455,3240,1386,8,3,121,53,22,13,69,56,28
E02005911,Rushcliffe 006,Middle Super Output Areas and Intermediate Zones,MSOAIZ,NG,8523,3501,6877,2721,2499,1228,4378,1493,137,70,396,160,62,25,334,135,135,,,,1057,527,1010,504,5,1,38,19,4,3,23,56,23
E02005912,Rushcliffe 007,Middle Super Output Areas and Intermediate Zones,MSOAIZ,NG,8790,3627,7086,2840,2772,1386,4314,1454,21,12,376,249,91,54,285,195,195,,,,1235,494,1144,456,7,2,83,35,1,1,38,72,32
E02005913,Rushcliffe 008,Middle Super Output Areas and Intermediate Zones,MSOAIZ,NG,6801,2764,5471,2082,2409,1149,3062,933,33,16,691,401,227,116,464,285,285,,,,566,243,528,226,3,2,27,13,8,2,17,40,22
E02005914,Rushcliffe 009,Middle Super Output Areas and Intermediate Zones,MSOAIZ,NG,7084,2928,5295,2173,1883,957,3412,1216,56,27,1091,454,415,171,676,283,283,,,,598,253,510,213,1,1,71,33,16,6,40,44,21
E02005915,Rushcliffe 010,Middle Super Output Areas and Intermediate Zones,MSOAIZ,NG,5658,2397,4730,1963,2112,1051,2618,912,37,18,332,154,107,48,225,106,106,,,,510,237,450,213,4,1,34,15,22,8,24,49,25
E02005916,Rushcliffe 011,Middle Super Output Areas and Intermediate Zones,MSOAIZ,NG,7095,3146,5396,2320,2176,1124,3220,1196,96,48,674,361,243,128,431,233,233,,,,877,389,810,360,2,2,61,26,4,1,29,52,28
E02005917,Rushcliffe 012,Middle Super Output Areas and Intermediate Zones,MSOAIZ,NG,5679,2378,5238,2177,2734,1369,2504,808,15,8,72,34,25,11,47,23,23,,,,309,137,284,123,0,0,13,8,12,6,14,45,22
E02005918,Rushcliffe 013,Middle Super Output Areas and Intermediate Zones,MSOAIZ,NG,5096,2260,4030,1776,1961,1054,2069,722,53,26,531,236,186,81,345,155,155,,,,434,196,387,177,17,5,30,14,0,0,19,48,26
E02005919,Rushcliffe 014,Middle Super Output Areas and Intermediate Zones,MSOAIZ,NG,5800,2425,4275,1781,2001,1006,2274,775,11,7,652,284,214,94,438,190,190,,,,761,302,645,257,36,12,40,18,40,15,45,101,51
E02005920,Rushcliffe 015,Middle Super Output Areas and Intermediate Zones,MSOAIZ,NG,7258,3015,6312,2581,2994,1478,3318,1103,22,10,236,124,68,27,168,97,97,,,,628,263,562,237,3,1,54,19,9,6,26,60,37
E02005921,Cherwell 001,Middle Super Output Areas and Intermediate Zones,MSOAIZ,OX,5234,2248,4255,1770,1985,966,2270,804,20,15,289,139,65,33,224,106,106,,,,588,277,529,253,18,6,25,14,16,4,24,82,47
E02005922,Cherwell 002,Middle Super Output Areas and Intermediate Zones,MSOAIZ,OX,8450,3404,5643,2263,1322,695,4321,1568,105,39,1021,410,180,83,841,327,327,,,,1629,666,1558,630,3,2,66,33,2,1,36,52,26
E02005923,Cherwell 003,Middle Super Output Areas and Intermediate Zones,MSOAIZ,OX,5825,2301,3426,1296,992,493,2434,803,50,19,1263,573,321,135,942,438,438,,,,1032,381,963,352,10,3,45,20,14,6,29,54,32
E02005924,Cherwell 004,Middle Super Output Areas and Intermediate Zones,MSOAIZ,OX,10725,4852,5040,2126,1412,752,3628,1374,178,90,1610,826,250,119,1360,707,707,,,,3779,1756,3615,1683,20,10,115,53,29,10,73,118,54
E02005925,Cherwell 005,Middle Super Output Areas and Intermediate Zones,MSOAIZ,OX,8470,3139,4290,1576,1179,573,3111,1003,10,4,3299,1259,1046,373,2253,886,886,,,,782,252,668,214,3,1,89,31,22,6,38,89,48
E02005926,Cherwell 006,Middle Super Output Areas and Intermediate Zones,MSOAIZ,OX,7492,3210,5843,2470,2688,1400,3155,1070,25,12,473,202,118,42,355,160,160,,,,1052,474,976,440,16,8,50,20,10,6,34,99,52
E02005927,Cherwell 007,Middle Super Output Areas and Intermediate Zones,MSOAIZ,OX,5363,2219,4029,1613,1511,766,2518,847,27,15,330,176,23,12,307,164,164,,,,958,401,908,377,6,2,32,19,12,3,24,19,14
E02005928,Cherwell 008,Middle Super Output Areas and Intermediate Zones,MSOAIZ,OX,7267,2975,6090,2436,2650,1285,3440,1151,50,31,346,165,42,15,304,150,150,,,,696,300,605,258,21,11,53,23,17,8,42,85,43
E02005929,Cherwell 009,Middle Super Output Areas and Intermediate Zones,MSOAIZ,OX,6744,2814,5370,2199,2395,1181,2975,1018,31,14,602,251,134,52,468,199,199,,,,615,284,511,230,36,19,49,24,19,11,54,126,66
E02005930,Cherwell 010,Middle Super Output Areas and Intermediate Zones,MSOAIZ,OX,7581,3123,5351,2183,2342,1168,3009,1015,43,19,596,244,104,37,492,207,207,,,,1496,621,1406,584,10,4,38,14,42,19,37,95,56
E02005931,Cherwell 011,Middle Super Output Areas and Intermediate Zones,MSOAIZ,OX,8744,3325,6046,2305,1984,918,4062,1387,35,15,556,219,76,30,480,189,189,,,,1642,616,815,349,458,137,60,28,309,102,267,465,170
E02005932,Cherwell 012,Middle Super Output Areas and Intermediate Zones,MSOAIZ,OX,7014,2683,5190,1941,959,454,4231,1487,18,8,582,208,37,18,545,190,190,,,,1188,509,1114,478,11,3,59,27,4,1,31,36,17
E02005933,Cherwell 013,Middle Super Output Areas and Intermediate Zones,MSOAIZ,OX,7414,2950,5378,2126,1551,790,3827,1336,44,22,1007,410,263,110,744,300,300,,,,930,365,856,335,11,3,54,25,9,2,30,55,27
E02005934,Cherwell 014,Middle Super Output Areas and Intermediate Zones,MSOAIZ,OX,9155,3531,6797,2648,2230,1101,4567,1547,73,21,1404,535,354,135,1050,400,400,,,,814,289,770,269,1,1,27,14,16,5,20,67,38
E02005935,Cherwell 015,Middle Super Output Areas and Intermediate Zones,MSOAIZ,OX,7209,3122,4944,2051,1130,631,3814,1420,38,17,625,304,32,15,593,289,289,,,,1536,711,1469,676,10,3,53,29,4,3,35,66,39
E02005936,Cherwell 016,Middle Super Output Areas and Intermediate Zones,MSOAIZ,OX,8179,3335,6316,2524,2720,1299,3596,1225,82,43,781,317,148,59,633,258,258,,,,845,374,744,331,26,13,61,25,14,5,43,155,77
E02005937,Cherwell 017,Middle Super Output Areas and Intermediate Zones,MSOAIZ,OX,6536,2768,4843,2056,2219,1147,2624,909,32,16,657,301,342,140,315,161,161,,,,916,349,838,316,3,1,58,26,17,6,33,88,46
E02005938,Cherwell 018,Middle Super Output Areas and Intermediate Zones,MSOAIZ,OX,5554,2149,4236,1665,1706,856,2530,809,48,17,577,215,75,30,502,185,185,,,,651,231,611,214,7,3,33,14,0,0,17,42,21
E02005939,Cherwell 019,Middle Super Output Areas and Intermediate Zones,MSOAIZ,OX,5960,2580,4762,2055,1973,1037,2789,1018,56,26,305,118,41,15,264,103,103,,,,788,350,716,315,5,3,65,30,2,2,35,49,31
E02005940,Oxford 001,Middle Super Output Areas and Intermediate Zones,MSOAIZ,OX,5847,2593,3933,1730,1862,1003,2071,727,21,9,677,332,525,258,152,74,74,,,,1148,486,1082,459,14,5,46,18,6,4,27,68,36
E02005941,Oxford 002,Middle Super Output Areas and Intermediate Zones,MSOAIZ,OX,6296,2835,3496,1573,1831,970,1665,603,36,18,932,380,671,264,261,116,116,,,,1685,788,1477,688,115,52,49,28,44,20,100,147,76
E02005942,Oxford 003,Middle Super Output Areas and Intermediate Zones,MSOAIZ,OX,5519,2458,3351,1456,1820,900,1531,556,135,57,258,99,39,15,219,84,84,,,,1562,744,1420,669,32,18,47,27,63,30,75,213,102
E02005943,Oxford 004,Middle Super Output Areas and Intermediate Zones,MSOAIZ,OX,6222,2516,3959,1668,1907,981,2052,687,38,18,602,245,563,233,39,12,12,,,,1547,550,1457,513,19,6,69,29,2,2,37,76,35
E02005944,Oxford 005,Middle Super Output Areas and Intermediate Zones,MSOAIZ,OX,6956,2813,2491,1021,927,472,1564,549,171,74,2903,1157,2373,936,530,221,221,,,,1272,508,1199,472,6,3,58,27,9,6,36,119,53
E02005945,Oxford 006,Middle Super Output Areas and Intermediate Zones,MSOAIZ,OX,8883,3772,4710,1988,2281,1156,2429,832,53,27,900,519,397,183,503,336,336,,,,3107,1175,2920,1101,56,20,84,33,47,21,74,113,63
E02005946,Oxford 007,Middle Super Output Areas and Intermediate Zones,MSOAIZ,OX,7969,3306,5098,2096,2009,1033,3089,1063,64,27,753,344,615,263,138,81,81,,,,1959,788,1827,739,24,7,70,29,38,13,49,95,51
E02005947,Oxford 008,Middle Super Output Areas and Intermediate Zones,MSOAIZ,OX,5112,2705,1358,657,788,410,570,247,118,65,803,496,320,177,483,319,319,,,,2457,1309,2041,1118,188,86,54,29,174,76,191,376,178
E02005948,Oxford 009,Middle Super Output Areas and Intermediate Zones,MSOAIZ,OX,6150,2856,2217,1048,1015,574,1202,474,25,8,740,423,479,258,261,165,165,,,,3000,1303,2729,1180,45,24,55,23,171,76,123,168,74
E02005949,Oxford 010,Middle Super Output Areas and Intermediate Zones,MSOAIZ,OX,6161,2527,1770,765,786,404,984,361,51,21,2367,1051,1807,766,560,285,285,,,,1908,651,1754,589,58,23,68,27,28,12,62,65,39
E02005950,Oxford 011,Middle Super Output Areas and Intermediate Zones,MSOAIZ,OX,10596,4080,3058,1315,1470,698,1588,617,86,32,1296,662,611,238,685,424,424,,,,5961,2004,5678,1892,28,12,142,49,113,51,112,195,67
E02005951,Oxford 012,Middle Super Output Areas and Intermediate Zones,MSOAIZ,OX,5912,2592,2679,1196,1178,637,1501,559,65,33,972,462,814,385,158,77,77,,,,2122,858,2048,827,6,2,54,23,14,6,31,74,43
E02005952,Oxford 013,Middle Super Output Areas and Intermediate Zones,MSOAIZ,OX,13772,5317,6128,2450,2221,1044,3907,1406,256,139,2351,945,1191,482,1160,463,463,,,,4887,1709,4629,1608,19,8,191,77,48,16,101,150,74
E02005953,Oxford 014,Middle Super Output Areas and Intermediate Zones,MSOAIZ,OX,5649,2187,2667,1073,1036,493,1631,580,69,27,855,368,735,320,120,48,48,,,,1962,687,1869,653,3,1,60,23,30,10,34,96,32
E02005954,Oxford 015,Middle Super Output Areas and Intermediate Zones,MSOAIZ,OX,9530,3800,5533,2274,2205,1134,3328,1140,88,33,1245,598,929,435,316,163,163,,,,2529,842,2389,785,17,8,91,34,32,15,57,135,53
E02005955,Oxford 016,Middle Super Output Areas and Intermediate Zones,MSOAIZ,OX,9700,3936,4514,1909,1586,827,2928,1082,154,91,3097,1188,2439,924,658,264,264,,,,1833,693,1766,663,4,2,51,22,12,6,30,102,55
E02005956,Oxford 017,Middle Super Output Areas and Intermediate Zones,MSOAIZ,OX,6085,2390,2278,886,727,348,1551,538,119,51,2854,1167,2026,843,828,324,324,,,,797,261,759,243,0,0,25,14,13,4,18,37,25
E02005957,Oxford 018,Middle Super Output Areas and Intermediate Zones,MSOAIZ,OX,6882,2692,1864,768,389,193,1475,575,573,229,3576,1392,1361,533,2215,859,859,,,,818,278,753,259,0,0,46,12,19,7,19,51,25
E02005958,South Oxfordshire 001,Middle Super Output Areas and Intermediate Zones,MSOAIZ,OX,5675,2301,4438,1750,1409,703,3029,1047,30,9,378,175,37,23,341,152,152,,,,798,348,739,318,11,7,41,19,7,4,30,31,19
E02005959,South Oxfordshire 002,Middle Super Output Areas and Intermediate Zones,MSOAIZ,OX,5428,2214,4178,1699,2084,1008,2094,691,36,17,531,208,94,38,437,170,170,,,,590,242,489,203,22,10,22,9,57,20,39,93,48
E02005960,South Oxfordshire 003,Middle Super Output Areas and Intermediate Zones,MSOAIZ,OX,5836,2422,4533,1848,1985,999,2548,849,42,22,701,299,89,36,612,263,263,,,,503,223,459,202,13,4,24,14,7,3,21,57,30
E02005961,South Oxfordshire 004,Middle Super Output Areas and Intermediate Zones,MSOAIZ,OX,6593,2745,4964,2043,2320,1130,2644,913,34,15,678,293,80,41,598,252,252,,,,833,353,735,315,37,14,43,17,18,7,38,84,41
E02005962,South Oxfordshire 005,Middle Super Output Areas and Intermediate Zones,MSOAIZ,OX,8264,3285,7039,2796,2929,1416,4110,1380,69,27,524,206,63,26,461,180,180,,,,572,221,515,201,3,1,44,15,10,4,20,60,35
E02005963,South Oxfordshire 006,Middle Super Output Areas and Intermediate Zones,MSOAIZ,OX,8013,3226,5757,2316,2521,1233,3236,1083,49,20,1247,483,243,100,1004,383,383,,,,827,351,727,308,34,13,44,20,22,10,43,133,56
E02005964,South Oxfordshire 007,Middle Super Output Areas and Intermediate Zones,MSOAIZ,OX,7255,2934,5815,2356,2597,1289,3218,1067,55,22,609,233,72,27,537,206,206,,,,691,275,616,240,21,8,44,22,10,5,35,85,48
E02005965,South Oxfordshire 008,Middle Super Output Areas and Intermediate Zones,MSOAIZ,RG,5402,2252,3754,1530,1650,831,2104,699,47,16,543,252,71,35,472,217,217,,,,931,395,845,360,41,17,36,14,9,4,35,127,59
E02005966,South Oxfordshire 009,Middle Super Output Areas and Intermediate Zones,MSOAIZ,OX,8039,3173,5928,2301,1060,509,4868,1792,108,51,323,127,24,10,299,117,117,,,,1660,683,1592,652,4,2,58,25,6,4,31,20,11
E02005967,South Oxfordshire 010,Middle Super Output Areas and Intermediate Zones,MSOAIZ,OX,5585,2265,3889,1610,1567,817,2322,793,72,30,972,363,111,53,861,310,310,,,,623,246,392,163,139,44,43,21,49,18,83,29,16
E02005968,South Oxfordshire 011,Middle Super Output Areas and Intermediate Zones,MSOAIZ,RG,6559,2559,3688,1495,1652,815,2036,680,27,10,484,202,59,25,425,177,177,,,,2264,810,694,300,981,312,31,17,558,181,510,96,42
E02005969,South Oxfordshire 012,Middle Super Output Areas and Intermediate Zones,MSOAIZ,OX,9021,3901,6332,2630,2553,1331,3779,1299,149,77,1509,709,195,95,1314,614,614,,,,979,453,857,405,28,8,59,28,35,12,48,52,32
E02005970,South Oxfordshire 013,Middle Super Output Areas and Intermediate Zones,MSOAIZ,OX,5635,2384,3423,1413,916,460,2507,953,67,31,1099,452,187,81,912,371,371,,,,1015,472,945,442,22,7,45,21,3,2,30,31,16
E02005971,South Oxfordshire 014,Middle Super Output Areas and Intermediate Zones,MSOAIZ,OX,5727,2311,4239,1705,1582,832,2657,873,30,12,937,399,129,64,808,335,335,,,,445,163,400,142,7,3,36,17,2,1,21,76,32
E02005972,South Oxfordshire 015,Middle Super Output Areas and Intermediate Zones,MSOAIZ,RG,7896,3210,6007,2404,2643,1271,3364,1133,47,24,942,409,104,47,838,362,362,,,,782,323,673,280,51,20,48,19,10,4,43,118,50
E02005973,South Oxfordshire 016,Middle Super Output Areas and Intermediate Zones,MSOAIZ,RG,5501,2616,3590,1721,1824,1063,1766,658,29,14,747,350,94,47,653,303,303,,,,1045,486,975,455,10,4,50,22,10,5,31,90,45
E02005974,South Oxfordshire 017,Middle Super Output Areas and Intermediate Zones,MSOAIZ,RG,6018,2641,4146,1771,1846,952,2300,819,38,22,690,338,53,33,637,305,305,,,,1091,482,1036,453,9,4,26,16,20,9,29,53,28
E02005975,South Oxfordshire 018,Middle Super Output Areas and Intermediate Zones,MSOAIZ,RG,7564,3082,6104,2437,2926,1413,3178,1024,28,17,598,268,67,27,531,241,241,,,,638,273,514,225,75,25,40,18,9,5,48,196,87
E02005976,South Oxfordshire 019,Middle Super Output Areas and Intermediate Zones,MSOAIZ,RG,5795,2278,4636,1765,2231,1015,2405,750,24,9,332,163,50,21,282,142,142,,,,615,250,496,205,80,28,18,7,21,10,45,188,91
E02005977,South Oxfordshire 020,Middle Super Output Areas and Intermediate Zones,MSOAIZ,RG,5677,2305,4730,1871,2108,1026,2622,845,35,14,505,234,49,25,456,209,209,,,,360,162,297,130,19,10,29,13,15,9,32,47,24
E02005978,Vale of White Horse 001,Middle Super Output Areas and Intermediate Zones,MSOAIZ,OX,6592,2739,5323,2217,2568,1263,2755,954,7,3,491,192,91,40,400,152,152,,,,686,287,611,255,16,6,44,21,15,5,32,85,40
E02005979,Vale of White Horse 002,Middle Super Output Areas and Intermediate Zones,MSOAIZ,OX,8845,3728,6946,2866,3104,1599,3842,1267,51,22,500,277,107,62,393,215,215,,,,1252,522,1132,467,38,17,58,27,24,11,55,96,41
E02005980,Vale of White Horse 003,Middle Super Output Areas and Intermediate Zones,MSOAIZ,OX,9902,4005,6596,2736,3158,1602,3438,1134,79,37,1081,454,158,82,923,372,372,,,,1752,609,704,277,644,200,33,19,371,113,332,394,169
E02005981,Vale of White Horse 004,Middle Super Output Areas and Intermediate Zones,MSOAIZ,OX,8984,3544,7801,3045,2718,1308,5083,1737,33,17,318,116,33,12,285,104,104,,,,815,354,749,326,12,2,52,25,2,1,28,17,12
E02005982,Vale of White Horse 005,Middle Super Output Areas and Intermediate Zones,MSOAIZ,OX,5843,2450,4498,1877,1691,888,2807,989,31,12,490,194,273,103,217,91,91,,,,793,347,678,303,34,11,37,16,44,17,44,31,20
E02005983,Vale of White Horse 006,Middle Super Output Areas and Intermediate Zones,MSOAIZ,OX,10448,4845,6005,2655,2226,1199,3779,1456,159,75,2164,1091,382,194,1782,897,897,,,,1963,944,1826,885,36,11,71,36,30,12,59,157,80
E02005984,Vale of White Horse 007,Middle Super Output Areas and Intermediate Zones,MSOAIZ,SN,6871,2812,5503,2220,2378,1171,3125,1049,30,17,425,181,58,23,367,158,158,,,,763,329,651,290,59,17,21,13,32,9,39,150,65
E02005985,Vale of White Horse 008,Middle Super Output Areas and Intermediate Zones,MSOAIZ,OX,7556,3201,4538,2009,1922,1031,2616,978,91,39,2085,797,462,176,1623,621,621,,,,784,324,742,304,15,7,23,10,4,3,20,58,32
E02005986,Vale of White Horse 009,Middle Super Output Areas and Intermediate Zones,MSOAIZ,SN,8918,3822,5757,2463,2186,1136,3571,1327,147,68,1707,697,304,128,1403,569,569,,,,1171,529,1005,472,75,23,45,18,46,16,57,136,65
E02005987,Vale of White Horse 010,Middle Super Output Areas and Intermediate Zones,MSOAIZ,OX,7596,3156,5475,2244,2283,1156,3192,1088,27,11,1274,525,256,110,1018,415,415,,,,758,342,682,309,15,5,39,18,22,10,33,62,34
E02005988,Vale of White Horse 011,Middle Super Output Areas and Intermediate Zones,MSOAIZ,OX,7178,2918,5543,2264,2050,1048,3493,1216,61,23,761,318,109,44,652,274,274,,,,767,292,485,203,160,43,66,29,56,17,89,46,21
E02005991,Vale of White Horse 014,Middle Super Output Areas and Intermediate Zones,MSOAIZ,OX,9657,4074,6795,2804,2731,1419,4064,1385,264,133,1440,603,191,83,1249,520,520,,,,1069,486,879,423,56,16,76,27,58,20,63,89,48
E02005992,Vale of White Horse 015,Middle Super Output Areas and Intermediate Zones,MSOAIZ,OX,8918,3748,6377,2639,2887,1443,3490,1196,86,39,1234,534,199,92,1035,442,442,,,,1105,477,1014,436,45,20,25,13,21,8,41,116,59
E02005993,West Oxfordshire 001,Middle Super Output Areas and Intermediate Zones,MSOAIZ,OX,6283,2815,4260,1875,1795,978,2465,897,66,36,1077,486,196,90,881,396,396,,,,822,382,735,342,31,10,47,24,9,6,40,58,36
E02005994,West Oxfordshire 002,Middle Super Output Areas and Intermediate Zones,MSOAIZ,OX,5801,2445,4178,1705,1903,920,2275,785,36,14,542,252,103,46,439,206,206,,,,804,357,689,311,60,25,50,18,5,3,46,241,117
E02005995,West Oxfordshire 003,Middle Super Output Areas and Intermediate Zones,MSOAIZ,OX,5850,2511,4361,1824,1997,1020,2364,804,32,14,517,255,89,45,428,210,210,,,,730,322,645,288,45,15,32,15,8,4,34,210,96
E02005996,West Oxfordshire 004,Middle Super Output Areas and Intermediate Zones,MSOAIZ,OX,7973,3469,5729,2453,2622,1373,3107,1080,61,25,798,372,94,43,704,329,329,,,,1235,546,1083,477,83,30,46,27,23,12,69,150,73
E02005997,West Oxfordshire 005,Middle Super Output Areas and Intermediate Zones,MSOAIZ,OX,5537,2419,4311,1854,1997,1040,2314,814,29,15,606,283,75,39,531,244,244,,,,521,233,464,208,13,5,34,17,10,3,25,70,34
E02005998,West Oxfordshire 006,Middle Super Output Areas and Intermediate Zones,MSOAIZ,OX,5716,2357,4744,1900,2122,1046,2622,854,9,4,289,144,54,22,235,122,122,,,,624,284,516,243,40,14,40,17,28,10,41,50,25
E02005999,West Oxfordshire 007,Middle Super Output Areas and Intermediate Zones,MSOAIZ,OX,6110,2510,4968,2021,2142,1069,2826,952,65,24,501,213,90,40,411,173,173,,,,480,207,408,179,18,5,34,16,20,7,28,96,45
E02006000,West Oxfordshire 008,Middle Super Output Areas and Intermediate Zones,MSOAIZ,OX,11686,4790,8517,3477,2740,1419,5777,2058,282,111,1453,569,186,76,1267,493,493,,,,1371,595,1247,538,25,12,87,39,12,6,57,63,38
E02006001,West Oxfordshire 009,Middle Super Output Areas and Intermediate Zones,MSOAIZ,OX,5613,2251,3632,1442,843,441,2789,1001,64,28,1276,503,53,20,1223,483,483,,,,616,265,566,242,8,2,41,20,1,1,23,25,13
E02006002,West Oxfordshire 010,Middle Super Output Areas and Intermediate Zones,MSOAIZ,OX,10004,4380,6247,2781,2566,1422,3681,1359,292,124,1853,758,157,77,1696,681,681,,,,1518,665,1353,605,45,12,92,39,28,9,60,94,52
E02006003,West Oxfordshire 011,Middle Super Output Areas and Intermediate Zones,MSOAIZ,OX,5395,2236,3992,1626,1870,905,2122,721,27,8,722,320,148,72,574,248,248,,,,617,258,551,230,13,4,38,19,15,5,28,37,24
E02006004,West Oxfordshire 012,Middle Super Output Areas and Intermediate Zones,MSOAIZ,OX,5436,2446,3778,1660,1782,930,1996,730,55,21,613,291,89,41,524,250,250,,,,778,371,681,330,53,22,34,14,10,5,41,212,103
E02006005,West Oxfordshire 013,Middle Super Output Areas and Intermediate Zones,MSOAIZ,OX,9020,3564,4943,2009,1134,590,3809,1419,214,85,806,313,80,31,726,282,282,,,,3018,1139,1293,563,1059,339,70,30,596,207,576,39,18
E02006006,West Oxfordshire 014,Middle Super Output Areas and Intermediate Zones,MSOAIZ,OX,5495,2321,3444,1452,1280,684,2164,768,69,22,663,306,77,39,586,267,267,,,,1285,521,618,310,428,121,52,23,187,67,211,34,20
E02006007,West Oxfordshire 015,Middle Super Output Areas and Intermediate Zones,MSOAIZ,OX,6496,2727,5001,2062,2108,1078,2893,984,39,17,727,322,120,57,607,265,265,,,,637,278,547,242,39,12,33,18,18,6,36,92,48
E02006008,Shropshire 025,Middle Super Output Areas and Intermediate Zones,MSOAIZ,TF,7456,3316,5114,2174,2171,1117,2943,1057,45,20,1224,603,946,443,278,160,160,,,,983,464,877,414,25,11,71,34,10,5,50,90,55
E02006009,Shropshire 027,Middle Super Output Areas and Intermediate Zones,MSOAIZ,WV,6420,2717,3965,1745,2026,1062,1939,683,16,9,851,362,670,290,181,72,72,,,,1521,567,566,251,639,201,48,21,268,94,316,67,34
E02006010,Shropshire 029,Middle Super Output Areas and Intermediate Zones,MSOAIZ,WV,11044,4799,7411,3133,3512,1754,3899,1379,71,35,1651,769,1174,529,477,240,240,,,,1742,773,1579,696,43,15,104,52,16,10,77,169,89
E02006011,Shropshire 031,Middle Super Output Areas and Intermediate Zones,MSOAIZ,WV,5896,2683,4464,1945,2080,1110,2384,835,17,8,626,325,515,262,111,63,63,,,,716,357,639,320,7,3,61,29,9,5,37,73,48
E02006012,Shropshire 033,Middle Super Output Areas and Intermediate Zones,MSOAIZ,WV,6010,2818,4392,1965,1970,1052,2422,913,12,8,671,331,503,218,168,113,113,,,,854,464,779,419,12,7,51,32,12,6,45,81,50
E02006013,Shropshire 034,Middle Super Output Areas and Intermediate Zones,MSOAIZ,WV,7607,3195,5380,2215,2644,1269,2736,946,13,6,678,288,522,221,156,67,67,,,,1328,585,1161,513,61,27,76,33,30,12,72,208,101
E02006014,Shropshire 035,Middle Super Output Areas and Intermediate Zones,MSOAIZ,WV,9022,3832,6482,2721,3378,1658,3104,1063,28,16,957,409,695,294,262,115,115,,,,1311,572,1193,514,45,17,68,38,5,3,58,244,114
E02006015,Shropshire 001,Middle Super Output Areas and Intermediate Zones,MSOAIZ,SY,9718,4282,6339,2719,2655,1403,3684,1316,75,39,1449,659,247,91,1202,568,568,,,,1764,811,1647,758,25,10,72,34,20,9,53,91,54
E02006016,Shropshire 002,Middle Super Output Areas and Intermediate Zones,MSOAIZ,TF,7398,3019,5640,2318,2750,1336,2890,982,27,13,652,249,109,38,543,211,211,,,,932,372,817,325,62,26,38,14,15,7,47,147,67
E02006017,Shropshire 004,Middle Super Output Areas and Intermediate Zones,MSOAIZ,SY,7174,3098,5134,2182,2491,1262,2643,920,43,22,757,328,127,52,630,276,276,,,,1116,505,1006,455,32,15,60,26,18,9,50,124,61
E02006018,Shropshire 005,Middle Super Output Areas and Intermediate Zones,MSOAIZ,TF,11692,5144,8050,3490,3294,1822,4756,1668,74,39,1774,802,309,139,1465,663,663,,,,1676,742,1520,673,41,15,100,45,15,9,69,118,71
E02006019,Shropshire 008,Middle Super Output Areas and Intermediate Zones,MSOAIZ,SY,5731,2626,4014,1821,1822,1019,2192,802,33,17,759,361,108,51,651,310,310,,,,871,399,753,348,11,4,102,44,5,3,51,54,28
E02006020,Shropshire 009,Middle Super Output Areas and Intermediate Zones,MSOAIZ,TF,6288,2422,4342,1679,1848,850,2494,829,32,16,718,284,125,48,593,236,236,,,,1102,400,650,265,247,74,31,13,174,48,135,94,43
E02006021,Shropshire 010,Middle Super Output Areas and Intermediate Zones,MSOAIZ,SY,7707,3015,6215,2432,2769,1289,3446,1143,47,19,569,227,75,32,494,195,195,,,,754,287,660,248,24,10,63,26,7,3,39,122,50
E02006022,Shropshire 013,Middle Super Output Areas and Intermediate Zones,MSOAIZ,TF,5614,2275,3717,1517,1616,799,2101,718,44,16,588,248,39,16,549,232,232,,,,1193,459,723,309,297,97,29,10,144,43,150,72,35
E02006023,Shropshire 003,Middle Super Output Areas and Intermediate Zones,MSOAIZ,SY,9106,3829,6584,2754,2920,1488,3664,1266,19,8,1466,628,1142,504,324,124,124,,,,841,338,750,295,23,11,65,30,3,2,43,196,101
E02006024,Shropshire 006,Middle Super Output Areas and Intermediate Zones,MSOAIZ,SY,9526,4098,6378,2723,2318,1251,4060,1472,49,28,1927,850,1394,609,533,241,241,,,,1112,454,1023,416,3,1,71,31,15,6,38,60,43
E02006025,Shropshire 007,Middle Super Output Areas and Intermediate Zones,MSOAIZ,SY,8899,4205,5817,2616,2607,1439,3210,1177,41,19,1136,592,672,341,464,251,251,,,,1795,916,1651,849,16,6,92,51,36,10,67,110,62
E02006026,Shropshire 011,Middle Super Output Areas and Intermediate Zones,MSOAIZ,SY,6809,2785,5219,2126,2292,1136,2927,990,41,16,641,280,486,217,155,63,63,,,,810,319,703,278,38,16,61,22,8,3,41,98,44
E02006027,Shropshire 012,Middle Super Output Areas and Intermediate Zones,MSOAIZ,SY,5264,2188,4261,1761,2161,1055,2100,706,31,15,384,154,246,105,138,49,49,,,,539,231,471,204,20,6,40,18,8,3,27,49,27
E02006028,Shropshire 014,Middle Super Output Areas and Intermediate Zones,MSOAIZ,SY,8967,3661,6600,2658,2935,1420,3665,1238,55,24,805,359,186,72,619,287,287,,,,1339,548,1200,486,50,22,64,31,25,9,62,168,72
E02006029,Shropshire 015,Middle Super Output Areas and Intermediate Zones,MSOAIZ,SY,8233,3316,4871,2004,1755,926,3116,1078,38,18,2593,1016,1006,396,1587,620,620,,,,654,233,574,202,19,7,46,19,15,5,31,77,45
E02006030,Shropshire 016,Middle Super Output Areas and Intermediate Zones,MSOAIZ,SY,7135,2904,4861,1988,1574,825,3287,1163,37,17,1461,573,539,201,922,372,372,,,,714,294,639,262,2,1,65,28,8,3,32,62,32
E02006031,Shropshire 017,Middle Super Output Areas and Intermediate Zones,MSOAIZ,SY,7211,3471,4306,2035,1498,865,2808,1170,68,39,1230,602,368,169,862,433,433,,,,1568,763,1448,707,7,4,98,45,15,7,56,39,32
E02006032,Shropshire 018,Middle Super Output Areas and Intermediate Zones,MSOAIZ,SY,8957,3695,5474,2238,1983,1010,3491,1228,91,48,2586,1070,937,338,1649,732,732,,,,698,280,613,247,2,2,69,28,14,3,33,108,59
E02006033,Shropshire 019,Middle Super Output Areas and Intermediate Zones,MSOAIZ,SY,7502,3889,4571,2152,2097,1184,2474,968,51,31,555,371,46,25,509,346,346,,,,2242,1281,2093,1207,34,15,69,39,46,20,74,83,54
E02006034,Shropshire 020,Middle Super Output Areas and Intermediate Zones,MSOAIZ,SY,8330,3746,6329,2765,2515,1391,3814,1374,35,17,574,318,70,48,504,270,270,,,,1328,608,1159,541,58,18,61,31,50,18,67,64,38
E02006035,Shropshire 021,Middle Super Output Areas and Intermediate Zones,MSOAIZ,SY,5648,2553,4696,2094,2399,1286,2297,808,4,4,454,226,134,54,320,172,172,,,,444,200,387,179,15,4,36,16,6,1,21,50,29
E02006036,Shropshire 022,Middle Super Output Areas and Intermediate Zones,MSOAIZ,SY,6051,2969,4327,2023,1840,1031,2487,992,11,8,567,314,90,45,477,269,269,,,,1086,585,977,527,3,2,97,50,9,6,58,60,39
E02006037,Shropshire 023,Middle Super Output Areas and Intermediate Zones,MSOAIZ,SY,9398,3999,7037,2982,3131,1633,3906,1349,14,9,1238,513,384,142,854,371,371,,,,1017,447,862,388,75,26,71,27,9,6,59,92,48
E02006038,Shropshire 024,Middle Super Output Areas and Intermediate Zones,MSOAIZ,TF,7529,3223,6035,2543,2892,1473,3143,1070,20,11,537,264,134,62,403,202,202,,,,862,361,770,324,19,5,65,27,8,5,37,75,44
E02006039,Shropshire 026,Middle Super Output Areas and Intermediate Zones,MSOAIZ,SY,7691,3239,5864,2415,2921,1433,2943,982,46,19,938,444,289,132,649,312,312,,,,742,304,588,246,13,8,108,39,33,11,58,101,57
E02006040,Shropshire 028,Middle Super Output Areas and Intermediate Zones,MSOAIZ,TF,7112,2981,5135,2118,2659,1284,2476,834,10,6,499,225,130,59,369,166,166,,,,1271,535,1174,493,41,15,45,21,11,6,42,197,97
E02006041,Shropshire 030,Middle Super Output Areas and Intermediate Zones,MSOAIZ,WV,5738,2472,3875,1673,2235,1099,1640,574,28,14,624,272,69,29,555,243,243,,,,1017,432,896,375,27,11,71,38,23,8,57,194,81
E02006042,Shropshire 032,Middle Super Output Areas and Intermediate Zones,MSOAIZ,TF,5743,2647,4333,2015,2645,1414,1688,601,56,25,643,270,34,17,609,253,253,,,,611,282,549,254,8,5,39,19,15,4,28,100,55
E02006043,Shropshire 036,Middle Super Output Areas and Intermediate Zones,MSOAIZ,WV,6819,2946,4182,1817,2401,1169,1781,648,63,33,879,357,67,31,812,326,326,,,,1443,622,1270,556,107,36,57,26,9,4,66,252,117
E02006044,Shropshire 037,Middle Super Output Areas and Intermediate Zones,MSOAIZ,SY,6141,2750,4486,2019,2934,1464,1552,555,51,20,476,195,41,21,435,174,174,,,,933,429,847,390,28,12,50,24,8,3,39,195,87
E02006045,Shropshire 038,Middle Super Output Areas and Intermediate Zones,MSOAIZ,SY,10798,5173,7076,3349,3881,2196,3195,1153,193,87,1977,922,191,84,1786,838,838,,,,1460,753,1294,679,19,6,130,58,17,10,74,92,62
E02006046,Shropshire 039,Middle Super Output Areas and Intermediate Zones,MSOAIZ,WR,8799,3694,6583,2764,3515,1724,3068,1040,70,31,1014,388,94,33,920,355,355,,,,999,449,883,400,19,6,79,34,18,9,49,133,62
E02006047,Mendip 001,Middle Super Output Areas and Intermediate Zones,MSOAIZ,BA,8163,3418,6144,2531,2781,1367,3363,1164,10,4,638,264,241,89,397,175,175,,,,1194,533,1060,468,40,18,81,40,13,7,65,177,86
E02006048,Mendip 002,Middle Super Output Areas and Intermediate Zones,MSOAIZ,BA,6564,2714,4819,1921,2108,1017,2711,904,15,10,907,399,225,88,682,311,311,,,,738,335,641,285,27,13,58,30,12,7,50,85,49
E02006049,Mendip 003,Middle Super Output Areas and Intermediate Zones,MSOAIZ,BA,7323,3167,6251,2732,2636,1410,3615,1322,20,9,91,30,19,8,72,22,22,,,,945,385,857,343,5,2,82,39,1,1,42,16,11
E02006050,Mendip 004,Middle Super Output Areas and Intermediate Zones,MSOAIZ,BA,8105,3613,4616,1959,1676,881,2940,1078,68,31,1900,873,430,193,1470,680,680,,,,1464,716,1362,667,9,3,84,40,9,6,49,57,34
E02006051,Mendip 005,Middle Super Output Areas and Intermediate Zones,MSOAIZ,BS,7308,3099,5695,2413,2991,1505,2704,908,16,8,640,254,105,41,535,213,213,,,,743,328,630,282,18,8,81,32,14,6,46,214,96
E02006052,Mendip 006,Middle Super Output Areas and Intermediate Zones,MSOAIZ,BS,7422,3187,5734,2404,2474,1270,3260,1134,16,9,434,189,126,54,308,135,135,,,,1140,532,1022,478,34,13,61,30,23,11,54,98,53
E02006053,Mendip 007,Middle Super Output Areas and Intermediate Zones,MSOAIZ,BA,9053,3848,6263,2618,2343,1216,3920,1402,95,37,1363,602,572,226,791,376,376,,,,1279,552,1204,514,11,3,62,33,2,2,38,53,39
E02006054,Mendip 008,Middle Super Output Areas and Intermediate Zones,MSOAIZ,BA,7543,3699,5232,2506,2732,1590,2500,916,102,45,829,478,208,110,621,368,368,,,,1314,625,1205,570,15,7,86,42,8,6,55,66,45
E02006055,Mendip 009,Middle Super Output Areas and Intermediate Zones,MSOAIZ,BA,8708,3744,5502,2310,1939,1014,3563,1296,174,69,1360,582,309,123,1051,459,459,,,,1595,744,1482,692,8,4,98,45,7,3,52,77,39
E02006056,Mendip 010,Middle Super Output Areas and Intermediate Zones,MSOAIZ,BA,7200,3068,5400,2284,2429,1219,2971,1065,28,11,705,295,184,74,521,221,221,,,,918,402,786,344,41,16,88,40,3,2,58,149,76
E02006057,Mendip 011,Middle Super Output Areas and Intermediate Zones,MSOAIZ,BA,7152,3410,4692,2160,2336,1279,2356,881,87,48,1047,506,221,102,826,404,404,,,,1213,638,1067,571,14,6,112,52,20,9,67,113,58
E02006058,Mendip 012,Middle Super Output Areas and Intermediate Zones,MSOAIZ,BS,7540,3085,6097,2486,2744,1347,3353,1139,33,16,436,176,103,38,333,138,138,,,,896,367,807,332,12,4,76,30,1,1,35,78,40
E02006059,Mendip 013,Middle Super Output Areas and Intermediate Zones,MSOAIZ,TA,6408,2673,5055,2105,2668,1288,2387,817,23,11,321,137,71,31,250,106,106,,,,792,327,698,291,49,17,37,16,8,3,36,217,93
E02006060,Mendip 014,Middle Super Output Areas and Intermediate Zones,MSOAIZ,BA,7542,3432,4668,2009,1765,984,2903,1025,83,41,1332,688,278,143,1054,545,545,,,,1387,652,1300,612,2,1,76,34,9,5,40,72,42
E02006061,Sedgemoor 001,Middle Super Output Areas and Intermediate Zones,MSOAIZ,BS,8753,3791,6942,2915,2967,1560,3975,1355,47,24,668,328,416,215,252,113,113,,,,1005,472,906,419,23,10,63,36,13,7,53,91,52
E02006062,Sedgemoor 002,Middle Super Output Areas and Intermediate Zones,MSOAIZ,TA,10435,4423,8662,3660,4074,2093,4588,1567,71,32,510,213,211,85,299,128,128,,,,1093,466,950,407,42,14,90,41,11,4,59,99,52
E02006063,Sedgemoor 003,Middle Super Output Areas and Intermediate Zones,MSOAIZ,TA,6939,2748,6064,2364,2804,1353,3260,1011,24,10,257,111,180,81,77,30,30,,,,525,223,436,187,1,1,73,31,15,4,36,69,40
E02006064,Sedgemoor 004,Middle Super Output Areas and Intermediate Zones,MSOAIZ,TA,7489,3740,5480,2618,2637,1551,2843,1067,12,6,426,295,213,155,213,140,140,,,,1502,774,1394,718,13,6,89,44,6,6,56,69,47
E02006065,Sedgemoor 005,Middle Super Output Areas and Intermediate Zones,MSOAIZ,TA,8421,3743,5369,2334,2194,1202,3175,1132,96,44,1614,756,922,440,692,316,316,,,,1289,571,1161,517,22,6,99,45,7,3,54,53,38
E02006066,Sedgemoor 006,Middle Super Output Areas and Intermediate Zones,MSOAIZ,TA,7669,3309,6115,2654,2834,1484,3281,1170,92,42,826,346,572,258,254,88,88,,,,560,230,464,197,15,6,75,23,6,4,33,76,37
E02006067,Sedgemoor 007,Middle Super Output Areas and Intermediate Zones,MSOAIZ,TA,6819,2972,5274,2289,2697,1373,2577,916,32,16,590,273,402,196,188,77,77,,,,780,317,622,255,41,14,100,40,17,8,62,143,77
E02006068,Sedgemoor 008,Middle Super Output Areas and Intermediate Zones,MSOAIZ,TA,7518,3092,3462,1504,1221,670,2241,834,2,2,2638,1000,1918,724,720,276,276,,,,1333,542,1203,484,4,2,111,50,15,6,58,83,44
E02006069,Sedgemoor 009,Middle Super Output Areas and Intermediate Zones,MSOAIZ,TA,9655,4435,5096,2295,1667,966,3429,1329,30,15,1563,706,671,298,892,408,408,,,,2869,1355,2656,1260,19,8,161,71,33,16,95,97,64
E02006070,Sedgemoor 010,Middle Super Output Areas and Intermediate Zones,MSOAIZ,TA,6772,2955,5148,2259,1825,998,3323,1261,53,19,278,114,181,74,97,40,40,,,,1261,546,1138,490,11,8,105,44,7,4,56,32,17
E02006071,Sedgemoor 011,Middle Super Output Areas and Intermediate Zones,MSOAIZ,TA,8312,3408,6681,2734,2704,1409,3977,1325,6,2,306,160,119,76,187,84,84,,,,1272,484,1177,444,13,4,73,33,9,3,40,47,28
E02006072,Sedgemoor 012,Middle Super Output Areas and Intermediate Zones,MSOAIZ,TA,9033,3758,7505,3131,3700,1830,3805,1301,50,20,556,219,333,142,223,77,77,,,,798,331,702,289,11,5,69,31,16,6,42,124,57
E02006073,Sedgemoor 013,Middle Super Output Areas and Intermediate Zones,MSOAIZ,TA,6905,2960,3452,1423,1104,591,2348,832,12,6,2376,1043,1506,730,870,313,313,,,,990,435,891,388,11,5,81,39,7,3,47,75,53
E02006074,Sedgemoor 014,Middle Super Output Areas and Intermediate Zones,MSOAIZ,TA,8336,3467,6304,2622,2397,1240,3907,1382,79,35,992,387,429,196,563,191,191,,,,858,367,778,325,5,4,54,28,21,10,42,103,56
E02006075,South Somerset 001,Middle Super Output Areas and Intermediate Zones,MSOAIZ,BA,4844,2099,3450,1479,1766,884,1684,595,26,12,454,208,132,46,322,162,162,,,,716,307,601,262,46,13,62,27,7,5,45,198,93
E02006076,South Somerset 002,Middle Super Output Areas and Intermediate Zones,MSOAIZ,TA,8341,3660,6185,2699,3079,1602,3106,1097,93,38,850,366,221,86,629,280,280,,,,1050,474,858,393,51,18,119,51,22,12,81,163,83
E02006077,South Somerset 003,Middle Super Output Areas and Intermediate Zones,MSOAIZ,TA,5354,2444,3933,1799,2016,1104,1917,695,19,11,677,306,178,86,499,220,220,,,,633,282,570,255,6,2,41,20,16,5,27,92,46
E02006078,South Somerset 004,Middle Super Output Areas and Intermediate Zones,MSOAIZ,TA,5572,2410,4192,1813,2019,1056,2173,757,50,21,565,242,168,66,397,176,176,,,,678,294,598,259,15,5,59,27,6,3,35,87,40
E02006079,South Somerset 005,Middle Super Output Areas and Intermediate Zones,MSOAIZ,DT,6925,3114,4757,2160,2239,1222,2518,938,14,7,856,384,248,102,608,282,282,,,,1177,498,1049,444,25,9,85,38,18,7,54,121,65
E02006080,South Somerset 006,Middle Super Output Areas and Intermediate Zones,MSOAIZ,DT,5909,2502,3808,1645,1716,895,2092,750,15,6,620,279,141,61,479,218,218,,,,1363,525,620,278,448,146,57,22,238,79,247,103,47
E02006081,South Somerset 007,Middle Super Output Areas and Intermediate Zones,MSOAIZ,TA,5278,2253,4132,1749,2033,1041,2099,708,34,13,542,232,151,52,391,180,180,,,,459,202,415,180,11,5,17,10,16,7,22,111,57
E02006082,South Somerset 008,Middle Super Output Areas and Intermediate Zones,MSOAIZ,DT,6450,2840,4556,2010,2107,1115,2449,895,65,30,1050,426,233,85,817,341,341,,,,703,331,600,288,8,3,69,31,26,9,43,76,43
E02006083,South Somerset 009,Middle Super Output Areas and Intermediate Zones,MSOAIZ,TA,5677,2504,4177,1812,1796,959,2381,853,63,22,760,344,272,109,488,235,235,,,,613,287,530,250,18,6,56,26,9,5,37,64,39
E02006084,South Somerset 010,Middle Super Output Areas and Intermediate Zones,MSOAIZ,TA,7044,3165,5287,2374,2673,1428,2614,946,50,23,917,382,212,88,705,294,294,,,,681,325,579,272,26,9,67,39,9,5,53,109,61
E02006085,South Somerset 011,Middle Super Output Areas and Intermediate Zones,MSOAIZ,BA,5875,2549,4270,1873,1695,929,2575,944,50,23,796,351,305,126,491,225,225,,,,732,284,499,206,126,41,43,17,64,20,78,27,18
E02006086,South Somerset 012,Middle Super Output Areas and Intermediate Zones,MSOAIZ,BA,6764,2706,5163,2061,1767,919,3396,1142,32,19,663,257,243,89,420,168,168,,,,858,345,667,272,106,27,43,23,42,23,73,48,24
E02006087,South Somerset 013,Middle Super Output Areas and Intermediate Zones,MSOAIZ,BA,6057,2640,3194,1460,1018,596,2176,864,118,55,1508,588,553,207,955,381,381,,,,1206,518,850,398,161,48,82,34,113,38,120,31,19
E02006088,South Somerset 014,Middle Super Output Areas and Intermediate Zones,MSOAIZ,BA,7330,3149,3894,1675,1436,782,2458,893,82,40,2433,1028,1040,393,1393,635,635,,,,849,362,734,317,38,14,59,25,18,6,45,72,44
E02006089,South Somerset 015,Middle Super Output Areas and Intermediate Zones,MSOAIZ,BA,6203,2939,3375,1589,1222,732,2153,857,11,5,909,474,244,121,665,353,353,,,,1849,836,1715,770,22,9,100,48,12,9,66,59,35
E02006090,South Somerset 016,Middle Super Output Areas and Intermediate Zones,MSOAIZ,BA,6838,2985,4781,2043,1718,939,3063,1104,69,29,876,403,246,111,630,292,292,,,,1046,468,959,430,4,1,78,34,5,3,38,66,42
E02006091,South Somerset 017,Middle Super Output Areas and Intermediate Zones,MSOAIZ,TA,9715,4254,7098,3082,3459,1793,3639,1289,82,32,1434,614,474,191,960,423,423,,,,905,432,756,368,27,10,96,42,26,12,64,196,94
E02006092,South Somerset 018,Middle Super Output Areas and Intermediate Zones,MSOAIZ,BA,6103,2659,5132,2222,2060,1106,3072,1116,44,16,256,120,74,29,182,91,91,,,,646,288,586,262,5,2,49,21,6,3,26,25,13
E02006093,South Somerset 019,Middle Super Output Areas and Intermediate Zones,MSOAIZ,TA,8331,3747,6012,2685,2764,1533,3248,1152,33,22,1057,494,301,121,756,373,373,,,,1135,496,999,438,12,5,99,43,25,10,58,94,50
E02006094,South Somerset 020,Middle Super Output Areas and Intermediate Zones,MSOAIZ,TA,5300,2357,3952,1740,1997,1036,1955,704,10,3,739,332,240,106,499,226,226,,,,525,244,467,218,12,5,41,19,5,2,26,74,38
E02006095,South Somerset 021,Middle Super Output Areas and Intermediate Zones,MSOAIZ,TA,7782,3585,5627,2555,2527,1415,3100,1140,66,33,991,474,310,129,681,345,345,,,,1027,478,957,444,1,1,63,31,6,2,34,71,45
E02006096,South Somerset 022,Middle Super Output Areas and Intermediate Zones,MSOAIZ,TA,6650,2849,4840,2089,1975,1062,2865,1027,95,41,966,411,236,107,730,304,304,,,,706,280,611,243,11,2,76,32,8,3,37,43,28
E02006097,South Somerset 023,Middle Super Output Areas and Intermediate Zones,MSOAIZ,TA,6283,2933,3757,1743,1722,992,2035,751,80,30,1514,736,507,230,1007,506,506,,,,882,393,821,359,4,2,54,29,3,3,34,50,31
E02006098,South Somerset 024,Middle Super Output Areas and Intermediate Zones,MSOAIZ,TA,7278,3158,5815,2498,3181,1578,2634,920,20,11,548,246,159,70,389,176,176,,,,749,323,628,275,38,15,82,32,1,1,48,146,80
E02006099,Taunton Deane 001,Middle Super Output Areas and Intermediate Zones,MSOAIZ,TA,6765,2736,4964,1998,1804,917,3160,1081,42,15,623,257,382,172,241,85,85,,,,1049,423,959,385,12,4,73,30,5,4,38,87,43
E02006100,Taunton Deane 002,Middle Super Output Areas and Intermediate Zones,MSOAIZ,TA,6994,2955,5054,2104,2098,1082,2956,1022,12,6,730,337,451,215,279,122,122,,,,1106,465,993,417,18,5,61,30,34,13,48,92,43
E02006101,Taunton Deane 003,Middle Super Output Areas and Intermediate Zones,MSOAIZ,TA,5519,2420,4046,1735,2018,1031,2028,704,43,21,656,294,542,245,114,49,49,,,,695,324,615,285,19,8,54,27,7,4,39,79,46
E02006102,Taunton Deane 004,Middle Super Output Areas and Intermediate Zones,MSOAIZ,TA,7125,3083,3601,1521,1297,704,2304,817,32,12,2822,1264,2392,1104,430,160,160,,,,592,230,541,207,1,1,46,18,4,4,23,78,56
E02006103,Taunton Deane 005,Middle Super Output Areas and Intermediate Zones,MSOAIZ,TA,7164,3079,5870,2503,2809,1482,3061,1021,73,31,515,222,403,179,112,43,43,,,,649,288,567,254,10,4,53,22,19,8,34,57,35
E02006104,Taunton Deane 006,Middle Super Output Areas and Intermediate Zones,MSOAIZ,TA,7452,3264,5363,2289,1809,988,3554,1301,19,9,798,375,707,331,91,44,44,,,,1208,554,1132,516,1,1,58,29,17,8,38,64,37
E02006105,Taunton Deane 007,Middle Super Output Areas and Intermediate Zones,MSOAIZ,TA,10173,4680,5918,2719,2092,1217,3826,1502,60,29,626,300,237,139,389,161,161,,,,3470,1568,3228,1470,26,8,201,86,15,4,98,99,64
E02006106,Taunton Deane 008,Middle Super Output Areas and Intermediate Zones,MSOAIZ,TA,6900,2991,4631,2004,1744,922,2887,1082,29,11,1318,607,974,442,344,165,165,,,,885,345,649,265,107,32,42,23,87,25,80,37,24
E02006107,Taunton Deane 009,Middle Super Output Areas and Intermediate Zones,MSOAIZ,TA,8064,3458,3478,1490,1146,621,2332,869,40,15,3755,1603,3061,1298,694,305,305,,,,682,289,617,261,11,4,51,22,3,2,28,109,61
E02006108,Taunton Deane 010,Middle Super Output Areas and Intermediate Zones,MSOAIZ,TA,7898,4029,4664,2320,2411,1434,2253,886,43,29,905,585,380,245,525,340,340,,,,2152,1017,1877,906,101,34,95,50,79,27,111,134,78
E02006109,Taunton Deane 011,Middle Super Output Areas and Intermediate Zones,MSOAIZ,TA,7717,3355,6522,2857,3207,1761,3315,1096,25,13,167,78,127,61,40,17,17,,,,924,361,827,324,30,9,63,26,4,2,37,79,46
E02006110,Taunton Deane 012,Middle Super Output Areas and Intermediate Zones,MSOAIZ,TA,7730,3441,4496,1982,1433,828,3063,1154,22,12,2022,904,1350,645,672,259,259,,,,1119,491,1032,452,10,3,65,31,12,5,39,71,52
E02006111,Taunton Deane 013,Middle Super Output Areas and Intermediate Zones,MSOAIZ,TA,10116,4322,7935,3423,3806,1979,4129,1444,74,33,830,310,521,218,309,92,92,,,,1111,479,977,417,17,8,106,48,11,6,62,166,77
E02006112,Taunton Deane 014,Middle Super Output Areas and Intermediate Zones,MSOAIZ,TA,7235,3094,5843,2448,2696,1363,3147,1085,28,15,322,185,256,145,66,40,40,,,,915,393,807,347,14,5,33,16,61,25,46,127,53
E02006113,West Somerset 001,Middle Super Output Areas and Intermediate Zones,MSOAIZ,TA,6927,3340,4776,2285,2503,1458,2273,827,31,19,450,256,41,24,409,232,232,,,,1568,728,1397,655,28,9,134,60,9,4,73,102,52
E02006114,West Somerset 002,Middle Super Output Areas and Intermediate Zones,MSOAIZ,TA,5933,2887,3577,1831,2366,1359,1211,472,33,16,1301,583,74,36,1227,547,547,,,,928,410,793,352,19,7,64,26,52,25,58,94,47
E02006115,West Somerset 003,Middle Super Output Areas and Intermediate Zones,MSOAIZ,TA,7154,3254,4335,2010,2238,1237,2097,773,39,17,1767,762,138,65,1629,697,697,,,,916,413,765,357,43,12,65,27,43,17,56,97,52
E02006116,West Somerset 004,Middle Super Output Areas and Intermediate Zones,MSOAIZ,TA,7805,3519,5558,2542,3246,1708,2312,834,31,14,661,281,53,22,608,259,259,,,,1364,592,1206,523,43,18,96,40,19,11,69,191,90
E02006117,West Somerset 005,Middle Super Output Areas and Intermediate Zones,MSOAIZ,TA,5463,2623,3646,1753,2374,1262,1272,491,12,6,876,406,76,34,800,372,372,,,,765,367,622,302,59,23,64,30,20,12,65,164,91
E02006118,Cannock Chase 001,Middle Super Output Areas and Intermediate Zones,MSOAIZ,WS,7338,3032,6487,2668,2706,1387,3781,1281,37,11,110,55,87,39,23,16,16,,,,656,271,587,242,11,5,50,21,8,3,29,48,27
E02006119,Cannock Chase 002,Middle Super Output Areas and Intermediate Zones,MSOAIZ,WS,8152,3481,5295,2111,1679,877,3616,1234,30,16,1518,747,1154,519,364,228,228,,,,1243,563,1150,518,14,6,71,33,8,6,45,66,44
E02006120,Cannock Chase 003,Middle Super Output Areas and Intermediate Zones,MSOAIZ,WS,8857,3698,6355,2634,2311,1219,4044,1415,47,20,1243,522,827,372,416,150,150,,,,1162,499,1089,464,2,1,67,31,4,3,35,50,23
E02006121,Cannock Chase 004,Middle Super Output Areas and Intermediate Zones,MSOAIZ,WS,5546,2293,3864,1551,1254,621,2610,930,4,2,1005,473,870,404,135,69,69,,,,624,234,560,213,0,0,56,18,8,3,21,49,33
E02006122,Cannock Chase 005,Middle Super Output Areas and Intermediate Zones,MSOAIZ,WS,6492,2839,4645,1919,1652,840,2993,1079,23,12,765,387,682,347,83,40,40,,,,1011,485,917,442,10,3,77,37,7,3,43,48,36
E02006123,Cannock Chase 006,Middle Super Output Areas and Intermediate Zones,MSOAIZ,WS,6643,2616,5166,1951,1547,710,3619,1241,14,6,884,377,681,316,203,61,61,,,,537,253,491,230,0,0,41,21,5,2,23,42,29
E02006124,Cannock Chase 007,Middle Super Output Areas and Intermediate Zones,MSOAIZ,WS,7272,2992,3857,1572,1402,723,2455,849,94,41,2452,1036,1698,790,754,246,246,,,,781,282,711,249,5,3,51,25,14,5,33,88,61
E02006125,Cannock Chase 008,Middle Super Output Areas and Intermediate Zones,MSOAIZ,WS,7331,3248,4581,1927,1825,894,2756,1033,29,14,1743,853,1544,766,199,87,87,,,,910,413,855,386,7,3,46,23,2,1,27,68,41
E02006126,Cannock Chase 009,Middle Super Output Areas and Intermediate Zones,MSOAIZ,WS,8227,3372,6629,2598,2089,1057,4540,1541,19,11,615,328,523,296,92,32,32,,,,897,395,804,352,2,1,88,39,3,3,43,67,40
E02006127,Cannock Chase 010,Middle Super Output Areas and Intermediate Zones,MSOAIZ,WS,7514,2797,6214,2269,1176,537,5038,1732,51,30,449,134,45,12,404,122,122,,,,771,353,713,326,6,2,52,25,0,0,27,29,11
E02006128,Cannock Chase 011,Middle Super Output Areas and Intermediate Zones,MSOAIZ,WS,8361,3745,6553,2816,3112,1628,3441,1188,13,8,867,459,436,237,431,222,222,,,,835,408,771,371,9,6,52,29,3,2,37,93,54
E02006129,Cannock Chase 012,Middle Super Output Areas and Intermediate Zones,MSOAIZ,WS,7585,3461,4146,1795,1522,813,2624,982,91,68,2230,1038,1601,775,629,263,263,,,,1030,503,932,457,16,6,67,33,15,7,46,88,57
E02006130,Cannock Chase 013,Middle Super Output Areas and Intermediate Zones,MSOAIZ,WS,7473,3090,5715,2295,2212,1082,3503,1213,11,9,1041,471,903,418,138,53,53,,,,646,279,601,259,2,1,35,16,8,3,20,60,36
E02006131,East Staffordshire 001,Middle Super Output Areas and Intermediate Zones,MSOAIZ,ST,7569,3152,5849,2403,2782,1350,3067,1053,66,28,651,283,176,71,475,212,212,,,,817,352,739,313,24,11,44,23,10,5,39,186,86
E02006132,East Staffordshire 002,Middle Super Output Areas and Intermediate Zones,MSOAIZ,ST,6157,2535,4508,1849,1854,953,2654,896,94,49,1130,455,434,171,696,284,284,,,,383,159,332,134,4,4,39,18,8,3,25,42,23
E02006133,East Staffordshire 003,Middle Super Output Areas and Intermediate Zones,MSOAIZ,ST,6742,2942,5075,2104,1774,939,3301,1165,21,13,589,326,220,121,369,205,205,,,,1011,471,914,421,31,14,62,33,4,3,50,46,28
E02006134,East Staffordshire 004,Middle Super Output Areas and Intermediate Zones,MSOAIZ,DE,9138,3951,7553,3185,3386,1750,4167,1435,30,13,789,378,235,109,554,269,269,,,,675,313,604,279,27,12,34,18,10,4,34,91,62
E02006135,East Staffordshire 005,Middle Super Output Areas and Intermediate Zones,MSOAIZ,DE,7817,3285,6960,2879,2737,1447,4223,1432,5,4,205,113,56,28,149,85,85,,,,608,263,569,245,8,3,30,14,1,1,18,39,26
E02006136,East Staffordshire 006,Middle Super Output Areas and Intermediate Zones,MSOAIZ,WS,7624,3208,6347,2625,3131,1510,3216,1115,17,8,401,194,96,47,305,147,147,,,,739,319,602,257,28,9,52,30,57,23,62,120,62
E02006137,East Staffordshire 007,Middle Super Output Areas and Intermediate Zones,MSOAIZ,DE,8643,3673,5476,2260,2049,1079,3427,1181,83,40,1637,793,605,286,1032,507,507,,,,1382,539,1256,494,41,13,81,30,4,2,45,65,41
E02006138,East Staffordshire 008,Middle Super Output Areas and Intermediate Zones,MSOAIZ,DE,6179,2502,3660,1404,1332,602,2328,802,27,10,938,459,367,166,571,293,293,,,,1486,605,1352,550,0,0,121,48,13,7,55,68,24
E02006139,East Staffordshire 009,Middle Super Output Areas and Intermediate Zones,MSOAIZ,DE,7006,2931,4013,1472,1762,746,2251,726,71,32,922,487,297,124,625,363,363,,,,1913,896,1771,838,26,9,99,41,17,8,58,87,44
E02006140,East Staffordshire 010,Middle Super Output Areas and Intermediate Zones,MSOAIZ,DE,8327,3430,5322,2220,2197,1134,3125,1086,31,13,2041,811,695,261,1346,550,550,,,,859,352,759,318,3,1,90,30,7,3,34,74,34
E02006141,East Staffordshire 011,Middle Super Output Areas and Intermediate Zones,MSOAIZ,DE,10222,4377,5415,2109,2112,952,3303,1157,60,32,1035,563,194,88,841,475,475,,,,3590,1612,3367,1518,13,7,172,71,38,16,94,122,61
E02006142,East Staffordshire 012,Middle Super Output Areas and Intermediate Zones,MSOAIZ,DE,5339,2211,4829,2003,1780,925,3049,1078,8,5,61,26,6,5,55,21,21,,,,408,160,366,140,4,1,38,19,0,0,20,33,17
E02006143,East Staffordshire 013,Middle Super Output Areas and Intermediate Zones,MSOAIZ,DE,7206,3033,5730,2360,2067,1061,3663,1299,8,5,407,188,146,64,261,124,124,,,,1019,459,931,421,7,3,70,31,11,4,38,42,21
E02006144,East Staffordshire 014,Middle Super Output Areas and Intermediate Zones,MSOAIZ,DE,7929,3636,4505,2005,1814,984,2691,1021,6,4,2378,1174,881,411,1497,763,763,,,,959,406,882,371,6,3,67,31,4,1,35,81,47
E02006145,East Staffordshire 015,Middle Super Output Areas and Intermediate Zones,MSOAIZ,DE,5590,2385,4739,2001,2185,1142,2554,859,7,4,245,117,75,32,170,85,85,,,,574,246,518,220,12,4,28,15,16,7,26,25,17
E02006146,Lichfield 001,Middle Super Output Areas and Intermediate Zones,MSOAIZ,WS,6987,2896,5573,2266,2261,1112,3312,1154,29,16,713,300,69,37,644,263,263,,,,639,291,585,264,3,2,44,21,7,4,27,33,23
E02006147,Lichfield 002,Middle Super Output Areas and Intermediate Zones,MSOAIZ,WS,7570,3000,6158,2419,2319,1135,3839,1284,47,23,696,269,77,37,619,232,232,,,,621,257,521,215,20,8,60,26,20,8,42,48,32
E02006148,Lichfield 003,Middle Super Output Areas and Intermediate Zones,MSOAIZ,WS,7245,2945,6342,2550,2774,1332,3568,1218,9,5,423,167,37,14,386,153,153,,,,415,195,358,169,12,4,42,20,3,2,26,56,28
E02006149,Lichfield 004,Middle Super Output Areas and Intermediate Zones,MSOAIZ,WS,10355,4590,4898,2127,1841,1023,3057,1104,77,57,3933,1692,506,204,3427,1488,1488,,,,1305,632,1195,576,21,8,68,35,21,13,56,142,82
E02006150,Lichfield 005,Middle Super Output Areas and Intermediate Zones,MSOAIZ,WS,11522,4902,9685,4043,4390,2186,5295,1857,57,34,787,362,75,32,712,330,330,,,,909,415,832,386,18,6,49,20,10,3,29,84,48
E02006151,Lichfield 006,Middle Super Output Areas and Intermediate Zones,MSOAIZ,WS,8721,3693,6579,2710,2440,1290,4139,1420,66,35,1269,574,135,73,1134,501,501,,,,737,341,666,310,5,2,64,27,2,2,31,70,33
E02006152,Lichfield 007,Middle Super Output Areas and Intermediate Zones,MSOAIZ,WS,10060,4268,7786,3249,2969,1548,4817,1701,58,31,1104,448,139,55,965,393,393,,,,1054,506,970,467,15,6,53,27,16,6,39,58,34
E02006153,Lichfield 008,Middle Super Output Areas and Intermediate Zones,MSOAIZ,WS,6914,2767,5458,2181,2434,1158,3024,1023,25,8,521,209,43,19,478,190,190,,,,823,329,595,244,103,38,39,17,86,30,85,87,40
E02006154,Lichfield 009,Middle Super Output Areas and Intermediate Zones,MSOAIZ,WS,9749,4115,8720,3664,4109,2077,4611,1587,40,17,354,152,38,17,316,135,135,,,,593,254,521,222,9,3,60,28,3,1,32,42,28
E02006155,Lichfield 010,Middle Super Output Areas and Intermediate Zones,MSOAIZ,WS,5694,2315,3454,1418,1132,595,2322,823,14,8,1583,633,214,87,1369,546,546,,,,570,224,504,199,15,5,47,18,4,2,25,73,32
E02006156,Lichfield 011,Middle Super Output Areas and Intermediate Zones,MSOAIZ,WS,7602,3046,6751,2683,3251,1549,3500,1134,10,4,383,159,54,19,329,140,140,,,,398,172,345,149,17,6,22,11,14,6,23,60,28
E02006157,Lichfield 012,Middle Super Output Areas and Intermediate Zones,MSOAIZ,WS,6474,2687,4512,1845,1875,943,2637,902,8,4,1187,481,118,54,1069,427,427,,,,680,316,585,274,35,13,51,25,9,4,42,87,41
E02006158,Newcastle-under-Lyme 001,Middle Super Output Areas and Intermediate Zones,MSOAIZ,ST,8486,3543,7746,3200,3075,1566,4671,1634,12,5,204,97,54,26,150,71,71,,,,476,217,401,182,2,1,67,29,6,5,35,48,24
E02006159,Newcastle-under-Lyme 002,Middle Super Output Areas and Intermediate Zones,MSOAIZ,ST,5741,2480,3694,1567,1525,784,2169,783,20,9,1040,498,325,145,715,353,353,,,,939,374,903,355,1,1,31,14,4,4,19,48,32
E02006160,Newcastle-under-Lyme 003,Middle Super Output Areas and Intermediate Zones,MSOAIZ,ST,8251,3588,5276,2292,2194,1172,3082,1120,11,9,2231,952,793,328,1438,624,624,,,,653,289,591,258,0,0,49,23,13,8,31,80,46
E02006161,Newcastle-under-Lyme 004,Middle Super Output Areas and Intermediate Zones,MSOAIZ,ST,7000,2783,6101,2427,2152,1075,3949,1352,4,3,333,135,129,47,204,88,88,,,,506,189,445,162,0,0,51,23,10,4,27,56,29
E02006162,Newcastle-under-Lyme 005,Middle Super Output Areas and Intermediate Zones,MSOAIZ,ST,8400,3678,6422,2758,2817,1447,3605,1311,35,16,1204,558,431,205,773,353,353,,,,681,304,613,268,7,3,52,27,9,6,36,58,42
E02006163,Newcastle-under-Lyme 006,Middle Super Output Areas and Intermediate Zones,MSOAIZ,ST,7864,3226,5146,2098,1925,996,3221,1102,7,5,2069,866,899,391,1170,475,475,,,,572,214,495,185,0,0,67,25,10,4,29,70,43
E02006164,Newcastle-under-Lyme 007,Middle Super Output Areas and Intermediate Zones,MSOAIZ,ST,7340,3179,3770,1596,1357,700,2413,896,17,9,2540,1122,1002,454,1538,668,668,,,,943,400,874,372,2,1,36,15,31,12,28,70,52
E02006165,Newcastle-under-Lyme 008,Middle Super Output Areas and Intermediate Zones,MSOAIZ,ST,7354,3448,5274,2330,1938,1031,3336,1299,53,25,857,534,215,138,642,396,396,,,,1103,517,996,473,9,2,93,40,5,2,44,67,42
E02006166,Newcastle-under-Lyme 009,Middle Super Output Areas and Intermediate Zones,MSOAIZ,ST,7090,3103,6153,2634,2458,1297,3695,1337,12,6,176,105,34,15,142,90,90,,,,705,336,634,300,0,0,64,33,7,3,36,44,22
E02006167,Newcastle-under-Lyme 010,Middle Super Output Areas and Intermediate Zones,MSOAIZ,ST,8695,3942,3986,1715,1543,817,2443,898,73,52,3578,1739,1427,688,2151,1051,1051,,,,948,370,831,323,10,3,83,34,24,10,47,110,66
E02006168,Newcastle-under-Lyme 011,Middle Super Output Areas and Intermediate Zones,MSOAIZ,ST,8230,4189,3954,1835,1709,943,2245,892,31,14,1889,1252,593,367,1296,885,885,,,,2255,1018,2116,952,11,5,93,46,35,15,66,101,70
E02006169,Newcastle-under-Lyme 012,Middle Super Output Areas and Intermediate Zones,MSOAIZ,ST,4837,2167,3089,1346,1421,750,1668,596,24,7,937,480,276,134,661,346,346,,,,726,303,589,235,48,19,45,23,44,26,68,61,31
E02006170,Newcastle-under-Lyme 013,Middle Super Output Areas and Intermediate Zones,MSOAIZ,ST,5083,2236,4006,1725,1820,941,2186,784,10,5,499,240,131,65,368,175,175,,,,522,238,480,218,3,1,34,16,5,3,20,46,28
E02006171,Newcastle-under-Lyme 014,Middle Super Output Areas and Intermediate Zones,MSOAIZ,ST,8904,4000,6454,2803,2872,1547,3582,1256,21,12,1647,856,594,301,1053,555,555,,,,701,280,612,242,0,0,62,29,27,9,38,81,49
E02006172,Newcastle-under-Lyme 015,Middle Super Output Areas and Intermediate Zones,MSOAIZ,ST,9519,4171,8368,3617,3939,2066,4429,1551,66,43,461,251,140,59,321,192,192,,,,537,217,475,193,11,3,43,19,8,2,24,87,43
E02006173,Newcastle-under-Lyme 016,Middle Super Output Areas and Intermediate Zones,MSOAIZ,TF,6914,2841,5848,2389,2824,1363,3024,1026,9,6,365,155,96,36,269,119,119,,,,604,245,519,214,35,10,38,14,12,7,31,88,46
E02006174,South Staffordshire 001,Middle Super Output Areas and Intermediate Zones,MSOAIZ,WV,10294,4264,8173,3283,3638,1784,4535,1499,10,5,937,466,123,65,814,401,401,,,,1046,438,966,400,22,9,54,26,4,3,38,128,72
E02006175,South Staffordshire 002,Middle Super Output Areas and Intermediate Zones,MSOAIZ,WV,6571,2641,4561,1802,1529,742,3032,1060,138,77,1269,514,137,60,1132,454,454,,,,545,220,474,186,11,7,49,23,11,4,34,58,28
E02006176,South Staffordshire 003,Middle Super Output Areas and Intermediate Zones,MSOAIZ,WV,7289,3146,5367,2258,2653,1336,2714,922,32,18,714,348,15,8,699,340,340,,,,1022,442,913,401,45,17,36,15,28,9,41,154,80
E02006177,South Staffordshire 004,Middle Super Output Areas and Intermediate Zones,MSOAIZ,WS,9794,3968,8252,3239,3494,1661,4758,1578,27,18,889,442,75,45,814,397,397,,,,585,242,498,208,8,2,72,28,7,4,34,41,27
E02006178,South Staffordshire 005,Middle Super Output Areas and Intermediate Zones,MSOAIZ,WS,7820,3198,5845,2312,2375,1142,3470,1170,5,3,1339,627,131,70,1208,557,557,,,,570,217,497,190,4,1,67,25,2,1,27,61,39
E02006179,South Staffordshire 006,Middle Super Output Areas and Intermediate Zones,MSOAIZ,WV,6544,2787,5576,2303,2294,1193,3282,1110,18,11,468,241,47,22,421,219,219,,,,426,197,373,174,17,6,29,12,7,5,23,56,35
E02006180,South Staffordshire 007,Middle Super Output Areas and Intermediate Zones,MSOAIZ,WV,6481,2590,4814,1852,2013,932,2801,920,14,5,1282,546,113,59,1169,487,487,,,,326,162,286,140,1,1,36,19,3,2,22,45,25
E02006181,South Staffordshire 008,Middle Super Output Areas and Intermediate Zones,MSOAIZ,WV,5707,2567,3685,1585,1674,878,2011,707,48,24,1552,769,128,71,1424,698,698,,,,366,152,327,130,6,4,32,17,1,1,22,56,37
E02006182,South Staffordshire 009,Middle Super Output Areas and Intermediate Zones,MSOAIZ,WV,6608,2751,5876,2396,2632,1344,3244,1052,2,2,256,121,19,14,237,107,107,,,,425,199,390,182,7,3,22,10,6,4,17,49,33
E02006183,South Staffordshire 010,Middle Super Output Areas and Intermediate Zones,MSOAIZ,WV,7397,3090,6196,2551,2480,1222,3716,1329,48,26,340,147,37,17,303,130,130,,,,771,339,679,303,16,6,36,16,40,14,36,42,27
E02006184,South Staffordshire 011,Middle Super Output Areas and Intermediate Zones,MSOAIZ,WV,5426,2274,3890,1514,1314,621,2576,893,36,23,923,505,82,51,841,454,454,,,,536,211,484,192,2,1,45,16,5,2,19,41,21
E02006185,South Staffordshire 012,Middle Super Output Areas and Intermediate Zones,MSOAIZ,WV,7115,3113,4849,1984,2176,1106,2673,878,24,17,1569,793,151,86,1418,707,707,,,,603,277,544,255,13,6,43,14,3,2,22,70,42
E02006186,South Staffordshire 013,Middle Super Output Areas and Intermediate Zones,MSOAIZ,WV,12044,4995,10219,4158,4839,2388,5380,1770,28,16,798,361,83,50,715,311,311,,,,893,401,819,363,13,6,52,26,9,6,38,106,59
E02006187,South Staffordshire 014,Middle Super Output Areas and Intermediate Zones,MSOAIZ,DY,7067,3074,5776,2432,2938,1460,2838,972,6,4,594,313,50,28,544,285,285,,,,587,275,531,247,16,7,32,18,8,3,28,104,50
E02006188,Stafford 001,Middle Super Output Areas and Intermediate Zones,MSOAIZ,ST,5844,2521,4945,2082,2316,1187,2629,895,20,13,487,236,234,110,253,126,126,,,,340,162,295,144,3,1,42,17,0,0,18,52,28
E02006189,Stafford 002,Middle Super Output Areas and Intermediate Zones,MSOAIZ,ST,7035,3086,5418,2371,2683,1389,2735,982,3,2,795,347,345,157,450,190,190,,,,704,303,627,271,28,10,32,17,17,5,32,115,63
E02006190,Stafford 003,Middle Super Output Areas and Intermediate Zones,MSOAIZ,ST,10130,4676,6929,3047,2725,1499,4204,1548,37,17,1641,771,507,215,1134,556,556,,,,1433,776,1304,704,13,6,100,55,16,11,72,90,65
E02006191,Stafford 004,Middle Super Output Areas and Intermediate Zones,MSOAIZ,ST,7928,3268,6834,2786,2822,1420,4012,1366,17,8,259,110,40,21,219,89,89,,,,736,315,663,284,12,6,51,22,10,3,31,82,49
E02006192,Stafford 005,Middle Super Output Areas and Intermediate Zones,MSOAIZ,TF,7789,3388,6255,2616,2923,1429,3332,1187,28,14,572,316,260,134,312,182,182,,,,847,392,732,338,44,20,65,29,6,5,54,87,50
E02006193,Stafford 006,Middle Super Output Areas and Intermediate Zones,MSOAIZ,ST,6464,2780,5484,2379,2490,1295,2994,1084,15,8,303,123,172,67,131,56,56,,,,610,244,559,224,4,2,47,18,0,0,20,52,26
E02006194,Stafford 007,Middle Super Output Areas and Intermediate Zones,MSOAIZ,ST,7585,3222,4570,1969,1759,943,2811,1026,35,17,2048,835,558,231,1490,604,604,,,,877,364,812,336,8,2,54,25,3,1,28,55,37
E02006195,Stafford 008,Middle Super Output Areas and Intermediate Zones,MSOAIZ,WS,8225,3543,6971,2927,3028,1541,3943,1386,34,21,475,258,110,63,365,195,195,,,,662,291,591,254,13,7,50,24,8,6,37,83,46
E02006196,Stafford 009,Middle Super Output Areas and Intermediate Zones,MSOAIZ,ST,6392,2856,2770,1180,870,471,1900,709,42,21,1546,774,509,242,1037,532,532,,,,1963,836,1257,493,249,75,80,44,377,224,343,71,45
E02006197,Stafford 010,Middle Super Output Areas and Intermediate Zones,MSOAIZ,ST,8106,4233,3901,1875,1248,707,2653,1168,51,28,985,712,190,126,795,586,586,,,,3069,1561,2803,1445,75,23,155,77,36,16,116,100,57
E02006198,Stafford 011,Middle Super Output Areas and Intermediate Zones,MSOAIZ,ST,7465,3111,6303,2618,2603,1326,3700,1292,30,15,122,48,15,5,107,43,43,,,,959,403,826,355,62,24,48,17,23,7,48,51,27
E02006199,Stafford 012,Middle Super Output Areas and Intermediate Zones,MSOAIZ,ST,7957,3359,6770,2800,2753,1370,4017,1430,32,19,355,205,127,68,228,137,137,,,,753,311,709,292,4,2,30,14,10,3,19,47,24
E02006200,Stafford 013,Middle Super Output Areas and Intermediate Zones,MSOAIZ,ST,7983,3546,4042,1708,1311,690,2731,1018,52,34,3200,1489,1012,470,2188,1019,1019,,,,614,268,542,232,1,1,66,30,5,5,36,75,47
E02006201,Stafford 014,Middle Super Output Areas and Intermediate Zones,MSOAIZ,WS,12199,5006,11170,4600,5052,2615,6118,1985,38,19,83,37,2,2,81,35,35,,,,833,306,754,272,8,3,70,30,1,1,34,75,44
E02006202,Stafford 015,Middle Super Output Areas and Intermediate Zones,MSOAIZ,TF,8607,3641,7028,2929,3092,1547,3936,1382,5,2,628,307,322,141,306,166,166,,,,793,337,668,289,24,10,76,25,25,13,48,153,66
E02006203,Stafford 016,Middle Super Output Areas and Intermediate Zones,MSOAIZ,ST,7900,3467,4752,1993,1571,830,3181,1163,90,41,2202,1050,868,368,1334,682,682,,,,781,337,713,306,2,1,45,22,21,8,31,75,46
E02006204,Staffordshire Moorlands 001,Middle Super Output Areas and Intermediate Zones,MSOAIZ,ST,7214,3127,5017,2171,2411,1225,2606,946,25,15,1449,599,581,225,868,374,374,,,,648,299,548,258,11,3,78,32,11,6,41,75,43
E02006205,Staffordshire Moorlands 002,Middle Super Output Areas and Intermediate Zones,MSOAIZ,ST,6989,3058,6478,2808,3326,1667,3152,1141,10,6,74,37,26,11,48,26,26,,,,375,181,309,147,5,1,56,30,5,3,34,52,26
E02006206,Staffordshire Moorlands 003,Middle Super Output Areas and Intermediate Zones,MSOAIZ,ST,8264,3424,5201,2066,1647,824,3554,1242,10,6,1891,839,784,348,1107,491,491,,,,1092,474,995,432,6,3,86,36,5,3,42,70,39
E02006207,Staffordshire Moorlands 004,Middle Super Output Areas and Intermediate Zones,MSOAIZ,ST,6246,2785,5654,2516,2963,1552,2691,964,27,11,180,83,66,24,114,59,59,,,,333,149,277,124,4,1,49,21,3,3,25,52,26
E02006208,Staffordshire Moorlands 005,Middle Super Output Areas and Intermediate Zones,MSOAIZ,ST,8028,3911,5334,2409,2067,1134,3267,1275,27,22,897,536,253,136,644,400,400,,,,1659,881,1506,800,7,4,133,70,13,7,81,111,63
E02006209,Staffordshire Moorlands 006,Middle Super Output Areas and Intermediate Zones,MSOAIZ,ST,10712,4594,9392,3913,4068,2073,5324,1840,14,5,480,267,128,71,352,196,196,,,,721,356,672,332,4,3,44,20,1,1,24,105,53
E02006210,Staffordshire Moorlands 007,Middle Super Output Areas and Intermediate Zones,MSOAIZ,ST,5428,2377,4365,1855,2513,1188,1852,667,21,13,316,156,85,43,231,113,113,,,,613,290,495,237,11,6,72,30,35,17,53,113,63
E02006211,Staffordshire Moorlands 008,Middle Super Output Areas and Intermediate Zones,MSOAIZ,ST,6422,2708,5809,2439,3001,1526,2808,913,0,0,211,90,75,33,136,57,57,,,,357,159,326,147,9,2,19,8,3,2,12,45,20
E02006212,Staffordshire Moorlands 009,Middle Super Output Areas and Intermediate Zones,MSOAIZ,ST,7678,3307,7032,3021,3506,1784,3526,1237,11,6,151,69,42,23,109,46,46,,,,421,177,318,143,28,7,73,25,2,2,34,63,34
E02006213,Staffordshire Moorlands 010,Middle Super Output Areas and Intermediate Zones,MSOAIZ,ST,6426,2844,4896,2121,2305,1184,2591,937,28,12,821,389,336,167,485,222,222,,,,566,269,490,238,4,2,63,25,9,4,31,115,53
E02006214,Staffordshire Moorlands 011,Middle Super Output Areas and Intermediate Zones,MSOAIZ,ST,6005,2685,4546,1962,1962,1042,2584,920,27,10,720,368,305,155,415,213,213,,,,658,314,546,265,16,5,83,36,13,8,49,54,31
E02006215,Staffordshire Moorlands 012,Middle Super Output Areas and Intermediate Zones,MSOAIZ,ST,7783,3382,6820,2917,3279,1650,3541,1267,10,6,285,137,120,60,165,77,77,,,,578,271,496,235,17,6,63,29,2,1,36,90,51
E02006216,Staffordshire Moorlands 013,Middle Super Output Areas and Intermediate Zones,MSOAIZ,ST,8665,3570,7688,3090,3174,1564,4514,1526,32,15,328,129,128,47,200,82,82,,,,535,283,446,237,9,3,74,37,6,6,46,82,53
E02006217,Tamworth 001,Middle Super Output Areas and Intermediate Zones,MSOAIZ,B,8647,3649,6953,2912,3040,1559,3913,1353,11,5,1018,446,892,374,126,72,72,,,,625,253,542,218,0,0,73,31,10,4,35,40,33
E02006218,Tamworth 002,Middle Super Output Areas and Intermediate Zones,MSOAIZ,B,7796,3877,3905,1760,1508,867,2397,893,60,29,2223,1270,1549,904,674,366,366,,,,1501,745,1406,692,3,2,74,40,18,11,53,107,73
E02006219,Tamworth 003,Middle Super Output Areas and Intermediate Zones,MSOAIZ,B,7873,3101,5673,2184,1704,854,3969,1330,6,3,1470,627,1084,454,386,173,173,,,,683,262,625,235,6,2,50,24,2,1,27,41,25
E02006220,Tamworth 004,Middle Super Output Areas and Intermediate Zones,MSOAIZ,B,7390,3167,5552,2341,2196,1162,3356,1179,14,8,1046,491,921,446,125,45,45,,,,721,288,654,261,2,1,61,24,4,2,27,57,39
E02006221,Tamworth 005,Middle Super Output Areas and Intermediate Zones,MSOAIZ,B,6087,2540,4639,1823,1223,636,3416,1187,97,48,408,205,307,155,101,50,50,,,,909,446,846,415,3,1,48,26,12,4,31,34,18
E02006222,Tamworth 006,Middle Super Output Areas and Intermediate Zones,MSOAIZ,B,6771,2716,4386,1763,1312,687,3074,1076,14,7,1494,594,1277,501,217,93,93,,,,833,329,749,299,0,0,77,27,7,3,30,44,23
E02006223,Tamworth 007,Middle Super Output Areas and Intermediate Zones,MSOAIZ,B,7158,2756,2824,1054,574,278,2250,776,30,14,3595,1425,2472,959,1123,466,466,,,,654,235,582,205,0,0,72,30,0,0,30,55,28
E02006224,Tamworth 008,Middle Super Output Areas and Intermediate Zones,MSOAIZ,B,7692,2946,6184,2354,1454,678,4730,1676,13,5,871,330,519,193,352,137,137,,,,586,241,553,228,4,1,26,11,3,1,13,38,16
E02006225,Tamworth 009,Middle Super Output Areas and Intermediate Zones,MSOAIZ,B,7375,3013,6384,2559,2214,1101,4170,1458,23,9,276,148,167,89,109,59,59,,,,660,276,582,242,7,3,69,30,2,1,34,32,21
E02006226,Tamworth 010,Middle Super Output Areas and Intermediate Zones,MSOAIZ,B,9657,3852,7195,2825,1972,968,5223,1857,64,30,1472,572,1046,407,426,165,165,,,,887,401,797,362,12,4,67,29,11,6,39,39,24
E02006227,Babergh 001,Middle Super Output Areas and Intermediate Zones,MSOAIZ,IP,5925,2738,4049,1874,2184,1189,1865,685,35,20,997,451,696,330,301,121,121,,,,679,309,599,275,32,10,31,16,17,8,34,165,84
E02006228,Babergh 002,Middle Super Output Areas and Intermediate Zones,MSOAIZ,IP,5718,2438,4463,1887,2054,1031,2409,856,3,2,513,213,317,138,196,75,75,,,,672,297,578,264,15,6,57,23,22,4,33,67,39
E02006229,Babergh 003,Middle Super Output Areas and Intermediate Zones,MSOAIZ,CO,5613,2571,4051,1803,1946,1042,2105,761,46,23,763,373,480,256,283,117,117,,,,693,332,615,300,19,6,51,22,8,4,32,60,40
E02006230,Babergh 004,Middle Super Output Areas and Intermediate Zones,MSOAIZ,IP,10372,4392,6871,2923,3175,1659,3696,1264,58,27,1561,707,1108,513,453,194,194,,,,1740,649,1091,457,449,124,77,31,123,37,192,142,86
E02006231,Babergh 005,Middle Super Output Areas and Intermediate Zones,MSOAIZ,IP,8205,3574,6160,2662,2245,1171,3915,1491,22,9,880,376,254,121,626,255,255,,,,1078,491,868,416,101,31,56,28,53,16,75,65,36
E02006232,Babergh 006,Middle Super Output Areas and Intermediate Zones,MSOAIZ,CO,5650,2406,4492,1891,2065,1045,2427,846,5,2,547,247,314,155,233,92,92,,,,501,212,438,182,6,3,41,20,16,7,30,105,54
E02006233,Babergh 007,Middle Super Output Areas and Intermediate Zones,MSOAIZ,CO,10941,5174,6508,3059,2857,1675,3651,1384,93,46,2217,1035,1585,744,632,291,291,,,,1988,962,1818,875,11,7,126,59,33,21,87,135,72
E02006234,Babergh 008,Middle Super Output Areas and Intermediate Zones,MSOAIZ,CO,8773,3564,6074,2466,2147,1117,3927,1349,45,21,1628,620,1243,475,385,145,145,,,,922,407,817,362,10,4,81,36,14,5,45,104,50
E02006235,Babergh 009,Middle Super Output Areas and Intermediate Zones,MSOAIZ,IP,7855,3380,6196,2647,3172,1586,3024,1061,12,8,660,302,427,206,233,96,96,,,,835,343,699,292,70,19,54,25,12,7,51,152,80
E02006236,Babergh 010,Middle Super Output Areas and Intermediate Zones,MSOAIZ,IP,9979,4168,8325,3475,4050,2058,4275,1417,37,13,698,286,442,187,256,99,99,,,,823,337,724,296,18,7,69,30,12,4,41,96,57
E02006237,Babergh 011,Middle Super Output Areas and Intermediate Zones,MSOAIZ,IP,7139,3117,5395,2294,2501,1288,2894,1006,13,7,600,302,442,218,158,84,84,,,,812,375,655,303,77,32,65,30,15,10,72,319,139
E02006238,Forest Heath 001,Middle Super Output Areas and Intermediate Zones,MSOAIZ,IP,9571,4278,5839,2700,2627,1463,3212,1237,119,47,1321,580,510,212,811,368,368,,,,2132,871,1975,792,59,23,82,44,16,12,79,160,80
E02006239,Forest Heath 002,Middle Super Output Areas and Intermediate Zones,MSOAIZ,IP,5500,2350,3107,1364,1396,732,1711,632,2,1,459,205,153,70,306,135,135,,,,1463,619,1084,491,203,61,56,25,120,42,128,469,161
E02006240,Forest Heath 003,Middle Super Output Areas and Intermediate Zones,MSOAIZ,IP,8509,3337,4256,1751,1841,903,2415,848,70,33,549,226,142,67,407,159,159,,,,2771,1077,2110,889,334,91,89,34,238,63,188,863,250
E02006241,Forest Heath 004,Middle Super Output Areas and Intermediate Zones,MSOAIZ,IP,8618,3755,4703,2005,1781,932,2922,1073,72,38,1796,810,620,286,1176,524,524,,,,1905,828,1823,791,21,7,42,21,19,9,37,142,74
E02006242,Forest Heath 005,Middle Super Output Areas and Intermediate Zones,MSOAIZ,IP,7598,3251,4489,1935,1525,789,2964,1146,157,75,889,327,270,91,619,236,236,,,,1857,813,1729,763,59,21,51,20,18,9,50,206,101
E02006243,Forest Heath 006,Middle Super Output Areas and Intermediate Zones,MSOAIZ,CB,8930,4024,4469,2021,1581,841,2888,1180,328,136,1736,833,684,282,1052,551,551,,,,2144,904,1962,813,81,35,89,49,12,7,91,253,130
E02006245,Ipswich 001,Middle Super Output Areas and Intermediate Zones,MSOAIZ,IP,8037,3218,4602,1926,2023,1053,2579,873,9,4,2850,1057,2657,967,193,90,90,,,,492,181,448,159,1,1,31,16,12,5,22,84,50
E02006246,Ipswich 002,Middle Super Output Areas and Intermediate Zones,MSOAIZ,IP,7419,3034,6247,2560,2713,1391,3534,1169,9,6,410,183,321,124,89,59,59,,,,706,257,621,229,12,3,65,22,8,3,28,47,28
E02006247,Ipswich 003,Middle Super Output Areas and Intermediate Zones,MSOAIZ,IP,8879,3777,4984,2104,1412,743,3572,1361,96,52,2389,1002,1567,625,822,377,377,,,,1335,579,1264,542,1,1,58,31,12,5,37,75,40
E02006248,Ipswich 004,Middle Super Output Areas and Intermediate Zones,MSOAIZ,IP,8272,3296,5920,2304,2070,1057,3850,1247,13,5,1379,623,1067,492,312,131,131,,,,879,319,820,295,11,2,48,22,0,0,24,81,45
E02006249,Ipswich 005,Middle Super Output Areas and Intermediate Zones,MSOAIZ,IP,7608,3403,5433,2271,2284,1193,3149,1078,16,10,353,213,227,132,126,81,81,,,,1735,868,1672,836,7,3,52,25,4,4,32,71,41
E02006250,Ipswich 006,Middle Super Output Areas and Intermediate Zones,MSOAIZ,IP,9428,4363,4059,1793,1157,630,2902,1163,82,36,1526,836,844,468,682,368,368,,,,3669,1657,3527,1578,28,16,94,47,20,16,79,92,41
E02006251,Ipswich 007,Middle Super Output Areas and Intermediate Zones,MSOAIZ,IP,9108,4501,4294,1934,1343,735,2951,1199,92,46,975,641,381,221,594,420,420,,,,3648,1830,3495,1756,34,12,95,50,24,12,74,99,50
E02006252,Ipswich 008,Middle Super Output Areas and Intermediate Zones,MSOAIZ,IP,8964,3921,5956,2497,1868,1018,4088,1479,49,22,708,417,156,101,552,316,316,,,,2188,948,2051,885,24,9,98,46,15,8,63,63,37
E02006253,Ipswich 009,Middle Super Output Areas and Intermediate Zones,MSOAIZ,IP,7003,3017,5973,2548,2889,1524,3084,1024,13,8,181,100,93,47,88,53,53,,,,783,329,737,305,2,2,35,17,9,5,24,53,32
E02006254,Ipswich 010,Middle Super Output Areas and Intermediate Zones,MSOAIZ,IP,8729,3898,3642,1564,1104,580,2538,984,82,44,3232,1415,2497,1040,735,375,375,,,,1689,828,1590,777,4,3,71,37,24,11,51,84,47
E02006255,Ipswich 011,Middle Super Output Areas and Intermediate Zones,MSOAIZ,IP,7787,3573,4614,2035,1609,867,3005,1168,79,37,374,218,142,73,232,145,145,,,,2670,1257,2562,1204,18,8,71,36,19,9,53,50,26
E02006256,Ipswich 012,Middle Super Output Areas and Intermediate Zones,MSOAIZ,IP,8406,3920,3897,1748,1308,694,2589,1054,76,41,2269,1122,1352,697,917,425,425,,,,2100,967,1948,896,10,5,119,52,23,14,71,64,42
E02006257,Ipswich 013,Middle Super Output Areas and Intermediate Zones,MSOAIZ,IP,6645,2993,4059,1715,1671,876,2388,839,21,9,1792,922,1639,833,153,89,89,,,,699,298,636,272,9,2,46,20,8,4,26,74,49
E02006258,Ipswich 014,Middle Super Output Areas and Intermediate Zones,MSOAIZ,IP,8954,3570,4555,1862,1339,682,3216,1180,58,25,3012,1103,2195,793,817,310,310,,,,1222,524,1136,483,14,7,71,33,1,1,41,107,56
E02006259,Ipswich 015,Middle Super Output Areas and Intermediate Zones,MSOAIZ,IP,7238,3226,3937,1673,1688,868,2249,805,21,8,2663,1298,952,455,1711,843,843,,,,545,210,487,185,3,1,46,19,9,5,25,72,37
E02006260,Ipswich 016,Middle Super Output Areas and Intermediate Zones,MSOAIZ,IP,8785,3588,4591,1933,1544,812,3047,1121,31,15,3157,1221,2852,1070,305,151,151,,,,915,369,837,340,8,3,41,20,29,6,29,91,50
E02006261,Mid Suffolk 001,Middle Super Output Areas and Intermediate Zones,MSOAIZ,IP,7564,3234,5761,2414,2918,1441,2843,973,30,16,885,408,652,302,233,106,106,,,,749,329,616,275,25,10,100,42,8,2,54,139,67
E02006262,Mid Suffolk 002,Middle Super Output Areas and Intermediate Zones,MSOAIZ,IP,8610,3605,6850,2825,3195,1569,3655,1256,46,23,696,312,486,222,210,90,90,,,,894,383,762,332,55,20,67,26,10,5,51,124,62
E02006263,Mid Suffolk 003,Middle Super Output Areas and Intermediate Zones,MSOAIZ,IP,7278,3090,5415,2268,2797,1347,2618,921,46,19,787,360,660,310,127,50,50,,,,853,359,674,287,93,37,68,28,18,7,72,177,84
E02006264,Mid Suffolk 004,Middle Super Output Areas and Intermediate Zones,MSOAIZ,IP,8135,3325,6630,2677,2668,1323,3962,1354,64,32,483,215,347,155,136,60,60,,,,842,346,763,314,25,11,44,18,10,3,32,116,55
E02006265,Mid Suffolk 005,Middle Super Output Areas and Intermediate Zones,MSOAIZ,IP,6942,2980,5437,2280,2561,1287,2876,993,102,39,776,374,568,268,208,106,106,,,,548,242,451,206,46,15,45,18,6,3,36,79,45
E02006266,Mid Suffolk 006,Middle Super Output Areas and Intermediate Zones,MSOAIZ,IP,9127,3848,6878,2843,3058,1541,3820,1302,119,61,1459,644,1010,435,449,209,209,,,,575,239,505,210,14,5,33,14,23,10,29,96,61
E02006267,Mid Suffolk 007,Middle Super Output Areas and Intermediate Zones,MSOAIZ,IP,8373,3371,6519,2575,2810,1369,3709,1206,36,16,765,289,600,202,165,87,87,,,,923,423,831,382,37,16,35,17,20,8,41,130,68
E02006268,Mid Suffolk 008,Middle Super Output Areas and Intermediate Zones,MSOAIZ,IP,6174,2736,3660,1619,1635,911,2025,708,35,18,1962,861,1366,634,596,227,227,,,,445,189,400,170,4,1,31,12,10,6,19,72,49
E02006269,Mid Suffolk 009,Middle Super Output Areas and Intermediate Zones,MSOAIZ,IP,6743,2811,5645,2318,2190,1102,3455,1216,19,8,370,173,273,115,97,58,58,,,,658,286,580,255,17,5,52,21,9,5,31,51,26
E02006270,Mid Suffolk 010,Middle Super Output Areas and Intermediate Zones,MSOAIZ,IP,11334,4787,8527,3533,2551,1331,5976,2202,136,67,726,281,454,174,272,107,107,,,,1868,865,1697,788,10,4,146,64,15,9,77,77,41
E02006271,Mid Suffolk 011,Middle Super Output Areas and Intermediate Zones,MSOAIZ,IP,7671,3381,5464,2405,2450,1312,3014,1093,61,29,712,333,505,219,207,114,114,,,,1355,568,655,325,433,145,53,23,214,75,243,79,46
E02006272,Mid Suffolk 012,Middle Super Output Areas and Intermediate Zones,MSOAIZ,IP,7303,3138,5975,2505,2598,1343,3377,1162,32,15,623,294,505,244,118,50,50,,,,617,286,561,260,12,5,44,21,0,0,26,56,38
E02006273,St Edmundsbury 001,Middle Super Output Areas and Intermediate Zones,MSOAIZ,IP,6311,2695,4730,2039,2285,1183,2445,856,25,12,764,327,304,123,460,204,204,,,,695,267,419,177,121,36,58,25,97,29,90,97,50
E02006274,St Edmundsbury 002,Middle Super Output Areas and Intermediate Zones,MSOAIZ,IP,6401,2527,3538,1416,1487,731,2051,685,23,8,778,328,307,118,471,210,210,,,,1920,709,997,404,544,174,37,19,342,112,305,142,66
E02006275,St Edmundsbury 003,Middle Super Output Areas and Intermediate Zones,MSOAIZ,IP,7195,2956,3545,1446,1131,604,2414,842,30,15,2923,1207,1551,599,1372,608,608,,,,626,246,518,207,0,0,80,30,28,9,39,71,42
E02006276,St Edmundsbury 004,Middle Super Output Areas and Intermediate Zones,MSOAIZ,IP,6442,2730,4988,2100,2536,1274,2452,826,65,32,698,304,257,104,441,200,200,,,,576,243,496,212,29,11,38,14,13,6,31,115,51
E02006277,St Edmundsbury 005,Middle Super Output Areas and Intermediate Zones,MSOAIZ,IP,7959,3148,5796,2245,1534,755,4262,1490,152,63,469,161,35,12,434,149,149,,,,1516,665,1411,625,5,2,79,32,21,6,40,26,14
E02006278,St Edmundsbury 006,Middle Super Output Areas and Intermediate Zones,MSOAIZ,IP,8258,4184,4327,2095,1971,1144,2356,951,123,59,1123,640,306,158,817,482,482,,,,2600,1344,2445,1272,17,9,120,53,18,10,72,85,46
E02006279,St Edmundsbury 007,Middle Super Output Areas and Intermediate Zones,MSOAIZ,IP,9021,3965,6412,2841,3038,1655,3374,1186,28,14,1352,585,634,251,718,334,334,,,,1139,473,980,417,41,11,94,36,24,9,56,90,52
E02006280,St Edmundsbury 008,Middle Super Output Areas and Intermediate Zones,MSOAIZ,IP,9008,3776,6965,2885,3304,1650,3661,1235,20,12,905,394,317,141,588,253,253,,,,909,389,780,334,70,30,50,20,9,5,55,209,96
E02006281,St Edmundsbury 009,Middle Super Output Areas and Intermediate Zones,MSOAIZ,IP,8248,3916,5954,2719,3038,1682,2916,1037,67,33,969,580,248,137,721,443,443,,,,1165,542,1065,493,33,15,55,28,12,6,49,93,42
E02006282,St Edmundsbury 010,Middle Super Output Areas and Intermediate Zones,MSOAIZ,IP,6173,2722,4555,1977,2298,1191,2257,786,26,12,784,354,317,129,467,225,225,,,,707,325,618,294,33,9,49,19,7,3,31,101,54
E02006283,St Edmundsbury 011,Middle Super Output Areas and Intermediate Zones,MSOAIZ,CO,6023,2543,4698,1977,2012,1039,2686,938,16,8,440,175,164,63,276,112,112,,,,694,297,627,266,20,8,36,18,11,5,31,175,86
E02006284,St Edmundsbury 012,Middle Super Output Areas and Intermediate Zones,MSOAIZ,CB,7753,3176,5186,2048,1669,877,3517,1171,94,42,1680,721,713,315,967,406,406,,,,735,327,661,292,2,1,58,27,14,7,35,58,38
E02006285,St Edmundsbury 013,Middle Super Output Areas and Intermediate Zones,MSOAIZ,CB,7916,3011,5435,2054,1121,577,4314,1477,55,25,1530,597,797,273,733,324,324,,,,875,325,823,305,8,2,44,18,0,0,20,21,10
E02006286,St Edmundsbury 014,Middle Super Output Areas and Intermediate Zones,MSOAIZ,CB,11234,4453,6980,2784,2071,1075,4909,1709,100,41,2421,948,1132,385,1289,563,563,,,,1673,646,1534,594,28,7,86,36,25,9,52,60,34
E02006287,Suffolk Coastal 001,Middle Super Output Areas and Intermediate Zones,MSOAIZ,NR,5838,2721,4371,2086,2838,1497,1533,589,30,15,627,245,67,26,560,219,219,,,,680,307,553,260,47,14,71,29,9,4,47,130,68
E02006288,Suffolk Coastal 002,Middle Super Output Areas and Intermediate Zones,MSOAIZ,IP,8535,3673,6218,2613,3107,1593,3111,1020,48,23,867,402,61,35,806,367,367,,,,1189,529,1075,479,63,20,48,28,3,2,50,213,106
E02006289,Suffolk Coastal 003,Middle Super Output Areas and Intermediate Zones,MSOAIZ,IP,8196,3670,5642,2527,2870,1549,2772,978,91,40,1428,631,122,54,1306,577,577,,,,925,411,837,369,28,12,48,24,12,6,42,110,61
E02006290,Suffolk Coastal 004,Middle Super Output Areas and Intermediate Zones,MSOAIZ,IP,7965,3859,5235,2525,2944,1670,2291,855,19,10,1436,681,143,70,1293,611,611,,,,1148,569,1015,506,48,18,66,35,19,10,63,127,74
E02006291,Suffolk Coastal 005,Middle Super Output Areas and Intermediate Zones,MSOAIZ,IP,6988,3118,5138,2267,2715,1420,2423,847,36,16,1028,467,81,34,947,433,433,,,,712,324,665,297,8,3,29,19,10,5,27,74,44
E02006292,Suffolk Coastal 006,Middle Super Output Areas and Intermediate Zones,MSOAIZ,IP,6505,2694,5223,2150,2726,1306,2497,844,42,16,652,262,27,14,625,248,248,,,,497,221,446,196,8,6,29,13,14,6,25,91,45
E02006293,Suffolk Coastal 007,Middle Super Output Areas and Intermediate Zones,MSOAIZ,IP,9783,4089,6598,2776,2779,1400,3819,1376,60,23,779,333,26,11,753,322,322,,,,2169,867,1530,650,379,123,64,32,196,62,217,177,90
E02006294,Suffolk Coastal 008,Middle Super Output Areas and Intermediate Zones,MSOAIZ,IP,7920,3792,5550,2632,3111,1772,2439,860,37,17,1196,582,92,35,1104,547,547,,,,1028,497,929,449,32,11,52,29,15,8,48,109,64
E02006295,Suffolk Coastal 009,Middle Super Output Areas and Intermediate Zones,MSOAIZ,IP,9260,3942,7649,3207,3346,1762,4303,1445,17,6,602,307,30,17,572,290,290,,,,933,392,882,365,2,1,44,22,5,4,27,59,30
E02006296,Suffolk Coastal 010,Middle Super Output Areas and Intermediate Zones,MSOAIZ,IP,12695,5135,10421,4112,3964,1979,6457,2133,39,15,363,175,26,14,337,161,161,,,,1805,795,1705,752,19,6,78,35,3,2,43,67,38
E02006297,Suffolk Coastal 011,Middle Super Output Areas and Intermediate Zones,MSOAIZ,IP,7965,3193,7116,2839,3101,1525,4015,1314,20,11,109,43,4,2,105,41,41,,,,657,267,604,246,36,12,11,7,6,2,21,63,33
E02006298,Suffolk Coastal 012,Middle Super Output Areas and Intermediate Zones,MSOAIZ,IP,8799,3764,6821,2902,2691,1425,4130,1477,31,15,668,315,69,27,599,288,288,,,,1228,506,1110,458,37,10,57,29,24,9,48,51,26
E02006299,Suffolk Coastal 013,Middle Super Output Areas and Intermediate Zones,MSOAIZ,IP,8234,3770,7097,3258,3915,2147,3182,1111,18,9,314,155,38,15,276,140,140,,,,749,313,683,284,15,5,47,22,4,2,29,56,35
E02006300,Suffolk Coastal 014,Middle Super Output Areas and Intermediate Zones,MSOAIZ,IP,7507,3477,3864,1750,1465,850,2399,900,6,4,2370,1150,288,140,2082,1010,1010,,,,1187,518,1108,481,15,8,58,27,6,2,37,80,55
E02006301,Suffolk Coastal 015,Middle Super Output Areas and Intermediate Zones,MSOAIZ,IP,5601,2661,3348,1549,1529,879,1819,670,24,14,606,318,58,27,548,291,291,,,,1583,751,1454,695,37,12,72,33,20,11,56,40,29
E02006302,Waveney 001,Middle Super Output Areas and Intermediate Zones,MSOAIZ,NR,6454,2895,5322,2345,2806,1471,2516,874,28,14,316,164,240,124,76,40,40,,,,722,337,644,300,15,9,56,23,7,5,37,66,35
E02006303,Waveney 002,Middle Super Output Areas and Intermediate Zones,MSOAIZ,NR,7598,3191,3893,1551,1335,676,2558,875,16,5,2820,1286,2278,1028,542,258,258,,,,791,299,706,257,0,0,79,39,6,3,42,78,50
E02006304,Waveney 003,Middle Super Output Areas and Intermediate Zones,MSOAIZ,NR,7407,3306,5844,2613,3082,1660,2762,953,22,11,909,407,242,92,667,315,315,,,,581,244,498,212,11,2,68,28,4,2,32,51,31
E02006305,Waveney 004,Middle Super Output Areas and Intermediate Zones,MSOAIZ,NR,9200,4079,5016,2248,1902,1055,3114,1193,24,11,884,382,187,87,697,295,295,,,,3209,1405,3033,1330,6,2,145,64,25,9,75,67,33
E02006306,Waveney 005,Middle Super Output Areas and Intermediate Zones,MSOAIZ,NR,7174,3203,5221,2353,2461,1348,2760,1005,16,9,905,416,632,299,273,117,117,,,,986,397,863,351,2,1,99,39,22,6,46,46,28
E02006307,Waveney 006,Middle Super Output Areas and Intermediate Zones,MSOAIZ,NR,7275,3172,6610,2854,3475,1805,3135,1049,9,5,99,52,75,35,24,17,17,,,,525,241,461,213,6,2,55,24,3,2,28,32,20
E02006308,Waveney 007,Middle Super Output Areas and Intermediate Zones,MSOAIZ,NR,6937,3496,3378,1514,1302,727,2076,787,19,12,1154,685,448,292,706,393,393,,,,2322,1247,2216,1189,12,6,81,44,13,8,58,64,38
E02006309,Waveney 008,Middle Super Output Areas and Intermediate Zones,MSOAIZ,NR,6691,2989,4209,1871,2037,1097,2172,774,21,8,1744,816,974,405,770,411,411,,,,660,253,590,224,6,4,61,24,3,1,29,57,41
E02006310,Waveney 009,Middle Super Output Areas and Intermediate Zones,MSOAIZ,NR,8007,3290,6141,2532,2099,1102,4042,1430,22,12,785,278,200,86,585,192,192,,,,1000,434,908,396,7,3,85,35,0,0,38,59,34
E02006311,Waveney 010,Middle Super Output Areas and Intermediate Zones,MSOAIZ,NR,8091,3828,5026,2370,2671,1529,2355,841,86,43,1493,694,859,420,634,274,274,,,,1385,660,1277,610,7,2,99,46,2,2,50,101,61
E02006312,Waveney 011,Middle Super Output Areas and Intermediate Zones,MSOAIZ,NR,8758,3649,6908,2887,3214,1652,3694,1235,14,7,744,314,432,179,312,135,135,,,,1001,399,902,364,13,5,76,26,10,4,35,91,42
E02006313,Waveney 012,Middle Super Output Areas and Intermediate Zones,MSOAIZ,NR,10110,4520,7978,3565,3822,2068,4156,1497,46,24,788,359,380,179,408,180,180,,,,1197,513,1076,448,37,22,79,38,5,5,65,101,59
E02006314,Waveney 013,Middle Super Output Areas and Intermediate Zones,MSOAIZ,NR,7229,3190,5194,2244,2508,1320,2686,924,40,18,970,435,758,328,212,107,107,,,,910,437,805,384,36,12,64,37,5,4,53,115,56
E02006315,Waveney 014,Middle Super Output Areas and Intermediate Zones,MSOAIZ,NR,5788,2828,4091,2024,2519,1447,1572,577,60,27,812,393,633,295,179,98,98,,,,685,316,607,279,34,12,37,21,7,4,37,140,68
E02006316,Waveney 015,Middle Super Output Areas and Intermediate Zones,MSOAIZ,NR,6800,3247,4879,2319,2734,1546,2145,773,19,9,980,467,767,385,213,82,82,,,,840,396,766,363,17,7,49,23,8,3,33,82,56
E02006317,Elmbridge 001,Middle Super Output Areas and Intermediate Zones,MSOAIZ,KT,6007,2509,4690,1977,1781,938,2909,1039,45,19,466,207,136,57,330,150,150,,,,778,288,719,266,18,6,33,15,8,1,22,28,18
E02006318,Elmbridge 002,Middle Super Output Areas and Intermediate Zones,MSOAIZ,KT,6271,2685,5070,2087,2026,1018,3044,1069,10,5,91,66,20,11,71,55,55,,,,1035,498,982,469,8,3,39,21,6,5,29,65,29
E02006319,Elmbridge 003,Middle Super Output Areas and Intermediate Zones,MSOAIZ,KT,6708,2824,4723,1921,1504,775,3219,1146,58,25,1043,530,259,135,784,395,395,,,,828,315,750,283,11,3,59,25,8,4,32,56,33
E02006320,Elmbridge 004,Middle Super Output Areas and Intermediate Zones,MSOAIZ,KT,6511,2787,3995,1703,1023,573,2972,1130,103,45,1485,649,342,157,1143,492,492,,,,890,370,813,340,7,3,45,17,25,10,30,38,20
E02006321,Elmbridge 005,Middle Super Output Areas and Intermediate Zones,MSOAIZ,KT,6182,2451,5055,1951,1636,827,3419,1124,21,11,252,131,43,22,209,109,109,,,,812,333,772,310,6,3,28,17,6,3,23,42,25
E02006322,Elmbridge 006,Middle Super Output Areas and Intermediate Zones,MSOAIZ,KT,6313,2504,4947,1923,1691,829,3256,1094,16,10,595,281,94,43,501,238,238,,,,720,270,679,253,8,3,33,14,0,0,17,35,20
E02006323,Elmbridge 007,Middle Super Output Areas and Intermediate Zones,MSOAIZ,TW,6790,3063,4678,2047,1905,1016,2773,1031,95,63,380,207,66,38,314,169,169,,,,1584,716,1526,688,10,4,39,19,9,5,28,53,30
E02006324,Elmbridge 008,Middle Super Output Areas and Intermediate Zones,MSOAIZ,KT,7339,2773,5637,2129,1765,867,3872,1262,83,35,861,327,272,98,589,229,229,,,,701,254,662,233,7,2,28,18,4,1,21,57,28
E02006325,Elmbridge 009,Middle Super Output Areas and Intermediate Zones,MSOAIZ,KT,8915,3226,7700,2780,2735,1286,4965,1494,22,11,258,96,49,19,209,77,77,,,,867,305,823,288,12,4,25,11,7,2,17,68,34
E02006326,Elmbridge 010,Middle Super Output Areas and Intermediate Zones,MSOAIZ,KT,6461,2722,4761,1953,1757,900,3004,1053,31,16,362,214,44,24,318,190,190,,,,1265,516,1220,495,12,4,25,14,8,3,21,42,23
E02006327,Elmbridge 011,Middle Super Output Areas and Intermediate Zones,MSOAIZ,KT,6305,2662,4904,2045,1956,1035,2948,1010,5,3,213,122,43,23,170,99,99,,,,1120,458,1067,433,12,4,39,20,2,1,25,63,34
E02006328,Elmbridge 012,Middle Super Output Areas and Intermediate Zones,MSOAIZ,TW,8867,4002,5941,2554,2133,1163,3808,1391,54,30,764,400,183,94,581,306,306,,,,2011,964,1912,915,30,14,60,29,9,6,49,97,54
E02006329,Elmbridge 013,Middle Super Output Areas and Intermediate Zones,MSOAIZ,KT,6698,2638,4847,1895,2208,1017,2639,878,34,18,666,266,97,42,569,224,224,,,,1061,416,977,375,50,24,27,12,7,5,41,90,43
E02006330,Elmbridge 014,Middle Super Output Areas and Intermediate Zones,MSOAIZ,KT,9178,3844,6509,2597,2485,1215,4024,1382,71,33,1343,717,285,117,1058,600,600,,,,1167,446,1058,400,53,15,45,22,11,9,46,88,51
E02006331,Elmbridge 015,Middle Super Output Areas and Intermediate Zones,MSOAIZ,KT,7094,2788,5744,2234,2273,1144,3471,1090,24,11,570,261,112,48,458,213,213,,,,713,257,695,250,0,0,13,6,5,1,7,43,25
E02006332,Elmbridge 016,Middle Super Output Areas and Intermediate Zones,MSOAIZ,KT,6291,2567,4542,1854,1704,836,2838,1018,11,6,232,74,72,20,160,54,54,,,,1399,579,1338,550,6,2,53,25,2,2,29,107,54
E02006333,Elmbridge 017,Middle Super Output Areas and Intermediate Zones,MSOAIZ,KT,9223,3765,6025,2461,2624,1288,3401,1173,33,11,1092,527,309,149,783,378,378,,,,1918,687,1723,615,106,34,67,30,22,8,72,155,79
E02006334,Elmbridge 018,Middle Super Output Areas and Intermediate Zones,MSOAIZ,KT,8330,3112,6717,2549,3042,1392,3675,1157,67,41,332,143,60,27,272,116,116,,,,1121,334,1069,315,6,1,32,13,14,5,19,93,45
E02006335,Epsom and Ewell 001,Middle Super Output Areas and Intermediate Zones,MSOAIZ,KT,7831,3187,6511,2609,2621,1331,3890,1278,16,7,291,177,25,13,266,164,164,,,,964,368,917,347,1,1,42,18,4,2,21,49,26
E02006336,Epsom and Ewell 002,Middle Super Output Areas and Intermediate Zones,MSOAIZ,KT,6793,2670,4885,1941,1506,777,3379,1164,88,38,1237,486,110,41,1127,445,445,,,,570,198,520,177,3,1,34,16,13,4,21,13,7
E02006337,Epsom and Ewell 003,Middle Super Output Areas and Intermediate Zones,MSOAIZ,KT,8741,3303,7901,2995,3054,1504,4847,1491,6,4,112,52,4,3,108,49,49,,,,699,237,644,212,6,2,42,21,7,2,25,23,15
E02006338,Epsom and Ewell 004,Middle Super Output Areas and Intermediate Zones,MSOAIZ,KT,6791,2638,5705,2237,2177,1093,3528,1144,107,38,274,110,24,13,250,97,97,,,,676,243,601,211,5,2,62,24,8,6,32,29,10
E02006339,Epsom and Ewell 005,Middle Super Output Areas and Intermediate Zones,MSOAIZ,KT,8783,3379,5964,2308,1509,757,4455,1551,224,99,1327,487,91,32,1236,455,455,,,,1214,455,1117,413,5,3,83,34,9,5,42,54,30
E02006341,Epsom and Ewell 007,Middle Super Output Areas and Intermediate Zones,MSOAIZ,KT,9498,3846,6547,2653,2432,1264,4115,1389,55,23,947,442,38,20,909,422,422,,,,1895,701,1804,663,15,7,72,29,4,2,38,54,27
E02006342,Epsom and Ewell 008,Middle Super Output Areas and Intermediate Zones,MSOAIZ,KT,6948,3392,4180,2010,1758,1050,2422,960,56,30,478,301,30,17,448,284,284,,,,2134,993,1996,926,61,24,68,39,9,4,67,100,58
E02006343,Epsom and Ewell 009,Middle Super Output Areas and Intermediate Zones,MSOAIZ,KT,8238,3239,6809,2699,2659,1349,4150,1350,32,15,407,157,11,6,396,151,151,,,,873,323,729,272,93,33,42,15,9,3,51,117,45
E02006344,Guildford 001,Middle Super Output Areas and Intermediate Zones,MSOAIZ,KT,8151,3291,6295,2496,2755,1342,3540,1154,58,22,863,363,554,255,309,108,108,,,,783,336,586,248,151,66,32,15,14,7,88,152,74
E02006345,Guildford 002,Middle Super Output Areas and Intermediate Zones,MSOAIZ,GU,6159,2411,3872,1616,1771,909,2101,707,54,20,608,219,405,152,203,67,67,,,,1577,532,382,154,601,197,10,7,584,174,378,48,24
E02006346,Guildford 003,Middle Super Output Areas and Intermediate Zones,MSOAIZ,RH,9684,3862,8422,3320,3926,1911,4496,1409,43,24,424,193,316,136,108,57,57,,,,698,282,629,251,28,12,21,11,20,8,31,97,43
E02006347,Guildford 004,Middle Super Output Areas and Intermediate Zones,MSOAIZ,GU,7126,3079,5562,2411,1954,1022,3608,1389,58,20,455,169,216,95,239,74,74,,,,1000,455,903,413,10,3,47,26,40,13,42,51,24
E02006348,Guildford 005,Middle Super Output Areas and Intermediate Zones,MSOAIZ,GU,8449,3456,6370,2686,2722,1401,3648,1285,125,49,930,371,471,204,459,167,167,,,,959,314,814,257,33,15,58,23,54,19,57,65,36
E02006349,Guildford 006,Middle Super Output Areas and Intermediate Zones,MSOAIZ,GU,7798,3106,5018,2080,1490,770,3528,1310,348,123,791,333,323,176,468,157,157,,,,1574,548,1478,512,4,2,49,21,43,13,36,67,22
E02006350,Guildford 007,Middle Super Output Areas and Intermediate Zones,MSOAIZ,GU,6179,2400,3074,1198,891,426,2183,772,106,40,2070,849,1850,742,220,107,107,,,,860,274,770,244,15,4,59,21,16,5,30,69,39
E02006351,Guildford 008,Middle Super Output Areas and Intermediate Zones,MSOAIZ,GU,8239,3404,5862,2342,2006,1001,3856,1341,73,30,998,448,816,322,182,126,126,,,,1225,540,1161,513,15,4,30,20,19,3,27,81,44
E02006352,Guildford 009,Middle Super Output Areas and Intermediate Zones,MSOAIZ,GU,6077,2274,3969,1557,1360,665,2609,892,144,47,689,288,649,279,40,9,9,,,,1236,357,1172,337,6,2,36,12,22,6,20,39,25
E02006353,Guildford 010,Middle Super Output Areas and Intermediate Zones,MSOAIZ,GU,6127,2612,4021,1729,1423,752,2598,977,45,18,1554,651,719,320,835,331,331,,,,480,196,445,178,0,0,27,15,8,3,18,27,18
E02006354,Guildford 011,Middle Super Output Areas and Intermediate Zones,MSOAIZ,GU,8871,3599,7485,2965,3268,1608,4217,1357,45,28,164,81,79,45,85,36,36,,,,1128,495,1062,462,25,10,40,22,1,1,33,49,30
E02006355,Guildford 012,Middle Super Output Areas and Intermediate Zones,MSOAIZ,GU,6292,2368,2297,940,845,438,1452,502,39,16,2445,976,2230,898,215,78,78,,,,1456,406,1306,364,50,10,59,19,41,13,42,55,30
E02006356,Guildford 013,Middle Super Output Areas and Intermediate Zones,MSOAIZ,GU,10352,4977,4906,2346,1887,1057,3019,1289,165,98,1067,576,352,214,715,362,362,,,,4091,1895,3840,1792,77,24,121,58,53,21,103,123,62
E02006357,Guildford 014,Middle Super Output Areas and Intermediate Zones,MSOAIZ,GU,6133,2636,5065,2145,1784,936,3281,1209,46,22,553,268,423,221,130,47,47,,,,429,181,379,160,12,3,33,15,5,3,21,40,20
E02006358,Guildford 015,Middle Super Output Areas and Intermediate Zones,MSOAIZ,GU,6187,2472,3676,1465,1431,698,2245,767,88,61,648,337,541,284,107,53,53,,,,1717,578,1537,511,15,6,67,25,98,36,67,58,31
E02006359,Guildford 016,Middle Super Output Areas and Intermediate Zones,MSOAIZ,GU,5858,2559,4450,1871,2206,1085,2244,786,1,1,324,191,209,125,115,66,66,,,,1026,461,953,428,19,10,34,17,20,6,33,57,35
E02006360,Guildford 017,Middle Super Output Areas and Intermediate Zones,MSOAIZ,GU,7787,3220,5829,2338,2585,1235,3244,1103,158,65,847,389,700,338,147,51,51,,,,797,352,714,311,43,20,24,12,16,9,41,156,76
E02006361,Guildford 018,Middle Super Output Areas and Intermediate Zones,MSOAIZ,RH,5451,2247,4085,1643,1987,948,2098,695,39,18,473,206,281,122,192,84,84,,,,730,320,665,291,25,11,27,12,13,6,29,124,60
E02006362,Mole Valley 001,Middle Super Output Areas and Intermediate Zones,MSOAIZ,KT,6600,2677,5497,2187,2484,1252,3013,935,19,10,542,245,76,32,466,213,213,,,,454,196,389,173,26,7,33,14,6,2,23,88,39
E02006363,Mole Valley 002,Middle Super Output Areas and Intermediate Zones,MSOAIZ,KT,5741,2340,4914,1952,2019,1012,2895,940,10,8,308,171,41,26,267,145,145,,,,485,197,443,180,18,4,18,11,6,2,17,24,12
E02006364,Mole Valley 003,Middle Super Output Areas and Intermediate Zones,MSOAIZ,KT,6976,3177,3644,1603,1108,604,2536,999,175,92,1779,798,244,113,1535,685,685,,,,1283,637,1160,583,35,14,69,34,19,6,54,95,47
E02006365,Mole Valley 004,Middle Super Output Areas and Intermediate Zones,MSOAIZ,KT,5679,2535,4477,1962,2083,1130,2394,832,35,19,296,155,24,11,272,144,144,,,,803,366,726,326,44,20,27,17,6,3,40,68,33
E02006366,Mole Valley 005,Middle Super Output Areas and Intermediate Zones,MSOAIZ,KT,7909,3112,7026,2769,3041,1489,3985,1280,13,4,315,124,39,14,276,110,110,,,,511,194,471,176,15,6,25,12,0,0,18,44,21
E02006367,Mole Valley 006,Middle Super Output Areas and Intermediate Zones,MSOAIZ,KT,5741,2444,4585,1899,2253,1150,2332,749,15,5,695,339,71,40,624,299,299,,,,407,182,337,156,4,3,51,18,15,5,26,39,19
E02006368,Mole Valley 007,Middle Super Output Areas and Intermediate Zones,MSOAIZ,RH,5572,2396,4572,1908,2047,1096,2525,812,3,1,481,259,56,34,425,225,225,,,,465,204,411,178,20,9,24,12,10,5,26,51,24
E02006369,Mole Valley 008,Middle Super Output Areas and Intermediate Zones,MSOAIZ,RH,6398,2866,5089,2236,2622,1408,2467,828,34,21,405,215,44,26,361,189,189,,,,767,344,581,276,93,35,13,7,80,26,68,103,50
E02006370,Mole Valley 009,Middle Super Output Areas and Intermediate Zones,MSOAIZ,RH,5956,2646,4606,1960,1807,973,2799,987,32,12,350,221,49,26,301,195,195,,,,878,403,780,362,25,10,48,23,25,8,41,90,50
E02006371,Mole Valley 010,Middle Super Output Areas and Intermediate Zones,MSOAIZ,RH,6800,3025,4758,2000,1922,1027,2836,973,60,33,762,420,91,43,671,377,377,,,,1144,535,1057,489,27,10,56,34,4,2,46,76,37
E02006372,Mole Valley 011,Middle Super Output Areas and Intermediate Zones,MSOAIZ,RH,6349,2703,3848,1628,1385,729,2463,899,147,64,1667,720,189,83,1478,637,637,,,,650,273,595,247,15,6,25,13,15,7,26,37,18
E02006373,Mole Valley 012,Middle Super Output Areas and Intermediate Zones,MSOAIZ,RH,7467,3039,5203,2089,2240,1075,2963,1014,65,28,853,364,55,28,798,336,336,,,,1154,474,1046,427,16,7,66,29,26,11,47,192,84
E02006374,Mole Valley 013,Middle Super Output Areas and Intermediate Zones,MSOAIZ,RH,6797,2868,5296,2169,2119,1066,3177,1103,68,34,679,342,100,55,579,287,287,,,,635,265,530,222,28,12,41,20,36,11,43,119,58
E02006375,Reigate and Banstead 001,Middle Super Output Areas and Intermediate Zones,MSOAIZ,SM,6189,2381,5478,2073,2055,988,3423,1085,11,5,308,145,51,18,257,127,127,,,,371,147,340,132,13,4,17,10,1,1,15,21,11
E02006376,Reigate and Banstead 002,Middle Super Output Areas and Intermediate Zones,MSOAIZ,SM,7829,3349,6490,2726,2631,1431,3859,1295,84,39,512,255,102,43,410,212,212,,,,689,295,614,268,25,6,50,21,0,0,27,54,34
E02006377,Reigate and Banstead 003,Middle Super Output Areas and Intermediate Zones,MSOAIZ,SM,5782,2287,5102,2023,2098,1064,3004,959,15,11,296,119,61,24,235,95,95,,,,361,129,314,112,4,1,24,9,19,7,17,8,5
E02006378,Reigate and Banstead 004,Middle Super Output Areas and Intermediate Zones,MSOAIZ,SM,8681,3325,7230,2733,2399,1140,4831,1593,145,58,591,239,103,39,488,200,200,,,,664,265,598,239,17,4,37,17,12,5,26,51,30
E02006379,Reigate and Banstead 005,Middle Super Output Areas and Intermediate Zones,MSOAIZ,KT,5830,2519,3350,1453,956,569,2394,884,184,86,1851,812,391,166,1460,646,646,,,,425,154,388,138,0,0,34,13,3,3,16,20,14
E02006380,Reigate and Banstead 006,Middle Super Output Areas and Intermediate Zones,MSOAIZ,KT,6906,2798,6103,2431,2525,1258,3578,1173,2,2,193,100,37,16,156,84,84,,,,534,227,477,202,13,5,27,15,17,5,25,74,38
E02006381,Reigate and Banstead 007,Middle Super Output Areas and Intermediate Zones,MSOAIZ,SM,6751,2767,5822,2337,2412,1182,3410,1155,18,8,308,147,75,28,233,119,119,,,,531,239,496,224,10,4,16,7,9,4,15,72,36
E02006382,Reigate and Banstead 008,Middle Super Output Areas and Intermediate Zones,MSOAIZ,RH,6404,2574,4040,1593,1172,608,2868,985,41,17,1726,731,521,213,1205,518,518,,,,561,211,509,187,15,6,31,14,6,4,24,36,22
E02006383,Reigate and Banstead 009,Middle Super Output Areas and Intermediate Zones,MSOAIZ,RH,8716,3836,6924,2954,2882,1484,4042,1470,24,13,223,111,43,14,180,97,97,,,,1394,687,1317,645,17,8,52,28,8,6,42,151,71
E02006384,Reigate and Banstead 010,Middle Super Output Areas and Intermediate Zones,MSOAIZ,RH,9943,4197,6180,2556,2325,1209,3855,1347,125,66,1869,792,483,177,1386,615,615,,,,1708,754,1606,706,20,8,70,34,12,6,48,61,29
E02006385,Reigate and Banstead 011,Middle Super Output Areas and Intermediate Zones,MSOAIZ,RH,9823,4284,6067,2614,1666,866,4401,1748,367,177,858,309,121,47,737,262,262,,,,2485,1157,2356,1106,22,7,92,37,15,7,51,46,27
E02006386,Reigate and Banstead 012,Middle Super Output Areas and Intermediate Zones,MSOAIZ,RH,7760,3164,5934,2305,2089,1036,3845,1269,17,5,654,346,52,25,602,321,321,,,,1073,471,1004,440,16,5,38,19,15,7,31,82,37
E02006387,Reigate and Banstead 013,Middle Super Output Areas and Intermediate Zones,MSOAIZ,RH,6427,2585,4385,1738,1525,784,2860,954,70,30,1436,592,316,124,1120,468,468,,,,494,207,431,180,1,1,52,22,10,4,27,42,18
E02006388,Reigate and Banstead 014,Middle Super Output Areas and Intermediate Zones,MSOAIZ,RH,8728,3553,6300,2515,1836,941,4464,1574,108,41,1047,449,244,89,803,360,360,,,,1242,528,1171,493,11,3,52,27,8,5,35,31,20
E02006389,Reigate and Banstead 015,Middle Super Output Areas and Intermediate Zones,MSOAIZ,RH,6737,2747,4971,2005,1853,961,3118,1044,22,11,1120,463,361,142,759,321,321,,,,567,241,515,218,18,8,32,13,2,2,23,57,27
E02006390,Reigate and Banstead 016,Middle Super Output Areas and Intermediate Zones,MSOAIZ,RH,7848,3134,5803,2322,2063,1067,3740,1255,31,12,1298,528,273,107,1025,421,421,,,,687,254,625,230,6,3,52,20,4,1,24,29,18
E02006391,Reigate and Banstead 017,Middle Super Output Areas and Intermediate Zones,MSOAIZ,RH,5907,2336,4637,1834,1499,753,3138,1081,66,32,183,66,8,3,175,63,63,,,,978,385,921,362,5,1,48,20,4,2,23,43,19
E02006392,Reigate and Banstead 018,Middle Super Output Areas and Intermediate Zones,MSOAIZ,RH,8085,3587,5184,2274,1932,1052,3252,1222,112,60,861,401,173,70,688,331,331,,,,1873,818,1759,771,18,7,69,31,27,9,47,55,34
E02006393,Runnymede 001,Middle Super Output Areas and Intermediate Zones,MSOAIZ,TW,6384,2709,3452,1531,1297,729,2155,802,54,27,612,323,369,201,243,122,122,,,,2197,789,2108,752,21,8,45,22,23,7,37,69,39
E02006394,Runnymede 002,Middle Super Output Areas and Intermediate Zones,MSOAIZ,TW,8208,3333,4043,1705,1650,848,2393,857,31,11,1394,664,944,391,450,273,273,,,,2611,889,2430,817,80,28,42,22,59,22,72,129,64
E02006395,Runnymede 003,Middle Super Output Areas and Intermediate Zones,MSOAIZ,TW,9080,3800,6188,2553,1935,975,4253,1578,86,42,1614,682,1402,587,212,95,95,,,,1135,483,1051,441,21,8,54,28,9,6,42,57,40
E02006396,Runnymede 004,Middle Super Output Areas and Intermediate Zones,MSOAIZ,TW,5551,2426,4344,1901,1931,1048,2413,853,45,21,524,197,318,135,206,62,62,,,,564,264,505,233,22,12,25,13,12,6,31,74,43
E02006397,Runnymede 005,Middle Super Output Areas and Intermediate Zones,MSOAIZ,TW,5801,2323,4201,1743,1958,982,2243,761,58,31,209,78,163,65,46,13,13,,,,1183,398,1088,359,61,24,16,7,18,8,39,150,73
E02006398,Runnymede 006,Middle Super Output Areas and Intermediate Zones,MSOAIZ,KT,7558,3348,4700,2057,1622,854,3078,1203,125,62,1513,665,1053,474,460,191,191,,,,1114,513,1050,478,12,6,34,18,18,11,35,106,51
E02006399,Runnymede 007,Middle Super Output Areas and Intermediate Zones,MSOAIZ,KT,10547,4574,7894,3424,2950,1637,4944,1787,145,59,1146,495,768,321,378,174,174,,,,1260,549,1113,486,22,11,83,33,42,19,63,102,47
E02006400,Runnymede 008,Middle Super Output Areas and Intermediate Zones,MSOAIZ,KT,5558,2374,3958,1700,1708,870,2250,830,32,18,708,314,104,45,604,269,269,,,,799,309,565,230,145,46,11,5,78,28,79,61,33
E02006401,Runnymede 009,Middle Super Output Areas and Intermediate Zones,MSOAIZ,KT,9117,3958,6793,2893,2409,1304,4384,1589,79,34,1092,509,914,426,178,83,83,,,,1096,480,1016,439,23,11,46,24,11,6,41,57,42
E02006402,Runnymede 010,Middle Super Output Areas and Intermediate Zones,MSOAIZ,KT,9542,3869,7931,3224,3064,1580,4867,1644,55,21,694,283,606,252,88,31,31,,,,775,300,672,257,57,19,44,23,2,1,43,87,41
E02006403,Spelthorne 001,Middle Super Output Areas and Intermediate Zones,MSOAIZ,TW,6035,2622,3483,1468,1164,585,2319,883,200,90,1454,684,173,85,1281,599,599,,,,848,358,798,335,5,3,40,18,5,2,23,50,22
E02006404,Spelthorne 002,Middle Super Output Areas and Intermediate Zones,MSOAIZ,TW,6563,2476,3687,1451,1142,573,2545,878,218,88,1811,635,244,87,1567,548,548,,,,804,277,744,257,13,3,44,16,3,1,20,43,25
E02006405,Spelthorne 003,Middle Super Output Areas and Intermediate Zones,MSOAIZ,TW,10050,3995,8214,3267,2993,1490,5221,1777,82,29,358,142,45,21,313,121,121,,,,1320,524,1249,496,19,7,44,19,8,2,28,76,33
E02006406,Spelthorne 004,Middle Super Output Areas and Intermediate Zones,MSOAIZ,TW,7811,3528,4645,2041,1610,847,3035,1194,91,41,814,418,59,34,755,384,384,,,,2177,985,2040,927,24,12,85,35,28,11,58,84,43
E02006407,Spelthorne 005,Middle Super Output Areas and Intermediate Zones,MSOAIZ,TW,8771,3584,6956,2802,2655,1364,4301,1438,60,20,677,321,93,51,584,270,270,,,,1015,403,952,377,10,3,50,20,3,3,26,63,38
E02006408,Spelthorne 006,Middle Super Output Areas and Intermediate Zones,MSOAIZ,TW,8223,3486,6165,2612,2137,1147,4028,1465,156,58,650,285,86,39,564,246,246,,,,1216,510,1132,470,16,5,62,33,6,2,40,36,21
E02006409,Spelthorne 007,Middle Super Output Areas and Intermediate Zones,MSOAIZ,TW,6714,2712,4460,1768,1459,746,3001,1022,70,31,1596,682,198,89,1398,593,593,,,,539,195,508,184,0,0,28,10,3,1,11,49,36
E02006410,Spelthorne 008,Middle Super Output Areas and Intermediate Zones,MSOAIZ,TW,7987,3163,4954,1955,1510,758,3444,1197,97,40,1833,734,241,92,1592,642,642,,,,1022,391,944,365,30,7,46,17,2,2,26,81,43
E02006411,Spelthorne 009,Middle Super Output Areas and Intermediate Zones,MSOAIZ,TW,7095,3033,6035,2553,2578,1344,3457,1209,52,25,250,111,15,9,235,102,102,,,,727,326,673,295,8,3,43,25,3,3,31,31,18
E02006412,Spelthorne 010,Middle Super Output Areas and Intermediate Zones,MSOAIZ,TW,6790,2831,5473,2256,2343,1186,3130,1070,72,33,445,197,83,35,362,162,162,,,,751,317,682,285,19,9,42,17,8,6,32,49,28
E02006413,Spelthorne 011,Middle Super Output Areas and Intermediate Zones,MSOAIZ,TW,5999,2496,4809,1976,1837,989,2972,987,38,14,724,313,100,43,624,270,270,,,,404,177,386,166,5,2,11,7,2,2,11,24,16
E02006414,Spelthorne 012,Middle Super Output Areas and Intermediate Zones,MSOAIZ,TW,6139,2539,4837,2007,1841,955,2996,1052,109,42,685,306,73,41,612,265,265,,,,462,156,421,139,4,2,32,13,5,2,17,46,28
E02006415,Spelthorne 013,Middle Super Output Areas and Intermediate Zones,MSOAIZ,TW,6660,3047,5527,2515,2539,1419,2988,1096,58,29,157,83,21,10,136,73,73,,,,847,385,715,337,68,23,31,15,33,10,48,71,35
E02006416,Surrey Heath 001,Middle Super Output Areas and Intermediate Zones,MSOAIZ,SL,8117,3398,6765,2766,2854,1420,3911,1346,16,7,491,242,66,35,425,207,207,,,,720,320,643,283,42,16,33,19,2,2,37,125,63
E02006417,Surrey Heath 002,Middle Super Output Areas and Intermediate Zones,MSOAIZ,GU,5508,2332,4215,1733,1321,700,2894,1033,7,4,552,265,54,27,498,238,238,,,,685,303,627,281,32,9,18,8,8,5,22,49,27
E02006418,Surrey Heath 003,Middle Super Output Areas and Intermediate Zones,MSOAIZ,GU,6756,2778,5898,2398,2224,1133,3674,1265,10,5,266,116,29,16,237,100,100,,,,558,245,527,229,1,1,26,13,4,2,16,24,14
E02006419,Surrey Heath 004,Middle Super Output Areas and Intermediate Zones,MSOAIZ,GU,7902,3079,4257,1664,1366,682,2891,982,121,48,2269,878,295,117,1974,761,761,,,,1195,459,824,338,229,77,53,13,89,31,121,60,30
E02006420,Surrey Heath 005,Middle Super Output Areas and Intermediate Zones,MSOAIZ,GU,7282,2788,6125,2335,2278,1114,3847,1221,27,11,97,36,8,4,89,32,32,,,,965,380,854,340,53,19,35,14,23,7,40,68,26
E02006421,Surrey Heath 006,Middle Super Output Areas and Intermediate Zones,MSOAIZ,GU,7948,2998,6988,2614,2388,1141,4600,1473,23,11,170,77,38,14,132,63,63,,,,665,257,583,224,45,15,19,9,18,9,33,102,39
E02006422,Surrey Heath 007,Middle Super Output Areas and Intermediate Zones,MSOAIZ,GU,6026,2344,5206,2016,1638,820,3568,1196,26,9,110,50,10,2,100,48,48,,,,662,256,618,237,14,4,22,12,8,3,19,22,13
E02006423,Surrey Heath 008,Middle Super Output Areas and Intermediate Zones,MSOAIZ,GU,10143,4111,6481,2573,2162,1133,4319,1440,212,99,1690,680,223,90,1467,590,590,,,,1677,713,1549,662,52,20,57,24,19,7,51,83,46
E02006424,Surrey Heath 009,Middle Super Output Areas and Intermediate Zones,MSOAIZ,GU,6159,2360,5437,2088,2067,1007,3370,1081,26,9,175,67,18,8,157,59,59,,,,494,180,457,164,5,1,29,13,3,2,16,27,16
E02006425,Surrey Heath 010,Middle Super Output Areas and Intermediate Zones,MSOAIZ,GU,6074,2354,4438,1723,1644,812,2794,911,18,8,884,367,120,46,764,321,321,,,,676,226,613,200,21,8,31,13,11,5,26,58,30
E02006426,Surrey Heath 011,Middle Super Output Areas and Intermediate Zones,MSOAIZ,GU,5717,2266,4726,1865,1596,797,3130,1068,79,35,308,123,39,15,269,108,108,,,,568,225,512,203,19,8,37,14,0,0,22,36,18
E02006427,Surrey Heath 012,Middle Super Output Areas and Intermediate Zones,MSOAIZ,GU,6808,2738,4808,1994,1722,909,3086,1085,51,23,455,188,43,20,412,168,168,,,,1437,509,655,259,424,131,64,21,294,98,250,57,24
E02006429,Tandridge 002,Middle Super Output Areas and Intermediate Zones,MSOAIZ,CR,7209,3149,5598,2373,2110,1080,3488,1293,193,108,307,150,209,91,98,59,59,,,,1079,494,1039,477,3,2,34,13,3,2,17,32,24
E02006430,Tandridge 003,Middle Super Output Areas and Intermediate Zones,MSOAIZ,CR,8793,3473,6702,2626,1926,988,4776,1638,122,51,1104,459,376,176,728,283,283,,,,810,311,705,265,23,9,70,33,12,4,46,55,26
E02006431,Tandridge 004,Middle Super Output Areas and Intermediate Zones,MSOAIZ,RH,9978,4265,7627,3213,2902,1516,4725,1697,89,40,687,317,549,258,138,59,59,,,,1446,621,1338,573,59,20,43,24,6,4,48,129,74
E02006432,Tandridge 005,Middle Super Output Areas and Intermediate Zones,MSOAIZ,CR,5319,2193,4522,1789,1787,895,2735,894,10,5,243,169,197,133,46,36,36,,,,502,204,454,185,10,3,29,12,9,4,19,42,26
E02006433,Tandridge 006,Middle Super Output Areas and Intermediate Zones,MSOAIZ,TN,9226,3760,7468,2962,3341,1653,4127,1309,19,7,545,282,429,215,116,67,67,,,,1085,453,980,413,49,15,54,23,2,2,40,109,56
E02006434,Tandridge 007,Middle Super Output Areas and Intermediate Zones,MSOAIZ,RH,6006,2358,4267,1663,1531,761,2736,902,38,16,1238,497,896,364,342,133,133,,,,430,167,391,150,15,7,23,9,1,1,17,33,15
E02006435,Tandridge 008,Middle Super Output Areas and Intermediate Zones,MSOAIZ,RH,5664,2361,4100,1682,1594,787,2506,895,40,19,850,380,608,270,242,110,110,,,,604,253,531,224,30,13,28,11,15,5,29,70,27
E02006436,Tandridge 009,Middle Super Output Areas and Intermediate Zones,MSOAIZ,RH,5832,2386,4253,1714,1524,776,2729,938,40,16,924,401,754,343,170,58,58,,,,533,221,450,190,41,15,26,12,16,4,31,82,34
E02006437,Tandridge 010,Middle Super Output Areas and Intermediate Zones,MSOAIZ,TN,7791,3199,6000,2405,2405,1215,3595,1190,30,17,813,374,705,319,108,55,55,,,,846,351,630,256,133,52,70,37,13,6,95,102,52
E02006438,Tandridge 011,Middle Super Output Areas and Intermediate Zones,MSOAIZ,RH,7711,3151,6279,2491,2403,1216,3876,1275,32,18,545,238,243,105,302,133,133,,,,719,333,614,279,34,16,36,18,35,20,54,136,71
E02006439,Waverley 001,Middle Super Output Areas and Intermediate Zones,MSOAIZ,GU,5851,2490,4639,1907,1719,869,2920,1038,86,35,599,304,436,204,163,100,100,,,,469,210,438,195,8,4,19,9,4,2,15,58,34
E02006440,Waverley 002,Middle Super Output Areas and Intermediate Zones,MSOAIZ,GU,7126,2844,5547,2260,2028,1042,3519,1218,11,5,837,294,274,99,563,195,195,,,,691,262,641,244,0,0,48,17,2,1,18,40,23
E02006441,Waverley 003,Middle Super Output Areas and Intermediate Zones,MSOAIZ,GU,7161,3296,4109,1882,1787,1002,2322,880,149,79,1313,639,940,459,373,180,180,,,,1515,651,1428,609,9,8,50,26,28,8,42,75,45
E02006442,Waverley 004,Middle Super Output Areas and Intermediate Zones,MSOAIZ,GU,5819,2290,5022,1955,2226,1097,2796,858,9,3,152,71,137,57,15,14,14,,,,504,222,447,194,28,12,21,12,8,4,28,132,39
E02006443,Waverley 005,Middle Super Output Areas and Intermediate Zones,MSOAIZ,GU,7210,3141,4511,1930,1701,915,2810,1015,112,54,1728,766,1338,632,390,134,134,,,,803,361,732,333,12,4,38,15,21,9,28,56,30
E02006444,Waverley 006,Middle Super Output Areas and Intermediate Zones,MSOAIZ,GU,6679,2718,5071,2001,1868,945,3203,1056,42,20,853,415,762,354,91,61,61,,,,672,258,634,239,1,1,30,16,7,2,19,41,24
E02006445,Waverley 007,Middle Super Output Areas and Intermediate Zones,MSOAIZ,GU,6497,2995,4663,2056,1827,969,2836,1087,34,19,209,122,134,82,75,40,40,,,,1449,728,1257,643,128,47,55,32,9,6,85,142,70
E02006446,Waverley 008,Middle Super Output Areas and Intermediate Zones,MSOAIZ,GU,6561,2730,5241,2119,2436,1191,2805,928,19,11,614,305,590,297,24,8,8,,,,584,246,516,215,35,14,16,10,17,7,31,103,49
E02006447,Waverley 009,Middle Super Output Areas and Intermediate Zones,MSOAIZ,GU,5994,2412,4847,1956,1941,976,2906,980,28,11,469,180,346,117,123,63,63,,,,552,226,509,207,7,3,34,14,2,2,19,98,39
E02006448,Waverley 010,Middle Super Output Areas and Intermediate Zones,MSOAIZ,GU,7146,2818,5514,2176,2182,1054,3332,1122,44,18,966,373,771,300,195,73,73,,,,580,233,519,208,16,6,42,18,3,1,25,42,18
E02006449,Waverley 011,Middle Super Output Areas and Intermediate Zones,MSOAIZ,GU,6880,2894,5161,2087,2207,1125,2954,962,125,60,889,439,748,376,141,63,63,,,,605,257,552,236,20,5,30,15,3,1,21,100,51
E02006450,Waverley 012,Middle Super Output Areas and Intermediate Zones,MSOAIZ,GU,6488,2563,4954,1930,2241,1052,2713,878,64,30,561,228,439,183,122,45,45,,,,688,279,510,208,95,36,40,18,43,17,71,221,96
E02006451,Waverley 013,Middle Super Output Areas and Intermediate Zones,MSOAIZ,GU,10163,4372,7768,3248,3387,1781,4381,1467,86,48,1099,541,759,402,340,139,139,,,,1028,450,870,372,103,53,46,21,9,4,78,182,85
E02006453,Waverley 015,Middle Super Output Areas and Intermediate Zones,MSOAIZ,RH,7556,3235,5855,2480,2688,1427,3167,1053,81,33,753,362,527,264,226,98,98,,,,657,258,532,212,58,20,59,21,8,5,46,210,102
E02006454,Waverley 016,Middle Super Output Areas and Intermediate Zones,MSOAIZ,GU,6521,2766,4945,2049,2090,1098,2855,951,66,27,877,392,728,306,149,86,86,,,,578,266,528,241,10,6,33,17,7,2,25,55,32
E02006455,Waverley 017,Middle Super Output Areas and Intermediate Zones,MSOAIZ,GU,5634,2445,4148,1718,1354,724,2794,994,41,18,660,338,595,307,65,31,31,,,,718,337,668,309,12,6,15,10,23,12,28,67,34
E02006456,Woking 001,Middle Super Output Areas and Intermediate Zones,MSOAIZ,KT,7662,3174,5888,2437,1931,1029,3957,1408,48,17,870,378,732,333,138,45,45,,,,808,315,738,282,7,3,63,30,0,0,33,48,27
E02006457,Woking 002,Middle Super Output Areas and Intermediate Zones,MSOAIZ,KT,9019,3615,7480,2979,3254,1594,4226,1385,4,3,229,128,99,45,130,83,83,,,,1245,476,996,397,150,43,27,13,72,23,79,61,29
E02006458,Woking 003,Middle Super Output Areas and Intermediate Zones,MSOAIZ,KT,9009,3498,7406,2820,3047,1437,4359,1383,12,6,606,269,281,108,325,161,161,,,,913,366,860,346,11,2,19,10,23,8,20,72,37
E02006459,Woking 004,Middle Super Output Areas and Intermediate Zones,MSOAIZ,GU,10563,3618,5438,1706,1636,608,3802,1098,110,40,2553,1049,2040,873,513,176,176,,,,2327,777,2124,709,35,11,121,43,47,14,68,135,46
E02006460,Woking 005,Middle Super Output Areas and Intermediate Zones,MSOAIZ,GU,9484,3945,6123,2590,1760,942,4363,1648,198,77,1863,743,1503,627,360,116,116,,,,1234,503,1162,473,7,2,65,28,0,0,30,66,32
E02006461,Woking 006,Middle Super Output Areas and Intermediate Zones,MSOAIZ,GU,6566,2696,4882,1994,2148,1083,2734,911,26,15,305,121,94,33,211,88,88,,,,1267,533,1204,504,21,9,26,14,16,6,29,86,33
E02006462,Woking 007,Middle Super Output Areas and Intermediate Zones,MSOAIZ,GU,8412,3339,6104,2415,1753,898,4351,1517,200,83,828,319,505,205,323,114,114,,,,1226,497,1145,464,13,4,64,27,4,2,33,54,25
E02006463,Woking 008,Middle Super Output Areas and Intermediate Zones,MSOAIZ,GU,9445,4393,5345,2444,1950,1127,3395,1317,88,49,566,330,277,163,289,167,167,,,,3361,1517,3239,1465,34,11,64,32,24,9,52,85,53
E02006464,Woking 009,Middle Super Output Areas and Intermediate Zones,MSOAIZ,GU,6847,2882,5148,2081,1743,877,3405,1204,76,26,892,446,484,276,408,170,170,,,,697,307,635,281,9,4,45,18,8,4,26,34,22
E02006465,Woking 010,Middle Super Output Areas and Intermediate Zones,MSOAIZ,GU,6091,2509,4886,1966,1917,945,2969,1021,11,7,249,140,32,10,217,130,130,,,,908,376,846,354,18,5,43,16,1,1,22,37,20
E02006466,Woking 011,Middle Super Output Areas and Intermediate Zones,MSOAIZ,GU,8691,3355,5699,2286,1781,938,3918,1348,93,30,1999,691,1641,592,358,99,99,,,,849,319,756,286,14,6,58,20,21,7,33,51,29
E02006467,Woking 012,Middle Super Output Areas and Intermediate Zones,MSOAIZ,GU,6493,2443,5618,2111,2130,1001,3488,1110,53,15,226,90,94,43,132,47,47,,,,544,200,503,184,9,5,21,7,11,4,16,52,27
E02006468,North Warwickshire 001,Middle Super Output Areas and Intermediate Zones,MSOAIZ,CV,10384,4174,8335,3284,3127,1527,5208,1757,20,11,1032,465,913,417,119,48,48,,,,935,377,813,330,36,10,80,33,6,4,47,62,37
E02006469,North Warwickshire 002,Middle Super Output Areas and Intermediate Zones,MSOAIZ,CV,8660,3507,5574,2238,2140,1053,3434,1185,141,56,1824,738,1065,477,759,261,261,,,,1073,440,986,409,9,3,64,22,14,6,31,48,35
E02006470,North Warwickshire 003,Middle Super Output Areas and Intermediate Zones,MSOAIZ,CV,10929,4824,7043,3011,2928,1519,4115,1492,59,29,2500,1103,1777,804,723,299,299,,,,1221,611,1122,570,7,2,75,31,17,8,41,106,70
E02006471,North Warwickshire 004,Middle Super Output Areas and Intermediate Zones,MSOAIZ,B,6925,2864,5876,2366,2584,1231,3292,1135,38,22,485,237,313,161,172,76,76,,,,474,207,405,179,18,5,47,20,4,3,28,52,32
E02006472,North Warwickshire 005,Middle Super Output Areas and Intermediate Zones,MSOAIZ,CV,8845,3703,6342,2627,2466,1229,3876,1398,55,30,1386,577,829,388,557,189,189,,,,970,414,872,374,16,5,72,29,10,6,40,92,55
E02006473,North Warwickshire 006,Middle Super Output Areas and Intermediate Zones,MSOAIZ,B,9779,4275,7889,3303,3085,1575,4804,1728,55,27,692,387,461,257,231,130,130,,,,1065,507,969,455,12,7,76,39,8,6,52,78,51
E02006474,North Warwickshire 007,Middle Super Output Areas and Intermediate Zones,MSOAIZ,CV,5946,2465,4589,1857,1822,873,2767,984,4,1,423,212,367,183,56,29,29,,,,851,357,749,318,5,2,62,24,35,13,39,79,38
E02006475,Nuneaton and Bedworth 001,Middle Super Output Areas and Intermediate Zones,MSOAIZ,CV,7220,3080,6290,2574,2756,1416,3534,1158,5,4,369,262,353,257,16,5,5,,,,521,219,467,196,4,1,50,22,0,0,23,35,21
E02006476,Nuneaton and Bedworth 002,Middle Super Output Areas and Intermediate Zones,MSOAIZ,CV,7275,3075,4036,1753,1443,774,2593,979,42,14,2047,802,1562,639,485,163,163,,,,1079,462,965,415,28,10,70,32,16,5,47,71,44
E02006477,Nuneaton and Bedworth 003,Middle Super Output Areas and Intermediate Zones,MSOAIZ,CV,6863,2733,6242,2470,2539,1267,3703,1203,22,9,97,50,36,19,61,31,31,,,,473,188,418,166,4,2,51,20,0,0,22,29,16
E02006478,Nuneaton and Bedworth 004,Middle Super Output Areas and Intermediate Zones,MSOAIZ,CV,8233,3176,6882,2630,1851,882,5031,1748,85,30,405,146,218,83,187,63,63,,,,836,353,758,316,6,2,65,32,7,3,37,25,17
E02006479,Nuneaton and Bedworth 005,Middle Super Output Areas and Intermediate Zones,MSOAIZ,CV,8663,3982,5014,2051,1965,954,3049,1097,90,42,1194,736,630,426,564,310,310,,,,2288,1107,2088,1027,18,5,127,53,55,22,80,77,46
E02006480,Nuneaton and Bedworth 006,Middle Super Output Areas and Intermediate Zones,MSOAIZ,CV,7452,3184,4782,1957,1606,832,3176,1125,17,8,1726,784,1463,651,263,133,133,,,,856,395,784,364,5,2,54,24,13,5,31,71,40
E02006481,Nuneaton and Bedworth 007,Middle Super Output Areas and Intermediate Zones,MSOAIZ,CV,6873,2885,4701,1934,1614,838,3087,1096,5,3,1114,487,1021,453,93,34,34,,,,1004,432,911,396,0,0,92,35,1,1,36,49,29
E02006482,Nuneaton and Bedworth 008,Middle Super Output Areas and Intermediate Zones,MSOAIZ,CV,6666,2797,5158,2113,1714,899,3444,1214,61,27,386,188,128,76,258,112,112,,,,1016,444,929,408,7,2,68,30,12,4,36,45,25
E02006483,Nuneaton and Bedworth 009,Middle Super Output Areas and Intermediate Zones,MSOAIZ,CV,7721,3235,4221,1702,1739,836,2482,866,63,20,2252,1023,1935,847,317,176,176,,,,1095,439,1011,400,0,0,77,35,7,4,39,90,51
E02006484,Nuneaton and Bedworth 010,Middle Super Output Areas and Intermediate Zones,MSOAIZ,CV,7565,3292,5009,2125,1642,874,3367,1251,9,6,1244,588,643,364,601,224,224,,,,1254,546,1094,483,16,5,134,54,10,4,63,49,27
E02006485,Nuneaton and Bedworth 011,Middle Super Output Areas and Intermediate Zones,MSOAIZ,CV,6876,2807,6448,2637,2803,1395,3645,1242,16,9,25,9,21,7,4,2,2,,,,370,142,339,131,3,1,23,9,5,1,11,17,10
E02006486,Nuneaton and Bedworth 012,Middle Super Output Areas and Intermediate Zones,MSOAIZ,CV,7005,2966,5696,2314,2060,1037,3636,1277,47,25,548,307,480,281,68,26,26,,,,665,293,589,262,7,3,67,27,2,1,31,49,27
E02006487,Nuneaton and Bedworth 013,Middle Super Output Areas and Intermediate Zones,MSOAIZ,CV,6591,2985,4299,1834,1779,961,2520,873,12,4,1697,859,1219,595,478,264,264,,,,512,239,450,209,1,1,53,24,8,5,30,71,49
E02006488,Nuneaton and Bedworth 014,Middle Super Output Areas and Intermediate Zones,MSOAIZ,CV,6137,2794,5233,2322,2773,1465,2460,857,6,6,418,243,329,185,89,58,58,,,,436,199,365,171,36,12,28,13,7,3,28,44,24
E02006489,Nuneaton and Bedworth 015,Middle Super Output Areas and Intermediate Zones,MSOAIZ,CV,8034,3341,5596,2265,1763,868,3833,1397,107,44,1013,467,850,383,163,84,84,,,,1272,537,1168,483,5,3,90,46,9,5,54,46,28
E02006490,Nuneaton and Bedworth 016,Middle Super Output Areas and Intermediate Zones,MSOAIZ,CV,7424,3074,5743,2381,1997,1043,3746,1338,32,14,872,344,631,241,241,103,103,,,,733,311,641,278,0,0,88,32,4,1,33,44,24
E02006492,Rugby 001,Middle Super Output Areas and Intermediate Zones,MSOAIZ,LE,10629,4405,8045,3253,3190,1542,4855,1711,28,17,840,383,548,255,292,128,128,,,,1604,694,1072,514,255,79,46,24,231,77,180,112,58
E02006493,Rugby 002,Middle Super Output Areas and Intermediate Zones,MSOAIZ,CV,9041,3671,5924,2383,1586,770,4338,1613,134,56,1752,737,875,364,877,373,373,,,,1190,474,1119,446,4,1,43,19,24,8,28,41,21
E02006494,Rugby 003,Middle Super Output Areas and Intermediate Zones,MSOAIZ,CV,6655,3075,3177,1389,1258,656,1919,733,31,17,2068,1021,1311,724,757,297,297,,,,1304,593,1233,559,11,3,48,25,12,6,34,75,55
E02006495,Rugby 004,Middle Super Output Areas and Intermediate Zones,MSOAIZ,CV,7636,3195,6354,2616,2701,1352,3653,1264,73,33,644,280,465,204,179,76,76,,,,511,235,456,214,7,2,32,14,16,5,21,54,31
E02006496,Rugby 005,Middle Super Output Areas and Intermediate Zones,MSOAIZ,CV,6893,3033,3793,1616,1177,613,2616,1003,59,28,692,351,416,246,276,105,105,,,,2314,1012,2188,948,9,6,114,56,3,2,64,35,26
E02006497,Rugby 006,Middle Super Output Areas and Intermediate Zones,MSOAIZ,CV,7721,3388,4274,1890,1392,741,2882,1149,159,83,1374,586,597,308,777,278,278,,,,1866,800,1749,748,11,7,84,37,22,8,52,48,29
E02006498,Rugby 007,Middle Super Output Areas and Intermediate Zones,MSOAIZ,CV,11321,4435,8306,3234,2300,1160,6006,2074,163,68,1721,668,529,242,1192,426,426,,,,1072,437,1010,412,4,2,57,22,1,1,25,59,28
E02006499,Rugby 008,Middle Super Output Areas and Intermediate Zones,MSOAIZ,CV,5913,2463,5176,2152,1992,1057,3184,1095,90,43,116,50,22,10,94,40,40,,,,502,199,469,182,7,2,23,14,3,1,17,29,19
E02006500,Rugby 009,Middle Super Output Areas and Intermediate Zones,MSOAIZ,CV,5121,2358,3276,1418,1512,799,1764,619,21,11,824,438,414,229,410,209,209,,,,839,421,657,343,125,52,39,15,18,11,78,161,70
E02006501,Rugby 010,Middle Super Output Areas and Intermediate Zones,MSOAIZ,CV,8964,3895,7057,2944,2776,1469,4281,1475,8,3,979,535,844,461,135,74,74,,,,837,360,732,313,12,6,80,36,13,5,47,83,53
E02006502,Rugby 011,Middle Super Output Areas and Intermediate Zones,MSOAIZ,CV,10554,4648,7969,3491,3690,1991,4279,1500,72,32,1486,665,1263,565,223,100,100,,,,959,409,880,373,13,5,59,27,7,4,36,68,51
E02006503,Rugby 012,Middle Super Output Areas and Intermediate Zones,MSOAIZ,NN,7732,3309,6437,2700,3277,1622,3160,1078,21,12,623,279,567,252,56,27,27,,,,562,269,477,229,28,9,43,22,14,9,40,89,49
E02006504,Stratford-on-Avon 001,Middle Super Output Areas and Intermediate Zones,MSOAIZ,B,5613,2287,4637,1858,2267,1076,2370,782,40,14,354,162,12,6,342,156,156,,,,484,210,399,170,36,16,31,16,18,8,40,98,43
E02006505,Stratford-on-Avon 002,Middle Super Output Areas and Intermediate Zones,MSOAIZ,CV,6624,3044,5145,2330,2722,1479,2423,851,32,18,773,369,73,39,700,330,330,,,,614,288,573,269,3,2,30,13,8,4,19,60,39
E02006506,Stratford-on-Avon 003,Middle Super Output Areas and Intermediate Zones,MSOAIZ,B,5824,2513,4259,1786,1815,937,2444,849,55,24,824,374,93,43,731,331,331,,,,624,284,545,246,4,1,62,28,13,9,38,62,45
E02006507,Stratford-on-Avon 004,Middle Super Output Areas and Intermediate Zones,MSOAIZ,NN,8982,3759,6824,2760,2670,1360,4154,1400,119,48,1241,553,92,40,1149,513,513,,,,753,368,673,325,13,7,59,31,8,5,43,45,30
E02006508,Stratford-on-Avon 005,Middle Super Output Areas and Intermediate Zones,MSOAIZ,OX,9401,3920,7351,2998,3102,1540,4249,1458,85,36,959,420,77,36,882,384,384,,,,881,405,763,359,12,6,63,25,43,15,46,125,61
E02006509,Stratford-on-Avon 006,Middle Super Output Areas and Intermediate Zones,MSOAIZ,B,6023,2752,3964,1733,1703,928,2261,805,37,18,1211,583,123,60,1088,523,523,,,,733,369,673,333,17,9,36,20,7,7,36,78,49
E02006510,Stratford-on-Avon 007,Middle Super Output Areas and Intermediate Zones,MSOAIZ,CV,6071,2606,5106,2172,2636,1322,2470,850,59,24,340,152,31,19,309,133,133,,,,514,229,447,201,18,10,42,16,7,2,28,52,29
E02006511,Stratford-on-Avon 008,Middle Super Output Areas and Intermediate Zones,MSOAIZ,CV,8932,3815,6689,2796,2976,1489,3713,1307,60,21,1197,550,98,42,1099,508,508,,,,862,384,731,325,52,20,65,31,14,8,59,124,64
E02006512,Stratford-on-Avon 009,Middle Super Output Areas and Intermediate Zones,MSOAIZ,CV,10742,5000,6355,2912,2759,1512,3596,1400,175,86,1973,947,185,91,1788,856,856,,,,2169,1012,2038,946,17,11,107,49,7,6,66,70,43
E02006513,Stratford-on-Avon 010,Middle Super Output Areas and Intermediate Zones,MSOAIZ,CV,7385,3168,5739,2424,2408,1272,3331,1152,142,57,435,209,24,10,411,199,199,,,,1020,447,917,399,19,11,65,28,19,9,48,49,31
E02006514,Stratford-on-Avon 011,Middle Super Output Areas and Intermediate Zones,MSOAIZ,CV,8829,4226,6122,2840,3064,1697,3058,1143,92,52,782,444,42,28,740,416,416,,,,1738,841,1637,786,22,12,60,30,19,13,55,95,49
E02006515,Stratford-on-Avon 012,Middle Super Output Areas and Intermediate Zones,MSOAIZ,WR,9054,3769,6943,2833,2937,1472,4006,1361,147,73,991,428,81,39,910,389,389,,,,901,390,809,351,35,13,29,14,28,12,39,72,45
E02006516,Stratford-on-Avon 013,Middle Super Output Areas and Intermediate Zones,MSOAIZ,OX,8816,3740,6255,2624,2759,1360,3496,1264,36,18,1243,536,137,55,1106,481,481,,,,1150,485,882,389,132,46,55,21,81,29,96,132,77
E02006517,Stratford-on-Avon 014,Middle Super Output Areas and Intermediate Zones,MSOAIZ,GL,7305,3088,5359,2242,2280,1145,3079,1097,84,32,845,364,50,33,795,331,331,,,,914,400,784,353,57,17,48,20,25,10,47,103,50
E02006518,Stratford-on-Avon 015,Middle Super Output Areas and Intermediate Zones,MSOAIZ,OX,9252,4241,6687,2996,3248,1726,3439,1270,90,40,1330,622,108,53,1222,569,569,,,,977,484,870,433,23,10,66,33,18,8,51,168,99
E02006519,Warwick 001,Middle Super Output Areas and Intermediate Zones,MSOAIZ,CV,7501,3487,5930,2654,2769,1490,3161,1164,11,8,421,236,331,178,90,58,58,,,,1073,546,980,507,0,0,76,32,17,7,39,66,43
E02006520,Warwick 002,Middle Super Output Areas and Intermediate Zones,MSOAIZ,CV,8388,3658,6973,2939,2796,1475,4177,1464,98,60,377,186,251,129,126,57,57,,,,891,441,820,408,9,3,42,24,20,6,33,49,32
E02006521,Warwick 003,Middle Super Output Areas and Intermediate Zones,MSOAIZ,CV,7408,3236,6149,2640,2897,1561,3252,1079,14,9,659,292,561,227,98,65,65,,,,547,269,501,248,0,0,41,19,5,2,21,39,26
E02006522,Warwick 004,Middle Super Output Areas and Intermediate Zones,MSOAIZ,CV,5441,2327,4431,1821,2065,988,2366,833,14,8,328,154,257,115,71,39,39,,,,554,283,479,254,21,9,42,16,12,4,29,114,61
E02006523,Warwick 005,Middle Super Output Areas and Intermediate Zones,MSOAIZ,CV,9921,4228,8004,3297,3623,1805,4381,1492,47,22,661,315,499,235,162,80,80,,,,1097,531,916,440,84,44,38,19,59,28,91,112,63
E02006524,Warwick 006,Middle Super Output Areas and Intermediate Zones,MSOAIZ,CV,5579,2442,3100,1303,1190,619,1910,684,13,6,1962,928,1791,855,171,73,73,,,,447,165,418,152,0,0,28,12,1,1,13,57,40
E02006525,Warwick 007,Middle Super Output Areas and Intermediate Zones,MSOAIZ,CV,12592,5845,8037,3475,3335,1750,4702,1725,96,45,1009,634,644,372,365,262,262,,,,3353,1635,3187,1549,33,15,103,54,30,17,86,97,56
E02006526,Warwick 008,Middle Super Output Areas and Intermediate Zones,MSOAIZ,CV,8283,3630,6038,2592,2446,1269,3592,1323,30,15,1291,606,865,407,426,199,199,,,,883,388,805,349,0,0,73,35,5,4,39,41,29
E02006527,Warwick 009,Middle Super Output Areas and Intermediate Zones,MSOAIZ,CV,8802,4115,5784,2521,2355,1246,3429,1275,19,13,745,427,333,184,412,243,243,,,,2172,1109,2064,1058,13,5,73,37,22,9,51,82,45
E02006528,Warwick 010,Middle Super Output Areas and Intermediate Zones,MSOAIZ,CV,11001,4693,5636,2459,2229,1107,3407,1352,170,65,1472,805,716,334,756,471,471,,,,3636,1317,3520,1262,11,3,81,43,24,9,55,87,47
E02006529,Warwick 011,Middle Super Output Areas and Intermediate Zones,MSOAIZ,CV,11238,5238,6490,2885,2082,1128,4408,1757,287,142,2304,1030,1988,884,316,146,146,,,,2025,1110,1821,1008,60,28,125,65,19,9,102,132,71
E02006530,Warwick 012,Middle Super Output Areas and Intermediate Zones,MSOAIZ,CV,10366,4480,7859,3236,2901,1513,4958,1723,56,29,994,463,304,173,690,290,290,,,,1390,713,1318,676,17,6,50,27,5,4,37,67,39
E02006531,Warwick 013,Middle Super Output Areas and Intermediate Zones,MSOAIZ,CV,9828,3865,3623,1508,1297,604,2326,904,48,16,2549,1122,2153,888,396,234,234,,,,3505,1159,3368,1096,11,6,101,45,25,12,63,103,60
E02006532,Warwick 014,Middle Super Output Areas and Intermediate Zones,MSOAIZ,CV,8721,3587,7100,2861,2610,1279,4490,1582,93,40,657,284,343,156,314,128,128,,,,804,367,717,334,34,10,41,18,12,5,33,67,35
E02006533,Warwick 015,Middle Super Output Areas and Intermediate Zones,MSOAIZ,CV,9521,3848,7348,2920,2695,1323,4653,1597,76,32,910,384,442,200,468,184,184,,,,1111,480,1040,445,8,5,62,29,1,1,35,76,32
E02006534,Adur 001,Middle Super Output Areas and Intermediate Zones,MSOAIZ,BN,8497,3544,6689,2816,2582,1437,4107,1379,20,9,985,397,951,382,34,15,15,,,,767,295,678,253,7,3,76,36,6,3,42,36,27
E02006535,Adur 002,Middle Super Output Areas and Intermediate Zones,MSOAIZ,BN,6568,2829,5818,2527,2448,1314,3370,1213,23,9,187,70,117,49,70,21,21,,,,502,196,436,171,0,0,66,25,0,0,25,38,27
E02006536,Adur 003,Middle Super Output Areas and Intermediate Zones,MSOAIZ,BN,6816,2875,5743,2418,2194,1189,3549,1229,41,16,303,139,238,119,65,20,20,,,,604,236,536,202,22,11,38,19,8,4,34,125,66
E02006537,Adur 004,Middle Super Output Areas and Intermediate Zones,MSOAIZ,BN,9988,4304,5651,2457,2010,1127,3641,1330,75,36,3029,1279,2133,966,896,313,313,,,,1157,481,1031,432,4,2,118,43,4,4,49,76,51
E02006538,Adur 005,Middle Super Output Areas and Intermediate Zones,MSOAIZ,BN,8464,4059,6127,2888,2531,1467,3596,1421,92,49,541,289,256,163,285,126,126,,,,1621,790,1515,731,6,4,91,49,9,6,59,83,43
E02006539,Adur 006,Middle Super Output Areas and Intermediate Zones,MSOAIZ,BN,7038,3132,5156,2289,2131,1179,3025,1110,17,6,1182,520,970,455,212,65,65,,,,613,280,517,235,8,3,88,42,0,0,45,70,37
E02006540,Adur 007,Middle Super Output Areas and Intermediate Zones,MSOAIZ,BN,5654,2589,3995,1840,1690,978,2305,862,19,8,1022,456,489,228,533,228,228,,,,579,265,520,236,2,2,52,23,5,4,29,39,20
E02006541,Adur 008,Middle Super Output Areas and Intermediate Zones,MSOAIZ,BN,7399,3625,5358,2648,2440,1500,2918,1148,55,21,842,373,635,290,207,83,83,,,,1072,536,1002,502,8,4,61,29,1,1,34,72,47
E02006542,Arun 001,Middle Super Output Areas and Intermediate Zones,MSOAIZ,BN,5608,2629,3990,1858,2005,1112,1985,746,19,9,462,237,317,143,145,94,94,,,,938,433,813,382,63,16,36,21,26,14,51,199,92
E02006543,Arun 002,Middle Super Output Areas and Intermediate Zones,MSOAIZ,BN,5528,2432,4145,1863,1879,1043,2266,820,32,9,545,233,468,204,77,29,29,,,,701,276,610,238,31,11,48,23,12,4,38,105,51
E02006544,Arun 003,Middle Super Output Areas and Intermediate Zones,MSOAIZ,PO,9849,4128,8011,3355,3278,1722,4733,1633,54,26,747,302,524,228,223,74,74,,,,944,398,848,351,12,6,76,37,8,4,47,93,47
E02006545,Arun 004,Middle Super Output Areas and Intermediate Zones,MSOAIZ,BN,8240,3458,4900,2161,1772,1003,3128,1158,187,90,1931,754,1110,490,821,264,264,,,,1159,416,1069,379,18,5,67,30,5,2,37,63,37
E02006546,Arun 005,Middle Super Output Areas and Intermediate Zones,MSOAIZ,BN,9526,4201,7069,3124,3052,1721,4017,1403,130,54,1218,569,588,318,630,251,251,,,,1024,401,935,357,11,7,57,26,21,11,44,85,53
E02006547,Arun 006,Middle Super Output Areas and Intermediate Zones,MSOAIZ,PO,5462,2300,4052,1739,1598,855,2454,884,86,35,770,298,387,161,383,137,137,,,,489,196,407,164,25,6,56,25,1,1,32,65,32
E02006548,Arun 007,Middle Super Output Areas and Intermediate Zones,MSOAIZ,BN,9394,4133,7301,3256,2763,1612,4538,1644,129,61,581,246,159,96,422,150,150,,,,1323,538,1241,500,14,5,60,29,8,4,38,60,32
E02006549,Arun 008,Middle Super Output Areas and Intermediate Zones,MSOAIZ,BN,5798,2864,5236,2606,3238,1861,1998,745,4,2,71,34,59,31,12,3,3,,,,453,201,422,185,2,1,28,14,1,1,16,34,21
E02006550,Arun 009,Middle Super Output Areas and Intermediate Zones,MSOAIZ,BN,9327,4118,7458,3349,3515,1991,3943,1358,35,18,858,332,366,159,492,173,173,,,,915,383,804,338,7,2,97,39,7,4,45,61,36
E02006551,Arun 010,Middle Super Output Areas and Intermediate Zones,MSOAIZ,BN,7559,4049,6440,3413,4164,2505,2276,908,38,19,224,166,52,39,172,127,127,,,,799,410,731,371,3,1,59,33,6,5,39,58,41
E02006552,Arun 011,Middle Super Output Areas and Intermediate Zones,MSOAIZ,BN,6778,3462,3202,1632,1413,878,1789,754,77,38,468,218,118,65,350,153,153,,,,2967,1533,2864,1480,20,10,60,32,23,11,53,64,41
E02006553,Arun 012,Middle Super Output Areas and Intermediate Zones,MSOAIZ,PO,7273,3139,5688,2517,2264,1261,3424,1256,76,36,439,172,170,85,269,87,87,,,,1015,379,924,342,0,0,83,34,8,3,37,55,35
E02006554,Arun 013,Middle Super Output Areas and Intermediate Zones,MSOAIZ,PO,6657,3140,5461,2564,2698,1556,2763,1008,19,10,342,177,248,133,94,44,44,,,,764,343,692,314,2,1,61,25,9,3,29,71,46
E02006555,Arun 014,Middle Super Output Areas and Intermediate Zones,MSOAIZ,PO,7362,3164,4183,1827,1540,841,2643,986,79,35,1482,669,766,397,716,272,272,,,,1550,597,1448,552,0,0,86,37,16,8,45,68,36
E02006556,Arun 015,Middle Super Output Areas and Intermediate Zones,MSOAIZ,PO,8154,3659,7208,3223,3655,2019,3553,1204,12,5,99,55,60,40,39,15,15,,,,810,358,757,332,3,1,44,22,6,3,26,25,18
E02006557,Arun 016,Middle Super Output Areas and Intermediate Zones,MSOAIZ,PO,7017,2828,3976,1571,1222,626,2754,945,81,37,1637,689,956,413,681,276,276,,,,1269,499,1156,462,12,2,87,30,14,5,37,54,32
E02006558,Arun 017,Middle Super Output Areas and Intermediate Zones,MSOAIZ,PO,9102,4850,3993,2166,2043,1292,1950,874,102,52,570,383,216,143,354,240,240,,,,4326,2179,4122,2086,34,10,128,66,42,17,93,111,70
E02006559,Arun 018,Middle Super Output Areas and Intermediate Zones,MSOAIZ,PO,8031,3831,7131,3455,4301,2427,2830,1028,13,9,60,25,6,1,54,24,24,,,,792,322,723,288,5,3,56,24,8,7,34,35,20
E02006560,Arun 019,Middle Super Output Areas and Intermediate Zones,MSOAIZ,PO,9079,4321,7439,3575,3901,2256,3538,1319,53,21,669,327,168,79,501,248,248,,,,840,349,723,306,27,8,86,32,4,3,43,78,49
E02006561,Chichester 001,Middle Super Output Areas and Intermediate Zones,MSOAIZ,GU,6480,2636,4837,1924,2003,983,2834,941,65,33,875,381,144,61,731,320,320,,,,593,248,506,211,34,13,39,20,14,4,37,110,50
E02006562,Chichester 002,Middle Super Output Areas and Intermediate Zones,MSOAIZ,RH,5855,2387,4745,1900,2201,1055,2544,845,24,10,518,234,66,30,452,204,204,,,,426,177,363,150,20,7,34,15,9,5,27,142,66
E02006563,Chichester 003,Middle Super Output Areas and Intermediate Zones,MSOAIZ,PO,5549,2392,4044,1689,2084,1017,1960,672,11,7,662,316,92,43,570,273,273,,,,690,303,569,257,81,29,37,15,3,2,46,142,77
E02006564,Chichester 004,Middle Super Output Areas and Intermediate Zones,MSOAIZ,PO,7145,3424,4516,2155,2323,1336,2193,819,67,37,1451,673,248,108,1203,565,565,,,,990,491,891,437,22,13,51,28,26,13,54,121,68
E02006565,Chichester 005,Middle Super Output Areas and Intermediate Zones,MSOAIZ,RH,7799,3502,4806,2139,2513,1325,2293,814,46,21,1143,508,192,84,951,424,424,,,,1421,649,1164,542,131,55,81,30,45,22,107,383,185
E02006566,Chichester 006,Middle Super Output Areas and Intermediate Zones,MSOAIZ,PO,7499,3356,5038,2299,2804,1492,2234,807,73,36,1064,481,171,73,893,408,408,,,,1117,439,966,372,87,40,41,19,23,8,67,207,101
E02006567,Chichester 007,Middle Super Output Areas and Intermediate Zones,MSOAIZ,PO,7404,3149,5582,2350,2801,1401,2781,949,45,22,878,377,199,78,679,299,299,,,,755,324,641,282,57,20,34,13,23,9,42,144,76
E02006568,Chichester 008,Middle Super Output Areas and Intermediate Zones,MSOAIZ,PO,10336,4791,4268,2077,2024,1217,2244,860,196,90,3125,1494,455,211,2670,1283,1283,,,,2600,1040,2199,848,123,60,137,56,141,76,192,147,90
E02006569,Chichester 009,Middle Super Output Areas and Intermediate Zones,MSOAIZ,PO,7203,3197,4954,2270,2749,1480,2205,790,41,19,519,224,61,25,458,199,199,,,,1601,634,869,414,355,102,59,26,318,92,220,88,50
E02006570,Chichester 010,Middle Super Output Areas and Intermediate Zones,MSOAIZ,PO,8065,4130,4239,2244,2181,1375,2058,869,45,27,1332,738,177,92,1155,646,646,,,,2339,1062,2181,988,39,17,100,46,19,11,74,110,59
E02006571,Chichester 011,Middle Super Output Areas and Intermediate Zones,MSOAIZ,PO,7519,3343,5944,2614,2803,1520,3141,1094,43,23,591,280,125,56,466,224,224,,,,876,391,801,360,13,7,50,20,12,4,31,65,35
E02006572,Chichester 012,Middle Super Output Areas and Intermediate Zones,MSOAIZ,PO,8984,3807,5247,2299,2141,1170,3106,1129,116,59,2292,924,365,149,1927,775,775,,,,1178,461,1035,405,42,14,88,36,13,6,56,151,64
E02006573,Chichester 013,Middle Super Output Areas and Intermediate Zones,MSOAIZ,PO,10538,4871,8044,3718,4440,2455,3604,1263,104,45,875,377,100,43,775,334,334,,,,1335,629,1211,569,27,16,82,36,15,8,60,180,102
E02006574,Chichester 014,Middle Super Output Areas and Intermediate Zones,MSOAIZ,PO,10461,4863,8105,3803,4174,2384,3931,1419,63,26,896,400,77,31,819,369,369,,,,1314,575,1184,521,27,10,90,37,13,7,54,83,59
E02006575,Crawley 001,Middle Super Output Areas and Intermediate Zones,MSOAIZ,RH,8119,2942,4417,1617,1496,651,2921,966,115,46,2239,882,1655,631,584,251,251,,,,1249,355,1184,333,3,1,38,15,24,6,22,99,42
E02006576,Crawley 002,Middle Super Output Areas and Intermediate Zones,MSOAIZ,RH,7946,3228,6381,2556,2143,1074,4238,1482,54,23,480,224,417,179,63,45,45,,,,996,410,958,388,9,3,24,15,5,4,22,35,15
E02006577,Crawley 003,Middle Super Output Areas and Intermediate Zones,MSOAIZ,RH,7766,3301,4120,1686,1371,725,2749,961,82,47,2402,1104,2268,1024,134,80,80,,,,1030,384,945,348,2,1,67,30,16,5,36,132,80
E02006578,Crawley 004,Middle Super Output Areas and Intermediate Zones,MSOAIZ,RH,9610,4141,4974,2150,1654,912,3320,1238,249,124,2207,966,1704,722,503,244,244,,,,2099,855,1967,797,32,11,84,37,16,10,58,81,46
E02006579,Crawley 005,Middle Super Output Areas and Intermediate Zones,MSOAIZ,RH,7864,3269,4786,1974,1732,918,3054,1056,105,51,1462,637,1216,507,246,130,130,,,,1440,567,1373,539,11,3,42,17,14,8,28,71,40
E02006580,Crawley 006,Middle Super Output Areas and Intermediate Zones,MSOAIZ,RH,7935,3281,5342,2211,1677,871,3665,1340,76,31,1542,654,1318,564,224,90,90,,,,924,354,844,325,10,3,53,21,17,5,29,51,31
E02006581,Crawley 007,Middle Super Output Areas and Intermediate Zones,MSOAIZ,RH,8380,3650,4589,1999,1645,886,2944,1113,77,41,1735,827,1052,461,683,366,366,,,,1899,740,1795,690,22,13,61,28,21,9,50,80,43
E02006582,Crawley 008,Middle Super Output Areas and Intermediate Zones,MSOAIZ,RH,7932,3008,6337,2372,1526,723,4811,1649,118,59,275,106,39,14,236,92,92,,,,1174,459,1114,435,6,3,51,20,3,1,24,28,12
E02006583,Crawley 009,Middle Super Output Areas and Intermediate Zones,MSOAIZ,RH,8879,3809,6170,2534,1882,989,4288,1545,50,22,1203,612,1033,526,170,86,86,,,,1366,588,1277,539,0,0,84,44,5,5,49,90,53
E02006584,Crawley 010,Middle Super Output Areas and Intermediate Zones,MSOAIZ,RH,7442,2900,3586,1335,554,275,3032,1060,113,40,2831,1184,2752,1149,79,35,35,,,,858,310,802,289,1,1,52,19,3,1,21,54,31
E02006585,Crawley 011,Middle Super Output Areas and Intermediate Zones,MSOAIZ,RH,7770,3096,4668,1856,1419,769,3249,1087,62,25,2189,912,2098,855,91,57,57,,,,769,255,718,235,3,1,47,18,1,1,20,82,48
E02006586,Crawley 012,Middle Super Output Areas and Intermediate Zones,MSOAIZ,RH,7836,2662,4123,1490,784,340,3339,1150,78,23,2309,731,2187,697,122,34,34,,,,1265,394,1179,366,5,1,74,25,7,2,28,61,24
E02006587,Crawley 013,Middle Super Output Areas and Intermediate Zones,MSOAIZ,RH,8380,3440,3513,1448,701,347,2812,1101,114,56,3391,1355,1600,625,1791,730,730,,,,1299,543,1210,505,5,2,70,30,14,6,38,63,38
E02006588,Horsham 001,Middle Super Output Areas and Intermediate Zones,MSOAIZ,RH,7322,3198,5123,2115,1930,944,3193,1171,41,19,1011,531,54,30,957,501,501,,,,1041,484,928,431,50,21,56,27,7,5,53,106,49
E02006589,Horsham 002,Middle Super Output Areas and Intermediate Zones,MSOAIZ,RH,11206,4465,9568,3755,3499,1691,6069,2064,76,38,555,271,16,11,539,260,260,,,,973,380,907,354,14,5,48,19,4,2,26,34,21
E02006590,Horsham 003,Middle Super Output Areas and Intermediate Zones,MSOAIZ,RH,8474,3646,6021,2504,2273,1176,3748,1328,51,21,1158,510,118,57,1040,453,453,,,,1137,561,1046,507,23,16,59,32,9,6,54,107,50
E02006591,Horsham 004,Middle Super Output Areas and Intermediate Zones,MSOAIZ,RH,7902,3428,5705,2434,2153,1157,3552,1277,42,21,899,371,108,40,791,331,331,,,,1195,565,1114,529,6,3,71,30,4,3,36,61,37
E02006592,Horsham 005,Middle Super Output Areas and Intermediate Zones,MSOAIZ,RH,5925,2430,4739,1873,2023,959,2716,914,46,22,524,250,55,24,469,226,226,,,,513,233,400,175,69,36,28,15,16,7,58,103,52
E02006593,Horsham 006,Middle Super Output Areas and Intermediate Zones,MSOAIZ,RH,10213,4697,6068,2655,2253,1281,3815,1374,72,36,2160,1122,247,114,1913,1008,1008,,,,1815,826,1707,771,25,12,68,37,15,6,55,98,58
E02006594,Horsham 007,Middle Super Output Areas and Intermediate Zones,MSOAIZ,RH,6701,2892,5231,2252,1917,1035,3314,1217,34,21,733,304,130,46,603,258,258,,,,669,293,614,271,2,1,42,17,11,4,22,34,22
E02006595,Horsham 008,Middle Super Output Areas and Intermediate Zones,MSOAIZ,RH,7662,3154,6248,2529,2891,1415,3357,1114,24,11,335,145,25,14,310,131,131,,,,802,350,632,278,120,44,32,18,18,10,72,253,119
E02006596,Horsham 009,Middle Super Output Areas and Intermediate Zones,MSOAIZ,RH,8692,3342,7240,2745,1959,979,5281,1766,118,58,698,270,37,18,661,252,252,,,,616,257,519,218,12,4,71,30,14,5,39,20,12
E02006597,Horsham 010,Middle Super Output Areas and Intermediate Zones,MSOAIZ,RH,9313,3945,6914,2883,2647,1376,4267,1507,68,38,1199,501,96,44,1103,457,457,,,,1001,453,890,403,42,18,61,27,8,5,50,131,70
E02006598,Horsham 011,Middle Super Output Areas and Intermediate Zones,MSOAIZ,RH,5398,2184,4346,1738,1641,802,2705,936,8,3,363,149,27,12,336,137,137,,,,578,242,504,213,22,9,40,15,12,5,29,103,52
E02006599,Horsham 012,Middle Super Output Areas and Intermediate Zones,MSOAIZ,RH,6975,3049,6183,2716,3364,1725,2819,991,27,11,209,95,20,10,189,85,85,,,,453,183,399,155,22,11,20,11,12,6,28,103,44
E02006600,Horsham 013,Middle Super Output Areas and Intermediate Zones,MSOAIZ,RH,9201,4324,6135,2883,2857,1635,3278,1248,36,15,1879,862,278,116,1601,746,746,,,,1019,498,872,427,38,17,68,36,41,18,71,132,66
E02006601,Horsham 014,Middle Super Output Areas and Intermediate Zones,MSOAIZ,RH,7933,3464,5636,2427,2647,1391,2989,1036,33,16,1228,570,145,75,1083,495,495,,,,946,405,824,352,32,14,74,32,16,7,53,90,46
E02006602,Horsham 015,Middle Super Output Areas and Intermediate Zones,MSOAIZ,RH,7225,2921,5749,2312,2230,1112,3519,1200,47,21,579,211,81,33,498,178,178,,,,719,317,654,282,18,10,36,18,11,7,35,131,60
E02006603,Horsham 016,Middle Super Output Areas and Intermediate Zones,MSOAIZ,BN,8491,3784,7082,3105,3350,1808,3732,1297,19,12,377,185,68,28,309,157,157,,,,928,433,872,406,2,1,49,23,5,3,27,85,49
E02006604,Mid Sussex 001,Middle Super Output Areas and Intermediate Zones,MSOAIZ,RH,12302,5493,7872,3378,2846,1546,5026,1832,123,58,2232,1025,149,82,2083,943,943,,,,1969,966,1855,911,18,7,80,40,16,8,55,106,66
E02006605,Mid Sussex 002,Middle Super Output Areas and Intermediate Zones,MSOAIZ,RH,6109,2429,4824,1870,1797,872,3027,998,34,15,315,156,8,4,307,152,152,,,,782,326,702,291,42,17,26,13,12,5,35,154,62
E02006606,Mid Sussex 003,Middle Super Output Areas and Intermediate Zones,MSOAIZ,RH,8069,3310,6792,2742,2344,1175,4448,1567,82,36,200,99,16,7,184,92,92,,,,935,405,869,368,8,3,54,32,4,2,37,60,28
E02006607,Mid Sussex 004,Middle Super Output Areas and Intermediate Zones,MSOAIZ,RH,7436,2981,6498,2578,2547,1291,3951,1287,23,6,238,106,15,8,223,98,98,,,,614,260,540,234,19,5,47,19,8,2,26,63,31
E02006608,Mid Sussex 005,Middle Super Output Areas and Intermediate Zones,MSOAIZ,RH,5749,2343,5089,2045,2092,1064,2997,981,25,13,261,131,18,7,243,124,124,,,,336,139,307,126,2,1,19,9,8,3,13,38,15
E02006609,Mid Sussex 006,Middle Super Output Areas and Intermediate Zones,MSOAIZ,RH,6777,2729,5154,2022,2417,1108,2737,914,22,8,664,298,34,13,630,285,285,,,,743,314,622,255,65,35,36,13,20,11,59,194,87
E02006610,Mid Sussex 007,Middle Super Output Areas and Intermediate Zones,MSOAIZ,RH,6851,2784,4703,1869,1808,890,2895,979,62,33,725,318,29,11,696,307,307,,,,1059,444,925,395,57,19,46,17,31,13,49,302,120
E02006611,Mid Sussex 008,Middle Super Output Areas and Intermediate Zones,MSOAIZ,RH,10026,4165,8635,3526,3800,1912,4835,1614,7,6,374,197,14,7,360,190,190,,,,913,383,847,353,16,8,39,18,11,4,30,97,53
E02006612,Mid Sussex 009,Middle Super Output Areas and Intermediate Zones,MSOAIZ,RH,9888,4656,6101,2760,2033,1131,4068,1629,155,64,772,423,22,13,750,410,410,,,,2773,1357,2648,1292,23,10,91,50,11,5,65,87,52
E02006613,Mid Sussex 010,Middle Super Output Areas and Intermediate Zones,MSOAIZ,RH,7218,3028,4467,1863,1523,814,2944,1049,168,61,1845,783,76,33,1769,750,750,,,,702,299,671,284,4,3,26,11,1,1,15,36,22
E02006614,Mid Sussex 011,Middle Super Output Areas and Intermediate Zones,MSOAIZ,RH,9990,4149,7543,3040,3115,1533,4428,1507,136,65,1135,543,45,20,1090,523,523,,,,1089,453,1004,414,7,5,69,29,9,5,39,87,48
E02006615,Mid Sussex 012,Middle Super Output Areas and Intermediate Zones,MSOAIZ,RH,6714,2608,5376,2069,1381,675,3995,1394,160,56,511,214,26,10,485,204,204,,,,658,265,621,249,0,0,35,14,2,2,16,9,4
E02006616,Mid Sussex 013,Middle Super Output Areas and Intermediate Zones,MSOAIZ,RH,8051,3264,6586,2698,2463,1272,4123,1426,100,37,715,265,35,19,680,246,246,,,,608,242,552,218,5,3,51,21,0,0,24,42,22
E02006617,Mid Sussex 014,Middle Super Output Areas and Intermediate Zones,MSOAIZ,RH,8989,3877,5871,2447,1929,1008,3942,1439,113,49,1548,746,62,36,1486,710,710,,,,1403,605,1295,557,19,9,75,33,14,6,48,54,30
E02006618,Mid Sussex 015,Middle Super Output Areas and Intermediate Zones,MSOAIZ,RH,5996,2377,5487,2189,2290,1125,3197,1064,20,7,48,21,13,2,35,19,19,,,,406,145,371,132,8,2,27,11,0,0,13,35,15
E02006619,Mid Sussex 016,Middle Super Output Areas and Intermediate Zones,MSOAIZ,RH,7982,3192,5734,2255,2122,1035,3612,1220,63,30,1103,439,40,13,1063,426,426,,,,904,391,753,336,54,19,79,26,18,10,55,178,77
E02006620,Mid Sussex 017,Middle Super Output Areas and Intermediate Zones,MSOAIZ,RH,9144,4024,7645,3307,3664,1957,3981,1350,38,17,673,328,24,10,649,318,318,,,,710,328,667,304,5,3,35,19,3,2,24,78,44
E02006621,Worthing 001,Middle Super Output Areas and Intermediate Zones,MSOAIZ,BN,7488,3330,6918,3049,3258,1782,3660,1267,11,6,93,60,20,11,73,49,49,,,,416,185,360,158,8,3,46,22,2,2,27,50,30
E02006622,Worthing 002,Middle Super Output Areas and Intermediate Zones,MSOAIZ,BN,7648,3466,6038,2697,2474,1373,3564,1324,25,11,637,333,73,39,564,294,294,,,,897,401,828,370,0,0,64,27,5,4,31,51,24
E02006623,Worthing 003,Middle Super Output Areas and Intermediate Zones,MSOAIZ,BN,7836,3340,5309,2325,1972,1094,3337,1231,19,8,1500,620,305,114,1195,506,506,,,,967,361,868,323,4,1,89,35,6,2,38,41,26
E02006624,Worthing 004,Middle Super Output Areas and Intermediate Zones,MSOAIZ,BN,7135,2862,6418,2524,2395,1227,4023,1297,14,6,41,16,5,2,36,14,14,,,,626,297,574,273,5,3,44,19,3,2,24,36,19
E02006625,Worthing 005,Middle Super Output Areas and Intermediate Zones,MSOAIZ,BN,8002,3295,6370,2532,1788,964,4582,1568,57,32,316,165,42,24,274,141,141,,,,1227,549,1102,496,5,2,101,44,19,7,53,32,17
E02006626,Worthing 006,Middle Super Output Areas and Intermediate Zones,MSOAIZ,BN,7403,3001,4166,1762,1209,678,2957,1084,47,21,2297,866,547,213,1750,653,653,,,,824,310,748,275,13,7,46,20,17,8,35,69,42
E02006627,Worthing 007,Middle Super Output Areas and Intermediate Zones,MSOAIZ,BN,8404,3758,6551,2880,2609,1467,3942,1413,29,13,816,411,238,111,578,300,300,,,,970,430,899,401,3,2,56,22,12,5,29,38,24
E02006628,Worthing 008,Middle Super Output Areas and Intermediate Zones,MSOAIZ,BN,8936,3969,5627,2366,1512,871,4115,1495,31,13,920,496,217,98,703,398,398,,,,2295,1055,2128,983,9,6,140,58,18,8,72,63,39
E02006629,Worthing 009,Middle Super Output Areas and Intermediate Zones,MSOAIZ,BN,7735,3391,4956,2115,1688,952,3268,1163,28,13,1328,599,457,199,871,400,400,,,,1375,631,1274,581,10,4,80,38,11,8,50,48,33
E02006630,Worthing 010,Middle Super Output Areas and Intermediate Zones,MSOAIZ,BN,7405,4164,3965,2136,1714,1137,2251,999,46,31,718,438,114,54,604,384,384,,,,2609,1513,2452,1418,10,3,122,74,25,18,95,67,46
E02006631,Worthing 011,Middle Super Output Areas and Intermediate Zones,MSOAIZ,PO,8939,4945,3968,2111,1614,1061,2354,1050,95,45,718,427,122,60,596,367,367,,,,4076,2314,3779,2162,64,30,176,92,57,30,152,82,48
E02006632,Worthing 012,Middle Super Output Areas and Intermediate Zones,MSOAIZ,BN,7878,3783,6222,2902,2768,1630,3454,1272,13,8,184,108,29,16,155,92,92,,,,1419,734,1347,695,0,0,67,36,5,3,39,40,31
E02006633,Worthing 013,Middle Super Output Areas and Intermediate Zones,MSOAIZ,BN,7943,3740,6844,3222,3657,2137,3187,1085,25,10,316,156,97,47,219,109,109,,,,711,322,645,289,8,4,56,27,2,2,33,47,30
E02006634,Wiltshire 012,Middle Super Output Areas and Intermediate Zones,MSOAIZ,SN,8484,3533,5834,2367,2770,1329,3064,1038,56,22,1036,481,99,43,937,438,438,,,,1149,487,942,397,112,45,66,31,29,14,90,409,176
E02006635,Wiltshire 019,Middle Super Output Areas and Intermediate Zones,MSOAIZ,SN,7561,3415,4636,2055,2252,1205,2384,850,24,15,1549,733,199,97,1350,636,636,,,,1100,496,872,411,155,51,55,25,18,9,85,252,116
E02006636,Wiltshire 024,Middle Super Output Areas and Intermediate Zones,MSOAIZ,SN,6804,3059,4491,2006,2071,1124,2420,882,84,38,1142,536,151,72,991,464,464,,,,878,387,745,327,60,24,42,21,31,15,60,209,92
E02006637,Wiltshire 025,Middle Super Output Areas and Intermediate Zones,MSOAIZ,SN,10604,4505,6707,2857,2340,1245,4367,1612,276,118,2126,868,217,84,1909,784,784,,,,1435,627,1173,526,76,27,103,47,83,27,101,60,35
E02006638,Wiltshire 026,Middle Super Output Areas and Intermediate Zones,MSOAIZ,SN,6241,3076,3751,1741,1849,1036,1902,705,22,14,1749,940,180,91,1569,849,849,,,,652,348,578,315,29,13,29,13,16,7,33,67,33
E02006639,Wiltshire 028,Middle Super Output Areas and Intermediate Zones,MSOAIZ,SN,8066,3391,5737,2396,2689,1316,3048,1080,62,24,1428,588,167,76,1261,512,512,,,,736,327,584,266,40,16,75,30,37,15,61,103,56
E02006640,Wiltshire 029,Middle Super Output Areas and Intermediate Zones,MSOAIZ,SP,7013,2941,4756,1968,2090,1034,2666,934,107,43,964,408,87,44,877,364,364,,,,986,426,784,344,73,30,42,20,87,32,82,200,96
E02006641,Wiltshire 034,Middle Super Output Areas and Intermediate Zones,MSOAIZ,SN,6988,2968,4966,2104,2058,1063,2908,1041,41,15,1040,443,90,40,950,403,403,,,,793,338,613,270,52,19,66,30,62,19,68,148,68
E02006642,Wiltshire 038,Middle Super Output Areas and Intermediate Zones,MSOAIZ,SP,5714,2412,3623,1562,1529,789,2094,773,26,12,906,380,96,45,810,335,335,,,,1086,418,580,248,277,92,40,13,189,65,170,73,40
E02006643,Wiltshire 041,Middle Super Output Areas and Intermediate Zones,MSOAIZ,SP,12151,4512,4000,1653,1077,573,2923,1080,124,56,2695,1079,384,152,2311,927,927,,,,5278,1698,1395,598,2342,650,61,26,1480,424,1100,54,26
E02006644,Wiltshire 001,Middle Super Output Areas and Intermediate Zones,MSOAIZ,SN,6694,2782,5197,2143,2124,1076,3073,1067,47,20,762,305,119,44,643,261,261,,,,608,269,546,243,14,6,36,16,12,4,26,80,45
E02006645,Wiltshire 002,Middle Super Output Areas and Intermediate Zones,MSOAIZ,SN,7104,2992,4921,2043,1907,983,3014,1060,62,27,1053,415,121,41,932,374,374,,,,997,468,907,429,39,12,30,16,21,11,39,71,39
E02006646,Wiltshire 003,Middle Super Output Areas and Intermediate Zones,MSOAIZ,SN,5447,2242,4423,1800,1831,938,2592,862,16,7,539,229,49,22,490,207,207,,,,420,180,345,151,11,5,48,19,16,5,29,49,26
E02006647,Wiltshire 004,Middle Super Output Areas and Intermediate Zones,MSOAIZ,SN,5884,2337,4866,1912,2270,1052,2596,860,22,9,313,124,32,13,281,111,111,,,,600,248,520,217,19,6,47,20,14,5,31,83,44
E02006648,Wiltshire 005,Middle Super Output Areas and Intermediate Zones,MSOAIZ,SN,5788,2398,4137,1707,1935,964,2202,743,36,14,513,221,44,22,469,199,199,,,,1009,410,654,282,151,51,20,11,184,66,128,93,46
E02006649,Wiltshire 006,Middle Super Output Areas and Intermediate Zones,MSOAIZ,SN,6759,2979,4604,1988,1787,962,2817,1026,59,29,1237,529,133,57,1104,472,472,,,,807,405,731,368,23,9,45,24,8,4,37,52,28
E02006650,Wiltshire 007,Middle Super Output Areas and Intermediate Zones,MSOAIZ,SN,10739,4387,7258,3103,3016,1579,4242,1524,39,16,691,277,62,27,629,250,250,,,,2649,940,885,365,1088,340,61,26,615,209,575,102,51
E02006651,Wiltshire 008,Middle Super Output Areas and Intermediate Zones,MSOAIZ,SN,6945,2760,5402,2123,2318,1102,3084,1021,29,12,522,216,61,22,461,194,194,,,,808,335,562,254,140,45,42,18,64,18,81,184,74
E02006652,Wiltshire 009,Middle Super Output Areas and Intermediate Zones,MSOAIZ,SN,9422,3703,7039,2772,2265,1152,4774,1620,24,10,1235,451,125,42,1110,409,409,,,,1075,441,1001,412,11,4,54,21,9,4,29,49,29
E02006653,Wiltshire 010,Middle Super Output Areas and Intermediate Zones,MSOAIZ,SN,9795,3989,7391,2987,2454,1278,4937,1709,68,25,1224,505,109,47,1115,458,458,,,,1053,434,963,396,16,5,64,29,10,4,38,59,38
E02006654,Wiltshire 011,Middle Super Output Areas and Intermediate Zones,MSOAIZ,SN,9150,4291,5359,2451,2251,1256,3108,1195,117,63,2419,1141,206,94,2213,1047,1047,,,,1180,586,1084,537,21,7,66,36,9,6,49,75,50
E02006655,Wiltshire 013,Middle Super Output Areas and Intermediate Zones,MSOAIZ,SN,6853,2703,5295,2057,2244,1040,3051,1017,19,8,467,189,51,22,416,167,167,,,,915,384,829,349,40,15,33,15,13,5,35,157,65
E02006656,Wiltshire 014,Middle Super Output Areas and Intermediate Zones,MSOAIZ,SN,7062,2867,5495,2179,1407,725,4088,1454,72,24,544,209,55,23,489,186,186,,,,929,442,865,411,1,1,56,26,7,4,31,22,13
E02006657,Wiltshire 015,Middle Super Output Areas and Intermediate Zones,MSOAIZ,SN,9782,3951,6277,2519,1592,838,4685,1681,156,61,1951,787,216,103,1735,684,684,,,,1258,516,1139,466,22,8,53,28,44,14,50,140,68
E02006658,Wiltshire 016,Middle Super Output Areas and Intermediate Zones,MSOAIZ,SN,7111,3162,5442,2401,1991,1118,3451,1283,35,16,809,363,72,31,737,332,332,,,,776,350,689,308,20,6,56,30,11,6,42,49,32
E02006659,Wiltshire 017,Middle Super Output Areas and Intermediate Zones,MSOAIZ,SN,7312,2997,4924,2065,2035,1045,2889,1020,27,12,728,307,67,32,661,275,275,,,,1566,575,589,252,584,194,71,26,322,103,323,67,38
E02006660,Wiltshire 018,Middle Super Output Areas and Intermediate Zones,MSOAIZ,SN,12726,5481,8508,3619,3425,1791,5083,1828,146,58,2120,939,243,107,1877,832,832,,,,1785,779,1452,654,134,46,108,45,91,34,125,167,86
E02006661,Wiltshire 045,Middle Super Output Areas and Intermediate Zones,MSOAIZ,SP,7596,2808,2625,1082,1015,504,1610,578,48,19,837,334,384,176,453,158,158,,,,4017,1342,613,256,1950,620,16,5,1438,461,1086,69,31
E02006662,Wiltshire 046,Middle Super Output Areas and Intermediate Zones,MSOAIZ,SP,5898,2367,3765,1581,1336,705,2429,876,29,12,1105,419,768,318,337,101,101,,,,955,333,557,214,211,60,31,11,156,48,119,44,22
E02006663,Wiltshire 048,Middle Super Output Areas and Intermediate Zones,MSOAIZ,SP,10535,4264,6066,2552,1920,1056,4146,1496,194,93,2244,861,1072,458,1172,403,403,,,,1970,723,1311,517,377,112,65,30,217,64,206,61,35
E02006664,Wiltshire 049,Middle Super Output Areas and Intermediate Zones,MSOAIZ,SP,6384,2683,4535,1920,2208,1113,2327,807,25,12,623,262,556,237,67,25,25,,,,1043,420,718,300,186,68,34,14,105,38,120,158,69
E02006665,Wiltshire 050,Middle Super Output Areas and Intermediate Zones,MSOAIZ,SP,6454,2953,4278,1970,2296,1244,1982,726,64,26,962,425,676,315,286,110,110,,,,985,445,836,385,57,26,48,19,44,15,60,165,87
E02006666,Wiltshire 051,Middle Super Output Areas and Intermediate Zones,MSOAIZ,SP,5566,2338,4104,1676,1591,837,2513,839,36,15,849,404,539,299,310,105,105,,,,531,213,474,185,2,1,53,26,2,1,28,46,30
E02006667,Wiltshire 052,Middle Super Output Areas and Intermediate Zones,MSOAIZ,SP,6369,2509,2725,1120,922,465,1803,655,68,24,2943,1110,2222,869,721,241,241,,,,575,222,445,174,8,3,70,30,52,15,48,58,33
E02006668,Wiltshire 053,Middle Super Output Areas and Intermediate Zones,MSOAIZ,SP,5937,2517,4376,1822,1836,961,2540,861,16,9,966,447,788,360,178,87,87,,,,528,214,445,182,18,7,40,18,25,7,32,51,25
E02006669,Wiltshire 054,Middle Super Output Areas and Intermediate Zones,MSOAIZ,SP,9699,4358,5901,2640,2889,1524,3012,1116,73,32,1537,698,1090,516,447,182,182,,,,1930,870,1461,689,294,106,57,27,118,48,181,258,118
E02006670,Wiltshire 055,Middle Super Output Areas and Intermediate Zones,MSOAIZ,SP,6575,3068,4001,1824,1418,824,2583,1000,88,33,595,330,187,112,408,218,218,,,,1800,830,1626,758,14,5,135,56,25,11,72,91,51
E02006671,Wiltshire 056,Middle Super Output Areas and Intermediate Zones,MSOAIZ,SP,5738,2791,3231,1588,1389,841,1842,747,54,22,584,298,409,203,175,95,95,,,,1763,834,1584,760,48,14,98,46,33,14,74,106,49
E02006672,Wiltshire 057,Middle Super Output Areas and Intermediate Zones,MSOAIZ,SP,6497,2728,4460,1918,2009,1077,2451,841,87,39,814,319,277,129,537,190,190,,,,989,377,662,266,212,72,52,18,63,21,111,147,75
E02006673,Wiltshire 058,Middle Super Output Areas and Intermediate Zones,MSOAIZ,SP,4922,2435,3088,1474,1653,943,1435,531,31,12,817,484,518,287,299,197,197,,,,868,402,750,355,42,15,41,18,35,14,47,118,63
E02006674,Wiltshire 059,Middle Super Output Areas and Intermediate Zones,MSOAIZ,SP,5569,2425,3184,1410,1276,716,1908,694,101,42,1284,563,664,295,620,268,268,,,,935,379,762,316,87,30,32,15,54,18,63,65,31
E02006675,Wiltshire 060,Middle Super Output Areas and Intermediate Zones,MSOAIZ,SP,7901,3229,6496,2626,2962,1444,3534,1182,41,15,488,208,328,145,160,63,63,,,,762,323,654,279,36,14,54,24,18,6,44,114,57
E02006676,Wiltshire 061,Middle Super Output Areas and Intermediate Zones,MSOAIZ,SP,5827,2658,3815,1750,2161,1127,1654,623,38,15,894,406,702,333,192,73,73,,,,899,397,779,351,39,17,62,23,19,6,46,181,90
E02006677,Wiltshire 062,Middle Super Output Areas and Intermediate Zones,MSOAIZ,SP,7662,3201,5941,2476,2921,1456,3020,1020,37,20,625,249,509,211,116,38,38,,,,924,383,810,336,36,14,57,24,21,9,47,135,73
E02006678,Wiltshire 020,Middle Super Output Areas and Intermediate Zones,MSOAIZ,SN,7344,3033,5246,2249,1886,1018,3360,1231,7,4,1175,432,110,49,1065,383,383,,,,879,325,798,290,1,1,69,30,11,4,35,37,23
E02006679,Wiltshire 021,Middle Super Output Areas and Intermediate Zones,MSOAIZ,SN,9519,3872,7501,3025,2880,1446,4621,1579,40,19,924,407,90,33,834,374,374,,,,961,377,827,323,50,17,72,33,12,4,54,93,44
E02006680,Wiltshire 022,Middle Super Output Areas and Intermediate Zones,MSOAIZ,SN,7239,3251,4988,2136,1870,1024,3118,1112,27,23,1212,570,183,83,1029,487,487,,,,953,485,867,448,16,4,69,32,1,1,37,59,37
E02006681,Wiltshire 023,Middle Super Output Areas and Intermediate Zones,MSOAIZ,SN,5827,2538,4724,2021,2332,1206,2392,815,9,4,488,244,48,30,440,214,214,,,,533,230,484,203,6,3,33,16,10,8,27,73,39
E02006682,Wiltshire 027,Middle Super Output Areas and Intermediate Zones,MSOAIZ,BA,9385,4286,7079,3164,3461,1877,3618,1287,23,13,1225,590,146,74,1079,516,516,,,,982,471,909,438,8,3,54,25,11,5,33,76,48
E02006683,Wiltshire 030,Middle Super Output Areas and Intermediate Zones,MSOAIZ,BA,7715,3094,5900,2385,1927,980,3973,1405,15,7,905,344,91,35,814,309,309,,,,833,331,754,300,31,10,34,17,14,4,31,62,27
E02006684,Wiltshire 031,Middle Super Output Areas and Intermediate Zones,MSOAIZ,BA,6098,2778,3537,1588,1318,741,2219,847,27,15,1008,462,144,67,864,395,395,,,,1482,687,1387,649,12,4,68,29,15,5,38,44,26
E02006685,Wiltshire 032,Middle Super Output Areas and Intermediate Zones,MSOAIZ,BA,7558,3234,5608,2377,2086,1148,3522,1229,45,19,624,296,62,23,562,273,273,,,,1235,516,1103,466,59,19,48,21,25,10,50,46,26
E02006686,Wiltshire 033,Middle Super Output Areas and Intermediate Zones,MSOAIZ,BA,5358,2130,3618,1452,1423,738,2195,714,17,8,1266,499,123,57,1143,442,442,,,,431,157,363,134,6,3,44,15,18,5,23,26,14
E02006687,Wiltshire 035,Middle Super Output Areas and Intermediate Zones,MSOAIZ,BA,7289,3017,4575,1926,1555,811,3020,1115,51,25,1487,598,176,78,1311,520,520,,,,1153,453,1062,417,17,5,71,30,3,1,36,23,15
E02006688,Wiltshire 036,Middle Super Output Areas and Intermediate Zones,MSOAIZ,BA,5655,2447,4202,1799,1389,770,2813,1029,24,14,397,194,64,28,333,166,166,,,,1004,417,913,378,12,4,63,30,16,5,39,28,23
E02006689,Wiltshire 037,Middle Super Output Areas and Intermediate Zones,MSOAIZ,SN,6252,2584,5182,2165,2392,1198,2790,967,4,3,310,124,46,21,264,103,103,,,,708,273,604,237,36,12,43,16,25,8,36,48,19
E02006690,Wiltshire 039,Middle Super Output Areas and Intermediate Zones,MSOAIZ,BA,6716,2865,5259,2296,2346,1217,2913,1079,26,9,653,236,78,29,575,207,207,,,,693,288,562,243,51,12,75,30,5,3,45,85,36
E02006691,Wiltshire 040,Middle Super Output Areas and Intermediate Zones,MSOAIZ,BA,13345,5595,8795,3704,2637,1424,6158,2280,79,30,2220,870,216,90,2004,780,780,,,,2155,933,1940,846,34,12,146,63,35,12,87,96,58
E02006692,Wiltshire 042,Middle Super Output Areas and Intermediate Zones,MSOAIZ,BA,5504,2290,2764,1302,1334,768,1430,534,22,9,823,333,91,41,732,292,292,,,,1854,621,458,190,732,227,42,19,622,185,431,41,25
E02006693,Wiltshire 043,Middle Super Output Areas and Intermediate Zones,MSOAIZ,BA,5713,2462,4140,1783,1505,811,2635,972,59,26,741,327,134,55,607,272,272,,,,739,304,648,265,16,6,52,26,23,7,39,34,22
E02006694,Wiltshire 044,Middle Super Output Areas and Intermediate Zones,MSOAIZ,BA,5816,2791,3936,1842,1787,1027,2149,815,29,14,664,344,72,36,592,308,308,,,,1104,546,1001,497,24,9,69,33,10,7,49,83,45
E02006695,Wiltshire 047,Middle Super Output Areas and Intermediate Zones,MSOAIZ,SP,6293,2762,4283,1862,2133,1080,2150,782,32,13,537,241,45,19,492,222,222,,,,1169,533,1010,460,80,33,32,19,47,21,73,272,113
E02006696,Bromsgrove 001,Middle Super Output Areas and Intermediate Zones,MSOAIZ,DY,6187,2504,5503,2194,2486,1248,3017,946,8,6,126,52,41,16,85,36,36,,,,505,223,478,210,3,2,15,8,9,3,13,45,29
E02006697,Bromsgrove 002,Middle Super Output Areas and Intermediate Zones,MSOAIZ,DY,7054,3030,5933,2460,2827,1422,3106,1038,24,13,392,193,141,65,251,128,128,,,,594,303,512,262,23,8,47,28,12,5,41,111,61
E02006698,Bromsgrove 003,Middle Super Output Areas and Intermediate Zones,MSOAIZ,B,6461,2674,5580,2269,2347,1199,3233,1070,68,27,348,161,84,36,264,125,125,,,,419,194,382,177,8,3,29,14,0,0,17,46,23
E02006699,Bromsgrove 004,Middle Super Output Areas and Intermediate Zones,MSOAIZ,B,5924,2569,4952,2066,2301,1155,2651,911,11,7,638,341,228,113,410,228,228,,,,288,133,246,112,1,1,41,20,0,0,21,35,22
E02006700,Bromsgrove 005,Middle Super Output Areas and Intermediate Zones,MSOAIZ,B,5536,2308,5085,2097,2203,1150,2882,947,17,12,88,38,39,18,49,20,20,,,,288,136,244,115,6,4,31,16,7,1,21,58,25
E02006701,Bromsgrove 006,Middle Super Output Areas and Intermediate Zones,MSOAIZ,B,5880,2383,5402,2169,2384,1173,3018,996,5,4,34,14,13,5,21,9,9,,,,394,174,354,156,5,3,27,12,8,3,18,45,22
E02006702,Bromsgrove 007,Middle Super Output Areas and Intermediate Zones,MSOAIZ,B,5755,2427,4106,1700,1573,805,2533,895,84,40,1096,472,281,135,815,337,337,,,,426,188,363,162,2,1,59,24,2,1,26,43,27
E02006703,Bromsgrove 008,Middle Super Output Areas and Intermediate Zones,MSOAIZ,B,7075,2891,6416,2560,2553,1254,3863,1306,10,6,181,102,43,28,138,74,74,,,,430,199,402,184,7,4,21,11,0,0,15,38,24
E02006704,Bromsgrove 009,Middle Super Output Areas and Intermediate Zones,MSOAIZ,B,6394,2717,5308,2195,2346,1197,2962,998,40,16,461,223,175,78,286,145,145,,,,529,244,459,210,22,6,32,18,16,10,34,56,39
E02006705,Bromsgrove 010,Middle Super Output Areas and Intermediate Zones,MSOAIZ,B,6593,2819,4943,2044,1843,933,3100,1111,7,3,915,440,352,133,563,307,307,,,,685,305,621,277,7,4,56,23,1,1,28,43,27
E02006706,Bromsgrove 011,Middle Super Output Areas and Intermediate Zones,MSOAIZ,B,6281,3062,4611,2085,2015,1128,2596,957,43,20,896,543,174,111,722,432,432,,,,668,380,593,341,25,11,44,24,6,4,39,63,34
E02006707,Bromsgrove 012,Middle Super Output Areas and Intermediate Zones,MSOAIZ,B,6828,2638,6198,2383,2143,1084,4055,1299,13,9,142,56,36,15,106,41,41,,,,450,179,426,171,1,1,19,6,4,1,8,25,11
E02006708,Bromsgrove 013,Middle Super Output Areas and Intermediate Zones,MSOAIZ,B,8077,3418,4823,1919,1440,718,3383,1201,128,63,2265,1010,790,344,1475,666,666,,,,799,387,736,357,15,6,41,18,7,6,30,62,39
E02006709,Bromsgrove 014,Middle Super Output Areas and Intermediate Zones,MSOAIZ,B,6788,2850,5694,2295,2252,1088,3442,1207,44,22,363,174,103,42,260,132,132,,,,618,325,566,301,10,4,32,15,10,5,24,69,34
E02006710,Malvern Hills 001,Middle Super Output Areas and Intermediate Zones,MSOAIZ,WR,7732,3402,5606,2422,3063,1524,2543,898,46,21,962,418,42,18,920,400,400,,,,968,462,849,415,15,5,87,36,17,6,47,150,79
E02006711,Malvern Hills 002,Middle Super Output Areas and Intermediate Zones,MSOAIZ,WR,7659,3235,6084,2512,3054,1529,3030,983,40,20,629,311,71,40,558,271,271,,,,740,324,651,283,24,11,49,22,16,8,41,166,68
E02006712,Malvern Hills 003,Middle Super Output Areas and Intermediate Zones,MSOAIZ,WR,6828,2842,5664,2325,2713,1330,2951,995,57,27,391,185,51,26,340,159,159,,,,651,272,538,231,18,8,83,28,12,5,41,65,33
E02006713,Malvern Hills 004,Middle Super Output Areas and Intermediate Zones,MSOAIZ,WR,6081,2881,4136,1935,2053,1164,2083,771,80,32,990,474,136,61,854,413,413,,,,818,404,750,369,5,2,51,27,12,6,35,57,36
E02006714,Malvern Hills 005,Middle Super Output Areas and Intermediate Zones,MSOAIZ,WR,5155,2293,4024,1740,2019,1052,2005,688,12,8,355,199,41,23,314,176,176,,,,668,290,580,252,23,10,40,17,25,11,38,96,56
E02006715,Malvern Hills 006,Middle Super Output Areas and Intermediate Zones,MSOAIZ,WR,8052,3455,5989,2548,2474,1291,3515,1257,110,45,1106,457,168,68,938,389,389,,,,811,377,733,346,6,2,70,28,2,1,31,36,28
E02006716,Malvern Hills 007,Middle Super Output Areas and Intermediate Zones,MSOAIZ,WR,6417,2740,2893,1254,1230,660,1663,594,89,39,2985,1263,446,182,2539,1081,1081,,,,391,151,336,130,2,1,48,18,5,2,21,59,33
E02006717,Malvern Hills 008,Middle Super Output Areas and Intermediate Zones,MSOAIZ,WR,5572,2426,4545,1950,2167,1110,2378,840,31,10,481,236,57,32,424,204,204,,,,444,190,406,172,10,5,28,13,0,0,18,71,40
E02006718,Malvern Hills 009,Middle Super Output Areas and Intermediate Zones,MSOAIZ,WR,5784,2730,4164,1952,2274,1273,1890,679,75,36,900,451,112,50,788,401,401,,,,591,257,539,233,11,4,31,15,10,5,24,54,34
E02006719,Malvern Hills 010,Middle Super Output Areas and Intermediate Zones,MSOAIZ,WR,6546,3229,4989,2376,2597,1440,2392,936,20,9,267,145,9,3,258,142,142,,,,1147,641,1067,598,23,10,49,28,8,5,43,123,58
E02006720,Malvern Hills 011,Middle Super Output Areas and Intermediate Zones,MSOAIZ,WR,6596,2979,4887,2132,2578,1307,2309,825,38,16,771,408,106,55,665,353,353,,,,752,352,667,310,22,9,61,31,2,2,42,148,71
E02006721,Redditch 001,Middle Super Output Areas and Intermediate Zones,MSOAIZ,B,5686,2401,4909,2078,1951,994,2958,1084,18,8,433,182,227,104,206,78,78,,,,295,120,263,110,0,0,32,10,0,0,10,31,13
E02006722,Redditch 002,Middle Super Output Areas and Intermediate Zones,MSOAIZ,B,5473,2312,2679,1069,546,280,2133,789,8,3,2089,941,1780,784,309,157,157,,,,655,270,587,236,4,2,58,28,6,4,34,42,29
E02006723,Redditch 003,Middle Super Output Areas and Intermediate Zones,MSOAIZ,B,8150,3441,4468,1797,1000,524,3468,1273,5,3,2897,1294,2312,1042,585,252,252,,,,691,292,646,267,2,2,40,21,3,2,25,89,55
E02006724,Redditch 004,Middle Super Output Areas and Intermediate Zones,MSOAIZ,B,6867,2742,3138,1129,828,377,2310,752,74,27,1945,877,1509,659,436,218,218,,,,1613,663,1523,628,3,1,68,24,19,10,35,97,46
E02006725,Redditch 005,Middle Super Output Areas and Intermediate Zones,MSOAIZ,B,5655,2411,3535,1437,1031,524,2504,913,8,4,1548,739,1306,624,242,115,115,,,,527,205,469,176,8,2,46,26,4,1,29,37,26
E02006726,Redditch 006,Middle Super Output Areas and Intermediate Zones,MSOAIZ,B,6385,2594,4420,1673,1434,688,2986,985,15,7,812,383,615,295,197,88,88,,,,1090,505,1010,468,12,7,65,29,3,1,37,48,26
E02006727,Redditch 007,Middle Super Output Areas and Intermediate Zones,MSOAIZ,B,6083,2475,4946,1996,1752,894,3194,1102,36,17,480,212,285,101,195,111,111,,,,575,225,520,204,0,0,48,18,7,3,21,46,25
E02006728,Redditch 008,Middle Super Output Areas and Intermediate Zones,MSOAIZ,B,6898,2961,5761,2353,2137,1103,3624,1250,13,8,446,263,304,179,142,84,84,,,,638,310,552,266,4,2,78,41,4,1,44,40,27
E02006729,Redditch 009,Middle Super Output Areas and Intermediate Zones,MSOAIZ,B,7242,2831,5470,2125,1656,800,3814,1325,10,6,1093,442,983,412,110,30,30,,,,633,231,561,202,19,4,53,25,0,0,29,36,27
E02006730,Redditch 010,Middle Super Output Areas and Intermediate Zones,MSOAIZ,B,6188,2391,2977,1140,767,390,2210,750,52,25,2241,873,1989,748,252,125,125,,,,868,320,806,294,9,5,53,21,0,0,26,50,33
E02006731,Redditch 011,Middle Super Output Areas and Intermediate Zones,MSOAIZ,B,5810,2597,3898,1611,1286,668,2612,943,14,8,1278,678,781,404,497,274,274,,,,576,273,541,254,8,2,25,15,2,2,19,44,27
E02006732,Redditch 012,Middle Super Output Areas and Intermediate Zones,MSOAIZ,B,7284,3007,6192,2468,2156,1075,4036,1393,13,7,389,203,342,175,47,28,28,,,,657,307,611,288,2,1,40,17,4,1,19,33,22
E02006733,Redditch 013,Middle Super Output Areas and Intermediate Zones,MSOAIZ,B,6024,2559,4733,1920,1795,887,2938,1033,21,11,547,264,351,176,196,88,88,,,,688,338,627,307,10,3,42,24,9,4,31,35,26
E02006734,Worcester 001,Middle Super Output Areas and Intermediate Zones,MSOAIZ,WR,8056,3494,6958,2935,2851,1510,4107,1425,44,20,250,129,85,34,165,95,95,,,,755,385,699,358,1,1,49,23,6,3,27,49,25
E02006735,Worcester 002,Middle Super Output Areas and Intermediate Zones,MSOAIZ,WR,5157,2379,1968,837,654,349,1314,488,34,21,2725,1315,1291,608,1434,707,707,,,,369,157,316,130,0,0,40,19,13,8,27,61,49
E02006736,Worcester 003,Middle Super Output Areas and Intermediate Zones,MSOAIZ,WR,6734,2829,5144,2099,1116,564,4028,1535,10,5,337,140,33,9,304,131,131,,,,1214,570,1130,527,2,1,72,35,10,7,43,29,15
E02006737,Worcester 004,Middle Super Output Areas and Intermediate Zones,MSOAIZ,WR,7781,3464,5547,2430,2050,1126,3497,1304,76,40,964,398,276,108,688,290,290,,,,1147,567,1016,506,8,4,111,51,12,6,61,47,29
E02006738,Worcester 005,Middle Super Output Areas and Intermediate Zones,MSOAIZ,WR,8961,3649,4025,1668,1376,706,2649,962,242,97,3413,1320,1606,623,1807,697,697,,,,1180,512,1092,474,1,1,75,31,12,6,38,101,52
E02006739,Worcester 006,Middle Super Output Areas and Intermediate Zones,MSOAIZ,WR,5012,2106,3668,1606,1724,938,1944,668,11,3,216,102,61,32,155,70,70,,,,1093,382,1031,349,4,1,51,29,7,3,33,24,13
E02006740,Worcester 007,Middle Super Output Areas and Intermediate Zones,MSOAIZ,WR,6689,3554,3421,1632,1271,729,2150,903,31,20,567,415,107,78,460,337,337,,,,2585,1429,2486,1365,5,4,76,43,18,17,64,85,58
E02006741,Worcester 008,Middle Super Output Areas and Intermediate Zones,MSOAIZ,WR,5639,2151,4375,1647,965,475,3410,1172,11,5,310,90,19,5,291,85,85,,,,917,397,872,380,6,1,39,16,0,0,17,26,12
E02006742,Worcester 009,Middle Super Output Areas and Intermediate Zones,MSOAIZ,WR,8400,3544,4349,1883,1683,919,2666,964,70,39,2054,924,786,330,1268,594,594,,,,1832,646,1702,597,6,3,92,35,32,11,49,95,52
E02006743,Worcester 010,Middle Super Output Areas and Intermediate Zones,MSOAIZ,WR,6522,2579,4028,1621,1393,700,2635,921,94,48,1556,596,757,279,799,317,317,,,,809,294,730,263,6,2,58,25,15,4,31,35,20
E02006744,Worcester 011,Middle Super Output Areas and Intermediate Zones,MSOAIZ,WR,6850,3262,3786,1552,1376,677,2410,875,85,34,822,545,218,122,604,423,423,,,,2078,1089,1928,1029,23,10,110,43,17,7,60,79,42
E02006745,Worcester 012,Middle Super Output Areas and Intermediate Zones,MSOAIZ,WR,7768,3252,6412,2714,2691,1437,3721,1277,25,12,402,164,165,64,237,100,100,,,,879,333,784,299,6,4,79,26,10,4,34,50,29
E02006746,Worcester 013,Middle Super Output Areas and Intermediate Zones,MSOAIZ,WR,7444,3297,5581,2427,2301,1236,3280,1191,149,69,567,245,139,61,428,184,184,,,,1097,522,993,477,23,8,73,33,8,4,45,50,34
E02006747,Worcester 014,Middle Super Output Areas and Intermediate Zones,MSOAIZ,WR,5841,2482,4878,2026,1526,815,3352,1211,44,23,150,55,8,3,142,52,52,,,,742,362,692,339,0,0,50,23,0,0,23,27,16
E02006748,Wychavon 001,Middle Super Output Areas and Intermediate Zones,MSOAIZ,WR,6546,2765,5238,2141,2352,1147,2886,994,23,8,606,301,51,25,555,276,276,,,,595,268,520,236,15,10,41,15,19,7,32,84,47
E02006749,Wychavon 002,Middle Super Output Areas and Intermediate Zones,MSOAIZ,WR,5377,2185,2853,1170,811,429,2042,741,11,4,1948,790,233,99,1715,691,691,,,,544,212,471,181,0,0,68,29,5,2,31,21,9
E02006750,Wychavon 003,Middle Super Output Areas and Intermediate Zones,MSOAIZ,WR,5354,2587,3637,1679,1637,937,2000,742,47,27,976,499,88,47,888,452,452,,,,647,353,584,322,11,5,48,24,4,2,31,47,29
E02006751,Wychavon 004,Middle Super Output Areas and Intermediate Zones,MSOAIZ,WR,5833,2561,3925,1659,1646,883,2279,776,15,7,1376,649,168,78,1208,571,571,,,,449,203,393,178,10,4,31,15,15,6,25,68,43
E02006752,Wychavon 005,Middle Super Output Areas and Intermediate Zones,MSOAIZ,WR,6725,2730,6073,2427,2268,1149,3805,1278,15,6,278,143,20,10,258,133,133,,,,343,143,313,130,1,1,18,8,11,4,13,16,11
E02006753,Wychavon 006,Middle Super Output Areas and Intermediate Zones,MSOAIZ,WR,6263,2595,5131,2097,2415,1199,2716,898,11,7,514,223,93,32,421,191,191,,,,533,236,491,215,11,6,27,13,4,2,21,74,32
E02006754,Wychavon 007,Middle Super Output Areas and Intermediate Zones,MSOAIZ,WR,5475,2243,4507,1802,2224,1030,2283,772,11,7,327,140,33,17,294,123,123,,,,547,245,484,217,15,7,35,16,13,5,28,83,49
E02006755,Wychavon 008,Middle Super Output Areas and Intermediate Zones,MSOAIZ,WR,5331,2212,4613,1888,2322,1107,2291,781,19,8,227,99,16,10,211,89,89,,,,418,183,368,161,18,8,30,13,2,1,22,54,34
E02006756,Wychavon 009,Middle Super Output Areas and Intermediate Zones,MSOAIZ,WR,5285,2085,4442,1715,1531,741,2911,974,10,4,324,143,21,10,303,133,133,,,,457,198,406,176,4,1,38,16,9,5,22,52,25
E02006757,Wychavon 010,Middle Super Output Areas and Intermediate Zones,MSOAIZ,WR,6677,2854,5328,2240,2671,1333,2657,907,6,3,667,295,67,25,600,270,270,,,,556,258,466,219,19,10,45,19,26,10,39,120,58
E02006758,Wychavon 011,Middle Super Output Areas and Intermediate Zones,MSOAIZ,WR,5228,2134,4023,1621,1574,773,2449,848,9,4,769,318,79,35,690,283,283,,,,360,152,311,131,12,7,29,11,8,3,21,67,39
E02006759,Wychavon 012,Middle Super Output Areas and Intermediate Zones,MSOAIZ,WR,7001,3285,4614,2137,2396,1329,2218,808,72,37,1422,657,136,54,1286,603,603,,,,817,403,707,357,39,15,66,28,5,3,46,76,51
E02006760,Wychavon 013,Middle Super Output Areas and Intermediate Zones,MSOAIZ,WR,7857,3293,5830,2429,2669,1334,3161,1095,30,16,1252,517,158,66,1094,451,451,,,,665,285,570,240,23,7,56,30,16,8,45,80,46
E02006761,Wychavon 014,Middle Super Output Areas and Intermediate Zones,MSOAIZ,WR,5786,2776,2613,1219,969,571,1644,648,45,23,1408,744,174,78,1234,666,666,,,,1653,749,1565,703,43,17,36,22,9,7,46,67,41
E02006762,Wychavon 015,Middle Super Output Areas and Intermediate Zones,MSOAIZ,WR,5695,2422,4362,1860,1864,966,2498,894,21,7,523,224,60,21,463,203,203,,,,758,315,718,293,0,0,35,21,5,1,22,31,16
E02006763,Wychavon 016,Middle Super Output Areas and Intermediate Zones,MSOAIZ,WR,6407,2619,5066,2099,2008,1032,3058,1067,63,29,600,215,72,23,528,192,192,,,,636,248,582,221,2,2,49,22,3,3,27,42,28
E02006764,Wychavon 017,Middle Super Output Areas and Intermediate Zones,MSOAIZ,WR,5392,2210,3301,1330,1017,531,2284,799,16,8,1314,555,187,79,1127,476,476,,,,723,292,673,269,13,6,34,16,3,1,23,38,25
E02006765,Wychavon 018,Middle Super Output Areas and Intermediate Zones,MSOAIZ,WR,5808,2696,4283,1968,2205,1219,2078,749,26,14,779,361,95,45,684,316,316,,,,648,309,553,268,38,17,34,15,23,9,41,72,44
E02006766,Wychavon 019,Middle Super Output Areas and Intermediate Zones,MSOAIZ,WR,7505,3214,5984,2492,2864,1448,3120,1044,11,6,600,293,37,17,563,276,276,,,,802,367,708,326,41,15,37,19,16,7,41,108,56
E02006767,Wyre Forest 001,Middle Super Output Areas and Intermediate Zones,MSOAIZ,WR,8584,3804,6591,2787,3234,1642,3357,1145,30,13,1070,547,449,210,621,337,337,,,,788,395,696,349,16,9,52,26,24,11,46,105,62
E02006768,Wyre Forest 002,Middle Super Output Areas and Intermediate Zones,MSOAIZ,DY,6754,2910,5515,2337,2384,1262,3131,1075,26,9,509,244,210,93,299,151,151,,,,656,294,582,262,0,0,67,29,7,3,32,48,26
E02006769,Wyre Forest 003,Middle Super Output Areas and Intermediate Zones,MSOAIZ,DY,7096,3047,6006,2537,2348,1224,3658,1313,10,5,84,51,4,2,80,49,49,,,,946,431,867,396,22,8,55,26,2,1,35,50,23
E02006770,Wyre Forest 004,Middle Super Output Areas and Intermediate Zones,MSOAIZ,DY,7088,3196,3544,1487,1070,586,2474,901,31,13,1895,900,1142,515,753,385,385,,,,1537,750,1438,702,10,6,85,40,4,2,48,81,46
E02006771,Wyre Forest 005,Middle Super Output Areas and Intermediate Zones,MSOAIZ,DY,6515,2933,4947,2168,2542,1319,2405,849,35,12,712,355,314,149,398,206,206,,,,716,341,629,296,9,4,73,37,5,4,45,105,57
E02006772,Wyre Forest 006,Middle Super Output Areas and Intermediate Zones,MSOAIZ,DY,6316,2815,4761,2037,2120,1115,2641,922,8,3,1017,511,494,232,523,279,279,,,,481,231,426,203,4,2,47,24,4,2,28,49,33
E02006773,Wyre Forest 007,Middle Super Output Areas and Intermediate Zones,MSOAIZ,DY,8182,3790,5438,2416,2453,1307,2985,1109,72,38,1474,749,755,368,719,381,381,,,,1123,539,1019,497,18,8,82,33,4,1,42,75,48
E02006774,Wyre Forest 008,Middle Super Output Areas and Intermediate Zones,MSOAIZ,DY,7455,3347,5078,2210,1881,1016,3197,1194,45,27,763,392,314,147,449,245,245,,,,1513,682,1443,653,0,0,64,25,6,4,29,56,36
E02006775,Wyre Forest 009,Middle Super Output Areas and Intermediate Zones,MSOAIZ,DY,5144,2070,2225,906,743,394,1482,512,48,15,2328,917,1352,519,976,398,398,,,,484,198,428,170,8,3,37,19,11,6,28,59,34
E02006776,Wyre Forest 010,Middle Super Output Areas and Intermediate Zones,MSOAIZ,WV,6546,2817,5020,2154,1925,1014,3095,1140,55,27,762,290,197,77,565,213,213,,,,680,333,619,294,0,0,61,39,0,0,39,29,13
E02006777,Wyre Forest 011,Middle Super Output Areas and Intermediate Zones,MSOAIZ,WR,7099,3248,5890,2613,3168,1641,2722,972,31,16,366,180,139,64,227,116,116,,,,725,392,638,349,2,1,79,38,6,4,43,87,47
E02006778,Wyre Forest 012,Middle Super Output Areas and Intermediate Zones,MSOAIZ,DY,6783,2894,5623,2397,2502,1325,3121,1072,38,19,552,240,216,98,336,142,142,,,,530,215,483,191,2,1,42,22,3,1,24,40,23
E02006779,Wyre Forest 013,Middle Super Output Areas and Intermediate Zones,MSOAIZ,DY,7614,3497,5665,2431,2245,1216,3420,1215,90,46,592,305,220,125,372,180,180,,,,1221,691,1131,651,5,3,72,30,13,7,40,46,24
E02006780,Wyre Forest 014,Middle Super Output Areas and Intermediate Zones,MSOAIZ,DY,5782,2617,4132,1880,2076,1135,2056,745,38,16,1128,524,625,286,503,238,238,,,,424,168,359,142,2,1,51,21,12,4,26,60,29
E02006781,Isles of Scilly 001,Middle Super Output Areas and Intermediate Zones,MSOAIZ,TR,2123,989,862,412,606,313,256,99,19,8,400,179,260,121,140,58,58,,,,639,294,436,204,81,36,31,13,91,41,90,203,96
E02006782,Bromley 040,Middle Super Output Areas and Intermediate Zones,MSOAIZ,BR,7565,3091,5357,2157,1997,1027,3360,1130,66,28,1406,633,153,69,1253,564,564,,,,696,247,636,215,4,2,46,25,10,5,32,40,26
E02006783,Lewisham 037,Middle Super Output Areas and Intermediate Zones,MSOAIZ,SE,7208,2893,3081,1240,691,382,2390,858,46,26,3025,1216,1040,412,1985,804,804,,,,1034,394,960,360,1,1,55,23,18,10,34,22,17
E02006784,Lewisham 038,Middle Super Output Areas and Intermediate Zones,MSOAIZ,SE,7358,3168,3533,1439,945,513,2588,926,68,24,2647,1260,779,371,1868,889,889,,,,1038,399,947,352,7,2,61,31,23,14,47,72,46
E02006785,Bexley 029,Middle Super Output Areas and Intermediate Zones,MSOAIZ,DA,6384,2567,4778,1886,1758,887,3020,999,39,19,875,388,131,59,744,329,329,,,,660,257,599,234,0,0,58,22,3,1,23,32,17
E02006786,Greenwich 033,Middle Super Output Areas and Intermediate Zones,MSOAIZ,SE,6894,2599,3545,1359,1130,532,2415,827,78,28,1886,764,1158,500,728,264,264,,,,1321,419,1241,389,4,2,47,20,29,8,30,64,29
E02006787,Bromley 041,Middle Super Output Areas and Intermediate Zones,MSOAIZ,BR,7575,3034,6061,2377,1931,991,4130,1386,52,25,672,281,57,24,615,257,257,,,,739,321,703,301,4,1,32,19,0,0,20,51,30
E02006788,Croydon 045,Middle Super Output Areas and Intermediate Zones,MSOAIZ,SE,7520,2903,3950,1570,877,463,3073,1107,49,18,2539,965,1679,683,860,282,282,,,,942,333,873,311,10,4,46,14,13,4,22,40,17
E02006789,Bromley 042,Middle Super Output Areas and Intermediate Zones,MSOAIZ,TN,6415,2662,5378,2250,2451,1264,2927,986,52,24,282,117,20,8,262,109,109,,,,632,232,449,174,120,36,29,11,34,11,58,71,39
E02006790,Tandridge 012,Middle Super Output Areas and Intermediate Zones,MSOAIZ,TN,7387,3047,5861,2384,2290,1187,3571,1197,32,16,736,343,597,293,139,50,50,,,,658,258,587,224,16,6,32,19,23,9,34,100,46
E02006791,Ealing 040,Middle Super Output Areas and Intermediate Zones,MSOAIZ,W,6711,3068,3385,1566,1200,647,2185,919,19,11,909,416,528,248,381,168,168,,,,2322,1035,2236,995,11,5,70,31,5,4,40,76,40
E02006792,Hounslow 029,Middle Super Output Areas and Intermediate Zones,MSOAIZ,W,8335,4035,3917,1910,1809,1008,2108,902,23,16,868,460,596,318,272,142,142,,,,3429,1591,3300,1533,16,7,75,37,38,14,58,98,58
E02006793,Enfield 037,Middle Super Output Areas and Intermediate Zones,MSOAIZ,N,8825,3356,2660,1023,761,371,1899,652,21,8,3824,1466,2559,1006,1265,460,460,,,,2149,790,2060,748,6,2,66,32,17,8,42,171,69
E02006794,Haringey 037,Middle Super Output Areas and Intermediate Zones,MSOAIZ,N,7277,2911,1203,493,394,183,809,310,346,165,3427,1401,2042,921,1385,480,480,,,,2134,779,2036,745,2,1,48,16,48,17,34,167,73
E02006795,Harrow 032,Middle Super Output Areas and Intermediate Zones,MSOAIZ,HA,8108,2639,5666,1923,1928,844,3738,1079,28,8,222,69,74,34,148,35,35,,,,2133,615,2046,586,6,1,73,25,8,3,29,59,24
E02006796,Hillingdon 033,Middle Super Output Areas and Intermediate Zones,MSOAIZ,UB,8404,3321,5862,2323,1977,996,3885,1327,53,18,794,336,650,280,144,56,56,,,,1641,620,1551,580,8,3,72,34,10,3,40,54,24
E02006798,Lewisham 039,Middle Super Output Areas and Intermediate Zones,MSOAIZ,SE,7375,3210,1524,685,397,201,1127,484,32,24,3532,1518,2625,1095,907,423,423,,,,2189,935,2079,888,4,4,82,33,24,10,47,98,48
E02006799,Barking and Dagenham 023,Middle Super Output Areas and Intermediate Zones,MSOAIZ,RM,9695,3624,4506,1662,1165,583,3341,1079,112,39,3011,1240,2442,996,569,244,244,,,,2000,648,1857,591,18,6,95,37,30,14,57,66,35
E02006800,Redbridge 034,Middle Super Output Areas and Intermediate Zones,MSOAIZ,RM,13014,4170,7738,2388,2617,992,5121,1396,94,34,1011,355,551,185,460,170,170,,,,4041,1338,3833,1268,14,5,154,52,40,13,70,130,55
E02006801,Lambeth 036,Middle Super Output Areas and Intermediate Zones,MSOAIZ,SE,7557,3840,1466,833,656,394,810,439,95,60,3046,1448,1264,568,1782,880,880,,,,2802,1418,2390,1244,206,75,115,62,91,37,174,148,81
E02006802,Southwark 034,Middle Super Output Areas and Intermediate Zones,MSOAIZ,SE,6391,2867,1392,688,456,253,936,435,53,31,3126,1362,2028,862,1098,500,500,,,,1653,716,1497,653,7,2,108,43,41,18,63,167,70
E02006803,Sheffield 072,Middle Super Output Areas and Intermediate Zones,MSOAIZ,S,8798,3763,7402,3063,2375,1217,5027,1846,39,22,533,259,455,227,78,32,32,,,,774,391,677,350,4,1,74,34,19,6,41,50,28
E02006804,North East Derbyshire 014,Middle Super Output Areas and Intermediate Zones,MSOAIZ,S,7972,3461,4717,1915,1715,847,3002,1068,35,17,2553,1203,2310,1080,243,123,123,,,,615,299,560,271,15,6,36,18,4,4,28,52,27
E02006805,Coventry 043,Middle Super Output Areas and Intermediate Zones,MSOAIZ,CV,8205,3197,4718,1800,1558,717,3160,1083,34,17,1493,668,551,231,942,437,437,,,,1891,675,1754,622,3,1,105,42,29,10,53,69,37
E02006806,Nuneaton and Bedworth 018,Middle Super Output Areas and Intermediate Zones,MSOAIZ,CV,7812,3305,6140,2555,2304,1204,3836,1351,12,5,732,338,573,278,159,60,60,,,,883,377,798,336,11,3,70,34,4,4,41,45,30
E02006807,Birmingham 132,Middle Super Output Areas and Intermediate Zones,MSOAIZ,B,7891,3013,6481,2459,2316,1142,4165,1317,22,15,139,65,129,60,10,5,5,,,,1154,440,1077,411,6,2,65,25,6,2,29,95,34
E02006808,Solihull 030,Middle Super Output Areas and Intermediate Zones,MSOAIZ,B,6097,2393,5155,2005,1793,908,3362,1097,5,3,231,89,214,82,17,7,7,,,,676,283,615,257,4,3,52,21,5,2,26,30,13
E02006809,Birmingham 133,Middle Super Output Areas and Intermediate Zones,MSOAIZ,B,9956,3083,8488,2572,3647,1289,4841,1283,28,10,165,95,103,57,62,38,38,,,,1157,366,1109,348,5,3,41,14,2,1,18,118,40
E02006810,Sandwell 039,Middle Super Output Areas and Intermediate Zones,MSOAIZ,B,9993,4177,7252,2866,3332,1596,3920,1270,37,18,1531,777,1462,742,69,35,35,,,,1061,450,978,416,8,5,63,24,12,5,34,112,66
E02006811,Middlesbrough 020,Middle Super Output Areas and Intermediate Zones,MSOAIZ,TS,9542,3927,8582,3477,3802,1894,4780,1583,29,20,176,106,60,17,116,89,89,,,,694,291,597,254,0,0,95,36,2,1,37,61,33
E02006812,Redcar and Cleveland 021,Middle Super Output Areas and Intermediate Zones,MSOAIZ,TS,7353,3354,5251,2318,2317,1241,2934,1077,48,27,1389,710,807,402,582,308,308,,,,598,269,521,234,2,1,63,29,12,5,35,67,30
E02006813,Kingston upon Hull 033,Middle Super Output Areas and Intermediate Zones,MSOAIZ,HU,8088,3791,4713,2046,1625,889,3088,1157,133,82,2420,1282,2110,1053,310,229,229,,,,725,311,633,276,5,1,79,31,8,3,35,97,70
E02006814,East Riding of Yorkshire 043,Middle Super Output Areas and Intermediate Zones,MSOAIZ,HU,8281,3517,6659,2792,2581,1327,4078,1465,18,12,587,269,563,258,24,11,11,,,,979,418,878,372,4,2,88,38,9,6,46,38,26
E02006815,Leicester 037,Middle Super Output Areas and Intermediate Zones,MSOAIZ,LE,9111,3739,5120,2026,1908,980,3212,1046,21,9,3014,1355,2807,1283,207,72,72,,,,822,268,755,239,10,4,44,21,13,4,29,134,81
E02006816,Harborough 011,Middle Super Output Areas and Intermediate Zones,MSOAIZ,LE,6947,2809,6076,2390,2692,1320,3384,1070,101,60,245,126,34,17,211,109,109,,,,476,209,425,186,4,1,42,18,5,4,23,49,24
E02006817,Leicester 038,Middle Super Output Areas and Intermediate Zones,MSOAIZ,LE,7507,2974,5028,1973,2027,953,3001,1020,43,17,834,398,511,199,323,199,199,,,,1534,555,1384,504,3,2,89,32,58,17,51,68,31
E02006818,Oadby and Wigston 008,Middle Super Output Areas and Intermediate Zones,MSOAIZ,LE,8236,3277,7286,2923,3189,1634,4097,1289,50,20,181,61,152,51,29,10,10,,,,664,247,595,218,11,5,58,24,0,0,29,55,26
E02006819,Leicester 039,Middle Super Output Areas and Intermediate Zones,MSOAIZ,LE,8046,3254,3277,1349,963,498,2314,851,85,44,3874,1552,2942,1219,932,333,333,,,,717,259,641,226,11,4,49,21,16,8,33,93,50
E02006820,Blaby 013,Middle Super Output Areas and Intermediate Zones,MSOAIZ,LE,9622,4117,8339,3513,3660,1927,4679,1586,40,19,441,232,135,63,306,169,169,,,,762,319,705,289,10,3,44,25,3,2,30,40,34
E02006821,Portsmouth 026,Middle Super Output Areas and Intermediate Zones,MSOAIZ,PO,6504,2630,5164,2107,1992,1055,3172,1052,22,11,284,123,180,81,104,42,42,,,,1005,370,591,233,279,91,47,17,88,29,137,29,19
E02006822,Havant 018,Middle Super Output Areas and Intermediate Zones,MSOAIZ,PO,8672,3602,6815,2873,2772,1462,4043,1411,26,9,1020,383,443,154,577,229,229,,,,755,308,644,261,6,3,105,44,0,0,47,56,29
E02006823,Chiltern 013,Middle Super Output Areas and Intermediate Zones,MSOAIZ,HP,8509,3422,7305,2890,3287,1595,4018,1295,50,17,498,243,65,32,433,211,211,,,,556,222,509,202,7,3,31,15,9,2,20,100,50
E02006824,Wycombe 024,Middle Super Output Areas and Intermediate Zones,MSOAIZ,HP,9549,3760,8344,3240,3296,1639,5048,1601,28,13,471,227,171,74,300,153,153,,,,666,256,594,225,16,10,49,19,7,2,31,40,24
E02006825,East Cambridgeshire 011,Middle Super Output Areas and Intermediate Zones,MSOAIZ,CB,6344,2713,4377,1785,1996,960,2381,825,47,29,673,314,41,16,632,298,298,,,,632,296,544,262,48,17,35,14,5,3,34,615,289
E02006826,Forest Heath 008,Middle Super Output Areas and Intermediate Zones,MSOAIZ,CB,9449,4381,5132,2398,2277,1247,2855,1151,45,24,1733,758,830,349,903,409,409,,,,2313,1083,2126,993,75,30,102,53,10,7,90,226,118
E02006827,Amber Valley 017,Middle Super Output Areas and Intermediate Zones,MSOAIZ,NG,7618,3355,4395,1857,1690,898,2705,959,21,14,2049,925,967,417,1082,508,508,,,,1050,488,968,440,9,5,53,34,20,9,48,103,71
E02006828,Erewash 016,Middle Super Output Areas and Intermediate Zones,MSOAIZ,DE,6738,2722,5706,2262,1686,825,4020,1437,40,21,337,136,133,48,204,88,88,,,,625,284,567,260,0,0,52,23,6,1,24,30,19
E02006829,East Hampshire 016,Middle Super Output Areas and Intermediate Zones,MSOAIZ,PO,6423,2772,5551,2366,2484,1282,3067,1084,40,22,233,115,37,20,196,95,95,,,,549,244,490,217,2,1,57,26,0,0,27,50,25
E02006830,Havant 019,Middle Super Output Areas and Intermediate Zones,MSOAIZ,PO,6700,2771,3691,1536,1282,680,2409,856,110,44,2281,963,1478,701,803,262,262,,,,589,209,539,190,2,1,42,17,6,1,19,29,19
E02006831,Havant 020,Middle Super Output Areas and Intermediate Zones,MSOAIZ,PO,6188,2636,5382,2302,2310,1246,3072,1056,18,8,301,136,39,17,262,119,119,,,,447,173,401,153,6,3,38,16,2,1,20,40,17
E02006832,Sevenoaks 016,Middle Super Output Areas and Intermediate Zones,MSOAIZ,TN,6161,2468,4933,1971,1593,800,3340,1171,63,23,370,178,27,10,343,168,168,,,,769,283,689,254,10,3,65,24,5,2,29,26,13
E02006833,Tonbridge and Malling 014,Middle Super Output Areas and Intermediate Zones,MSOAIZ,TN,10107,4211,7253,2965,3043,1497,4210,1468,55,23,1700,733,224,88,1476,645,645,,,,978,422,868,379,49,17,42,19,19,7,43,121,68
E02006834,Nottingham 038,Middle Super Output Areas and Intermediate Zones,MSOAIZ,NG,7664,3661,3918,1649,1262,680,2656,969,27,9,2945,1659,2504,1398,441,261,261,,,,669,278,592,238,4,3,61,30,12,7,40,105,66
E02006835,Gedling 016,Middle Super Output Areas and Intermediate Zones,MSOAIZ,NG,5819,2520,4503,1936,1697,867,2806,1069,21,12,591,278,427,202,164,76,76,,,,665,273,579,237,7,4,73,29,6,3,36,39,21
E02006836,Sutton 025,Middle Super Output Areas and Intermediate Zones,MSOAIZ,SM,8062,3195,6857,2684,2866,1391,3991,1293,33,20,112,50,32,13,80,37,37,,,,996,413,946,389,7,2,36,18,7,4,24,64,28
E02006837,Epsom and Ewell 010,Middle Super Output Areas and Intermediate Zones,MSOAIZ,SM,10403,4130,8948,3479,3781,1844,5167,1635,5,3,315,178,41,21,274,157,157,,,,1076,444,987,407,45,18,35,13,9,6,37,59,26
E02006838,East Hampshire 017,Middle Super Output Areas and Intermediate Zones,MSOAIZ,GU,6511,2809,5546,2378,2591,1355,2955,1023,15,9,317,148,28,13,289,135,135,,,,574,243,513,214,14,8,30,16,17,5,29,59,31
E02006839,Waverley 018,Middle Super Output Areas and Intermediate Zones,MSOAIZ,GU,7933,3271,6347,2541,2647,1305,3700,1236,37,20,567,299,432,223,135,76,76,,,,764,333,686,301,25,6,38,19,15,7,32,218,78
E02006840,Torbay 019,Middle Super Output Areas and Intermediate Zones,MSOAIZ,TQ,10472,4501,7862,3367,3228,1748,4634,1619,29,12,499,224,47,22,452,202,202,,,,2032,865,1892,802,5,3,123,52,12,8,63,50,33
E02006841,Gateshead 027,Middle Super Output Areas and Intermediate Zones,MSOAIZ,NE,7086,3949,2104,1060,538,296,1566,764,47,26,2470,1585,2195,1417,275,168,168,,,,2365,1224,2227,1152,7,4,121,62,10,6,72,100,54
E02006842,Gateshead 028,Middle Super Output Areas and Intermediate Zones,MSOAIZ,NE,5064,2231,2815,1159,1009,480,1806,679,6,3,869,463,499,270,370,193,193,,,,1332,585,1226,542,2,1,91,36,13,6,43,42,21
E02006843,Sheffield 073,Middle Super Output Areas and Intermediate Zones,MSOAIZ,S,7110,3270,619,364,217,118,402,246,35,15,966,419,168,97,798,322,322,,,,5396,2425,5051,2306,74,17,63,36,208,66,119,94,47
E02006844,Sheffield 074,Middle Super Output Areas and Intermediate Zones,MSOAIZ,S,7860,3155,795,390,374,174,421,216,47,16,1818,888,449,238,1369,650,650,,,,5120,1818,4780,1725,25,9,210,52,105,32,93,80,43
E02006845,North Somerset 026,Middle Super Output Areas and Intermediate Zones,MSOAIZ,BS,7906,3352,5528,2275,1305,712,4223,1563,104,42,512,254,98,53,414,201,201,,,,1706,753,1585,696,8,4,102,47,11,6,57,56,28
E02006846,North Somerset 027,Middle Super Output Areas and Intermediate Zones,MSOAIZ,BS,7104,2887,4050,1635,653,357,3397,1278,45,22,510,226,58,38,452,188,188,,,,2471,986,2341,923,3,2,125,60,2,1,63,28,18
E02006847,Swindon 026,Middle Super Output Areas and Intermediate Zones,MSOAIZ,SN,9257,3551,7037,2622,830,397,6207,2225,333,149,331,128,50,15,281,113,113,,,,1545,647,1487,620,1,1,55,25,2,1,27,11,5
E02006848,Swindon 027,Middle Super Output Areas and Intermediate Zones,MSOAIZ,SN,6789,2892,4215,1721,435,242,3780,1479,248,99,516,210,49,18,467,192,192,,,,1793,853,1665,792,3,1,121,58,4,2,61,17,9
E02006849,Swindon 028,Middle Super Output Areas and Intermediate Zones,MSOAIZ,SN,9028,3437,7139,2648,1104,533,6035,2115,23,11,390,135,58,18,332,117,117,,,,1444,626,1352,586,5,3,81,34,6,3,40,32,17
E02006850,Leicester 040,Middle Super Output Areas and Intermediate Zones,MSOAIZ,LE,6895,3215,819,390,353,201,466,189,43,17,2196,1209,376,189,1820,1020,1020,,,,3758,1549,3606,1474,32,15,34,15,86,45,75,79,50
E02006851,Leicester 041,Middle Super Output Areas and Intermediate Zones,MSOAIZ,LE,4915,2961,434,274,115,70,319,204,38,23,823,642,53,38,770,604,604,,,,3561,1991,3485,1951,14,6,36,21,26,13,40,59,31
E02006852,Leeds 109,Middle Super Output Areas and Intermediate Zones,MSOAIZ,LS,10563,4551,6583,2845,2688,1405,3895,1440,19,10,418,191,187,83,231,108,108,,,,3418,1441,3160,1339,21,12,113,52,124,38,102,125,64
E02006853,Tower Hamlets 032,Middle Super Output Areas and Intermediate Zones,MSOAIZ,E,7063,3320,1391,715,432,231,959,484,153,94,2810,1050,510,198,2300,852,852,,,,2570,1401,2467,1346,23,12,48,29,32,14,55,139,60
E02006854,Tower Hamlets 033,Middle Super Output Areas and Intermediate Zones,MSOAIZ,E,5883,2991,1384,779,494,307,890,472,155,94,1354,418,193,59,1161,359,359,,,,2914,1658,2791,1601,59,28,33,16,31,13,57,76,42
E02006855,Canterbury 019,Middle Super Output Areas and Intermediate Zones,MSOAIZ,CT,5744,2356,2267,1006,812,432,1455,574,58,28,1471,587,1161,458,310,129,129,,,,1886,696,1775,647,12,6,81,35,18,8,49,62,39
E02006856,Canterbury 020,Middle Super Output Areas and Intermediate Zones,MSOAIZ,CT,10274,4786,3952,2037,1876,1161,2076,876,124,69,1587,729,931,426,656,303,303,,,,4397,1845,4141,1720,54,30,158,70,44,25,125,214,106
E02006857,Eastbourne 013,Middle Super Output Areas and Intermediate Zones,MSOAIZ,BN,8470,3856,5831,2684,2529,1455,3302,1229,45,19,969,449,578,256,391,193,193,,,,1556,668,1390,601,1,1,136,53,29,13,67,69,36
E02006858,Eastbourne 014,Middle Super Output Areas and Intermediate Zones,MSOAIZ,BN,6971,3224,3953,1888,1621,923,2332,965,95,35,678,226,36,11,642,215,215,,,,2226,1062,2166,1029,2,1,52,28,6,4,33,19,13
E02006859,Thurrock 019,Middle Super Output Areas and Intermediate Zones,MSOAIZ,RM,7378,2680,5523,1939,660,268,4863,1671,22,8,65,25,56,18,9,7,7,,,,1740,695,1686,674,3,1,44,18,7,2,21,28,13
E02006860,Oldham 035,Middle Super Output Areas and Intermediate Zones,MSOAIZ,OL,13696,4028,9483,2508,4700,1357,4783,1151,59,17,1945,761,440,206,1505,555,555,,,,1871,636,1688,578,4,3,145,42,34,13,58,338,106
E02006861,Leeds 110,Middle Super Output Areas and Intermediate Zones,MSOAIZ,LS,10488,3887,1643,736,699,363,944,373,81,25,1181,605,352,145,829,460,460,,,,7500,2475,7211,2358,42,15,166,57,81,45,117,83,46
E02006862,Corby 008,Middle Super Output Areas and Intermediate Zones,MSOAIZ,NN,6110,2499,4458,1788,1266,639,3192,1149,25,11,905,392,792,353,113,39,39,,,,672,274,607,247,7,2,55,24,3,1,27,50,34
E02006863,Corby 009,Middle Super Output Areas and Intermediate Zones,MSOAIZ,NN,9334,3382,6078,2164,634,306,5444,1858,49,15,672,281,46,18,626,263,263,,,,2491,902,2398,864,6,3,66,27,21,8,38,44,20
E02006864,Boston 008,Middle Super Output Areas and Intermediate Zones,MSOAIZ,PE,7919,3361,6467,2796,2914,1556,3553,1240,69,24,430,174,133,51,297,123,123,,,,894,333,775,284,34,12,67,29,18,8,49,59,34
E02006865,Boston 009,Middle Super Output Areas and Intermediate Zones,MSOAIZ,PE,7161,2987,5931,2541,2681,1390,3250,1151,35,10,217,97,48,23,169,74,74,,,,933,311,824,270,6,2,81,33,22,6,41,45,28
E02006866,North Kesteven 013,Middle Super Output Areas and Intermediate Zones,MSOAIZ,LN,6393,2792,4819,2063,1948,1018,2871,1045,128,59,736,343,417,200,319,143,143,,,,682,309,616,274,7,3,49,26,10,6,35,28,18
E02006867,North Kesteven 014,Middle Super Output Areas and Intermediate Zones,MSOAIZ,LN,7377,3278,6401,2799,2894,1576,3507,1223,16,9,232,141,163,104,69,37,37,,,,684,302,601,269,6,1,70,30,7,2,33,44,27
E02006868,Sheffield 075,Middle Super Output Areas and Intermediate Zones,MSOAIZ,S,12138,5068,4086,1723,1601,791,2485,932,50,23,4790,2175,1048,494,3742,1681,1681,,,,2629,927,2370,837,19,2,95,39,145,49,90,583,220
E02006869,Sheffield 076,Middle Super Output Areas and Intermediate Zones,MSOAIZ,S,11065,4820,7640,3153,2508,1306,5132,1847,56,27,2554,1299,2277,1165,277,134,134,,,,750,304,674,271,6,2,69,30,1,1,33,65,37
E02006870,Ryedale 008,Middle Super Output Areas and Intermediate Zones,MSOAIZ,YO,12053,5429,7920,3441,3577,1878,4343,1563,37,15,2089,1035,152,76,1937,959,959,,,,1897,862,1717,779,40,19,124,57,16,7,83,110,76
E02006871,Lancaster 020,Middle Super Output Areas and Intermediate Zones,MSOAIZ,LA,11864,5158,9347,4011,3830,2069,5517,1942,21,9,1378,638,909,361,469,277,277,,,,1029,439,891,377,4,2,124,54,10,6,62,89,61
E02006872,High Peak 013,Middle Super Output Areas and Intermediate Zones,MSOAIZ,SK,12440,5413,9729,4120,4364,2233,5365,1887,89,54,1093,547,910,440,183,107,107,,,,1370,613,1206,538,25,9,106,49,33,17,75,159,79
E02006873,South Cambridgeshire 020,Middle Super Output Areas and Intermediate Zones,MSOAIZ,CB,7185,2608,4354,1557,724,328,3630,1229,455,196,1279,429,59,22,1220,407,407,,,,1045,408,1000,389,1,1,38,15,6,3,19,52,18
E02006874,South Cambridgeshire 021,Middle Super Output Areas and Intermediate Zones,MSOAIZ,PE,8019,3172,5558,2093,1803,822,3755,1271,220,92,1309,592,445,214,864,378,378,,,,815,339,730,297,35,18,31,14,19,10,42,117,56
E02006875,Leeds 111,Middle Super Output Areas and Intermediate Zones,MSOAIZ,LS,5493,3569,1004,669,294,194,710,475,34,22,256,169,22,10,234,159,159,,,,4112,2658,3964,2569,10,8,89,53,49,28,89,87,51
E02006876,Leeds 112,Middle Super Output Areas and Intermediate Zones,MSOAIZ,LS,6495,3492,2020,946,589,315,1431,631,18,13,1670,878,1279,657,391,221,221,,,,2698,1598,2594,1552,4,2,56,28,44,16,46,89,57
E02006877,Peterborough 022,Middle Super Output Areas and Intermediate Zones,MSOAIZ,PE,7784,3205,4952,2016,1612,810,3340,1206,150,76,1225,513,271,98,954,415,415,,,,1420,576,1346,541,2,1,67,32,5,2,35,37,24
E02006878,Peterborough 023,Middle Super Output Areas and Intermediate Zones,MSOAIZ,PE,8978,3373,4910,1796,788,356,4122,1440,369,155,1637,597,426,137,1211,460,460,,,,2028,810,1939,773,2,1,74,31,13,5,37,34,15
E02006879,Shepway 014,Middle Super Output Areas and Intermediate Zones,MSOAIZ,CT,6628,3842,1760,966,846,546,914,420,31,24,812,553,417,265,395,288,288,,,,3975,2262,3843,2184,24,13,64,40,44,25,78,50,37
E02006880,Shepway 015,Middle Super Output Areas and Intermediate Zones,MSOAIZ,CT,6479,3683,2800,1562,1426,938,1374,624,30,17,231,170,15,11,216,159,159,,,,3341,1885,3226,1821,12,8,95,51,8,5,64,77,49
E02006881,Burnley 014,Middle Super Output Areas and Intermediate Zones,MSOAIZ,BB,9756,4270,6950,2917,2741,1427,4209,1490,24,11,1074,494,310,129,764,365,365,,,,1625,799,1541,757,8,3,67,35,9,4,42,83,49
E02006882,Harrow 033,Middle Super Output Areas and Intermediate Zones,MSOAIZ,HA,14103,4342,10518,3333,4264,1608,6254,1725,184,61,550,166,322,111,228,55,55,,,,2723,727,2612,696,9,3,75,22,27,6,31,128,55
E02006883,Bournemouth 023,Middle Super Output Areas and Intermediate Zones,MSOAIZ,BH,5299,3204,2442,1486,1135,775,1307,711,44,24,493,354,202,167,291,187,187,,,,2270,1302,2166,1237,7,3,84,54,13,8,65,50,38
E02006884,Rossendale 010,Middle Super Output Areas and Intermediate Zones,MSOAIZ,OL,11977,5412,8007,3411,3075,1588,4932,1823,23,13,2066,1077,770,360,1296,717,717,,,,1761,833,1626,764,5,5,116,58,14,6,69,120,78
E02006885,Bournemouth 024,Middle Super Output Areas and Intermediate Zones,MSOAIZ,BH,6682,3898,3490,2077,1986,1271,1504,806,163,92,157,97,9,6,148,91,91,,,,2797,1584,2643,1495,8,5,140,78,6,6,89,75,48
E02006886,Vale of White Horse 016,Middle Super Output Areas and Intermediate Zones,MSOAIZ,SN,10736,4365,6641,2711,2946,1441,3695,1270,39,18,1412,604,198,81,1214,523,523,,,,2349,891,1119,473,772,247,61,32,397,139,418,295,141
E02006887,Bristol 054,Middle Super Output Areas and Intermediate Zones,MSOAIZ,BS,6025,3380,864,522,217,143,647,379,135,87,2602,1354,1833,932,769,422,422,,,,2302,1332,2222,1287,15,10,47,24,18,11,45,122,85
E02006888,Bristol 055,Middle Super Output Areas and Intermediate Zones,MSOAIZ,BS,6792,2857,2181,894,839,386,1342,508,43,20,2396,1008,1558,644,838,364,364,,,,2058,878,1928,827,2,2,103,38,25,11,51,114,57
E02006889,Bristol 056,Middle Super Output Areas and Intermediate Zones,MSOAIZ,BS,7347,3015,1292,552,422,217,870,335,27,13,4536,1908,3654,1571,882,337,337,,,,1310,477,1229,442,2,2,54,18,25,15,35,182,65
E02006890,Bristol 057,Middle Super Output Areas and Intermediate Zones,MSOAIZ,BS,8561,3621,3987,1737,1289,648,2698,1089,74,29,1352,578,541,250,811,328,328,,,,3028,1229,2815,1143,4,3,172,73,37,10,86,120,48
E02006891,East Riding of Yorkshire 044,Middle Super Output Areas and Intermediate Zones,MSOAIZ,YO,7388,3114,6136,2554,2530,1296,3606,1258,25,9,298,141,160,78,138,63,63,,,,860,371,769,332,13,4,69,31,9,4,39,69,39
E02006892,East Riding of Yorkshire 045,Middle Super Output Areas and Intermediate Zones,MSOAIZ,YO,6342,2956,4248,1929,1808,1019,2440,910,20,9,695,337,589,290,106,47,47,,,,1319,639,1189,580,8,5,108,46,14,8,59,60,42
E02006893,Newcastle upon Tyne 031,Middle Super Output Areas and Intermediate Zones,MSOAIZ,NE,10655,4739,8936,3886,3881,2098,5055,1788,12,7,961,510,681,348,280,162,162,,,,667,290,565,236,0,0,98,50,4,4,54,79,46
E02006894,Wolverhampton 035,Middle Super Output Areas and Intermediate Zones,MSOAIZ,WV,11812,4471,5743,2053,2945,1194,2798,859,69,31,3133,1313,2023,770,1110,543,543,,,,2639,977,2432,903,28,11,100,35,79,28,74,228,97
E02006895,Birmingham 134,Middle Super Output Areas and Intermediate Zones,MSOAIZ,B,6136,3179,1112,589,345,187,767,402,104,58,2804,1385,852,379,1952,1006,1006,,,,2019,1084,1926,1044,14,6,52,24,27,10,40,97,63
E02006896,Birmingham 135,Middle Super Output Areas and Intermediate Zones,MSOAIZ,B,5216,3102,820,448,302,159,518,289,166,109,1395,902,458,195,937,707,707,,,,2767,1599,2686,1556,8,4,54,28,19,11,43,68,44
E02006897,Birmingham 136,Middle Super Output Areas and Intermediate Zones,MSOAIZ,B,5774,3150,835,466,297,168,538,298,25,17,2987,1591,1882,865,1105,726,726,,,,1749,994,1687,959,3,1,37,20,22,14,35,178,82
E02006898,Birmingham 137,Middle Super Output Areas and Intermediate Zones,MSOAIZ,B,6169,3371,1452,833,429,270,1023,563,103,66,1979,960,1801,867,178,93,93,,,,2555,1465,2466,1415,8,5,56,34,25,11,50,80,47
E02006899,Birmingham 138,Middle Super Output Areas and Intermediate Zones,MSOAIZ,B,5342,3433,887,587,263,177,624,410,62,46,566,440,151,111,415,329,329,,,,3760,2317,3661,2249,9,8,58,39,32,21,68,67,43
E02006900,Birmingham 139,Middle Super Output Areas and Intermediate Zones,MSOAIZ,B,14632,4067,8272,2033,3956,1086,4316,947,94,31,2709,1021,1224,451,1485,570,570,,,,3224,883,2967,808,12,3,158,45,87,27,75,333,99
E02006901,Birmingham 140,Middle Super Output Areas and Intermediate Zones,MSOAIZ,B,14386,4174,9045,2446,3601,1110,5444,1336,129,33,1086,379,525,191,561,188,188,,,,3885,1243,3682,1181,4,1,158,47,41,14,62,241,73
E02006902,Manchester 054,Middle Super Output Areas and Intermediate Zones,MSOAIZ,M,5725,3368,996,612,300,186,696,426,125,86,1343,780,909,518,434,262,262,,,,3164,1837,3074,1781,10,4,58,37,22,15,56,97,53
E02006903,Bassetlaw 016,Middle Super Output Areas and Intermediate Zones,MSOAIZ,S,10947,4957,7956,3350,3296,1691,4660,1659,19,10,1838,1128,1709,1050,129,78,78,,,,1016,393,907,346,12,6,94,39,3,2,47,118,76
E02006904,Nottingham 039,Middle Super Output Areas and Intermediate Zones,MSOAIZ,NG,6965,3787,1492,820,497,294,995,526,44,30,1465,836,730,340,735,496,496,,,,3849,2044,3699,1963,25,15,73,41,52,25,81,115,57
E02006905,Nottingham 040,Middle Super Output Areas and Intermediate Zones,MSOAIZ,NG,7203,3324,2524,1112,869,424,1655,688,46,22,2670,1366,2154,1062,516,304,304,,,,1837,758,1694,694,2,1,112,51,29,12,64,126,66
E02006906,Broxtowe 016,Middle Super Output Areas and Intermediate Zones,MSOAIZ,NG,12505,5154,10838,4374,4303,2092,6535,2282,9,4,404,188,345,148,59,40,40,,,,1168,539,1031,481,2,2,124,49,11,7,58,86,49
E02006907,Norwich 014,Middle Super Output Areas and Intermediate Zones,MSOAIZ,NR,5006,3076,1657,1014,694,480,963,534,42,25,960,649,426,255,534,394,394,,,,2265,1343,2096,1267,26,13,80,39,63,24,76,82,45
E02006908,Norwich 015,Middle Super Output Areas and Intermediate Zones,MSOAIZ,NR,5327,2880,2209,1151,920,530,1289,621,15,9,1616,909,1083,608,533,301,301,,,,1446,782,1373,740,0,0,70,39,3,3,42,41,29
E02006909,Hartlepool 014,Middle Super Output Areas and Intermediate Zones,MSOAIZ,TS,11795,4986,10449,4343,4366,2227,6083,2116,18,9,487,261,160,75,327,186,186,,,,758,324,642,267,8,5,85,41,23,11,57,83,49
E02006910,Redcar and Cleveland 022,Middle Super Output Areas and Intermediate Zones,MSOAIZ,TS,9987,4301,6762,2793,2810,1409,3952,1384,45,16,2209,1060,1297,586,912,474,474,,,,878,379,788,341,0,0,83,34,7,4,38,93,53
E02006911,Oadby and Wigston 009,Middle Super Output Areas and Intermediate Zones,MSOAIZ,LE,13753,4638,12071,4020,5021,2069,7050,1951,70,24,200,93,111,50,89,43,43,,,,1345,468,1259,436,3,1,67,25,16,6,32,67,33
E02006912,Manchester 055,Middle Super Output Areas and Intermediate Zones,MSOAIZ,WA,6581,3885,1446,935,400,272,1046,663,39,20,492,370,121,107,371,263,263,,,,4533,2510,4327,2399,8,5,148,82,50,24,111,71,50
E02006913,Manchester 056,Middle Super Output Areas and Intermediate Zones,MSOAIZ,M,6669,2939,1747,602,845,302,902,300,31,19,2065,915,1156,568,909,347,347,,,,2736,1369,2618,1323,6,2,66,26,46,18,46,90,34
E02006914,Manchester 057,Middle Super Output Areas and Intermediate Zones,MSOAIZ,M,3978,2299,699,425,248,155,451,270,13,7,898,571,172,95,726,476,476,,,,2309,1262,2177,1191,11,3,68,37,53,31,71,59,34
E02006915,Manchester 058,Middle Super Output Areas and Intermediate Zones,MSOAIZ,M,7906,3047,1627,604,442,183,1185,421,62,25,3970,1493,1902,756,2068,737,737,,,,2129,869,2041,833,0,0,73,31,15,5,36,118,56
E02006916,Manchester 059,Middle Super Output Areas and Intermediate Zones,MSOAIZ,M,5749,3274,969,567,209,131,760,436,21,16,1876,1119,761,426,1115,693,693,,,,2809,1530,2664,1464,4,2,46,28,95,36,66,74,42
E02006917,Manchester 060,Middle Super Output Areas and Intermediate Zones,MSOAIZ,M,5062,3087,1389,917,463,319,926,598,23,15,62,45,13,11,49,34,34,,,,3499,2061,3368,1981,5,4,105,62,21,14,80,89,49
E02006918,Hackney 028,Middle Super Output Areas and Intermediate Zones,MSOAIZ,E,7611,3113,1294,575,427,177,867,398,155,93,3816,1438,1614,629,2202,809,809,,,,2272,985,2175,937,4,1,66,38,27,9,48,74,22
E02006919,South Derbyshire 012,Middle Super Output Areas and Intermediate Zones,MSOAIZ,DE,8470,3595,6018,2452,1564,787,4454,1665,62,25,732,346,346,186,386,160,160,,,,1614,745,1498,687,6,2,101,51,9,5,58,44,27
E02006920,South Derbyshire 013,Middle Super Output Areas and Intermediate Zones,MSOAIZ,DE,7799,3155,5503,2168,1377,690,4126,1478,31,21,1186,473,768,309,418,164,164,,,,1032,470,990,447,2,2,32,18,8,3,23,47,23
E02006921,Hackney 029,Middle Super Output Areas and Intermediate Zones,MSOAIZ,N,7739,2909,1449,494,598,203,851,291,63,30,3562,1539,1659,761,1903,778,778,,,,2551,798,2410,763,4,2,107,23,30,10,35,114,48
E02006922,Colchester 022,Middle Super Output Areas and Intermediate Zones,MSOAIZ,CO,13494,5729,9848,4222,4119,2192,5729,2030,55,27,1823,748,1266,551,557,197,197,,,,1679,675,1548,617,12,5,111,48,8,5,58,89,57
E02006924,Redbridge 035,Middle Super Output Areas and Intermediate Zones,MSOAIZ,IG,12623,4020,9031,2748,3176,1216,5855,1532,23,7,432,213,199,85,233,128,128,,,,3015,1007,2892,969,10,2,86,26,27,10,38,122,45
E02006925,Redbridge 036,Middle Super Output Areas and Intermediate Zones,MSOAIZ,IG,13241,4102,10921,3313,3788,1501,7133,1812,22,9,410,199,281,121,129,78,78,,,,1779,532,1654,489,0,0,118,40,7,3,43,109,49
E02006926,Thurrock 020,Middle Super Output Areas and Intermediate Zones,MSOAIZ,RM,8057,2841,6587,2294,1079,487,5508,1807,30,16,172,70,78,24,94,46,46,,,,1227,442,1176,422,5,2,39,16,7,2,20,41,19
E02006927,Greenwich 034,Middle Super Output Areas and Intermediate Zones,MSOAIZ,SE,8241,3338,4621,1924,1834,918,2787,1006,70,27,2306,930,1834,767,472,163,163,,,,1168,422,1111,398,7,3,45,18,5,3,24,76,35
E02006928,Greenwich 035,Middle Super Output Areas and Intermediate Zones,MSOAIZ,SE,6410,2977,1218,632,258,138,960,494,206,116,2988,1247,1827,741,1161,506,506,,,,1902,941,1829,906,0,0,62,30,11,5,35,96,41
E02006929,Greenwich 036,Middle Super Output Areas and Intermediate Zones,MSOAIZ,SE,7489,3333,2199,999,573,289,1626,710,105,60,2972,1309,1455,691,1517,618,618,,,,2150,930,2035,883,5,3,74,31,36,13,47,63,35
E02006930,Greenwich 037,Middle Super Output Areas and Intermediate Zones,MSOAIZ,SE,6557,2876,2954,1286,931,459,2023,827,46,28,1278,592,788,339,490,253,253,,,,2206,935,2125,897,7,3,52,23,22,12,38,73,35
E02006931,Greenwich 038,Middle Super Output Areas and Intermediate Zones,MSOAIZ,SE,8973,4113,3721,1634,1250,606,2471,1028,59,43,2748,1286,1882,800,866,486,486,,,,2353,1103,2224,1043,54,20,58,33,17,7,60,92,47
E02006932,Liverpool 060,Middle Super Output Areas and Intermediate Zones,MSOAIZ,L,5312,3201,512,326,201,126,311,200,140,97,922,584,88,58,834,526,526,,,,3706,2168,3533,2061,19,7,60,37,94,63,107,32,26
E02006933,Liverpool 061,Middle Super Output Areas and Intermediate Zones,MSOAIZ,L,5383,3135,1245,742,467,308,778,434,9,8,1193,575,305,142,888,433,433,,,,2866,1765,2771,1701,4,2,64,42,27,20,64,70,45
E02006934,Liverpool 062,Middle Super Output Areas and Intermediate Zones,MSOAIZ,L,4367,2782,801,512,238,152,563,360,20,14,322,168,46,22,276,146,146,,,,3182,2058,3098,2006,8,6,55,34,21,12,52,42,30
W02000001,Isle of Anglesey 001,Middle Super Output Areas and Intermediate Zones,MSOAIZ,LL,8597,3793,5963,2572,3038,1523,2925,1049,6,4,1327,605,1205,542,122,63,63,,,,1123,518,964,445,3,1,139,60,17,12,73,178,94
W02000002,Isle of Anglesey 002,Middle Super Output Areas and Intermediate Zones,MSOAIZ,LL,6480,2916,5172,2298,2925,1493,2247,805,21,8,372,188,369,186,3,2,2,,,,783,353,660,288,12,4,89,50,22,11,65,132,69
W02000003,Isle of Anglesey 003,Middle Super Output Areas and Intermediate Zones,MSOAIZ,LL,10207,4673,5652,2444,2397,1266,3255,1178,11,5,2571,1292,2155,1097,416,195,195,,,,1819,832,1646,750,10,5,136,64,27,13,82,154,100
W02000004,Isle of Anglesey 004,Middle Super Output Areas and Intermediate Zones,MSOAIZ,LL,7315,3241,5803,2532,3098,1576,2705,956,22,9,598,286,522,260,76,26,26,,,,757,341,647,283,11,7,88,45,11,6,58,135,73
W02000005,Isle of Anglesey 005,Middle Super Output Areas and Intermediate Zones,MSOAIZ,LL,8666,3997,6476,2974,3743,1954,2733,1020,29,14,830,358,740,312,90,46,46,,,,1148,547,1026,490,15,7,101,46,6,4,57,183,104
W02000006,Isle of Anglesey 006,Middle Super Output Areas and Intermediate Zones,MSOAIZ,LL,6619,2847,4372,1832,1966,1012,2406,820,20,8,1483,670,1198,547,285,123,123,,,,614,268,531,230,0,0,70,34,13,4,38,130,69
W02000007,Isle of Anglesey 007,Middle Super Output Areas and Intermediate Zones,MSOAIZ,LL,7011,3003,4490,1912,2180,1089,2310,823,14,6,912,421,732,355,180,66,66,,,,1448,583,1017,434,204,65,69,33,158,51,149,147,81
W02000008,Isle of Anglesey 008,Middle Super Output Areas and Intermediate Zones,MSOAIZ,LL,6340,2789,4644,2009,2270,1181,2374,828,3,2,566,288,456,249,110,39,39,,,,1000,421,876,366,26,11,77,35,21,9,55,127,69
W02000009,Isle of Anglesey 009,Middle Super Output Areas and Intermediate Zones,MSOAIZ,LL,7706,3335,5717,2398,2737,1350,2980,1048,18,7,801,379,730,351,71,28,28,,,,996,461,886,413,12,4,96,43,2,1,48,174,90
W02000010,Gwynedd 001,Middle Super Output Areas and Intermediate Zones,MSOAIZ,LL,7210,2785,2044,928,983,539,1061,389,48,15,1268,687,666,345,602,342,342,,,,3722,1083,3562,1023,22,9,108,38,30,13,60,128,72
W02000011,Gwynedd 002,Middle Super Output Areas and Intermediate Zones,MSOAIZ,LL,7665,3011,4174,1649,1678,839,2496,810,17,7,1946,825,1138,466,808,359,359,,,,1386,450,1230,381,47,20,95,39,14,10,69,142,80
W02000012,Gwynedd 003,Middle Super Output Areas and Intermediate Zones,MSOAIZ,LL,8312,3546,5797,2424,2378,1202,3419,1222,11,6,1265,502,665,246,600,256,256,,,,1099,537,942,461,13,6,123,60,21,10,76,140,77
W02000013,Gwynedd 004,Middle Super Output Areas and Intermediate Zones,MSOAIZ,LL,6499,2720,4974,2024,2114,1035,2860,989,8,3,569,228,289,112,280,116,116,,,,846,404,708,343,10,5,120,52,8,4,61,102,61
W02000014,Gwynedd 005,Middle Super Output Areas and Intermediate Zones,MSOAIZ,LL,6865,2949,4964,2052,2175,1055,2789,997,7,3,967,444,628,271,339,173,173,,,,807,379,709,334,11,4,63,31,24,10,45,120,71
W02000015,Gwynedd 006,Middle Super Output Areas and Intermediate Zones,MSOAIZ,LL,7993,3508,4621,1995,2096,1099,2525,896,41,16,2514,1096,1453,605,1061,491,491,,,,664,307,568,264,6,2,78,33,12,8,43,153,94
W02000016,Gwynedd 007,Middle Super Output Areas and Intermediate Zones,MSOAIZ,LL,6310,2767,4705,1990,2251,1125,2454,865,22,10,844,398,472,223,372,175,175,,,,644,314,544,264,13,5,79,38,8,7,50,95,55
W02000017,Gwynedd 008,Middle Super Output Areas and Intermediate Zones,MSOAIZ,LL,7629,3335,5475,2353,2633,1358,2842,995,15,8,1313,571,746,306,567,265,265,,,,709,334,609,283,2,2,88,45,10,4,51,117,69
W02000018,Gwynedd 009,Middle Super Output Areas and Intermediate Zones,MSOAIZ,LL,6442,2997,4498,2057,2511,1350,1987,707,19,9,977,461,547,253,430,208,208,,,,812,387,721,348,0,0,66,30,25,9,39,136,83
W02000019,Gwynedd 010,Middle Super Output Areas and Intermediate Zones,MSOAIZ,LL,6888,3218,4854,2271,2898,1557,1956,714,18,8,915,398,382,160,533,238,238,,,,929,444,746,362,26,10,137,57,20,15,82,172,97
W02000020,Gwynedd 011,Middle Super Output Areas and Intermediate Zones,MSOAIZ,LL,6813,2958,4936,2117,2935,1439,2001,678,25,11,912,373,474,180,438,193,193,,,,789,379,663,318,14,7,93,41,19,13,61,151,78
W02000021,Gwynedd 012,Middle Super Output Areas and Intermediate Zones,MSOAIZ,LL,7896,3654,5029,2271,2771,1462,2258,809,35,15,1441,646,763,340,678,306,306,,,,1231,629,1056,540,21,13,123,59,31,17,89,160,93
W02000022,Gwynedd 013,Middle Super Output Areas and Intermediate Zones,MSOAIZ,LL,6041,2881,4481,2140,2671,1480,1810,660,25,9,594,276,262,133,332,143,143,,,,803,368,688,307,15,7,88,47,12,7,61,138,88
W02000023,Gwynedd 014,Middle Super Output Areas and Intermediate Zones,MSOAIZ,LL,5898,2698,3897,1806,2563,1307,1334,499,16,10,730,345,313,136,417,209,209,,,,1102,452,916,378,37,12,95,40,54,22,74,153,85
W02000024,Gwynedd 015,Middle Super Output Areas and Intermediate Zones,MSOAIZ,SY,5659,2556,3849,1675,2320,1125,1529,550,14,8,778,371,396,173,382,198,198,,,,838,410,670,330,28,9,122,60,18,11,80,180,92
W02000025,Gwynedd 016,Middle Super Output Areas and Intermediate Zones,MSOAIZ,LL,6484,3160,4183,1957,2432,1312,1751,645,27,14,1099,554,558,280,541,274,274,,,,1046,559,923,490,15,7,100,56,8,6,69,129,76
W02000026,Gwynedd 017,Middle Super Output Areas and Intermediate Zones,MSOAIZ,SY,7370,3730,5233,2615,3338,1884,1895,731,30,19,801,386,345,156,456,230,230,,,,1169,624,1029,552,44,16,82,49,14,7,72,137,86
W02000027,Conwy 001,Middle Super Output Areas and Intermediate Zones,MSOAIZ,LL,8147,4228,4421,2102,2154,1254,2267,848,36,14,1142,674,366,234,776,440,440,,,,2398,1346,2243,1270,16,9,106,53,33,14,76,150,92
W02000028,Conwy 002,Middle Super Output Areas and Intermediate Zones,MSOAIZ,LL,6881,3043,4516,2075,2248,1258,2268,817,35,16,1547,615,675,286,872,329,329,,,,727,305,660,276,7,2,59,26,1,1,29,56,32
W02000029,Conwy 003,Middle Super Output Areas and Intermediate Zones,MSOAIZ,LL,6082,2806,5207,2421,2550,1452,2657,969,47,25,28,11,0,0,28,11,11,,,,738,313,673,286,15,5,50,22,0,0,27,62,36
W02000030,Conwy 004,Middle Super Output Areas and Intermediate Zones,MSOAIZ,LL,5922,3002,4128,1996,2175,1252,1953,744,60,31,656,387,294,154,362,233,233,,,,1011,539,917,493,7,2,68,36,19,8,46,67,49
W02000031,Conwy 005,Middle Super Output Areas and Intermediate Zones,MSOAIZ,LL,8340,3606,6094,2712,2698,1467,3396,1245,179,74,557,217,246,96,311,121,121,,,,1438,563,1301,499,15,8,115,52,7,4,64,72,40
W02000032,Conwy 006,Middle Super Output Areas and Intermediate Zones,MSOAIZ,LL,7690,3539,6129,2851,3179,1771,2950,1080,75,32,581,234,194,76,387,158,158,,,,835,376,742,337,7,2,73,32,13,5,39,70,46
W02000033,Conwy 007,Middle Super Output Areas and Intermediate Zones,MSOAIZ,LL,6429,3002,3828,1601,1514,812,2314,789,27,15,461,306,167,112,294,194,194,,,,2036,1037,1952,994,8,4,71,35,5,4,43,77,43
W02000034,Conwy 008,Middle Super Output Areas and Intermediate Zones,MSOAIZ,LL,7499,3258,5546,2271,2154,1109,3392,1162,58,26,808,451,327,211,481,240,240,,,,969,447,827,392,19,4,101,42,22,9,55,118,63
W02000035,Conwy 009,Middle Super Output Areas and Intermediate Zones,MSOAIZ,LL,8792,3763,5971,2573,2377,1248,3594,1325,85,34,1625,642,1027,393,598,249,249,,,,1045,476,951,428,5,3,82,40,7,5,48,66,38
W02000036,Conwy 010,Middle Super Output Areas and Intermediate Zones,MSOAIZ,LL,10444,4986,7683,3661,4041,2306,3642,1355,100,41,1024,501,452,220,572,281,281,,,,1558,731,1420,666,6,3,115,55,17,7,65,79,52
W02000037,Conwy 011,Middle Super Output Areas and Intermediate Zones,MSOAIZ,LL,6955,3023,4872,2153,2197,1167,2675,986,50,17,883,359,484,195,399,164,164,,,,1069,455,940,401,6,2,102,43,21,9,54,81,39
W02000038,Conwy 012,Middle Super Output Areas and Intermediate Zones,MSOAIZ,LL,6042,2755,4365,1970,2322,1207,2043,763,35,17,726,314,270,113,456,201,201,,,,849,413,765,370,7,3,63,31,14,9,43,67,41
W02000039,Conwy 013,Middle Super Output Areas and Intermediate Zones,MSOAIZ,LL,7823,3502,5659,2482,2429,1321,3230,1161,27,15,930,422,404,164,526,258,258,,,,1116,531,995,471,2,1,111,52,8,7,60,91,52
W02000040,Conwy 014,Middle Super Output Areas and Intermediate Zones,MSOAIZ,LL,6795,2807,4908,1954,2669,1174,2239,780,11,5,544,274,268,143,276,131,131,,,,1113,473,968,410,12,5,113,48,20,10,63,219,101
W02000041,Conwy 015,Middle Super Output Areas and Intermediate Zones,MSOAIZ,LL,8690,3857,6103,2679,3178,1611,2925,1068,40,16,1158,539,395,195,763,344,344,,,,1211,529,1012,436,33,14,102,57,64,22,93,178,94
W02000042,Denbighshire 001,Middle Super Output Areas and Intermediate Zones,MSOAIZ,LL,5706,2622,4286,2004,2053,1160,2233,844,46,21,148,93,55,43,93,50,50,,,,1165,472,1060,418,10,3,89,47,6,4,54,61,32
W02000043,Denbighshire 002,Middle Super Output Areas and Intermediate Zones,MSOAIZ,LL,5317,2217,3656,1496,1499,786,2157,710,77,35,712,341,403,212,309,129,129,,,,804,305,715,274,3,2,84,28,2,1,31,68,40
W02000044,Denbighshire 003,Middle Super Output Areas and Intermediate Zones,MSOAIZ,LL,5172,2391,4307,2000,2100,1187,2207,813,39,17,77,35,25,11,52,24,24,,,,713,319,643,287,12,4,55,26,3,2,32,36,20
W02000045,Denbighshire 004,Middle Super Output Areas and Intermediate Zones,MSOAIZ,LL,8530,4084,4432,1923,1842,1007,2590,916,66,35,1365,727,375,200,990,527,527,,,,2532,1328,2382,1263,39,16,102,45,9,4,65,135,71
W02000047,Denbighshire 006,Middle Super Output Areas and Intermediate Zones,MSOAIZ,LL,5383,2058,2569,1006,751,399,1818,607,19,5,1844,707,1266,494,578,213,213,,,,895,305,810,275,0,0,82,29,3,1,30,56,35
W02000049,Denbighshire 008,Middle Super Output Areas and Intermediate Zones,MSOAIZ,LL,6449,2709,4639,1947,1908,989,2731,958,38,15,804,315,601,250,203,65,65,,,,856,367,756,324,14,6,73,31,13,6,43,112,65
W02000050,Denbighshire 009,Middle Super Output Areas and Intermediate Zones,MSOAIZ,LL,6382,2789,4589,2024,1979,1069,2610,955,30,11,653,263,518,212,135,51,51,,,,1055,459,962,414,25,11,66,33,2,1,45,55,32
W02000051,Denbighshire 010,Middle Super Output Areas and Intermediate Zones,MSOAIZ,LL,5111,2263,3701,1595,1629,848,2072,747,13,4,658,334,420,205,238,129,129,,,,661,287,568,242,19,7,68,34,6,4,45,78,43
W02000052,Denbighshire 011,Middle Super Output Areas and Intermediate Zones,MSOAIZ,LL,5122,2305,2602,1171,1091,584,1511,587,36,15,1531,649,1015,431,516,218,218,,,,867,424,779,379,13,6,61,29,14,10,45,86,46
W02000053,Denbighshire 012,Middle Super Output Areas and Intermediate Zones,MSOAIZ,LL,6321,2631,5149,2086,2234,1087,2915,999,30,13,371,203,164,99,207,104,104,,,,682,288,594,249,10,3,64,31,14,5,39,89,41
W02000054,Denbighshire 013,Middle Super Output Areas and Intermediate Zones,MSOAIZ,LL,5829,2460,4607,1886,2214,1060,2393,826,7,6,456,202,302,155,154,47,47,,,,668,315,552,265,18,10,91,37,7,3,50,91,51
W02000055,Denbighshire 014,Middle Super Output Areas and Intermediate Zones,MSOAIZ,LL,5282,2406,3696,1638,1706,939,1990,699,20,12,784,367,418,199,366,168,168,,,,693,333,601,295,4,1,79,33,9,4,38,89,56
W02000056,Denbighshire 015,Middle Super Output Areas and Intermediate Zones,MSOAIZ,LL,5219,2172,3914,1592,1843,868,2071,724,18,6,626,264,441,201,185,63,63,,,,561,256,472,217,20,8,58,24,11,7,39,100,54
W02000057,Denbighshire 016,Middle Super Output Areas and Intermediate Zones,MSOAIZ,LL,6043,2786,4247,1893,2236,1158,2011,735,39,16,835,405,551,255,284,150,150,,,,785,400,707,362,10,6,48,25,20,7,38,137,72
W02000058,Flintshire 001,Middle Super Output Areas and Intermediate Zones,MSOAIZ,LL,5159,2291,3644,1629,1615,879,2029,750,54,20,706,308,571,256,135,52,52,,,,703,306,618,268,6,3,69,30,10,5,38,52,28
W02000059,Flintshire 002,Middle Super Output Areas and Intermediate Zones,MSOAIZ,LL,6494,2691,4945,2010,1969,982,2976,1028,48,19,862,384,767,335,95,49,49,,,,588,251,487,209,12,5,76,32,13,5,42,51,27
W02000060,Flintshire 003,Middle Super Output Areas and Intermediate Zones,MSOAIZ,CH,10598,4491,6838,2816,2546,1320,4292,1496,29,16,2467,1108,1794,819,673,289,289,,,,1193,509,1041,443,1,1,126,55,25,10,66,71,42
W02000061,Flintshire 004,Middle Super Output Areas and Intermediate Zones,MSOAIZ,CH,6561,2862,3494,1424,1264,659,2230,765,4,2,2256,1116,1891,920,365,196,196,,,,762,298,673,256,2,2,75,33,12,7,42,45,22
W02000062,Flintshire 005,Middle Super Output Areas and Intermediate Zones,MSOAIZ,CH,6255,2400,5308,2047,1862,905,3446,1142,16,7,403,146,35,13,368,133,133,,,,507,186,453,160,7,2,43,23,4,1,26,21,14
W02000063,Flintshire 006,Middle Super Output Areas and Intermediate Zones,MSOAIZ,CH,8339,3506,6914,2821,3044,1479,3870,1342,55,30,525,288,458,255,67,33,33,,,,734,310,595,258,6,3,118,44,15,5,52,111,57
W02000064,Flintshire 007,Middle Super Output Areas and Intermediate Zones,MSOAIZ,CH,6104,2596,3550,1484,1249,660,2301,824,28,11,1743,784,1275,591,468,193,193,,,,744,297,702,275,0,0,40,20,2,2,22,39,20
W02000065,Flintshire 008,Middle Super Output Areas and Intermediate Zones,MSOAIZ,CH,7468,3000,6065,2479,2084,1065,3981,1414,59,22,346,123,131,51,215,72,72,,,,944,351,864,312,3,1,75,37,2,1,39,54,25
W02000066,Flintshire 009,Middle Super Output Areas and Intermediate Zones,MSOAIZ,CH,9630,4150,5566,2344,1972,1032,3594,1312,66,32,2640,1191,1847,826,793,365,365,,,,1278,545,1165,493,10,6,82,37,21,9,52,80,38
W02000067,Flintshire 010,Middle Super Output Areas and Intermediate Zones,MSOAIZ,CH,6314,2494,5521,2156,1975,982,3546,1174,27,12,280,144,182,94,98,50,50,,,,468,169,409,144,0,0,54,22,5,3,25,18,13
W02000068,Flintshire 011,Middle Super Output Areas and Intermediate Zones,MSOAIZ,CH,5605,2453,3595,1581,1460,796,2135,785,33,15,1005,459,488,265,517,194,194,,,,926,374,848,341,4,1,70,30,4,2,33,46,24
W02000069,Flintshire 012,Middle Super Output Areas and Intermediate Zones,MSOAIZ,CH,6062,2524,4886,2019,2009,1004,2877,1015,32,13,431,195,226,127,205,68,68,,,,676,273,628,247,1,1,41,21,6,4,26,37,24
W02000070,Flintshire 013,Middle Super Output Areas and Intermediate Zones,MSOAIZ,CH,10512,4266,8869,3563,3290,1662,5579,1901,52,33,486,217,452,203,34,14,14,,,,1022,418,924,380,5,2,79,32,14,4,38,83,35
W02000071,Flintshire 014,Middle Super Output Areas and Intermediate Zones,MSOAIZ,CH,7312,3049,6433,2696,2685,1389,3748,1307,36,13,232,99,130,63,102,36,36,,,,575,220,518,192,0,0,49,24,8,4,28,36,21
W02000072,Flintshire 015,Middle Super Output Areas and Intermediate Zones,MSOAIZ,CH,11106,4668,7625,3213,2425,1301,5200,1912,49,23,2095,830,1763,723,332,107,107,,,,1258,558,1091,489,8,4,149,60,10,5,69,79,44
W02000073,Flintshire 016,Middle Super Output Areas and Intermediate Zones,MSOAIZ,CH,9986,4313,7017,2996,3067,1638,3950,1358,63,26,1754,782,1182,492,572,290,290,,,,1066,461,931,404,10,5,107,45,18,7,57,86,48
W02000074,Flintshire 017,Middle Super Output Areas and Intermediate Zones,MSOAIZ,CH,9254,4098,6537,2810,2510,1326,4027,1484,33,13,1511,749,1155,569,356,180,180,,,,1108,485,975,427,9,5,120,51,4,2,58,65,41
W02000075,Flintshire 018,Middle Super Output Areas and Intermediate Zones,MSOAIZ,CH,5551,2224,4816,1893,1975,942,2841,951,17,9,256,125,218,113,38,12,12,,,,425,180,374,158,5,3,42,17,4,2,22,37,17
W02000076,Flintshire 019,Middle Super Output Areas and Intermediate Zones,MSOAIZ,CH,7422,3169,5977,2495,2664,1337,3313,1158,31,15,674,325,524,266,150,59,59,,,,664,294,594,260,10,4,51,26,9,4,34,76,40
W02000077,Flintshire 020,Middle Super Output Areas and Intermediate Zones,MSOAIZ,LL,5947,2536,4748,1975,2070,1039,2678,936,22,9,595,278,451,228,144,50,50,,,,521,244,432,198,10,5,71,37,8,4,46,61,30
W02000080,Wrexham 003,Middle Super Output Areas and Intermediate Zones,MSOAIZ,LL,7918,3287,5385,2170,1746,873,3639,1297,9,4,1874,825,1636,710,238,115,115,,,,578,242,507,217,0,0,65,23,6,2,25,72,46
W02000081,Wrexham 004,Middle Super Output Areas and Intermediate Zones,MSOAIZ,LL,5626,2331,3702,1493,1157,554,2545,939,6,3,1407,608,1274,562,133,46,46,,,,466,199,414,175,7,2,37,19,8,3,24,45,28
W02000082,Wrexham 005,Middle Super Output Areas and Intermediate Zones,MSOAIZ,LL,7419,3171,4773,1959,1454,747,3319,1212,25,12,1860,849,1534,701,326,148,148,,,,689,312,601,271,9,3,77,37,2,1,41,72,39
W02000083,Wrexham 006,Middle Super Output Areas and Intermediate Zones,MSOAIZ,LL,8591,3668,5726,2364,1873,974,3853,1390,32,12,1798,802,1653,742,145,60,60,,,,934,424,829,379,6,3,79,37,20,5,45,101,66
W02000084,Wrexham 007,Middle Super Output Areas and Intermediate Zones,MSOAIZ,LL,5109,2240,4536,1971,2041,1091,2495,880,6,3,148,81,95,57,53,24,24,,,,362,148,307,123,2,1,47,22,6,2,25,57,37
W02000085,Wrexham 008,Middle Super Output Areas and Intermediate Zones,MSOAIZ,LL,8808,3965,6585,2908,3000,1608,3585,1300,4,3,831,428,609,296,222,132,132,,,,1285,572,1173,521,3,1,91,44,18,6,51,103,54
W02000086,Wrexham 009,Middle Super Output Areas and Intermediate Zones,MSOAIZ,LL,5105,2239,3139,1385,1240,712,1899,673,18,6,1347,599,1289,574,58,25,25,,,,522,208,468,180,3,1,49,25,2,2,28,79,41
W02000087,Wrexham 010,Middle Super Output Areas and Intermediate Zones,MSOAIZ,LL,7334,2938,2044,815,668,343,1376,472,3,3,4783,1923,4634,1864,149,59,59,,,,393,137,359,122,5,2,24,10,5,3,15,111,60
W02000088,Wrexham 011,Middle Super Output Areas and Intermediate Zones,MSOAIZ,LL,8075,3515,4143,1779,1623,856,2520,923,118,61,1062,534,629,312,433,222,222,,,,2643,1083,2468,1001,53,24,93,44,29,14,82,109,58
W02000089,Wrexham 012,Middle Super Output Areas and Intermediate Zones,MSOAIZ,LL,8313,3781,3854,1718,1330,721,2524,997,31,16,2224,1181,1673,848,551,333,333,,,,2080,791,1985,747,10,5,76,35,9,4,44,124,75
W02000090,Wrexham 013,Middle Super Output Areas and Intermediate Zones,MSOAIZ,LL,5861,2422,3997,1668,1632,825,2365,843,39,10,1436,566,1202,468,234,98,98,,,,336,145,294,126,0,0,34,15,8,4,19,53,33
W02000091,Wrexham 014,Middle Super Output Areas and Intermediate Zones,MSOAIZ,LL,6139,2636,4604,1963,1842,965,2762,998,40,18,826,349,703,304,123,45,45,,,,617,273,511,217,10,3,83,47,13,6,56,52,33
W02000092,Wrexham 015,Middle Super Output Areas and Intermediate Zones,MSOAIZ,LL,6953,3079,3948,1654,1356,718,2592,936,17,11,2099,985,1745,811,354,174,174,,,,809,377,721,334,6,2,77,38,5,3,43,80,52
W02000093,Wrexham 016,Middle Super Output Areas and Intermediate Zones,MSOAIZ,LL,6612,2826,4570,1866,1749,879,2821,987,14,7,1033,478,782,356,251,122,122,,,,914,426,845,389,11,5,55,30,3,2,37,81,49
W02000094,Wrexham 017,Middle Super Output Areas and Intermediate Zones,MSOAIZ,LL,9048,3818,5032,2067,1938,1003,3094,1064,11,7,3349,1433,3207,1390,142,43,43,,,,543,245,479,212,2,1,54,28,8,4,33,113,66
W02000095,Wrexham 018,Middle Super Output Areas and Intermediate Zones,MSOAIZ,SY,6484,2697,4937,2016,2385,1127,2552,889,27,11,471,226,417,205,54,21,21,,,,959,396,840,343,16,7,84,39,19,7,53,90,48
W02000096,Wrexham 019,Middle Super Output Areas and Intermediate Zones,MSOAIZ,SY,6580,2839,4521,1902,2004,1003,2517,899,19,9,1290,582,904,415,386,167,167,,,,604,267,520,233,11,4,72,29,1,1,34,146,79
W02000097,Powys 001,Middle Super Output Areas and Intermediate Zones,MSOAIZ,SY,9012,3893,6736,2843,4027,1890,2709,953,12,7,703,353,426,233,277,120,120,,,,1365,596,1213,527,24,13,106,47,22,9,69,196,94
W02000098,Powys 002,Middle Super Output Areas and Intermediate Zones,MSOAIZ,SY,6295,2641,5043,2093,2491,1213,2552,880,22,11,346,158,268,126,78,32,32,,,,804,334,709,292,9,5,70,30,16,7,42,80,45
W02000099,Powys 003,Middle Super Output Areas and Intermediate Zones,MSOAIZ,SY,6456,2955,3589,1596,1678,919,1911,677,63,23,1423,712,501,286,922,426,426,,,,1237,537,1145,493,19,8,52,26,21,10,44,144,87
W02000100,Powys 004,Middle Super Output Areas and Intermediate Zones,MSOAIZ,SY,6153,2748,4354,1892,2559,1240,1795,652,25,7,920,420,658,286,262,134,134,,,,703,351,573,297,22,8,87,38,21,8,54,151,78
W02000101,Powys 005,Middle Super Output Areas and Intermediate Zones,MSOAIZ,SY,5461,2350,4128,1738,2080,1055,2048,683,1,1,341,165,307,144,34,21,21,,,,912,405,792,356,45,16,65,29,10,4,49,79,41
W02000102,Powys 006,Middle Super Output Areas and Intermediate Zones,MSOAIZ,SY,6293,2652,4877,2008,2716,1263,2161,745,23,7,531,247,411,195,120,52,52,,,,783,349,703,312,5,2,63,28,12,7,37,79,41
W02000103,Powys 007,Middle Super Output Areas and Intermediate Zones,MSOAIZ,SY,5663,2349,4441,1822,2436,1167,2005,655,16,8,467,194,322,140,145,54,54,,,,628,268,541,229,9,6,73,30,5,3,39,111,57
W02000104,Powys 008,Middle Super Output Areas and Intermediate Zones,MSOAIZ,SY,6109,2880,3943,1719,2009,1027,1934,692,15,8,1009,556,688,350,321,206,206,,,,1075,558,933,488,17,11,111,54,14,5,70,67,39
W02000105,Powys 009,Middle Super Output Areas and Intermediate Zones,MSOAIZ,SY,5117,2135,2082,889,698,393,1384,496,21,8,2418,983,1646,637,772,346,346,,,,528,223,472,199,1,1,51,22,4,1,24,68,32
W02000106,Powys 010,Middle Super Output Areas and Intermediate Zones,MSOAIZ,SY,6562,2954,4870,2091,2969,1437,1901,654,20,8,577,313,428,232,149,81,81,,,,974,472,884,426,2,2,77,37,11,7,46,121,70
W02000107,Powys 011,Middle Super Output Areas and Intermediate Zones,MSOAIZ,LD,9852,4449,7062,3172,4492,2245,2570,927,30,12,1088,491,753,339,335,152,152,,,,1415,649,1216,571,39,14,152,60,8,4,78,257,125
W02000108,Powys 012,Middle Super Output Areas and Intermediate Zones,MSOAIZ,SY,6952,3210,5102,2331,3271,1671,1831,660,11,8,740,354,484,235,256,119,119,,,,975,455,869,407,11,5,77,35,18,8,48,124,62
W02000109,Powys 013,Middle Super Output Areas and Intermediate Zones,MSOAIZ,LD,5211,2583,3264,1528,1636,931,1628,597,10,6,831,406,404,199,427,207,207,,,,1046,607,987,578,2,1,48,25,9,3,29,60,36
W02000110,Powys 014,Middle Super Output Areas and Intermediate Zones,MSOAIZ,SA,6948,3072,5092,2207,2959,1459,2133,748,14,5,617,288,353,177,264,111,111,,,,1107,512,991,464,32,11,66,29,18,8,48,118,60
W02000111,Powys 015,Middle Super Output Areas and Intermediate Zones,MSOAIZ,NP,8293,3751,5927,2587,3517,1740,2410,847,19,11,902,449,628,326,274,123,123,,,,1227,605,1025,506,36,17,158,77,8,5,99,218,99
W02000113,Powys 017,Middle Super Output Areas and Intermediate Zones,MSOAIZ,LD,7887,3635,4470,2115,2303,1301,2167,814,27,13,1771,804,1020,462,751,342,342,,,,1449,612,986,451,184,56,95,50,184,55,161,170,91
W02000114,Powys 018,Middle Super Output Areas and Intermediate Zones,MSOAIZ,NP,6845,2970,5257,2217,2928,1404,2329,813,28,13,577,292,320,180,257,112,112,,,,841,380,655,311,62,20,86,35,38,14,69,142,68
W02000116,Ceredigion 001,Middle Super Output Areas and Intermediate Zones,MSOAIZ,SY,7553,3291,5803,2484,3012,1509,2791,975,23,11,444,191,134,56,310,135,135,,,,1187,549,1071,493,24,11,77,37,15,8,56,96,56
W02000117,Ceredigion 002,Middle Super Output Areas and Intermediate Zones,MSOAIZ,SY,7721,3321,2286,1064,1310,713,976,351,50,12,662,425,169,103,493,322,322,,,,4638,1759,4395,1664,25,11,83,39,135,45,95,85,61
W02000118,Ceredigion 003,Middle Super Output Areas and Intermediate Zones,MSOAIZ,SY,6621,2840,3422,1535,1584,865,1838,670,35,14,1446,644,430,203,1016,441,441,,,,1628,594,1382,515,16,10,101,39,129,30,79,90,53
W02000120,Ceredigion 005,Middle Super Output Areas and Intermediate Zones,MSOAIZ,SY,7276,3257,5566,2439,3157,1586,2409,853,26,10,321,173,86,40,235,133,133,,,,1226,562,1083,492,10,4,109,54,24,12,70,137,73
W02000122,Ceredigion 007,Middle Super Output Areas and Intermediate Zones,MSOAIZ,SA,6701,2921,5280,2299,3086,1561,2194,738,15,10,417,176,134,54,283,122,122,,,,826,351,707,296,10,7,90,41,19,7,55,163,85
W02000123,Ceredigion 008,Middle Super Output Areas and Intermediate Zones,MSOAIZ,SY,7787,3432,5411,2364,3247,1609,2164,755,39,18,710,356,241,127,469,229,229,,,,1514,627,1339,550,8,4,124,55,43,18,77,113,67
W02000124,Ceredigion 009,Middle Super Output Areas and Intermediate Zones,MSOAIZ,SA,8823,4165,5828,2739,3359,1811,2469,928,47,16,1439,670,529,242,910,428,428,,,,1370,669,1265,619,20,8,76,37,9,5,50,139,71
W02000125,Ceredigion 010,Middle Super Output Areas and Intermediate Zones,MSOAIZ,SA,7402,3308,5751,2522,3291,1671,2460,851,11,6,676,332,231,111,445,221,221,,,,847,384,741,335,1,1,93,40,12,8,49,117,64
W02000126,Pembrokeshire 001,Middle Super Output Areas and Intermediate Zones,MSOAIZ,SA,8135,3537,6468,2801,3797,1860,2671,941,32,16,531,206,285,119,246,87,87,,,,926,427,740,346,35,15,132,57,19,9,81,178,87
W02000127,Pembrokeshire 002,Middle Super Output Areas and Intermediate Zones,MSOAIZ,SA,9649,4462,6838,3187,3945,2142,2893,1045,16,12,1362,586,709,337,653,249,249,,,,1296,594,1124,517,21,7,130,61,21,9,77,137,83
W02000128,Pembrokeshire 003,Middle Super Output Areas and Intermediate Zones,MSOAIZ,SA,7083,3130,5116,2283,2921,1510,2195,773,29,16,1056,439,670,299,386,140,140,,,,723,315,578,247,34,14,91,43,20,11,68,159,77
W02000129,Pembrokeshire 004,Middle Super Output Areas and Intermediate Zones,MSOAIZ,SA,6678,2807,5350,2233,2970,1425,2380,808,12,5,371,157,218,101,153,56,56,,,,790,331,677,283,10,6,95,39,8,3,48,155,81
W02000130,Pembrokeshire 005,Middle Super Output Areas and Intermediate Zones,MSOAIZ,SA,6901,3118,3410,1479,1506,811,1904,668,17,13,1781,828,1132,535,649,293,293,,,,1639,764,1172,606,242,73,110,46,115,39,158,54,34
W02000131,Pembrokeshire 006,Middle Super Output Areas and Intermediate Zones,MSOAIZ,SA,6896,3020,4667,2055,2092,1125,2575,930,10,5,1210,508,773,316,437,192,192,,,,955,415,820,356,25,9,90,43,20,7,59,54,37
W02000132,Pembrokeshire 007,Middle Super Output Areas and Intermediate Zones,MSOAIZ,SA,6287,2702,4775,2023,2488,1243,2287,780,9,4,473,207,335,143,138,64,64,,,,898,401,754,340,33,13,105,46,6,2,61,132,67
W02000133,Pembrokeshire 008,Middle Super Output Areas and Intermediate Zones,MSOAIZ,SA,7801,3322,6102,2572,3358,1609,2744,963,23,9,743,322,642,285,101,37,37,,,,825,362,667,306,11,3,125,46,22,7,56,108,57
W02000134,Pembrokeshire 009,Middle Super Output Areas and Intermediate Zones,MSOAIZ,SA,8469,3633,6496,2759,3016,1555,3480,1204,13,7,1217,518,769,358,448,160,160,,,,669,305,592,265,0,0,71,37,6,3,40,74,44
W02000135,Pembrokeshire 010,Middle Super Output Areas and Intermediate Zones,MSOAIZ,SA,6908,3097,4272,1863,2015,1060,2257,803,9,3,1770,808,1287,573,483,235,235,,,,809,391,680,338,17,6,110,45,2,2,53,48,32
W02000136,Pembrokeshire 011,Middle Super Output Areas and Intermediate Zones,MSOAIZ,SA,8401,3708,6447,2842,3625,1856,2822,986,36,14,656,268,341,164,315,104,104,,,,1124,512,989,450,35,13,69,38,31,11,62,138,72
W02000137,Pembrokeshire 012,Middle Super Output Areas and Intermediate Zones,MSOAIZ,SA,6958,3047,4068,1759,1790,959,2278,800,19,7,2081,915,1791,794,290,121,121,,,,737,333,655,299,6,2,64,27,12,5,34,53,33
W02000138,Pembrokeshire 013,Middle Super Output Areas and Intermediate Zones,MSOAIZ,SA,9672,4171,5900,2459,2442,1280,3458,1179,16,9,1958,899,1238,569,720,330,330,,,,1723,768,1575,705,15,6,125,53,8,4,63,75,36
W02000139,Pembrokeshire 014,Middle Super Output Areas and Intermediate Zones,MSOAIZ,SA,7659,3318,6071,2639,3207,1669,2864,970,32,11,747,314,552,234,195,80,80,,,,733,306,618,256,15,8,88,36,12,6,50,76,48
W02000140,Pembrokeshire 015,Middle Super Output Areas and Intermediate Zones,MSOAIZ,SA,6908,3046,4018,1720,1945,1000,2073,720,2,2,1997,883,1480,664,517,219,219,,,,804,393,727,356,25,11,44,22,8,4,37,87,48
W02000141,Pembrokeshire 016,Middle Super Output Areas and Intermediate Zones,MSOAIZ,SA,6140,3004,3968,1884,2156,1203,1812,681,12,7,877,454,663,331,214,123,123,,,,1126,571,997,510,20,10,98,43,11,8,61,157,88
W02000142,Carmarthenshire 001,Middle Super Output Areas and Intermediate Zones,MSOAIZ,SA,5570,2406,4023,1722,2219,1086,1804,636,17,9,751,347,671,304,80,43,43,,,,675,276,600,240,20,7,42,22,13,7,36,104,52
W02000143,Carmarthenshire 002,Middle Super Output Areas and Intermediate Zones,MSOAIZ,SA,5638,2516,4170,1850,2539,1258,1631,592,14,5,538,254,373,181,165,73,73,,,,771,333,648,276,21,9,66,32,36,16,57,145,74
W02000144,Carmarthenshire 003,Middle Super Output Areas and Intermediate Zones,MSOAIZ,SA,7628,3274,5855,2430,3246,1524,2609,906,33,14,733,360,509,279,224,81,81,,,,892,407,785,353,8,5,99,49,0,0,54,115,63
W02000145,Carmarthenshire 004,Middle Super Output Areas and Intermediate Zones,MSOAIZ,SA,7019,3124,5568,2420,3153,1561,2415,859,14,9,459,228,351,178,108,50,50,,,,867,407,740,351,9,4,113,50,5,2,56,111,60
W02000146,Carmarthenshire 005,Middle Super Output Areas and Intermediate Zones,MSOAIZ,SA,6581,2732,5532,2269,3050,1425,2482,844,16,7,320,145,215,109,105,36,36,,,,620,264,522,223,3,3,87,34,8,4,41,93,47
W02000147,Carmarthenshire 006,Middle Super Output Areas and Intermediate Zones,MSOAIZ,SA,7744,3221,5552,2305,2628,1300,2924,1005,26,11,852,393,375,187,477,206,206,,,,1167,445,1044,394,20,5,91,40,12,6,51,147,67
W02000148,Carmarthenshire 007,Middle Super Output Areas and Intermediate Zones,MSOAIZ,SA,5100,2267,3187,1397,1525,803,1662,594,4,2,1148,550,860,375,288,175,175,,,,688,283,614,255,9,4,64,23,1,1,28,73,35
W02000149,Carmarthenshire 008,Middle Super Output Areas and Intermediate Zones,MSOAIZ,SA,6025,2945,3985,1860,2238,1220,1747,640,13,9,716,436,517,308,199,128,128,,,,1206,586,1116,543,20,8,63,32,7,3,43,105,54
W02000151,Carmarthenshire 010,Middle Super Output Areas and Intermediate Zones,MSOAIZ,SA,7380,3209,5308,2234,2493,1270,2815,964,7,5,1323,632,1070,494,253,138,138,,,,652,288,579,251,3,3,62,28,8,6,37,90,50
W02000152,Carmarthenshire 011,Middle Super Output Areas and Intermediate Zones,MSOAIZ,SA,7881,3387,6038,2570,2833,1427,3205,1143,10,6,1121,524,945,455,176,69,69,,,,642,250,542,212,8,3,82,31,10,4,38,70,37
W02000153,Carmarthenshire 012,Middle Super Output Areas and Intermediate Zones,MSOAIZ,SA,7691,3351,6163,2667,3378,1675,2785,992,11,9,757,340,657,313,100,27,27,,,,632,271,553,240,2,1,72,27,5,3,31,128,64
W02000154,Carmarthenshire 013,Middle Super Output Areas and Intermediate Zones,MSOAIZ,SA,7480,3344,5314,2287,2539,1315,2775,972,7,4,1160,594,679,345,481,249,249,,,,912,409,782,351,8,3,117,51,5,4,58,87,50
W02000156,Carmarthenshire 015,Middle Super Output Areas and Intermediate Zones,MSOAIZ,SA,8100,3381,6372,2638,2831,1387,3541,1251,19,8,825,356,674,305,151,51,51,,,,801,334,719,303,18,5,50,22,14,4,31,83,45
W02000157,Carmarthenshire 016,Middle Super Output Areas and Intermediate Zones,MSOAIZ,SA,8933,3845,7178,2976,3406,1670,3772,1306,17,7,963,537,849,495,114,42,42,,,,655,272,549,228,3,1,87,36,16,7,44,120,53
W02000158,Carmarthenshire 017,Middle Super Output Areas and Intermediate Zones,MSOAIZ,SA,5649,2409,4625,1926,1955,973,2670,953,12,6,413,201,363,176,50,25,25,,,,539,247,470,210,0,0,55,31,14,6,37,60,29
W02000159,Carmarthenshire 018,Middle Super Output Areas and Intermediate Zones,MSOAIZ,SA,6040,2575,4346,1810,2111,1057,2235,753,6,3,1057,474,837,390,220,84,84,,,,544,245,481,216,10,5,46,21,7,3,29,87,43
W02000160,Carmarthenshire 019,Middle Super Output Areas and Intermediate Zones,MSOAIZ,SA,7441,3193,6140,2621,2815,1456,3325,1165,4,3,695,319,557,255,138,64,64,,,,512,198,447,171,5,2,48,21,12,4,27,90,52
W02000161,Carmarthenshire 020,Middle Super Output Areas and Intermediate Zones,MSOAIZ,SA,5513,2320,3449,1437,1493,742,1956,695,6,2,1280,550,1004,464,276,86,86,,,,711,288,605,243,21,10,43,19,42,16,45,67,43
W02000162,Carmarthenshire 021,Middle Super Output Areas and Intermediate Zones,MSOAIZ,SA,8508,3781,6512,2835,3136,1684,3376,1151,13,5,893,460,699,362,194,98,98,,,,994,423,907,383,4,2,79,35,4,3,40,96,58
W02000163,Carmarthenshire 022,Middle Super Output Areas and Intermediate Zones,MSOAIZ,SA,5396,2371,3606,1595,1656,910,1950,685,9,4,809,360,612,252,197,108,108,,,,909,366,825,330,0,0,69,27,15,9,36,63,46
W02000164,Carmarthenshire 023,Middle Super Output Areas and Intermediate Zones,MSOAIZ,SA,6830,3035,5211,2274,2584,1346,2627,928,11,7,658,310,504,241,154,69,69,,,,852,383,773,348,4,1,64,29,11,5,35,98,61
W02000165,Carmarthenshire 024,Middle Super Output Areas and Intermediate Zones,MSOAIZ,SA,6626,2827,4396,1842,1853,942,2543,900,38,12,1157,559,852,387,305,172,172,,,,954,363,847,312,4,2,86,39,17,10,51,81,51
W02000166,Carmarthenshire 025,Middle Super Output Areas and Intermediate Zones,MSOAIZ,SA,8650,3616,5630,2316,2060,1066,3570,1250,27,12,2168,933,1982,846,186,87,87,,,,708,295,629,259,2,1,67,32,10,3,36,117,60
W02000167,Carmarthenshire 026,Middle Super Output Areas and Intermediate Zones,MSOAIZ,SA,9709,4551,4865,2191,2172,1184,2693,1007,14,6,2248,1250,1362,755,886,495,495,,,,2479,1037,2301,956,5,4,145,61,28,16,81,103,67
W02000168,Swansea 001,Middle Super Output Areas and Intermediate Zones,MSOAIZ,SA,6217,2661,4601,1917,1854,940,2747,977,13,6,917,414,650,257,267,157,157,,,,599,275,519,241,6,2,69,30,5,2,34,87,49
W02000169,Swansea 002,Middle Super Output Areas and Intermediate Zones,MSOAIZ,SA,9316,4034,6714,2863,2909,1504,3805,1359,20,7,1547,678,1191,506,356,172,172,,,,885,410,759,359,18,6,97,40,11,5,51,150,76
W02000170,Swansea 003,Middle Super Output Areas and Intermediate Zones,MSOAIZ,SA,9073,3868,6910,2840,2810,1411,4100,1429,26,11,1213,607,1018,533,195,74,74,,,,805,342,714,290,7,7,78,39,6,6,52,119,68
W02000171,Swansea 004,Middle Super Output Areas and Intermediate Zones,MSOAIZ,SA,7890,3288,6542,2671,2167,1093,4375,1578,15,8,505,219,288,119,217,100,100,,,,744,347,683,317,2,2,49,24,10,4,30,84,43
W02000172,Swansea 005,Middle Super Output Areas and Intermediate Zones,MSOAIZ,SA,9700,4201,6956,2922,2595,1348,4361,1574,30,16,1641,762,1094,475,547,287,287,,,,961,435,806,368,12,4,127,58,16,5,67,112,66
W02000173,Swansea 006,Middle Super Output Areas and Intermediate Zones,MSOAIZ,SA,7345,2987,5658,2278,1668,838,3990,1440,0,0,822,338,578,231,244,107,107,,,,792,337,685,287,5,1,87,41,15,8,50,73,34
W02000174,Swansea 007,Middle Super Output Areas and Intermediate Zones,MSOAIZ,SA,9105,3867,7579,3142,3106,1608,4473,1534,15,8,783,399,662,333,121,66,66,,,,656,276,554,233,4,3,87,37,11,3,43,72,42
W02000175,Swansea 008,Middle Super Output Areas and Intermediate Zones,MSOAIZ,SA,7694,3416,4736,2030,1821,950,2915,1080,20,9,1463,697,820,341,643,356,356,,,,1381,630,1276,580,2,1,81,35,22,14,50,94,50
W02000176,Swansea 009,Middle Super Output Areas and Intermediate Zones,MSOAIZ,SA,8802,4011,5881,2569,2799,1460,3082,1109,10,6,2232,1113,1415,735,817,378,378,,,,600,273,500,230,7,2,72,34,21,7,43,79,50
W02000177,Swansea 010,Middle Super Output Areas and Intermediate Zones,MSOAIZ,SA,7032,2982,4985,2102,1697,873,3288,1229,50,20,1067,442,652,262,415,180,180,,,,866,391,786,351,0,0,70,37,10,3,40,64,27
W02000178,Swansea 011,Middle Super Output Areas and Intermediate Zones,MSOAIZ,SA,8855,3753,2692,1117,733,416,1959,701,3,3,5338,2295,3986,1724,1352,571,571,,,,585,226,489,185,1,1,48,20,47,20,41,237,112
W02000179,Swansea 012,Middle Super Output Areas and Intermediate Zones,MSOAIZ,SA,6677,2807,5542,2256,2117,1101,3425,1155,10,5,407,213,309,155,98,58,58,,,,655,295,575,259,1,1,71,32,8,3,36,63,38
W02000180,Swansea 013,Middle Super Output Areas and Intermediate Zones,MSOAIZ,SA,8059,3416,4404,1860,1570,839,2834,1021,21,9,2679,1109,2478,1024,201,85,85,,,,818,366,715,322,16,5,86,38,1,1,44,137,72
W02000181,Swansea 014,Middle Super Output Areas and Intermediate Zones,MSOAIZ,SA,6732,2980,3937,1715,1576,837,2361,878,5,2,1998,865,1732,717,266,148,148,,,,650,315,536,268,15,4,94,41,5,2,47,142,83
W02000182,Swansea 015,Middle Super Output Areas and Intermediate Zones,MSOAIZ,SA,7926,3446,5740,2419,2182,1159,3558,1260,8,3,727,420,365,221,362,199,199,,,,1339,550,1194,484,3,1,141,64,1,1,66,112,54
W02000183,Swansea 016,Middle Super Output Areas and Intermediate Zones,MSOAIZ,SA,9155,4279,5115,2244,2064,1102,3051,1142,26,10,1874,1016,806,493,1068,523,523,,,,1989,926,1777,828,4,3,183,86,25,9,98,151,83
W02000184,Swansea 017,Middle Super Output Areas and Intermediate Zones,MSOAIZ,SA,6927,3176,4738,2053,1919,1033,2819,1020,26,11,1439,766,918,531,521,235,235,,,,641,289,553,242,0,0,81,43,7,4,47,83,57
W02000185,Swansea 018,Middle Super Output Areas and Intermediate Zones,MSOAIZ,SA,5190,2175,4381,1803,2014,1009,2367,794,11,5,388,175,345,153,43,22,22,,,,353,158,308,138,0,0,38,18,7,2,20,57,34
W02000186,Swansea 019,Middle Super Output Areas and Intermediate Zones,MSOAIZ,SA,8696,3850,2591,1163,1017,564,1574,599,10,6,5258,2301,5026,2164,232,137,137,,,,561,256,504,225,1,1,48,26,8,4,31,276,124
W02000187,Swansea 020,Middle Super Output Areas and Intermediate Zones,MSOAIZ,SA,5712,2373,4789,1990,2186,1135,2603,855,19,10,416,170,161,57,255,113,113,,,,449,182,373,152,5,2,71,28,0,0,30,39,21
W02000188,Swansea 021,Middle Super Output Areas and Intermediate Zones,MSOAIZ,SA,7187,3321,4051,1806,1812,980,2239,826,81,43,1171,567,673,315,498,252,252,,,,1723,830,1572,769,18,6,125,53,8,2,61,161,75
W02000189,Swansea 022,Middle Super Output Areas and Intermediate Zones,MSOAIZ,SA,7722,3678,5440,2342,2349,1269,3091,1073,11,6,1313,916,873,599,440,317,317,,,,857,349,750,301,25,10,77,36,5,2,48,101,65
W02000190,Swansea 023,Middle Super Output Areas and Intermediate Zones,MSOAIZ,SA,4561,2027,3917,1741,1866,1012,2051,729,6,3,138,81,11,4,127,77,77,,,,456,180,384,147,3,1,44,24,25,8,33,44,22
W02000191,Swansea 024,Middle Super Output Areas and Intermediate Zones,MSOAIZ,SA,9524,3916,5058,2171,2156,1126,2902,1045,45,19,485,308,89,46,396,262,262,,,,3816,1354,3555,1260,9,3,152,57,100,34,94,120,64
W02000192,Swansea 025,Middle Super Output Areas and Intermediate Zones,MSOAIZ,SA,8609,5079,2567,1366,1229,748,1338,618,46,26,2067,1620,483,362,1584,1258,1258,,,,3805,1991,3579,1863,15,8,161,84,50,36,128,124,76
W02000193,Swansea 026,Middle Super Output Areas and Intermediate Zones,MSOAIZ,SA,9396,3609,2896,1322,1509,821,1387,501,77,19,680,476,61,23,619,453,453,,,,5650,1739,5374,1640,7,4,173,63,96,32,99,93,53
W02000194,Swansea 027,Middle Super Output Areas and Intermediate Zones,MSOAIZ,SA,5410,2448,4365,1943,2408,1280,1957,663,9,6,138,90,90,57,48,33,33,,,,829,369,753,337,6,2,64,27,6,3,32,69,40
W02000195,Swansea 028,Middle Super Output Areas and Intermediate Zones,MSOAIZ,SA,5854,2672,5208,2340,2852,1542,2356,798,18,12,110,64,62,26,48,38,38,,,,442,216,385,188,8,4,39,19,10,5,28,76,40
W02000196,Swansea 029,Middle Super Output Areas and Intermediate Zones,MSOAIZ,SA,6390,3062,4605,2154,2334,1305,2271,849,9,6,1098,595,1014,550,84,45,45,,,,589,245,524,214,3,1,57,28,5,2,31,89,62
W02000197,Swansea 030,Middle Super Output Areas and Intermediate Zones,MSOAIZ,SA,6249,2637,5451,2296,3097,1522,2354,774,20,8,206,90,189,83,17,7,7,,,,437,188,375,161,3,2,53,22,6,3,27,135,55
W02000198,Swansea 031,Middle Super Output Areas and Intermediate Zones,MSOAIZ,SA,7358,3478,6076,2824,3174,1751,2902,1073,7,5,113,72,17,8,96,64,64,,,,1058,520,911,449,8,2,121,61,18,8,71,104,57
W02000200,Neath Port Talbot 002,Middle Super Output Areas and Intermediate Zones,MSOAIZ,SA,5191,2232,3820,1578,1912,952,1908,626,1,1,938,462,635,302,303,160,160,,,,386,158,329,133,1,1,55,23,1,1,25,46,33
W02000201,Neath Port Talbot 003,Middle Super Output Areas and Intermediate Zones,MSOAIZ,SA,5384,2336,3794,1610,1884,940,1910,670,7,4,924,419,614,258,310,161,161,,,,608,267,529,229,0,0,68,32,11,6,38,51,36
W02000202,Neath Port Talbot 004,Middle Super Output Areas and Intermediate Zones,MSOAIZ,SA,11454,4904,8618,3539,3808,1856,4810,1683,10,5,1738,846,1169,521,569,325,325,,,,939,429,796,369,1,1,122,49,20,10,60,149,85
W02000203,Neath Port Talbot 005,Middle Super Output Areas and Intermediate Zones,MSOAIZ,SA,6692,2813,4879,2021,2134,1078,2745,943,13,8,1195,513,699,282,496,231,231,,,,539,233,457,191,3,2,65,34,14,6,42,66,38
W02000204,Neath Port Talbot 006,Middle Super Output Areas and Intermediate Zones,MSOAIZ,SA,6900,2940,6051,2528,2649,1358,3402,1170,7,4,346,172,205,94,141,78,78,,,,448,206,389,173,6,3,51,28,2,2,33,48,30
W02000205,Neath Port Talbot 007,Middle Super Output Areas and Intermediate Zones,MSOAIZ,SA,5927,2595,4273,1816,1935,987,2338,829,9,6,1139,534,563,231,576,303,303,,,,425,190,381,165,0,0,38,20,6,5,25,81,49
W02000206,Neath Port Talbot 008,Middle Super Output Areas and Intermediate Zones,MSOAIZ,SA,6673,3367,4071,1918,1989,1099,2082,819,11,7,1318,800,696,358,622,442,442,,,,1173,569,1077,520,1,1,80,41,15,7,49,100,73
W02000207,Neath Port Talbot 009,Middle Super Output Areas and Intermediate Zones,MSOAIZ,SA,5135,2139,4562,1889,2005,984,2557,905,4,2,247,107,173,76,74,31,31,,,,291,116,256,99,3,2,29,12,3,3,17,31,25
W02000208,Neath Port Talbot 010,Middle Super Output Areas and Intermediate Zones,MSOAIZ,SA,8900,3773,6699,2775,2611,1332,4088,1443,25,11,1144,505,897,377,247,128,128,,,,950,431,774,352,8,5,157,68,11,6,79,82,51
W02000209,Neath Port Talbot 011,Middle Super Output Areas and Intermediate Zones,MSOAIZ,SA,5258,2264,3208,1364,1791,882,1417,482,1,1,1549,680,1170,491,379,189,189,,,,408,172,324,134,2,2,70,32,12,4,38,92,47
W02000210,Neath Port Talbot 012,Middle Super Output Areas and Intermediate Zones,MSOAIZ,SA,6474,2663,4022,1626,1573,803,2449,823,13,10,1843,750,1531,597,312,153,153,,,,514,226,448,200,8,3,55,22,3,1,26,82,51
W02000211,Neath Port Talbot 013,Middle Super Output Areas and Intermediate Zones,MSOAIZ,SA,7921,3588,4772,2064,1883,1008,2889,1056,18,8,1783,884,1249,573,534,311,311,,,,1254,575,1164,533,11,4,60,28,19,10,42,94,57
W02000212,Neath Port Talbot 014,Middle Super Output Areas and Intermediate Zones,MSOAIZ,SA,7653,3342,5443,2330,2256,1162,3187,1168,10,4,1604,731,1220,558,384,173,173,,,,508,222,442,190,0,0,63,31,3,1,32,88,55
W02000213,Neath Port Talbot 015,Middle Super Output Areas and Intermediate Zones,MSOAIZ,SA,6769,2924,5760,2448,2591,1325,3169,1123,13,7,488,240,367,161,121,79,79,,,,446,190,376,160,0,0,66,28,4,2,30,62,39
W02000214,Neath Port Talbot 016,Middle Super Output Areas and Intermediate Zones,MSOAIZ,SA,9722,4151,5344,2371,2313,1254,3031,1117,9,7,3506,1382,2675,979,831,403,403,,,,664,274,590,235,0,0,61,34,13,5,39,199,117
W02000215,Neath Port Talbot 017,Middle Super Output Areas and Intermediate Zones,MSOAIZ,SA,9224,4234,5384,2375,2389,1264,2995,1111,19,13,2000,1004,1435,670,565,334,334,,,,1643,729,1527,672,28,10,77,40,11,7,57,178,113
W02000216,Neath Port Talbot 018,Middle Super Output Areas and Intermediate Zones,MSOAIZ,SA,7009,3019,5353,2264,2283,1173,3070,1091,14,6,430,186,265,90,165,96,96,,,,1122,509,1024,461,3,2,92,44,3,2,48,90,54
W02000217,Neath Port Talbot 019,Middle Super Output Areas and Intermediate Zones,MSOAIZ,SA,6383,2716,4744,1962,1742,891,3002,1071,6,4,936,423,456,181,480,242,242,,,,619,281,542,246,7,3,59,28,11,4,35,78,46
W02000218,Bridgend 001,Middle Super Output Areas and Intermediate Zones,MSOAIZ,CF,6995,2966,4808,2037,2107,1101,2701,936,16,7,875,372,373,147,502,225,225,,,,1213,506,1095,452,7,3,98,45,13,6,54,83,44
W02000219,Bridgend 002,Middle Super Output Areas and Intermediate Zones,MSOAIZ,CF,7413,3223,5517,2325,2291,1196,3226,1129,20,7,942,456,345,153,597,303,303,,,,865,397,778,354,0,0,63,32,24,11,43,69,38
W02000220,Bridgend 003,Middle Super Output Areas and Intermediate Zones,MSOAIZ,CF,7954,3449,5865,2474,2425,1256,3440,1218,11,8,887,444,255,111,632,333,333,,,,1134,488,1025,438,4,2,98,45,7,3,50,57,35
W02000221,Bridgend 004,Middle Super Output Areas and Intermediate Zones,MSOAIZ,CF,7784,3230,5220,2165,2050,1042,3170,1123,7,5,1463,607,413,160,1050,447,447,,,,1034,417,897,362,4,1,127,51,6,3,55,60,36
W02000222,Bridgend 005,Middle Super Output Areas and Intermediate Zones,MSOAIZ,CF,6201,2585,4948,2029,2169,1086,2779,943,3,2,671,301,292,127,379,174,174,,,,526,219,452,189,2,1,56,22,16,7,30,53,34
W02000223,Bridgend 006,Middle Super Output Areas and Intermediate Zones,MSOAIZ,CF,5357,2337,3949,1662,1348,711,2601,951,13,8,720,367,189,104,531,263,263,,,,623,271,555,236,8,3,55,28,5,4,35,52,29
W02000224,Bridgend 007,Middle Super Output Areas and Intermediate Zones,MSOAIZ,CF,6014,2556,4261,1764,1482,772,2779,992,9,3,1063,483,381,166,682,317,317,,,,620,275,518,229,4,3,92,41,6,2,46,61,31
W02000225,Bridgend 008,Middle Super Output Areas and Intermediate Zones,MSOAIZ,CF,8872,3783,6113,2552,2206,1120,3907,1432,6,2,1707,772,582,259,1125,513,513,,,,966,402,791,337,1,1,145,53,29,11,65,80,55
W02000226,Bridgend 009,Middle Super Output Areas and Intermediate Zones,MSOAIZ,CF,10023,4163,8129,3318,3017,1539,5112,1779,6,3,812,385,280,136,532,249,249,,,,1002,416,879,357,10,4,111,53,2,2,59,74,41
W02000227,Bridgend 010,Middle Super Output Areas and Intermediate Zones,MSOAIZ,CF,6992,3023,4354,1888,1628,860,2726,1028,12,4,1729,746,785,350,944,396,396,,,,822,338,733,298,4,1,75,33,10,6,40,75,47
W02000228,Bridgend 011,Middle Super Output Areas and Intermediate Zones,MSOAIZ,CF,5528,2350,4588,1921,1939,1010,2649,911,13,6,256,123,51,23,205,100,100,,,,609,262,510,218,22,13,39,19,38,12,44,62,38
W02000229,Bridgend 012,Middle Super Output Areas and Intermediate Zones,MSOAIZ,CF,6107,2616,4292,1816,1649,872,2643,944,10,6,1141,531,224,101,917,430,430,,,,609,225,503,183,1,1,91,35,14,6,42,55,38
W02000230,Bridgend 013,Middle Super Output Areas and Intermediate Zones,MSOAIZ,CF,5288,2171,4689,1935,2024,1022,2665,913,2,1,93,32,46,14,47,18,18,,,,452,178,369,147,12,5,63,22,8,4,31,52,25
W02000231,Bridgend 014,Middle Super Output Areas and Intermediate Zones,MSOAIZ,CF,8137,3770,4912,2175,2012,1090,2900,1085,16,9,1621,861,417,211,1204,650,650,,,,1498,674,1354,601,2,2,102,54,40,17,73,90,51
W02000232,Bridgend 015,Middle Super Output Areas and Intermediate Zones,MSOAIZ,CF,5918,2427,4735,1932,1420,722,3315,1210,14,7,240,109,20,8,220,101,101,,,,885,357,800,318,4,2,74,34,7,3,39,44,22
W02000233,Bridgend 016,Middle Super Output Areas and Intermediate Zones,MSOAIZ,CF,6185,2602,3855,1615,1272,646,2583,969,20,8,1417,589,37,17,1380,572,572,,,,848,365,766,328,7,3,70,32,5,2,37,45,25
W02000234,Bridgend 017,Middle Super Output Areas and Intermediate Zones,MSOAIZ,CF,10412,4112,8241,3142,2304,1155,5937,1987,45,19,1098,516,235,116,863,400,400,,,,926,393,839,350,4,2,79,39,4,2,43,102,42
W02000235,Bridgend 018,Middle Super Output Areas and Intermediate Zones,MSOAIZ,CF,8801,4073,7254,3284,3696,2025,3558,1259,42,25,183,133,38,29,145,104,104,,,,1228,577,1142,533,2,2,76,38,8,4,44,94,54
W02000236,Bridgend 019,Middle Super Output Areas and Intermediate Zones,MSOAIZ,CF,6861,3079,5329,2314,2347,1234,2982,1080,19,13,459,272,176,100,283,172,172,,,,966,428,847,380,14,5,88,37,17,6,48,88,52
W02000237,The Vale of Glamorgan 001,Middle Super Output Areas and Intermediate Zones,MSOAIZ,CF,5281,2158,4630,1888,2193,1086,2437,802,0,0,143,53,115,45,28,8,8,,,,445,181,409,162,9,4,16,9,11,6,19,63,36
W02000238,The Vale of Glamorgan 002,Middle Super Output Areas and Intermediate Zones,MSOAIZ,CF,6132,2715,5253,2284,2850,1452,2403,832,12,8,190,101,153,78,37,23,23,,,,591,281,547,257,8,4,32,18,4,2,24,86,41
W02000239,The Vale of Glamorgan 003,Middle Super Output Areas and Intermediate Zones,MSOAIZ,CF,6631,2688,5831,2338,2633,1278,3198,1060,2,1,172,79,157,71,15,8,8,,,,537,224,460,191,17,8,41,17,19,8,33,89,46
W02000240,The Vale of Glamorgan 004,Middle Super Output Areas and Intermediate Zones,MSOAIZ,CF,8646,3628,6674,2758,2560,1347,4114,1411,14,8,1011,459,611,271,400,188,188,,,,886,370,738,296,19,8,117,57,12,9,74,61,33
W02000241,The Vale of Glamorgan 005,Middle Super Output Areas and Intermediate Zones,MSOAIZ,CF,9541,4554,6963,3152,2969,1651,3994,1501,17,8,252,134,150,94,102,40,40,,,,2188,1192,2000,1088,26,8,143,79,19,17,104,121,68
W02000242,The Vale of Glamorgan 006,Middle Super Output Areas and Intermediate Zones,MSOAIZ,CF,7751,3333,6438,2718,2957,1531,3481,1187,14,7,712,348,276,173,436,175,175,,,,536,233,453,195,4,2,69,31,10,5,38,51,27
W02000243,The Vale of Glamorgan 007,Middle Super Output Areas and Intermediate Zones,MSOAIZ,CF,9097,3784,4704,1959,1522,822,3182,1137,8,5,3559,1494,2746,1178,813,316,316,,,,763,293,668,253,13,4,74,33,8,3,40,63,33
W02000244,The Vale of Glamorgan 008,Middle Super Output Areas and Intermediate Zones,MSOAIZ,CF,9965,4318,8202,3461,3402,1824,4800,1637,11,8,837,406,421,213,416,193,193,,,,849,405,764,360,9,4,73,39,3,2,45,66,38
W02000245,The Vale of Glamorgan 009,Middle Super Output Areas and Intermediate Zones,MSOAIZ,CF,8527,3586,5909,2357,1446,749,4463,1608,36,25,1320,672,597,294,723,378,378,,,,1229,507,1132,458,6,2,80,40,11,7,49,33,25
W02000246,The Vale of Glamorgan 010,Middle Super Output Areas and Intermediate Zones,MSOAIZ,CF,5477,2347,5030,2138,2171,1140,2859,998,12,6,104,63,88,58,16,5,5,,,,310,125,256,104,10,2,44,19,0,0,21,21,15
W02000247,The Vale of Glamorgan 011,Middle Super Output Areas and Intermediate Zones,MSOAIZ,CF,8597,3637,6604,2834,2803,1505,3801,1329,10,7,828,338,758,313,70,25,25,,,,1077,423,849,338,111,39,94,38,23,8,85,78,35
W02000248,The Vale of Glamorgan 012,Middle Super Output Areas and Intermediate Zones,MSOAIZ,CF,10822,4624,6719,2831,2068,1130,4651,1701,35,14,1020,511,463,202,557,309,309,,,,2971,1226,2757,1140,18,5,166,67,30,14,86,77,42
W02000249,The Vale of Glamorgan 013,Middle Super Output Areas and Intermediate Zones,MSOAIZ,CF,8733,3934,5478,2348,1718,977,3760,1371,15,6,1582,836,1126,614,456,222,222,,,,1571,692,1391,604,13,8,163,78,4,2,88,87,52
W02000250,The Vale of Glamorgan 014,Middle Super Output Areas and Intermediate Zones,MSOAIZ,CF,10635,4307,7435,3077,2569,1323,4866,1754,16,7,807,310,548,220,259,90,90,,,,2307,873,1494,606,429,128,101,47,283,92,267,70,40
W02000251,The Vale of Glamorgan 015,Middle Super Output Areas and Intermediate Zones,MSOAIZ,CF,8424,3892,5754,2504,2026,1139,3728,1365,43,15,968,550,398,201,570,349,349,,,,1611,788,1483,728,0,0,121,58,7,2,60,48,35
W02000252,Rhondda Cynon Taf 001,Middle Super Output Areas and Intermediate Zones,MSOAIZ,SA,8936,3742,5676,2403,2526,1285,3150,1118,0,0,2309,936,1566,647,743,289,289,,,,817,323,750,291,0,0,53,25,14,7,32,134,80
W02000253,Rhondda Cynon Taf 002,Middle Super Output Areas and Intermediate Zones,MSOAIZ,CF,6138,2722,4507,1941,2014,1059,2493,882,3,2,528,237,284,112,244,125,125,,,,1049,501,984,463,5,2,56,33,4,3,38,51,41
W02000254,Rhondda Cynon Taf 003,Middle Super Output Areas and Intermediate Zones,MSOAIZ,CF,7632,3356,5878,2505,2522,1322,3356,1183,8,4,648,342,300,169,348,173,173,,,,1022,466,931,420,0,0,86,42,5,4,46,76,39
W02000255,Rhondda Cynon Taf 004,Middle Super Output Areas and Intermediate Zones,MSOAIZ,CF,6156,2718,4501,1909,2050,1039,2451,870,15,7,1036,522,691,325,345,197,197,,,,549,246,508,228,1,1,34,15,6,2,18,55,34
W02000256,Rhondda Cynon Taf 005,Middle Super Output Areas and Intermediate Zones,MSOAIZ,CF,9798,4329,6753,2897,3150,1650,3603,1247,17,7,1240,647,377,202,863,445,445,,,,1687,721,1582,669,0,0,96,44,9,8,52,101,57
W02000257,Rhondda Cynon Taf 006,Middle Super Output Areas and Intermediate Zones,MSOAIZ,CF,7289,3282,5038,2193,2315,1230,2723,963,7,4,1079,544,569,274,510,270,270,,,,1078,484,1035,463,0,0,41,20,2,1,21,87,57
W02000258,Rhondda Cynon Taf 007,Middle Super Output Areas and Intermediate Zones,MSOAIZ,CF,5679,2573,3958,1735,2046,1077,1912,658,6,3,728,368,308,147,420,221,221,,,,900,413,834,380,0,0,60,30,6,3,33,87,54
W02000259,Rhondda Cynon Taf 008,Middle Super Output Areas and Intermediate Zones,MSOAIZ,CF,5746,2427,3638,1546,1744,910,1894,636,5,2,1074,444,405,159,669,285,285,,,,962,406,909,384,8,2,43,19,2,1,22,67,29
W02000260,Rhondda Cynon Taf 009,Middle Super Output Areas and Intermediate Zones,MSOAIZ,CF,5847,2640,3941,1726,2051,1082,1890,644,4,2,1034,505,591,281,443,224,224,,,,795,360,700,314,0,0,91,43,4,3,46,73,47
W02000261,Rhondda Cynon Taf 010,Middle Super Output Areas and Intermediate Zones,MSOAIZ,CF,7581,3362,5857,2567,2909,1537,2948,1030,6,5,557,245,174,70,383,175,175,,,,1094,495,985,444,0,0,103,48,6,3,51,67,50
W02000262,Rhondda Cynon Taf 011,Middle Super Output Areas and Intermediate Zones,MSOAIZ,CF,5205,2322,4012,1740,1864,963,2148,777,10,5,297,181,85,41,212,140,140,,,,841,371,781,344,3,1,52,23,5,3,27,45,25
W02000263,Rhondda Cynon Taf 012,Middle Super Output Areas and Intermediate Zones,MSOAIZ,CF,6377,2694,4486,1869,1913,965,2573,904,8,4,800,349,427,176,373,173,173,,,,1015,431,911,387,0,0,87,37,17,7,44,68,41
W02000264,Rhondda Cynon Taf 013,Middle Super Output Areas and Intermediate Zones,MSOAIZ,CF,5989,2657,3846,1683,1929,1012,1917,671,7,4,844,390,522,225,322,165,165,,,,1234,548,1122,499,4,1,90,36,18,12,49,58,32
W02000265,Rhondda Cynon Taf 014,Middle Super Output Areas and Intermediate Zones,MSOAIZ,CF,9024,3944,6337,2740,2897,1529,3440,1211,7,4,1161,558,685,300,476,258,258,,,,1418,576,1321,525,4,1,78,41,15,9,51,101,66
W02000266,Rhondda Cynon Taf 015,Middle Super Output Areas and Intermediate Zones,MSOAIZ,CF,7523,3183,5483,2220,1958,1004,3525,1216,18,7,1325,623,898,384,427,239,239,,,,639,296,585,266,0,0,47,27,7,3,30,58,37
W02000267,Rhondda Cynon Taf 016,Middle Super Output Areas and Intermediate Zones,MSOAIZ,CF,6510,2804,4794,2061,2259,1169,2535,892,5,4,346,173,95,46,251,127,127,,,,1305,529,1203,485,3,1,93,41,6,2,44,60,37
W02000268,Rhondda Cynon Taf 017,Middle Super Output Areas and Intermediate Zones,MSOAIZ,CF,9060,4030,7074,3044,3094,1629,3980,1415,2,2,556,278,283,135,273,143,143,,,,1353,653,1253,610,0,0,85,39,15,4,43,75,53
W02000269,Rhondda Cynon Taf 018,Middle Super Output Areas and Intermediate Zones,MSOAIZ,CF,8430,3598,6021,2524,2735,1398,3286,1126,5,3,916,444,500,228,416,216,216,,,,1376,558,1205,490,3,1,156,61,12,6,68,112,69
W02000270,Rhondda Cynon Taf 019,Middle Super Output Areas and Intermediate Zones,MSOAIZ,CF,6536,2888,5126,2253,2108,1117,3018,1136,14,5,351,181,130,69,221,112,112,,,,971,407,865,364,2,1,97,40,7,2,43,74,42
W02000271,Rhondda Cynon Taf 020,Middle Super Output Areas and Intermediate Zones,MSOAIZ,CF,5607,2487,3569,1537,1603,843,1966,694,7,3,1217,573,871,403,346,170,170,,,,740,328,671,297,0,0,69,31,0,0,31,74,46
W02000272,Rhondda Cynon Taf 021,Middle Super Output Areas and Intermediate Zones,MSOAIZ,CF,9846,4294,7605,3234,3163,1647,4442,1587,10,6,505,312,119,91,386,221,221,,,,1610,676,1468,612,3,2,123,55,16,7,64,116,66
W02000273,Rhondda Cynon Taf 022,Middle Super Output Areas and Intermediate Zones,MSOAIZ,CF,9226,3732,3977,1730,1630,875,2347,855,20,9,2243,975,786,360,1457,615,615,,,,2853,931,2727,881,8,2,101,38,17,10,50,133,87
W02000274,Rhondda Cynon Taf 023,Middle Super Output Areas and Intermediate Zones,MSOAIZ,CF,9703,3921,7078,2776,2525,1249,4553,1527,24,11,1641,728,1106,467,535,261,261,,,,855,342,768,305,6,3,71,30,10,4,37,105,64
W02000275,Rhondda Cynon Taf 024,Middle Super Output Areas and Intermediate Zones,MSOAIZ,CF,5882,2501,4159,1722,1744,878,2415,844,8,3,1093,494,616,260,477,234,234,,,,557,237,482,205,1,1,68,28,6,3,32,65,45
W02000276,Rhondda Cynon Taf 025,Middle Super Output Areas and Intermediate Zones,MSOAIZ,CF,5749,2518,4680,2026,2287,1185,2393,841,2,2,650,314,418,203,232,111,111,,,,359,144,327,127,0,0,30,15,2,2,17,58,32
W02000277,Rhondda Cynon Taf 026,Middle Super Output Areas and Intermediate Zones,MSOAIZ,CF,6891,3098,4898,2124,1809,950,3089,1174,24,16,1222,602,645,293,577,309,309,,,,676,307,603,272,0,0,64,30,9,5,35,71,49
W02000278,Rhondda Cynon Taf 027,Middle Super Output Areas and Intermediate Zones,MSOAIZ,CF,9342,3623,8334,3200,2394,1189,5940,2011,6,3,78,29,7,3,71,26,26,,,,885,372,791,328,9,4,75,36,10,4,44,39,19
W02000279,Rhondda Cynon Taf 028,Middle Super Output Areas and Intermediate Zones,MSOAIZ,CF,7660,3166,5904,2384,1923,961,3981,1423,4,2,944,405,548,237,396,168,168,,,,736,328,657,292,7,2,70,33,2,1,36,72,47
W02000280,Rhondda Cynon Taf 029,Middle Super Output Areas and Intermediate Zones,MSOAIZ,CF,8012,3266,6172,2483,2044,993,4128,1490,21,10,887,368,357,150,530,218,218,,,,872,364,729,296,25,10,110,51,8,7,68,60,41
W02000281,Rhondda Cynon Taf 030,Middle Super Output Areas and Intermediate Zones,MSOAIZ,CF,7526,3293,5921,2487,2291,1189,3630,1298,8,4,755,403,330,164,425,239,239,,,,786,354,681,312,15,7,75,32,15,3,42,56,45
W02000282,Rhondda Cynon Taf 031,Middle Super Output Areas and Intermediate Zones,MSOAIZ,CF,10985,4493,8800,3501,2775,1402,6025,2099,14,7,1126,503,500,215,626,288,288,,,,967,437,843,381,6,3,95,45,23,8,56,78,45
W02000284,Merthyr Tydfil 002,Middle Super Output Areas and Intermediate Zones,MSOAIZ,CF,9724,4048,6296,2537,2509,1234,3787,1303,13,6,1960,892,698,308,1262,584,584,,,,1322,541,1201,486,8,3,95,42,18,10,55,133,72
W02000285,Merthyr Tydfil 003,Middle Super Output Areas and Intermediate Zones,MSOAIZ,CF,8232,3385,6466,2630,2923,1414,3543,1216,9,4,714,304,147,74,567,230,230,,,,969,404,885,363,10,4,71,36,3,1,41,74,43
W02000286,Merthyr Tydfil 004,Middle Super Output Areas and Intermediate Zones,MSOAIZ,CF,6500,2966,3337,1432,1599,811,1738,621,18,6,2103,1010,947,421,1156,589,589,,,,924,438,846,394,9,6,45,25,24,13,44,118,80
W02000287,Merthyr Tydfil 005,Middle Super Output Areas and Intermediate Zones,MSOAIZ,CF,8127,3380,6455,2643,2637,1316,3818,1327,14,6,706,292,400,146,306,146,146,,,,867,385,785,346,10,5,71,33,1,1,39,85,54
W02000288,Merthyr Tydfil 006,Middle Super Output Areas and Intermediate Zones,MSOAIZ,CF,8199,3512,5755,2410,2759,1377,2996,1033,3,3,1356,581,508,194,848,387,387,,,,988,456,911,412,0,0,68,38,9,6,44,97,62
W02000289,Merthyr Tydfil 007,Middle Super Output Areas and Intermediate Zones,MSOAIZ,CF,8187,3316,6236,2493,2518,1206,3718,1287,15,7,1026,429,300,127,726,302,302,,,,832,342,759,311,4,2,66,27,3,2,31,78,45
W02000290,Caerphilly 001,Middle Super Output Areas and Intermediate Zones,MSOAIZ,NP,8779,3857,5364,2232,2361,1168,3003,1064,4,3,2650,1272,2364,1105,286,167,167,,,,682,309,623,279,6,2,45,23,8,5,30,79,41
W02000291,Caerphilly 002,Middle Super Output Areas and Intermediate Zones,MSOAIZ,NP,7512,3151,5046,2069,2257,1116,2789,953,17,7,1467,645,1247,538,220,107,107,,,,928,402,821,357,4,1,84,37,19,7,45,54,28
W02000292,Caerphilly 003,Middle Super Output Areas and Intermediate Zones,MSOAIZ,NP,5667,2432,3749,1538,1507,763,2242,775,3,2,1225,587,1006,481,219,106,106,,,,652,281,616,266,0,0,31,13,5,2,15,38,24
W02000293,Caerphilly 004,Middle Super Output Areas and Intermediate Zones,MSOAIZ,CF,6149,2645,4053,1729,1747,910,2306,819,4,3,1239,523,1128,488,111,35,35,,,,828,373,777,350,0,0,44,21,7,2,23,25,17
W02000294,Caerphilly 005,Middle Super Output Areas and Intermediate Zones,MSOAIZ,NP,5683,2363,4217,1763,1738,891,2479,872,20,8,924,365,635,254,289,111,111,,,,473,202,417,178,2,1,54,23,0,0,24,49,25
W02000295,Caerphilly 006,Middle Super Output Areas and Intermediate Zones,MSOAIZ,NP,9344,3790,7301,2895,2723,1361,4578,1534,28,9,1196,529,835,367,361,162,162,,,,763,324,679,283,2,1,74,35,8,5,41,56,33
W02000296,Caerphilly 007,Middle Super Output Areas and Intermediate Zones,MSOAIZ,NP,7697,3214,4932,2017,1942,987,2990,1030,10,6,1915,847,1315,585,600,262,262,,,,783,311,695,279,15,5,65,24,8,3,32,57,33
W02000297,Caerphilly 008,Middle Super Output Areas and Intermediate Zones,MSOAIZ,NP,7806,3214,5823,2314,1986,980,3837,1334,11,7,1081,502,776,375,305,127,127,,,,829,358,747,317,0,0,78,39,4,2,41,62,33
W02000298,Caerphilly 009,Middle Super Output Areas and Intermediate Zones,MSOAIZ,NP,7270,2940,5512,2193,1930,973,3582,1220,13,7,944,406,636,289,308,117,117,,,,756,310,684,280,0,0,69,28,3,2,30,45,24
W02000299,Caerphilly 010,Middle Super Output Areas and Intermediate Zones,MSOAIZ,NP,6413,2743,4476,1884,1895,973,2581,911,11,6,1221,525,1019,432,202,93,93,,,,653,299,588,269,0,0,62,28,3,2,30,52,29
W02000300,Caerphilly 011,Middle Super Output Areas and Intermediate Zones,MSOAIZ,NP,8493,3535,5935,2424,2452,1205,3483,1219,10,5,1646,721,1328,587,318,134,134,,,,856,355,788,324,3,2,64,28,1,1,31,46,30
W02000301,Caerphilly 012,Middle Super Output Areas and Intermediate Zones,MSOAIZ,NP,7705,3039,5410,2124,1841,918,3569,1206,25,9,1485,599,873,372,612,227,227,,,,742,284,666,254,6,1,59,24,11,5,30,43,23
W02000302,Caerphilly 013,Middle Super Output Areas and Intermediate Zones,MSOAIZ,CF,9629,4114,7413,3131,2873,1527,4540,1604,3,1,1019,447,560,270,459,177,177,,,,1121,490,999,440,4,2,94,40,24,8,50,73,45
W02000303,Caerphilly 014,Middle Super Output Areas and Intermediate Zones,MSOAIZ,NP,6995,2948,5068,2105,1871,949,3197,1156,25,18,1038,422,722,283,316,139,139,,,,801,369,727,329,1,1,70,36,3,3,40,63,34
W02000304,Caerphilly 015,Middle Super Output Areas and Intermediate Zones,MSOAIZ,NP,5485,2436,3833,1627,1490,772,2343,855,3,2,833,467,443,290,390,177,177,,,,780,317,687,278,0,0,89,38,4,1,39,36,23
W02000305,Caerphilly 016,Middle Super Output Areas and Intermediate Zones,MSOAIZ,NP,6464,2743,4650,1938,1751,881,2899,1057,46,23,1228,531,953,413,275,118,118,,,,502,233,450,207,0,0,51,25,1,1,26,38,18
W02000306,Caerphilly 017,Middle Super Output Areas and Intermediate Zones,MSOAIZ,NP,5194,2364,3668,1599,1608,839,2060,760,4,2,840,404,656,316,184,88,88,,,,640,331,583,300,2,1,49,25,6,5,31,42,28
W02000307,Caerphilly 018,Middle Super Output Areas and Intermediate Zones,MSOAIZ,CF,6778,2778,4553,1828,1471,737,3082,1091,15,6,1142,508,494,251,648,257,257,,,,1035,417,923,371,4,1,102,43,6,2,46,33,19
W02000308,Caerphilly 019,Middle Super Output Areas and Intermediate Zones,MSOAIZ,CF,9279,3760,6429,2612,2188,1102,4241,1510,11,6,1840,727,1343,531,497,196,196,,,,958,393,879,360,0,0,67,28,12,5,33,41,22
W02000309,Caerphilly 020,Middle Super Output Areas and Intermediate Zones,MSOAIZ,NP,6818,2837,5094,2031,1936,959,3158,1072,11,5,986,498,734,397,252,101,101,,,,677,269,612,240,3,1,57,25,5,3,29,50,34
W02000310,Caerphilly 021,Middle Super Output Areas and Intermediate Zones,MSOAIZ,NP,5450,2215,3740,1522,1419,710,2321,812,8,6,1258,504,1224,493,34,11,11,,,,395,162,350,142,6,3,36,16,3,1,20,49,21
W02000311,Caerphilly 022,Middle Super Output Areas and Intermediate Zones,MSOAIZ,NP,9502,4077,5743,2422,2191,1142,3552,1280,121,61,2512,1111,1785,825,727,286,286,,,,1055,446,930,391,14,5,99,44,12,6,55,71,37
W02000312,Caerphilly 023,Middle Super Output Areas and Intermediate Zones,MSOAIZ,CF,7478,3100,5448,2207,1904,980,3544,1227,28,11,1271,595,768,397,503,198,198,,,,692,264,629,236,6,2,55,25,2,1,28,39,23
W02000313,Caerphilly 024,Middle Super Output Areas and Intermediate Zones,MSOAIZ,CF,10165,4184,8482,3428,2628,1345,5854,2083,6,3,466,227,216,125,250,102,102,,,,1159,496,1050,448,12,3,95,44,2,1,48,52,30
W02000314,Blaenau Gwent 001,Middle Super Output Areas and Intermediate Zones,MSOAIZ,NP,7028,3011,4505,1861,1922,974,2583,887,7,3,2035,912,1007,450,1028,462,462,,,,440,204,367,171,0,0,47,23,26,10,33,41,31
W02000315,Blaenau Gwent 002,Middle Super Output Areas and Intermediate Zones,MSOAIZ,NP,5402,2457,3420,1473,1464,749,1956,724,3,1,1192,585,615,276,577,309,309,,,,756,378,684,341,5,3,50,24,17,10,37,31,20
W02000316,Blaenau Gwent 003,Middle Super Output Areas and Intermediate Zones,MSOAIZ,NP,7098,3058,4382,1866,2054,1054,2328,812,5,4,2240,965,1229,516,1011,449,449,,,,415,189,352,158,0,0,50,26,13,5,31,56,34
W02000317,Blaenau Gwent 004,Middle Super Output Areas and Intermediate Zones,MSOAIZ,NP,7640,3283,4878,2058,1932,1024,2946,1034,7,3,1986,900,1066,465,920,435,435,,,,724,293,656,258,4,1,43,22,21,12,35,45,29
W02000318,Blaenau Gwent 005,Middle Super Output Areas and Intermediate Zones,MSOAIZ,NP,9410,3959,5812,2358,2291,1171,3521,1187,17,8,2522,1123,1256,547,1266,576,576,,,,995,433,854,366,16,5,91,45,34,17,67,64,37
W02000319,Blaenau Gwent 006,Middle Super Output Areas and Intermediate Zones,MSOAIZ,NP,7900,3673,5061,2223,2223,1179,2838,1044,12,8,1677,863,845,399,832,464,464,,,,1087,540,993,487,3,2,78,44,13,7,53,63,39
W02000320,Blaenau Gwent 007,Middle Super Output Areas and Intermediate Zones,MSOAIZ,NP,8465,3696,5749,2414,2391,1221,3358,1193,7,4,1145,569,512,207,633,362,362,,,,1496,670,1370,611,7,4,101,45,18,10,59,68,39
W02000321,Blaenau Gwent 008,Middle Super Output Areas and Intermediate Zones,MSOAIZ,NP,9029,3985,6052,2573,2822,1432,3230,1141,6,2,1467,732,618,284,849,448,448,,,,1428,630,1314,580,12,2,88,40,14,8,50,76,48
W02000322,Blaenau Gwent 009,Middle Super Output Areas and Intermediate Zones,MSOAIZ,NP,7267,3294,4650,2058,2298,1215,2352,843,11,7,1330,635,469,220,861,415,415,,,,1221,555,1117,508,6,2,80,34,18,11,47,55,39
W02000323,Torfaen 001,Middle Super Output Areas and Intermediate Zones,MSOAIZ,NP,6026,2645,3839,1648,1678,909,2161,739,6,3,1541,700,638,289,903,411,411,,,,598,268,538,241,3,1,46,22,11,4,27,42,26
W02000324,Torfaen 002,Middle Super Output Areas and Intermediate Zones,MSOAIZ,NP,7029,2938,4531,1850,1758,892,2773,958,4,3,1951,829,899,370,1052,459,459,,,,495,230,415,193,0,0,68,29,12,8,37,48,26
W02000325,Torfaen 003,Middle Super Output Areas and Intermediate Zones,MSOAIZ,NP,7144,2923,3899,1561,1503,737,2396,824,8,5,2717,1120,1323,548,1394,572,572,,,,457,201,403,174,2,1,41,21,11,5,27,63,36
W02000326,Torfaen 004,Middle Super Output Areas and Intermediate Zones,MSOAIZ,NP,8896,3845,6309,2638,2667,1317,3642,1321,35,18,1483,679,589,254,894,425,425,,,,984,454,915,421,7,3,43,22,19,8,33,85,56
W02000327,Torfaen 005,Middle Super Output Areas and Intermediate Zones,MSOAIZ,NP,5961,2632,4812,2102,2140,1143,2672,959,4,4,723,329,158,77,565,252,252,,,,374,165,325,142,0,0,43,20,6,3,23,48,32
W02000328,Torfaen 006,Middle Super Output Areas and Intermediate Zones,MSOAIZ,NP,7119,3043,5513,2287,2031,1067,3482,1220,30,13,849,401,392,183,457,218,218,,,,675,307,612,279,10,3,36,19,17,6,28,52,35
W02000329,Torfaen 007,Middle Super Output Areas and Intermediate Zones,MSOAIZ,NP,7469,3233,4594,1902,1679,880,2915,1022,66,32,2001,942,845,387,1156,555,555,,,,770,332,678,289,8,2,58,29,26,12,43,38,25
W02000330,Torfaen 008,Middle Super Output Areas and Intermediate Zones,MSOAIZ,NP,7259,3314,5369,2403,2322,1311,3047,1092,16,7,1104,570,402,197,702,373,373,,,,717,296,626,254,5,2,80,37,6,3,42,53,38
W02000331,Torfaen 009,Middle Super Output Areas and Intermediate Zones,MSOAIZ,NP,6737,2653,3360,1314,919,464,2441,850,6,4,2686,1074,1261,479,1425,595,595,,,,651,240,586,210,2,1,56,25,7,4,30,34,21
W02000332,Torfaen 010,Middle Super Output Areas and Intermediate Zones,MSOAIZ,NP,6746,3127,3764,1632,1420,780,2344,852,33,15,2282,1152,1092,538,1190,614,614,,,,597,280,500,236,5,2,83,36,9,6,44,70,48
W02000333,Torfaen 011,Middle Super Output Areas and Intermediate Zones,MSOAIZ,NP,6482,2611,4674,1865,1317,665,3357,1200,155,81,1189,473,555,215,634,258,258,,,,445,181,371,152,0,0,65,25,9,4,29,19,11
W02000334,Torfaen 012,Middle Super Output Areas and Intermediate Zones,MSOAIZ,NP,6791,2753,5240,2100,1676,826,3564,1274,10,4,1117,466,380,169,737,297,297,,,,407,174,362,152,3,1,29,16,13,5,22,17,9
W02000335,Torfaen 013,Middle Super Output Areas and Intermediate Zones,MSOAIZ,NP,6701,2807,5338,2216,2299,1185,3039,1031,23,10,797,365,314,134,483,231,231,,,,502,187,413,151,0,0,73,30,16,6,36,41,29
W02000336,Monmouthshire 001,Middle Super Output Areas and Intermediate Zones,MSOAIZ,NP,7997,3653,6211,2735,3333,1713,2878,1022,19,13,513,295,160,76,353,219,219,,,,1138,551,978,480,41,18,99,41,20,12,71,116,59
W02000337,Monmouthshire 002,Middle Super Output Areas and Intermediate Zones,MSOAIZ,NP,7483,3316,4529,1974,1938,1036,2591,938,25,10,2253,1045,889,411,1364,634,634,,,,612,252,532,218,2,2,66,28,12,4,34,64,35
W02000338,Monmouthshire 003,Middle Super Output Areas and Intermediate Zones,MSOAIZ,NP,7562,3337,5851,2598,3126,1604,2725,994,22,9,990,430,268,114,722,316,316,,,,637,267,561,231,0,0,66,32,10,4,36,62,33
W02000339,Monmouthshire 004,Middle Super Output Areas and Intermediate Zones,MSOAIZ,NP,10104,4520,7035,3059,3268,1741,3767,1318,67,29,1726,815,382,168,1344,647,647,,,,1137,551,977,478,41,15,104,51,15,7,73,139,66
W02000340,Monmouthshire 005,Middle Super Output Areas and Intermediate Zones,MSOAIZ,NP,7078,2971,5215,2161,2885,1371,2330,790,10,4,411,210,119,59,292,151,151,,,,1230,492,1099,445,23,7,85,30,23,10,47,212,104
W02000341,Monmouthshire 006,Middle Super Output Areas and Intermediate Zones,MSOAIZ,NP,7922,3381,6382,2633,3202,1532,3180,1101,24,14,543,285,173,82,370,203,203,,,,856,392,740,344,25,10,85,35,6,3,48,117,57
W02000342,Monmouthshire 007,Middle Super Output Areas and Intermediate Zones,MSOAIZ,NP,9505,3780,8252,3243,3680,1749,4572,1494,28,16,402,174,81,33,321,141,141,,,,734,298,688,277,7,3,35,15,4,3,21,89,49
W02000343,Monmouthshire 008,Middle Super Output Areas and Intermediate Zones,MSOAIZ,NP,8482,3709,5150,2245,1872,1011,3278,1234,33,13,1940,805,475,200,1465,605,605,,,,1287,605,1163,542,8,3,104,52,12,8,63,72,41
W02000344,Monmouthshire 009,Middle Super Output Areas and Intermediate Zones,MSOAIZ,NP,7497,3033,6538,2596,2682,1310,3856,1286,24,8,377,201,161,81,216,120,120,,,,491,195,443,171,9,5,31,15,8,4,24,67,33
W02000345,Monmouthshire 010,Middle Super Output Areas and Intermediate Zones,MSOAIZ,NP,8120,3458,5736,2400,2474,1270,3262,1130,33,15,1677,764,642,311,1035,453,453,,,,625,251,538,215,11,5,73,29,3,2,36,49,28
W02000346,Monmouthshire 011,Middle Super Output Areas and Intermediate Zones,MSOAIZ,NP,7944,3075,6655,2498,1925,932,4730,1566,26,10,552,264,116,55,436,209,209,,,,664,276,604,250,0,0,41,19,19,7,26,47,27
W02000347,Newport 001,Middle Super Output Areas and Intermediate Zones,MSOAIZ,NP,7925,3433,6358,2685,2627,1375,3731,1310,16,9,601,330,353,178,248,152,152,,,,865,362,788,329,3,2,68,28,6,3,33,85,47
W02000348,Newport 002,Middle Super Output Areas and Intermediate Zones,MSOAIZ,NP,7925,3363,6063,2549,2540,1341,3523,1208,40,15,1111,507,739,326,372,181,181,,,,651,257,585,229,0,0,60,26,6,2,28,60,35
W02000349,Newport 003,Middle Super Output Areas and Intermediate Zones,MSOAIZ,NP,7556,3306,3893,1641,1349,716,2544,925,63,30,2903,1343,1840,843,1063,500,500,,,,622,251,552,220,0,0,52,20,18,11,31,75,41
W02000350,Newport 004,Middle Super Output Areas and Intermediate Zones,MSOAIZ,NP,7320,2974,6020,2422,2411,1199,3609,1223,5,3,730,289,519,194,211,95,95,,,,502,222,456,200,3,2,30,15,13,5,22,63,38
W02000351,Newport 005,Middle Super Output Areas and Intermediate Zones,MSOAIZ,NP,6072,2715,4090,1700,1428,776,2662,924,26,11,1365,739,777,410,588,329,329,,,,522,219,461,193,0,0,59,24,2,2,26,69,46
W02000352,Newport 006,Middle Super Output Areas and Intermediate Zones,MSOAIZ,NP,6562,3019,3790,1693,1282,712,2508,981,32,14,1620,787,434,222,1186,565,565,,,,1032,467,947,421,8,3,71,39,6,4,46,88,58
W02000353,Newport 007,Middle Super Output Areas and Intermediate Zones,MSOAIZ,NP,7059,2955,5173,2152,1930,1012,3243,1140,20,10,284,142,129,59,155,83,83,,,,1534,620,1386,559,8,3,126,53,14,5,61,48,31
W02000354,Newport 008,Middle Super Output Areas and Intermediate Zones,MSOAIZ,NP,5918,2587,4102,1739,1768,945,2334,794,7,5,1240,577,422,175,818,402,402,,,,493,217,448,197,0,0,40,16,5,4,20,76,49
W02000355,Newport 009,Middle Super Output Areas and Intermediate Zones,MSOAIZ,NP,8380,3386,7193,2895,2692,1396,4501,1499,2,2,488,224,297,140,191,84,84,,,,650,240,610,222,0,0,39,17,1,1,18,47,25
W02000356,Newport 010,Middle Super Output Areas and Intermediate Zones,MSOAIZ,NP,5389,2273,2562,1096,991,549,1571,547,14,4,2439,1015,1570,632,869,383,383,,,,304,113,255,100,5,1,36,9,8,3,13,70,45
W02000357,Newport 011,Middle Super Output Areas and Intermediate Zones,MSOAIZ,NP,7841,3289,5432,2131,1915,951,3517,1180,42,18,447,263,142,76,305,187,187,,,,1826,827,1728,782,8,3,81,37,9,5,45,94,50
W02000358,Newport 012,Middle Super Output Areas and Intermediate Zones,MSOAIZ,NP,5867,2534,5038,2094,2136,1120,2902,974,3,3,238,137,52,25,186,112,112,,,,535,270,500,256,2,1,21,8,12,5,14,53,30
W02000359,Newport 013,Middle Super Output Areas and Intermediate Zones,MSOAIZ,NP,9792,4074,5450,2183,1728,820,3722,1363,100,52,1466,571,599,222,867,349,349,,,,2645,1199,2500,1126,14,6,105,56,26,11,73,131,69
W02000360,Newport 014,Middle Super Output Areas and Intermediate Zones,MSOAIZ,NP,5969,2831,3006,1270,1086,580,1920,690,49,33,763,486,116,70,647,416,416,,,,2068,1000,1943,940,26,17,68,26,31,17,60,83,42
W02000361,Newport 015,Middle Super Output Areas and Intermediate Zones,MSOAIZ,NP,10086,3977,5661,2369,2206,1175,3455,1194,47,21,3530,1227,1954,688,1576,539,539,,,,757,309,649,263,0,0,89,36,19,10,46,91,51
W02000362,Newport 016,Middle Super Output Areas and Intermediate Zones,MSOAIZ,NP,5981,2605,4647,1922,1717,923,2930,999,62,26,629,352,375,197,254,155,155,,,,587,269,538,243,6,2,33,18,10,6,26,56,36
W02000363,Newport 017,Middle Super Output Areas and Intermediate Zones,MSOAIZ,NP,5580,2624,3940,1735,1523,869,2417,866,30,10,1049,630,578,326,471,304,304,,,,487,201,433,179,0,0,46,16,8,6,22,74,48
W02000364,Newport 018,Middle Super Output Areas and Intermediate Zones,MSOAIZ,NP,7272,2957,2906,1017,949,411,1957,606,12,8,2188,1051,835,408,1353,643,643,,,,2057,821,1940,766,11,9,53,24,53,22,55,109,60
W02000365,Newport 019,Middle Super Output Areas and Intermediate Zones,MSOAIZ,NP,7485,3077,3277,1358,783,413,2494,945,60,29,3340,1321,1928,738,1412,583,583,,,,713,320,648,292,0,0,53,21,12,7,28,95,49
W02000366,Newport 020,Middle Super Output Areas and Intermediate Zones,MSOAIZ,NP,8124,3193,6838,2621,1972,946,4866,1675,56,22,285,131,114,52,171,79,79,,,,880,388,809,353,11,5,42,21,18,9,35,65,31
W02000367,Cardiff 001,Middle Super Output Areas and Intermediate Zones,MSOAIZ,CF,5965,2456,5307,2153,2330,1156,2977,997,26,17,43,21,28,12,15,9,9,,,,529,231,494,211,8,3,26,16,1,1,20,60,34
W02000368,Cardiff 002,Middle Super Output Areas and Intermediate Zones,MSOAIZ,CF,5946,2488,4880,1976,1549,783,3331,1193,114,51,178,90,38,18,140,72,72,,,,743,353,701,331,2,1,37,20,3,1,22,31,18
W02000369,Cardiff 003,Middle Super Output Areas and Intermediate Zones,MSOAIZ,CF,7968,3115,5936,2328,1248,599,4688,1729,78,35,545,195,15,5,530,190,190,,,,1348,534,1258,501,16,4,65,27,9,2,33,61,23
W02000370,Cardiff 004,Middle Super Output Areas and Intermediate Zones,MSOAIZ,CF,6509,2957,5952,2704,3025,1707,2927,997,12,6,40,16,21,7,19,9,9,,,,454,209,412,189,6,3,36,17,0,0,20,51,22
W02000371,Cardiff 005,Middle Super Output Areas and Intermediate Zones,MSOAIZ,CF,9033,3989,6065,2573,2119,1126,3946,1447,49,33,1687,820,1214,578,473,242,242,,,,1131,497,1009,449,21,6,97,39,4,3,48,101,66
W02000372,Cardiff 006,Middle Super Output Areas and Intermediate Zones,MSOAIZ,CF,7575,3060,6533,2603,2427,1206,4106,1397,5,4,353,157,145,56,208,101,101,,,,640,269,588,246,0,0,38,18,14,5,23,44,27
W02000373,Cardiff 007,Middle Super Output Areas and Intermediate Zones,MSOAIZ,CF,6541,2668,3666,1466,1177,615,2489,851,6,2,2137,896,1740,705,397,191,191,,,,654,244,607,225,0,0,47,19,0,0,19,78,60
W02000374,Cardiff 008,Middle Super Output Areas and Intermediate Zones,MSOAIZ,CF,5683,2293,5025,2044,2202,1135,2823,909,13,5,120,41,29,12,91,29,29,,,,478,176,438,160,2,1,31,12,7,3,16,47,27
W02000375,Cardiff 009,Middle Super Output Areas and Intermediate Zones,MSOAIZ,CF,6954,2783,3963,1634,951,488,3012,1146,54,19,1955,725,1268,468,687,257,257,,,,927,380,853,340,0,0,69,38,5,2,40,55,25
W02000376,Cardiff 010,Middle Super Output Areas and Intermediate Zones,MSOAIZ,CF,6692,2989,4863,2057,1877,969,2986,1088,23,9,1161,639,621,381,540,258,258,,,,600,256,539,230,0,0,56,23,5,3,26,45,28
W02000377,Cardiff 011,Middle Super Output Areas and Intermediate Zones,MSOAIZ,CF,7045,2876,5225,2139,1152,584,4073,1555,51,21,700,270,430,168,270,102,102,,,,1033,429,946,389,3,2,79,36,5,2,40,36,17
W02000378,Cardiff 012,Middle Super Output Areas and Intermediate Zones,MSOAIZ,CF,7377,3096,6079,2560,2498,1338,3581,1222,16,8,259,107,110,43,149,64,64,,,,973,394,905,362,10,3,53,27,5,2,32,50,27
W02000379,Cardiff 013,Middle Super Output Areas and Intermediate Zones,MSOAIZ,CF,6270,2562,1841,789,444,250,1397,539,47,21,3734,1486,1195,483,2539,1003,1003,,,,575,228,521,203,0,0,50,23,4,2,25,73,38
W02000380,Cardiff 014,Middle Super Output Areas and Intermediate Zones,MSOAIZ,CF,6999,2764,6209,2407,2307,1083,3902,1324,2,2,229,102,186,86,43,16,16,,,,514,224,467,198,14,10,29,13,4,3,26,45,29
W02000381,Cardiff 015,Middle Super Output Areas and Intermediate Zones,MSOAIZ,CF,6271,2799,4045,1737,1506,825,2539,912,17,8,1517,725,1309,635,208,90,90,,,,613,272,525,232,0,0,86,39,2,1,40,79,57
W02000382,Cardiff 016,Middle Super Output Areas and Intermediate Zones,MSOAIZ,CF,5616,2342,2862,1142,985,504,1877,638,20,9,2174,944,1346,624,828,320,320,,,,466,189,414,163,0,0,43,19,9,7,26,94,58
W02000383,Cardiff 017,Middle Super Output Areas and Intermediate Zones,MSOAIZ,CF,7219,3027,4669,1887,1461,750,3208,1137,36,16,1626,755,1340,633,286,122,122,,,,843,342,774,310,0,0,67,31,2,1,32,45,27
W02000384,Cardiff 018,Middle Super Output Areas and Intermediate Zones,MSOAIZ,CF,5636,2322,4868,1965,1970,1017,2898,948,19,15,170,94,88,40,82,54,54,,,,548,231,502,204,4,3,42,24,0,0,27,31,17
W02000385,Cardiff 019,Middle Super Output Areas and Intermediate Zones,MSOAIZ,CF,6039,2453,5115,2040,2244,1140,2871,900,8,6,92,62,23,8,69,54,54,,,,788,329,756,310,1,1,28,17,3,1,19,36,16
W02000386,Cardiff 020,Middle Super Output Areas and Intermediate Zones,MSOAIZ,CF,7740,3349,6608,2752,2915,1543,3693,1209,13,8,338,215,220,136,118,79,79,,,,702,329,650,302,4,2,46,24,2,1,27,79,45
W02000387,Cardiff 021,Middle Super Output Areas and Intermediate Zones,MSOAIZ,CF,5725,2419,4714,1995,2039,1054,2675,941,12,6,116,55,44,30,72,25,25,,,,852,342,771,311,30,9,43,19,8,3,31,31,21
W02000388,Cardiff 022,Middle Super Output Areas and Intermediate Zones,MSOAIZ,CF,5842,2384,4563,1845,1750,896,2813,949,2,1,720,299,382,175,338,124,124,,,,527,222,456,192,6,2,59,26,6,2,30,30,17
W02000389,Cardiff 023,Middle Super Output Areas and Intermediate Zones,MSOAIZ,CF,8317,3504,5046,2112,1696,895,3350,1217,17,9,2144,899,1417,635,727,264,264,,,,1033,438,938,400,11,3,80,34,4,1,38,77,46
W02000390,Cardiff 024,Middle Super Output Areas and Intermediate Zones,MSOAIZ,CF,5634,2365,4862,2007,2321,1176,2541,831,12,9,187,102,22,9,165,93,93,,,,535,228,498,209,3,2,31,14,3,3,19,38,19
W02000391,Cardiff 025,Middle Super Output Areas and Intermediate Zones,MSOAIZ,CF,6459,2426,2781,1179,988,516,1793,663,58,18,661,251,405,158,256,93,93,,,,2851,928,2469,812,16,5,213,68,153,43,116,108,50
W02000392,Cardiff 026,Middle Super Output Areas and Intermediate Zones,MSOAIZ,CF,8555,3794,7137,3047,3011,1551,4126,1496,16,9,249,142,42,13,207,129,129,,,,1038,539,961,499,8,5,60,32,9,3,40,115,57
W02000393,Cardiff 027,Middle Super Output Areas and Intermediate Zones,MSOAIZ,CF,6335,2963,3971,1791,1351,739,2620,1052,32,14,1451,744,1259,654,192,90,90,,,,814,366,702,322,11,3,91,38,10,3,44,67,48
W02000394,Cardiff 028,Middle Super Output Areas and Intermediate Zones,MSOAIZ,CF,8324,2739,2022,890,888,460,1134,430,53,16,203,81,40,15,163,66,66,,,,5970,1717,5633,1617,0,0,298,86,39,14,100,76,35
W02000395,Cardiff 029,Middle Super Output Areas and Intermediate Zones,MSOAIZ,CF,6219,2727,4324,1733,1557,750,2767,983,5,3,399,242,23,8,376,234,234,,,,1436,724,1348,685,7,4,80,34,1,1,39,55,25
W02000396,Cardiff 030,Middle Super Output Areas and Intermediate Zones,MSOAIZ,CF,7891,2963,3088,1229,1155,552,1933,677,49,18,331,160,153,77,178,83,83,,,,4344,1515,4104,1428,7,3,190,67,43,17,87,79,41
W02000397,Cardiff 031,Middle Super Output Areas and Intermediate Zones,MSOAIZ,CF,6639,2985,4310,1876,1572,888,2738,988,15,8,1485,733,857,438,628,295,295,,,,724,309,630,274,4,1,79,30,11,4,35,105,59
W02000398,Cardiff 032,Middle Super Output Areas and Intermediate Zones,MSOAIZ,CF,9198,3453,1022,577,561,320,461,257,53,19,449,241,158,81,291,160,160,,,,7564,2544,7182,2361,43,20,139,65,200,98,183,110,72
W02000399,Cardiff 033,Middle Super Output Areas and Intermediate Zones,MSOAIZ,CF,9770,4602,2731,1239,1140,577,1591,662,35,17,978,638,168,97,810,541,541,,,,5928,2656,5636,2520,23,14,225,87,44,35,136,98,52
W02000400,Cardiff 034,Middle Super Output Areas and Intermediate Zones,MSOAIZ,CF,6337,3147,3559,1598,1338,687,2221,911,10,8,415,234,73,35,342,199,199,,,,2281,1269,2196,1229,5,1,72,37,8,2,40,72,38
W02000401,Cardiff 035,Middle Super Output Areas and Intermediate Zones,MSOAIZ,CF,5933,2688,4501,1931,1662,858,2839,1073,7,4,396,246,87,32,309,214,214,,,,960,469,910,440,2,1,35,18,13,10,29,69,38
W02000402,Cardiff 036,Middle Super Output Areas and Intermediate Zones,MSOAIZ,CF,8653,4064,2872,1318,946,488,1926,830,36,19,2326,1088,447,200,1879,888,888,,,,3216,1551,3040,1464,9,5,139,62,28,20,87,203,88
W02000403,Cardiff 037,Middle Super Output Areas and Intermediate Zones,MSOAIZ,CF,7213,3077,3569,1540,908,477,2661,1063,8,5,2317,981,1505,652,812,329,329,,,,1195,487,1081,434,3,1,107,50,4,2,53,124,64
W02000404,Cardiff 038,Middle Super Output Areas and Intermediate Zones,MSOAIZ,CF,5997,2786,2823,1256,928,486,1895,770,11,5,1786,902,184,78,1602,824,824,,,,1233,561,1101,506,4,3,107,45,21,7,55,144,62
W02000405,Cardiff 039,Middle Super Output Areas and Intermediate Zones,MSOAIZ,CF,7507,2996,2551,1012,753,384,1798,628,7,4,4145,1682,3916,1596,229,86,86,,,,708,248,652,228,0,0,34,14,22,6,20,96,50
W02000406,Cardiff 040,Middle Super Output Areas and Intermediate Zones,MSOAIZ,CF,8227,3566,5425,2304,1949,998,3476,1306,21,11,916,419,314,157,602,262,262,,,,1766,779,1640,718,5,3,109,53,12,5,61,99,53
W02000407,Cardiff 041,Middle Super Output Areas and Intermediate Zones,MSOAIZ,CF,6299,2637,3096,1278,995,527,2101,751,18,9,2442,1036,1587,712,855,324,324,,,,653,267,564,235,12,3,68,25,9,4,32,90,47
W02000408,Cardiff 042,Middle Super Output Areas and Intermediate Zones,MSOAIZ,CF,7136,3011,2837,1050,1215,492,1622,558,32,15,1643,795,495,277,1148,518,518,,,,2452,1081,2324,1025,4,2,87,39,37,15,56,172,70
W02000409,Cardiff 043,Middle Super Output Areas and Intermediate Zones,MSOAIZ,CF,5886,2541,3569,1521,1297,674,2272,847,10,6,1754,779,1503,652,251,127,127,,,,474,188,392,156,0,0,68,28,14,4,32,79,47
W02000410,Cardiff 044,Middle Super Output Areas and Intermediate Zones,MSOAIZ,CF,8133,3039,4384,1594,1654,694,2730,900,30,9,1219,486,316,143,903,343,343,,,,2304,881,2149,816,11,5,95,40,49,20,65,196,69
W02000411,Cardiff 045,Middle Super Output Areas and Intermediate Zones,MSOAIZ,CF,6386,2703,3442,1437,1018,545,2424,892,14,7,1974,892,1069,519,905,373,373,,,,882,331,790,288,0,0,88,41,4,2,43,74,36
W02000412,Cardiff 046,Middle Super Output Areas and Intermediate Zones,MSOAIZ,CF,6775,2804,3827,1517,1302,613,2525,904,32,11,1173,560,458,233,715,327,327,,,,1593,646,1482,604,12,3,68,31,31,8,42,150,70
W02000414,Powys 020,Middle Super Output Areas and Intermediate Zones,MSOAIZ,SA,5930,2565,4608,1945,2688,1269,1920,676,33,13,291,148,221,118,70,30,30,,,,866,391,724,333,23,9,97,42,22,7,58,132,68
W02000415,Merthyr Tydfil 008,Middle Super Output Areas and Intermediate Zones,MSOAIZ,CF,9365,3657,4220,1698,1877,919,2343,779,22,10,4310,1610,3037,1109,1273,501,501,,,,639,243,527,188,8,5,58,31,46,19,55,174,96
W02000416,Powys 021,Middle Super Output Areas and Intermediate Zones,MSOAIZ,SA,10008,4553,7594,3297,3872,2002,3722,1295,18,10,1518,828,1325,706,193,122,122,,,,753,334,644,282,2,2,104,48,3,2,52,125,84
W02000417,Neath Port Talbot 020,Middle Super Output Areas and Intermediate Zones,MSOAIZ,SA,10013,4393,7058,3001,3188,1628,3870,1373,6,3,1971,907,1615,697,356,210,210,,,,854,409,719,342,2,2,125,61,8,4,67,124,73
W02000418,Carmarthenshire 027,Middle Super Output Areas and Intermediate Zones,MSOAIZ,SA,12095,5149,9206,3854,4885,2367,4321,1487,32,13,1223,560,735,377,488,183,183,,,,1474,631,1246,548,31,10,165,59,32,14,83,160,91
W02000419,Denbighshire 017,Middle Super Output Areas and Intermediate Zones,MSOAIZ,LL,10617,4653,7972,3531,3340,1796,4632,1735,131,56,931,420,619,316,312,104,104,,,,1478,588,1347,534,0,0,117,50,14,4,54,105,58
W02000420,Wrexham 020,Middle Super Output Areas and Intermediate Zones,MSOAIZ,LL,13269,5577,11069,4574,4688,2365,6381,2209,25,15,806,354,755,327,51,27,27,,,,1178,530,1054,472,15,6,97,46,12,6,58,191,104
W02000421,Ceredigion 011,Middle Super Output Areas and Intermediate Zones,MSOAIZ,SY,11560,5027,9086,3877,5160,2496,3926,1381,21,13,448,229,126,72,322,157,157,,,,1768,780,1557,689,14,6,162,67,35,18,91,237,128
W02000422,Cardiff 048,Middle Super Output Areas and Intermediate Zones,MSOAIZ,CF,6043,3654,1793,1172,412,282,1381,890,79,54,438,214,37,21,401,193,193,,,,3680,2185,3532,2086,5,4,132,89,11,6,99,53,29
W02000423,Cardiff 049,Middle Super Output Areas and Intermediate Zones,MSOAIZ,CF,8040,4132,2340,1258,723,391,1617,867,44,30,2296,1113,1642,752,654,361,361,,,,3168,1633,3019,1558,6,4,126,63,17,8,75,192,98
S02001236,Culter,Middle Super Output Areas and Intermediate Zones,MSOAIZ,AB,4733,2143,3623,1599,1413,722,2184,860,26,17,615,310,560,281,55,29,29,281,29,175,449,208,393,175,4,1,40,26,12,33,33,46,26
S02001237,Cults; Bieldside and Milltimber West,Middle Super Output Areas and Intermediate Zones,MSOAIZ,AB,3751,1428,3137,1225,1492,702,1640,520,5,3,121,47,115,45,6,2,2,45,2,115,425,130,370,115,17,4,20,6,18,15,15,68,26
S02001238,Cults; Bieldside and Milltimber East,Middle Super Output Areas and Intermediate Zones,MSOAIZ,AB,5850,2291,4892,1948,2412,1138,2480,810,0,0,103,53,99,49,4,4,4,49,4,234,790,259,724,234,18,6,34,17,14,25,25,65,31
S02001239,Garthdee,Middle Super Output Areas and Intermediate Zones,MSOAIZ,AB,5152,2439,2265,1051,889,482,1340,552,36,17,1742,885,1096,538,646,347,347,538,347,411,1091,469,980,411,0,0,105,53,6,58,58,54,34
S02001240,Braeside; Mannofield; Broomhill and Seafield East,Middle Super Output Areas and Intermediate Zones,MSOAIZ,AB,4358,2193,3276,1580,1293,695,1978,883,5,2,79,58,62,45,17,13,13,45,13,447,958,527,845,447,5,2,72,47,36,80,80,45,28
S02001241,Braeside; Mannofield; Broomhill and Seafield South,Middle Super Output Areas and Intermediate Zones,MSOAIZ,AB,3797,1754,3307,1495,1536,843,1771,652,0,0,141,96,86,49,55,47,47,49,47,126,313,139,294,126,0,0,18,12,1,13,13,36,24
S02001242,Braeside; Mannofield; Broomhill and Seafield North,Middle Super Output Areas and Intermediate Zones,MSOAIZ,AB,4508,2214,3722,1809,1871,1066,1838,736,13,7,101,60,78,49,23,11,11,49,11,287,640,313,596,287,8,4,33,19,3,26,26,45,32
S02001243,Hazlehead,Middle Super Output Areas and Intermediate Zones,MSOAIZ,AB,4908,2318,3859,1754,2011,1053,1846,700,2,1,526,343,512,335,14,8,8,335,8,166,464,186,421,166,10,3,26,16,7,20,20,59,35
S02001244,Summerhill,Middle Super Output Areas and Intermediate Zones,MSOAIZ,AB,3820,1848,2209,999,808,451,1395,545,6,3,1257,692,998,517,259,175,175,517,175,115,325,138,276,115,2,1,29,15,18,23,23,29,19
S02001245,Midstocket,Middle Super Output Areas and Intermediate Zones,MSOAIZ,AB,4507,2081,3414,1548,1514,816,1891,729,9,3,273,165,144,74,129,91,91,74,91,287,779,343,650,287,57,15,51,34,21,56,56,41,25
S02001246,Rosemount,Middle Super Output Areas and Intermediate Zones,MSOAIZ,AB,5685,3389,2692,1625,939,594,1703,1002,50,29,818,520,601,377,217,143,143,377,143,1100,2108,1194,1950,1100,7,3,143,85,8,94,94,67,50
S02001247,West End North,Middle Super Output Areas and Intermediate Zones,MSOAIZ,AB,3488,1518,2692,1153,1176,586,1510,565,6,2,73,34,56,23,17,11,11,23,11,279,660,299,621,279,8,3,24,14,7,20,20,63,32
S02001248,West End South,Middle Super Output Areas and Intermediate Zones,MSOAIZ,AB,5989,3251,3754,1983,1406,813,2315,1155,33,15,159,101,137,85,22,16,16,85,16,1004,1954,1088,1792,1004,5,3,140,74,17,84,84,122,79
S02001249,City Centre West,Middle Super Output Areas and Intermediate Zones,MSOAIZ,AB,3949,2339,1364,869,452,296,886,558,26,15,685,443,470,293,215,150,150,293,150,909,1839,986,1711,909,17,9,104,63,7,77,77,61,41
S02001250,City Centre East,Middle Super Output Areas and Intermediate Zones,MSOAIZ,AB,2436,1402,654,418,156,102,483,308,15,8,428,267,200,112,228,155,155,112,155,654,1338,708,1237,654,6,4,75,43,20,54,54,16,9
S02001251,Ferryhill North,Middle Super Output Areas and Intermediate Zones,MSOAIZ,AB,4773,2763,2577,1498,806,472,1630,945,141,81,241,158,79,53,162,105,105,53,105,984,1892,1060,1768,984,8,6,105,65,11,76,76,63,47
S02001252,Ferryhill South,Middle Super Output Areas and Intermediate Zones,MSOAIZ,AB,4673,2507,3068,1569,1239,725,1815,834,14,10,487,352,366,260,121,92,92,260,92,488,1052,542,955,488,10,4,82,47,5,54,54,66,44
S02001253,Kincorth; Leggart and Nigg North,Middle Super Output Areas and Intermediate Zones,MSOAIZ,AB,4047,1860,2534,1148,1023,536,1499,603,12,9,1276,604,1263,599,13,5,5,599,5,63,198,84,154,63,4,2,36,18,4,21,21,39,24
S02001254,Kincorth; Leggart and Nigg South,Middle Super Output Areas and Intermediate Zones,MSOAIZ,AB,4024,1784,2738,1204,1079,570,1649,631,10,3,1041,476,983,459,58,17,17,459,17,59,207,80,152,59,12,3,30,16,13,21,21,38,24
S02001255,Cove South,Middle Super Output Areas and Intermediate Zones,MSOAIZ,AB,4069,1674,3715,1512,894,436,2805,1067,16,9,104,57,86,50,18,7,7,50,7,86,227,90,216,86,0,0,10,3,1,4,4,23,15
S02001256,Cove North,Middle Super Output Areas and Intermediate Zones,MSOAIZ,AB,3623,1648,2976,1323,874,453,2064,853,38,17,395,204,290,141,105,63,63,141,63,94,228,104,207,94,2,2,19,8,0,10,10,24,17
S02001257,Torry West,Middle Super Output Areas and Intermediate Zones,MSOAIZ,AB,5438,2863,2106,1152,718,427,1377,718,11,7,1976,1027,1623,807,353,220,220,807,220,607,1292,648,1223,607,4,2,59,36,6,41,41,64,36
S02001258,Torry East,Middle Super Output Areas and Intermediate Zones,MSOAIZ,AB,4577,2170,1253,600,455,250,774,341,24,9,2965,1403,2873,1336,92,67,67,1336,67,137,338,152,308,137,0,0,24,12,6,15,15,21,15
S02001259,Hanover South,Middle Super Output Areas and Intermediate Zones,MSOAIZ,AB,3208,1885,1049,635,315,196,705,428,29,11,739,543,572,409,167,134,134,409,134,595,1360,672,1197,595,5,1,149,70,9,77,77,60,35
S02001260,Hanover North,Middle Super Output Areas and Intermediate Zones,MSOAIZ,AB,3523,2066,1190,728,281,183,825,501,84,44,553,393,400,283,153,110,110,283,110,776,1677,885,1482,776,2,1,190,105,3,109,109,103,60
S02001261,George Street,Middle Super Output Areas and Intermediate Zones,MSOAIZ,AB,5963,3479,1592,974,500,321,1012,606,80,47,1782,1164,1143,732,639,432,432,732,432,1156,2505,1281,2262,1156,4,3,234,118,5,125,125,84,60
S02001262,Ashgrove,Middle Super Output Areas and Intermediate Zones,MSOAIZ,AB,3582,1944,1534,835,498,301,967,497,69,37,843,509,386,244,457,265,265,244,265,499,1143,569,1003,499,13,4,125,64,2,70,70,62,31
S02001263,Froghall; Powis and Sunnybank,Middle Super Output Areas and Intermediate Zones,MSOAIZ,AB,5049,2443,1562,855,613,360,900,478,49,17,1125,546,1044,500,81,46,46,500,46,850,2276,985,2009,850,42,22,198,100,27,135,135,86,57
S02001264,Seaton,Middle Super Output Areas and Intermediate Zones,MSOAIZ,AB,3597,2150,865,529,309,205,464,267,92,57,1823,1153,1636,1045,187,108,108,1045,108,357,858,437,704,357,70,37,70,31,14,80,80,51,31
S02001265,Old Aberdeen,Middle Super Output Areas and Intermediate Zones,MSOAIZ,AB,2864,1510,643,343,276,171,311,141,56,31,1691,922,1512,794,179,128,128,794,128,183,478,218,406,183,25,13,40,19,7,35,35,52,27
S02001266,Tillydrone,Middle Super Output Areas and Intermediate Zones,MSOAIZ,AB,4835,2327,1336,635,572,304,719,315,45,16,3036,1524,2884,1450,152,74,74,1450,74,122,456,161,325,122,62,15,37,16,32,39,39,7,7
S02001267,Woodside,Middle Super Output Areas and Intermediate Zones,MSOAIZ,AB,3883,2046,1095,573,304,172,768,386,23,15,2229,1208,2062,1089,167,119,119,1089,119,222,538,253,479,222,2,2,54,28,3,31,31,21,12
S02001268,Hilton,Middle Super Output Areas and Intermediate Zones,MSOAIZ,AB,5923,2959,3550,1799,1378,799,2133,982,39,18,1174,641,1039,570,135,71,71,570,71,409,1128,474,998,409,3,1,123,62,4,65,65,71,45
S02001269,Stockethill,Middle Super Output Areas and Intermediate Zones,MSOAIZ,AB,5344,2700,2554,1179,1033,581,1505,592,16,6,2109,1256,2050,1220,59,36,36,1220,36,212,632,236,581,212,0,0,48,22,3,24,24,49,29
S02001270,Mastrick,Middle Super Output Areas and Intermediate Zones,MSOAIZ,AB,4812,2202,2438,1074,802,458,1624,613,12,3,2161,1030,1867,914,294,116,116,914,116,59,188,79,151,59,2,1,30,17,5,20,20,25,19
S02001271,Sheddocksley,Middle Super Output Areas and Intermediate Zones,MSOAIZ,AB,4909,2336,2854,1235,934,502,1898,725,22,8,1837,998,1405,799,432,199,199,799,199,62,177,77,150,62,3,1,19,12,5,15,15,41,26
S02001272,Cummings Park,Middle Super Output Areas and Intermediate Zones,MSOAIZ,AB,3512,1457,1792,745,597,311,1190,432,5,2,1566,650,1416,594,150,56,56,594,56,38,135,50,109,38,5,1,21,11,0,12,12,19,12
S02001273,Northfield,Middle Super Output Areas and Intermediate Zones,MSOAIZ,AB,5479,2181,2720,1106,759,396,1939,700,22,10,2480,980,2116,849,364,131,131,849,131,65,249,78,218,65,4,1,25,11,2,13,13,30,17
S02001274,Heathryfold and Middlefield,Middle Super Output Areas and Intermediate Zones,MSOAIZ,AB,5213,2116,1745,725,523,263,1200,453,22,9,3262,1316,2829,1141,433,175,175,1141,175,68,202,73,191,68,0,0,11,5,0,5,5,4,2
S02001275,Kingswells,Middle Super Output Areas and Intermediate Zones,MSOAIZ,AB,5109,1919,4381,1659,1352,610,2940,999,89,50,188,73,152,59,36,14,14,59,14,145,495,167,450,145,19,10,20,8,6,22,22,45,20
S02001276,Bucksburn South,Middle Super Output Areas and Intermediate Zones,MSOAIZ,AB,3297,1672,2213,1081,773,434,1405,633,35,14,684,374,548,304,136,70,70,304,70,170,353,194,312,170,4,1,34,20,3,24,24,47,23
S02001277,Bucksburn North,Middle Super Output Areas and Intermediate Zones,MSOAIZ,AB,4489,2108,3258,1497,1416,754,1792,708,50,35,885,438,751,382,134,56,56,382,56,113,286,134,249,113,12,5,19,12,6,21,21,60,39
S02001278,Dyce,Middle Super Output Areas and Intermediate Zones,MSOAIZ,AB,5307,2390,4110,1786,1728,888,2381,897,1,1,782,412,675,345,107,67,67,345,67,131,347,158,285,131,10,4,34,17,18,27,27,68,34
S02001279,Danestone,Middle Super Output Areas and Intermediate Zones,MSOAIZ,AB,3874,1767,3464,1558,1137,572,2304,976,23,10,42,20,36,17,6,3,3,17,3,149,336,171,302,149,3,2,31,20,0,22,22,32,18
S02001280,Oldmachar West,Middle Super Output Areas and Intermediate Zones,MSOAIZ,AB,4343,1891,3796,1602,1234,591,2496,980,66,31,191,123,181,118,10,5,5,118,5,127,317,145,279,127,9,2,23,14,6,18,18,39,21
S02001281,Oldmachar East,Middle Super Output Areas and Intermediate Zones,MSOAIZ,AB,4840,1878,4517,1750,1692,790,2819,958,6,2,122,56,51,17,71,39,39,17,39,55,170,65,145,55,4,1,21,9,0,10,10,31,7
S02001282,Balgownie and Donmouth West,Middle Super Output Areas and Intermediate Zones,MSOAIZ,AB,3588,1686,2731,1213,1120,576,1604,635,7,2,660,377,649,372,11,5,5,372,5,61,165,73,145,61,3,2,17,10,0,12,12,32,23
S02001283,Balgownie and Donmouth East,Middle Super Output Areas and Intermediate Zones,MSOAIZ,AB,2706,1237,2275,1043,1084,561,1187,479,4,3,172,73,169,71,3,2,2,71,2,92,234,103,211,92,3,1,20,10,0,11,11,25,18
S02001284,Denmore,Middle Super Output Areas and Intermediate Zones,MSOAIZ,AB,2839,1145,2500,988,796,374,1698,612,6,2,96,50,87,47,9,3,3,47,3,87,224,97,200,87,5,2,19,8,0,10,10,19,10
S02001285,East Cairngorms,Middle Super Output Areas and Intermediate Zones,MSOAIZ,AB,3002,1446,1723,819,1017,550,705,268,1,1,357,207,245,154,112,53,53,154,53,273,646,308,559,273,38,15,44,18,5,35,35,276,112
S02001286,Aboyne and South Deeside,Middle Super Output Areas and Intermediate Zones,MSOAIZ,AB,4834,2012,3482,1413,1648,785,1785,605,49,23,479,249,278,164,201,85,85,164,85,233,676,271,600,233,35,12,40,25,1,38,38,197,79
S02001287,Mearns and Laurencekirk,Middle Super Output Areas and Intermediate Zones,MSOAIZ,DD,4107,1701,2874,1160,1068,532,1797,622,9,6,519,260,392,192,127,68,68,192,68,203,617,233,512,203,65,11,33,16,7,30,30,97,48
S02001288,Mearns South and Benholm,Middle Super Output Areas and Intermediate Zones,MSOAIZ,DD,3967,1644,2953,1178,1104,542,1840,631,9,5,479,232,354,172,125,60,60,172,60,156,405,176,365,156,20,11,16,7,4,20,20,130,58
S02001289,Mearns North and Inverbervie,Middle Super Output Areas and Intermediate Zones,MSOAIZ,DD,5326,2182,3999,1556,1297,639,2694,913,8,4,817,395,671,307,146,88,88,307,88,145,381,168,339,145,12,6,28,15,2,23,23,129,63
S02001290,Fetteresso; Netherley and Catter,Middle Super Output Areas and Intermediate Zones,MSOAIZ,AB,3340,1279,2726,1028,1116,489,1605,535,5,4,102,39,85,31,17,8,8,31,8,148,404,169,348,148,19,7,24,9,13,21,21,108,43
S02001291,Stonehaven South,Middle Super Output Areas and Intermediate Zones,MSOAIZ,AB,5406,2389,3984,1662,1440,740,2540,920,4,2,952,491,788,397,164,94,94,397,94,172,416,197,373,172,9,4,30,19,4,25,25,54,39
S02001292,Stonehaven North,Middle Super Output Areas and Intermediate Zones,MSOAIZ,AB,5842,2451,4639,1849,1731,869,2885,970,23,10,655,359,277,148,378,211,211,148,211,196,514,221,459,196,1,1,42,20,12,25,25,34,22
S02001293,Newtonhill,Middle Super Output Areas and Intermediate Zones,MSOAIZ,AB,2982,1160,2675,1023,858,412,1762,589,55,22,181,87,147,72,34,15,15,72,15,35,110,42,96,35,0,0,14,7,0,7,7,16,8
S02001294,Portlethen,Middle Super Output Areas and Intermediate Zones,MSOAIZ,AB,4467,1796,4210,1670,1198,588,2973,1068,39,14,79,41,55,30,24,11,11,30,11,57,152,71,126,57,1,1,22,11,3,14,14,26,14
S02001295,Banchory-Devenick and Findon,Middle Super Output Areas and Intermediate Zones,MSOAIZ,AB,4246,1650,3368,1275,917,437,2408,823,43,15,539,238,152,70,387,168,168,70,168,110,304,122,275,110,0,0,18,6,11,12,12,35,15
S02001296,Dunecht; Durris and Drumoak,Middle Super Output Areas and Intermediate Zones,MSOAIZ,AB,4802,1868,3538,1329,1553,676,1945,637,40,16,218,114,126,72,92,42,42,72,42,336,908,362,840,336,10,5,42,16,16,26,26,138,63
S02001297,Banchory East,Middle Super Output Areas and Intermediate Zones,MSOAIZ,AB,4045,1652,3078,1216,1126,556,1946,658,6,2,556,288,300,169,256,119,119,169,119,114,387,134,319,114,17,5,38,13,13,20,20,24,14
S02001298,Banchory West,Middle Super Output Areas and Intermediate Zones,MSOAIZ,AB,3053,1301,2419,992,1207,587,1199,398,13,7,273,152,237,133,36,19,19,133,19,124,332,136,305,124,12,4,13,7,2,12,12,29,21
S02001299,Crathes and Torphins,Middle Super Output Areas and Intermediate Zones,MSOAIZ,AB,3919,1552,2876,1118,1377,664,1498,453,1,1,220,101,157,81,63,20,20,81,20,276,714,290,680,276,12,5,13,5,9,14,14,109,43
S02001300,Cromar and Kildrummy,Middle Super Output Areas and Intermediate Zones,MSOAIZ,AB,4058,1733,2806,1158,1320,653,1470,499,16,6,376,194,277,138,99,56,56,138,56,296,737,321,675,296,25,9,25,12,12,25,25,139,60
S02001301,Howe of Alford,Middle Super Output Areas and Intermediate Zones,MSOAIZ,AB,5560,2331,4426,1779,1883,912,2537,864,6,3,457,267,359,215,98,52,52,215,52,201,559,226,489,201,8,3,54,18,8,25,25,118,59
S02001302,Kemnay,Middle Super Output Areas and Intermediate Zones,MSOAIZ,AB,3559,1485,2410,966,833,402,1572,562,5,2,1018,461,817,370,201,91,91,370,91,41,122,50,97,41,14,3,10,5,1,9,9,9,8
S02001303,Inverurie North,Middle Super Output Areas and Intermediate Zones,MSOAIZ,AB,5478,2451,4287,1861,1620,841,2647,1011,20,9,797,404,595,318,202,86,86,318,86,147,364,166,321,147,11,4,29,14,3,19,19,30,20
S02001304,Inverurie South,Middle Super Output Areas and Intermediate Zones,MSOAIZ,AB,5283,2542,3290,1500,1379,763,1859,714,52,23,1362,762,979,535,383,227,227,535,227,215,573,246,517,215,4,2,39,23,13,31,31,58,34
S02001305,Durno-Chapel of Garioch,Middle Super Output Areas and Intermediate Zones,MSOAIZ,AB,4829,1778,4066,1479,1402,600,2664,879,0,0,190,67,90,37,100,30,30,37,30,161,459,181,411,161,20,5,26,13,2,20,20,114,51
S02001306,Kintore,Middle Super Output Areas and Intermediate Zones,MSOAIZ,AB,5704,2180,4783,1783,1574,735,3187,1035,22,13,480,233,210,130,270,103,103,130,103,126,383,138,346,126,4,1,30,10,3,12,12,58,26
S02001307,Blackburn,Middle Super Output Areas and Intermediate Zones,MSOAIZ,AB,3271,1252,2710,1007,684,319,2018,684,8,4,191,98,100,56,91,42,42,56,42,114,333,131,283,114,20,6,13,7,17,17,17,37,16
S02001308,Westhill North and South,Middle Super Output Areas and Intermediate Zones,MSOAIZ,AB,3869,1446,3337,1226,1211,539,2105,678,21,9,165,63,46,25,119,38,38,25,38,130,342,142,320,130,10,3,10,7,2,12,12,25,15
S02001309,Westhill Central,Middle Super Output Areas and Intermediate Zones,MSOAIZ,AB,4163,1757,3727,1545,1470,756,2253,786,4,3,150,88,86,62,64,26,26,62,26,91,259,107,215,91,9,3,35,13,0,16,16,27,17
S02001310,Garlogie and Elrick,Middle Super Output Areas and Intermediate Zones,MSOAIZ,AB,3772,1395,3354,1234,866,404,2444,812,44,18,186,72,35,21,151,51,51,21,51,74,223,83,199,74,0,0,24,9,0,9,9,9,6
S02001311,Newmachar and Fintray,Middle Super Output Areas and Intermediate Zones,MSOAIZ,AB,4205,1643,3601,1375,1094,497,2442,855,65,23,340,166,126,87,214,79,79,87,79,85,254,96,230,85,8,2,16,9,0,11,11,10,6
S02001312,Balmedie and Potterton,Middle Super Output Areas and Intermediate Zones,MSOAIZ,AB,5229,2030,4475,1686,1462,676,3000,1005,13,5,344,161,151,82,193,79,79,82,79,144,358,160,321,144,9,2,18,10,10,16,16,52,23
S02001313,Ellon East,Middle Super Output Areas and Intermediate Zones,MSOAIZ,AB,5791,2453,4999,2050,1680,880,3315,1168,4,2,309,184,147,101,162,83,83,101,83,167,423,190,377,167,7,2,37,20,2,23,23,60,29
S02001314,Ellon West,Middle Super Output Areas and Intermediate Zones,MSOAIZ,AB,4344,1848,3482,1401,1274,633,2197,762,11,6,547,309,490,276,57,33,33,276,33,108,287,124,248,108,7,2,32,14,0,16,16,28,14
S02001315,Ythanside,Middle Super Output Areas and Intermediate Zones,MSOAIZ,AB,4301,1693,3494,1352,1359,618,2135,734,0,0,201,83,129,58,72,25,25,58,25,195,523,218,463,195,33,8,23,14,4,23,23,83,40
S02001316,Ythsie,Middle Super Output Areas and Intermediate Zones,MSOAIZ,AB,5693,2310,4475,1745,1637,752,2808,979,30,14,493,248,419,208,74,40,40,208,40,239,599,265,542,239,6,5,26,12,25,26,26,126,52
S02001317,Barrahill,Middle Super Output Areas and Intermediate Zones,MSOAIZ,AB,4860,1875,3889,1459,1310,597,2551,852,28,10,540,239,331,169,209,70,70,169,70,141,380,152,354,141,10,4,11,5,5,11,11,51,25
S02001318,Fyvie-Rothie,Middle Super Output Areas and Intermediate Zones,MSOAIZ,AB,3786,1522,2968,1143,1200,538,1759,602,9,3,332,168,262,145,70,23,23,145,23,164,417,178,380,164,24,8,13,6,0,14,14,69,33
S02001319,Insch; Oyne and Ythanwells,Middle Super Output Areas and Intermediate Zones,MSOAIZ,AB,4558,1878,3673,1452,1342,632,2329,818,2,2,403,218,353,179,50,39,39,179,39,151,407,171,369,151,8,3,29,16,1,20,20,75,37
S02001320,Clashindarroch,Middle Super Output Areas and Intermediate Zones,MSOAIZ,AB,4497,1819,3330,1322,1585,727,1722,586,23,9,398,178,263,119,135,59,59,119,59,239,672,269,596,239,28,11,39,16,9,30,30,97,50
S02001321,Huntly,Middle Super Output Areas and Intermediate Zones,MSOAIZ,AB,4347,2123,2660,1218,1315,708,1324,496,21,14,1245,683,973,545,272,138,138,545,138,166,401,194,343,166,3,2,50,23,5,28,28,41,28
S02001322,Auchterless and Monquhitter,Middle Super Output Areas and Intermediate Zones,MSOAIZ,AB,2778,1063,2186,825,897,394,1286,430,3,1,99,39,87,34,12,5,5,34,5,154,433,172,364,154,15,2,29,8,25,18,18,60,27
S02001323,Turriff,Middle Super Output Areas and Intermediate Zones,MSOAIZ,AB,4786,2229,3394,1523,1440,804,1942,712,12,7,928,500,693,389,235,111,111,389,111,143,401,167,344,143,2,2,39,17,16,24,24,63,39
S02001324,Portsoy; Fordyce and Cornhill,Middle Super Output Areas and Intermediate Zones,MSOAIZ,AB,3222,1420,2240,980,1211,616,1025,360,4,4,590,275,510,241,80,34,34,241,34,112,310,125,278,112,5,1,21,10,6,13,13,82,40
S02001325,Aberchirder and Whitehills,Middle Super Output Areas and Intermediate Zones,MSOAIZ,AB,3829,1640,2772,1141,1428,700,1344,441,0,0,640,312,559,279,81,33,33,279,33,127,337,149,291,127,14,6,32,16,0,22,22,80,38
S02001326,Banff,Middle Super Output Areas and Intermediate Zones,MSOAIZ,AB,4003,1887,2507,1106,1174,622,1320,478,13,6,1118,601,891,452,227,149,149,452,149,127,329,150,280,127,2,1,26,14,21,23,23,49,30
S02001327,Macduff,Middle Super Output Areas and Intermediate Zones,MSOAIZ,AB,3995,1794,2695,1143,1157,599,1535,542,3,2,1072,545,982,481,90,64,64,481,64,78,205,90,181,78,6,3,16,8,2,12,12,23,16
S02001328,Gardenstown and King Edward,Middle Super Output Areas and Intermediate Zones,MSOAIZ,AB,3167,1331,2491,1014,1316,609,1165,400,10,5,194,118,179,110,15,8,8,110,8,131,399,159,322,131,5,2,57,22,15,28,28,83,40
S02001329,New Pitsligo,Middle Super Output Areas and Intermediate Zones,MSOAIZ,AB,3063,1294,2424,987,1211,567,1213,420,0,0,378,181,365,177,13,4,4,177,4,89,205,96,192,89,0,0,8,5,5,7,7,56,30
S02001330,Deer and Mormond,Middle Super Output Areas and Intermediate Zones,MSOAIZ,AB,4562,1902,3678,1447,1685,767,1980,675,13,5,414,244,362,211,52,33,33,211,33,138,373,158,340,138,14,7,19,13,0,20,20,97,53
S02001331,Mintlaw,Middle Super Output Areas and Intermediate Zones,MSOAIZ,AB,2720,1199,1969,842,880,456,1064,376,25,10,626,300,464,213,162,87,87,213,87,43,109,48,96,43,1,1,12,4,0,5,5,16,9
S02001332,Auchnagatt,Middle Super Output Areas and Intermediate Zones,MSOAIZ,AB,2892,1153,2401,924,1014,454,1383,468,4,2,164,86,144,78,20,8,8,78,8,100,274,113,248,100,8,3,7,4,11,13,13,53,30
S02001333,Cruden,Middle Super Output Areas and Intermediate Zones,MSOAIZ,AB,4653,2025,3546,1490,1407,692,2130,795,9,3,748,376,647,341,101,35,35,341,35,117,315,136,274,117,8,5,22,10,11,19,19,44,23
S02001334,Peterhead Links,Middle Super Output Areas and Intermediate Zones,MSOAIZ,AB,4375,1801,3338,1351,1340,654,1993,694,5,3,795,350,279,141,516,209,209,141,209,64,195,78,165,64,0,0,27,13,3,14,14,47,22
S02001335,Peterhead Bay,Middle Super Output Areas and Intermediate Zones,MSOAIZ,AB,2611,1306,1622,763,773,437,845,324,4,2,745,429,560,304,185,125,125,304,125,82,219,96,193,82,3,1,19,10,4,14,14,25,18
S02001336,Peterhead Harbour,Middle Super Output Areas and Intermediate Zones,MSOAIZ,AB,6256,2952,2802,1288,1197,652,1576,624,29,12,2157,1121,1525,770,632,351,351,770,351,468,1233,507,1149,468,11,5,60,27,13,39,39,64,36
S02001337,Peterhead Ugieside,Middle Super Output Areas and Intermediate Zones,MSOAIZ,AB,4367,1818,3411,1406,1355,671,2055,734,1,1,663,289,255,147,408,142,142,147,142,91,253,104,219,91,2,1,27,10,5,13,13,40,19
S02001338,Longside and Rattray,Middle Super Output Areas and Intermediate Zones,MSOAIZ,AB,5781,2239,4706,1748,1800,818,2893,926,13,4,584,290,515,263,69,27,27,263,27,127,386,153,320,127,23,7,35,16,8,26,26,105,48
S02001339,Rosehearty and Strathbeg,Middle Super Output Areas and Intermediate Zones,MSOAIZ,AB,5981,2486,4577,1815,2187,1039,2378,772,12,4,967,480,932,464,35,16,16,464,16,117,326,144,276,117,11,5,32,19,7,27,27,111,47
S02001340,Fraserburgh Smiddyhill,Middle Super Output Areas and Intermediate Zones,MSOAIZ,AB,4042,1572,3560,1373,1600,765,1959,607,1,1,257,111,155,66,102,45,45,66,45,58,173,64,161,58,4,1,8,5,0,6,6,52,24
S02001341,Fraserburgh Lochpots,Middle Super Output Areas and Intermediate Zones,MSOAIZ,AB,2569,1095,1121,469,379,199,742,270,0,0,1145,514,946,428,199,86,86,428,86,99,295,108,271,99,6,2,10,5,8,9,9,8,4
S02001342,Fraserburgh Central-Academy,Middle Super Output Areas and Intermediate Zones,MSOAIZ,AB,2684,1274,1702,735,750,384,951,350,1,1,660,398,477,302,183,96,96,302,96,120,302,129,287,120,0,0,10,7,5,9,9,20,12
S02001343,Fraserburgh Harbour and Broadsea,Middle Super Output Areas and Intermediate Zones,MSOAIZ,AB,3640,1607,1493,651,653,339,794,298,46,14,1588,736,1205,582,383,154,154,582,154,200,553,214,526,200,8,3,7,7,12,14,14,6,6
S02001344,South Angus,Middle Super Output Areas and Intermediate Zones,MSOAIZ,DD,5551,2277,4807,1901,1852,910,2942,988,13,3,210,139,129,83,81,56,56,83,56,175,462,202,409,175,12,5,35,16,6,27,27,72,35
S02001345,Monikie,Middle Super Output Areas and Intermediate Zones,MSOAIZ,DD,5656,2065,4764,1700,1401,659,3357,1039,6,2,211,93,132,60,79,33,33,60,33,175,539,212,448,175,49,20,22,11,20,37,37,142,60
S02001346,Monifieth West,Middle Super Output Areas and Intermediate Zones,MSOAIZ,DD,2900,1251,2522,1071,1100,574,1422,497,0,0,196,99,194,97,2,2,2,97,2,57,150,61,140,57,0,0,10,4,0,4,4,32,20
S02001347,Monifieth East,Middle Super Output Areas and Intermediate Zones,MSOAIZ,DD,4693,2199,4094,1846,1830,1019,2233,808,31,19,282,194,166,108,116,86,86,108,86,102,261,123,230,102,0,0,31,21,0,21,21,56,36
S02001348,Carnoustie West,Middle Super Output Areas and Intermediate Zones,MSOAIZ,DD,5199,2345,3646,1591,1249,664,2380,918,17,9,947,487,731,404,216,83,83,404,83,199,550,231,491,199,10,4,47,27,2,32,32,56,36
S02001349,Carnoustie East,Middle Super Output Areas and Intermediate Zones,MSOAIZ,DD,5436,2379,4621,1982,2071,1100,2546,879,4,3,358,197,264,142,94,55,55,142,55,150,414,173,360,150,2,1,50,21,2,23,23,43,27
S02001350,Arbroath Landward,Middle Super Output Areas and Intermediate Zones,MSOAIZ,DD,2239,965,1623,679,775,377,840,297,8,5,59,26,42,19,17,7,7,19,7,200,477,222,427,200,19,10,19,6,12,22,22,80,38
S02001351,Arbroath Kirkton,Middle Super Output Areas and Intermediate Zones,MSOAIZ,DD,5697,2389,3875,1568,1465,740,2388,818,22,10,1251,594,720,371,531,223,223,371,223,131,522,198,315,131,117,35,22,9,68,67,67,49,29
S02001352,Arbroath Keptie,Middle Super Output Areas and Intermediate Zones,MSOAIZ,DD,3591,1750,2734,1260,1283,710,1445,547,6,3,504,302,365,227,139,75,75,227,75,144,319,164,279,144,6,1,30,18,4,20,20,34,24
S02001353,Arbroath Harbour,Middle Super Output Areas and Intermediate Zones,MSOAIZ,DD,4626,2630,2108,1051,812,488,1288,559,8,4,1645,1057,684,411,961,646,646,411,646,438,817,482,730,438,11,4,45,27,31,44,44,56,40
S02001354,Arbroath Cliffburn,Middle Super Output Areas and Intermediate Zones,MSOAIZ,DD,4801,2018,2626,1089,915,486,1704,601,7,2,1733,743,842,412,891,331,331,412,331,149,407,167,373,149,2,1,24,13,8,18,18,35,19
S02001355,Arbroath Warddykes,Middle Super Output Areas and Intermediate Zones,MSOAIZ,DD,4938,2176,2627,1102,964,511,1656,588,7,3,1967,937,1551,753,416,184,184,753,184,101,308,120,258,101,0,0,41,18,9,19,19,36,17
S02001356,Lunan,Middle Super Output Areas and Intermediate Zones,MSOAIZ,DD,2918,1321,1982,876,889,464,1092,411,1,1,407,200,239,126,168,74,74,126,74,176,443,203,390,176,12,6,36,17,5,27,27,86,42
S02001357,Montrose South,Middle Super Output Areas and Intermediate Zones,MSOAIZ,DD,5583,2930,2921,1419,1254,734,1646,674,21,11,1679,958,1232,666,447,292,292,666,292,461,922,515,821,461,11,6,77,42,13,54,54,61,38
S02001358,Montrose North,Middle Super Output Areas and Intermediate Zones,MSOAIZ,DD,4792,2241,3294,1426,1295,697,1978,721,21,8,1028,577,807,473,221,104,104,473,104,195,422,210,395,195,2,1,25,14,0,15,15,48,28
S02001359,Hillside,Middle Super Output Areas and Intermediate Zones,MSOAIZ,DD,3509,1441,2654,1090,1101,561,1531,520,22,9,448,179,213,99,235,80,80,99,80,140,374,156,336,140,2,1,33,12,3,16,16,33,16
S02001360,Friockheim,Middle Super Output Areas and Intermediate Zones,MSOAIZ,DD,3509,1462,2428,983,1049,498,1374,483,5,2,218,114,174,92,44,22,22,92,22,261,678,286,622,261,25,8,29,15,2,25,25,185,79
S02001361,Brechin East,Middle Super Output Areas and Intermediate Zones,MSOAIZ,DD,3570,1721,1653,720,612,339,1033,377,8,4,1453,766,1096,615,357,151,151,615,151,190,413,210,378,190,4,2,29,16,2,20,20,51,25
S02001362,Brechin West,Middle Super Output Areas and Intermediate Zones,MSOAIZ,DD,3837,1821,2745,1262,1141,650,1601,609,3,3,587,315,439,238,148,77,77,238,77,204,468,221,438,204,0,0,28,16,2,17,17,37,23
S02001363,Letham and Glamis,Middle Super Output Areas and Intermediate Zones,MSOAIZ,DD,5328,2306,3895,1616,1811,884,2069,726,15,6,413,227,305,185,108,42,42,185,42,336,830,377,749,336,19,11,47,24,15,41,41,190,86
S02001364,Forfar East,Middle Super Output Areas and Intermediate Zones,MSOAIZ,DD,4081,1839,3030,1330,1338,724,1666,592,26,14,651,300,186,112,465,188,188,112,188,152,343,175,296,152,10,6,35,16,2,23,23,57,34
S02001365,Forfar Central,Middle Super Output Areas and Intermediate Zones,MSOAIZ,DD,4700,2302,2226,1012,827,465,1393,544,6,3,1770,963,1393,754,377,209,209,754,209,263,643,293,584,263,16,8,41,20,2,30,30,61,34
S02001366,Forfar West,Middle Super Output Areas and Intermediate Zones,MSOAIZ,DD,4958,2252,3315,1398,1287,669,2018,725,10,4,1358,722,1195,625,163,97,97,625,97,96,245,106,223,96,3,1,19,9,0,10,10,40,26
S02001367,Kirriemuir Landward,Middle Super Output Areas and Intermediate Zones,MSOAIZ,PH,2778,1205,1744,737,855,429,889,308,0,0,256,127,149,77,107,50,50,77,50,252,633,275,585,252,8,5,23,13,17,23,23,145,66
S02001368,Kirriemuir,Middle Super Output Areas and Intermediate Zones,MSOAIZ,DD,6014,2783,4253,1856,1819,977,2422,871,12,8,1206,635,1013,522,193,113,113,522,113,216,497,258,428,216,9,4,54,33,6,42,42,58,34
S02001369,Angus Glens,Middle Super Output Areas and Intermediate Zones,MSOAIZ,PH,3541,1548,2210,935,1091,546,1111,386,8,3,297,143,197,100,100,43,43,100,43,324,778,350,731,324,25,12,19,12,3,26,26,256,120
S02001370,Mull; Iona; Coll and Tiree,Middle Super Output Areas and Intermediate Zones,MSOAIZ,PA,3709,1754,2536,1169,1479,778,1053,389,4,2,471,247,0,0,471,247,247,0,247,217,585,279,451,217,41,22,70,33,23,62,62,117,59
S02001371,Oban South,Middle Super Output Areas and Intermediate Zones,MSOAIZ,PA,5707,2597,3467,1512,1264,685,2142,797,61,30,1615,759,0,0,1615,759,759,0,759,259,582,293,502,259,26,8,39,21,15,34,34,43,33
S02001372,Oban North,Middle Super Output Areas and Intermediate Zones,MSOAIZ,PA,2661,1316,1718,815,711,401,997,411,10,3,509,264,0,0,509,264,264,0,264,197,372,206,353,197,12,5,7,4,0,9,9,62,31
S02001373,Benderloch Trail,Middle Super Output Areas and Intermediate Zones,MSOAIZ,PA,5174,2251,3810,1616,1886,972,1911,637,13,7,584,278,0,0,584,278,278,0,278,234,629,285,522,234,40,18,53,28,14,51,51,151,72
S02001374,Loch Awe,Middle Super Output Areas and Intermediate Zones,MSOAIZ,PA,2166,996,1517,722,925,497,584,220,8,5,238,92,0,0,238,92,92,0,92,130,324,147,286,130,20,8,11,7,7,17,17,87,35
S02001375,Mid Argyll,Middle Super Output Areas and Intermediate Zones,MSOAIZ,PA,3104,1426,2271,1016,1110,592,1141,413,20,11,353,172,0,0,353,172,172,0,172,164,403,196,343,164,24,9,31,21,5,32,32,77,42
S02001376,Greater Lochgilphead,Middle Super Output Areas and Intermediate Zones,MSOAIZ,PA,3769,1792,2512,1130,997,552,1479,556,36,22,912,473,0,0,912,473,473,0,473,133,291,157,250,133,12,6,28,17,1,24,24,54,32
S02001377,Knapdale,Middle Super Output Areas and Intermediate Zones,MSOAIZ,PA,2507,1227,1775,851,1030,541,730,304,15,6,320,173,0,0,320,173,173,0,173,115,301,156,217,115,31,12,42,21,11,41,41,111,47
S02001378,Whisky Isles,Middle Super Output Areas and Intermediate Zones,MSOAIZ,PA,3522,1646,2073,941,1214,623,855,316,4,2,784,394,0,0,784,394,394,0,394,172,493,226,350,172,75,28,59,22,9,54,54,172,85
S02001379,Kintyre Trail,Middle Super Output Areas and Intermediate Zones,MSOAIZ,PA,2959,1327,2090,917,1251,622,839,295,0,0,466,215,0,0,466,215,215,0,215,137,325,154,280,137,2,1,39,13,4,17,17,78,41
S02001380,Campbeltown,Middle Super Output Areas and Intermediate Zones,MSOAIZ,PA,4857,2456,2798,1305,1352,756,1442,545,4,4,1590,855,0,0,1590,855,855,0,855,218,404,257,326,218,11,2,50,30,17,39,39,65,39
S02001381,Bute,Middle Super Output Areas and Intermediate Zones,MSOAIZ,PA,2646,1328,1934,939,1144,651,786,285,4,3,227,144,0,0,227,144,144,0,144,193,440,215,396,193,15,7,20,10,9,22,22,45,30
S02001382,Rothesay Town,Middle Super Output Areas and Intermediate Zones,MSOAIZ,PA,3777,2059,1878,912,964,547,878,349,36,16,1434,863,0,0,1434,863,863,0,863,222,425,256,366,222,17,4,34,23,8,34,34,40,28
S02001383,Cowal South,Middle Super Output Areas and Intermediate Zones,MSOAIZ,PA,2566,1270,1936,954,1192,648,743,305,1,1,253,122,0,0,253,122,122,0,122,123,290,148,242,123,10,6,28,14,10,25,25,87,46
S02001384,Cowal North,Middle Super Output Areas and Intermediate Zones,MSOAIZ,PA,3266,1570,2504,1185,1349,736,1132,438,23,11,339,175,0,0,339,175,175,0,175,152,358,182,300,152,31,14,16,9,11,30,30,65,28
S02001385,Hunter's Quay,Middle Super Output Areas and Intermediate Zones,MSOAIZ,PA,5072,2402,3492,1622,1671,945,1794,667,27,10,1047,532,0,0,1047,532,532,0,532,204,490,225,446,204,7,2,29,15,8,21,21,43,23
S02001386,Dunoon,Middle Super Output Areas and Intermediate Zones,MSOAIZ,PA,4616,2265,3100,1399,1271,722,1791,662,38,15,813,502,0,0,813,502,502,0,502,276,647,333,551,276,18,9,64,40,14,57,57,56,31
S02001387,Garelochhead,Middle Super Output Areas and Intermediate Zones,MSOAIZ,G,4721,2060,3626,1560,1384,730,2239,828,3,2,739,334,0,0,739,334,334,0,334,105,297,137,228,105,29,11,32,18,8,32,32,59,29
S02001388,Helensburgh West and Rhu,Middle Super Output Areas and Intermediate Zones,MSOAIZ,G,4294,1894,3502,1551,1559,839,1941,711,2,1,272,122,0,0,272,122,122,0,122,143,498,210,288,143,126,39,22,12,62,67,67,22,11
S02001389,Helensburgh North,Middle Super Output Areas and Intermediate Zones,MSOAIZ,G,4289,1667,3136,1236,1309,645,1823,590,4,1,435,188,0,0,435,188,188,0,188,88,685,229,237,88,298,87,29,12,121,141,141,33,14
S02001390,Helensburgh Centre,Middle Super Output Areas and Intermediate Zones,MSOAIZ,G,3145,1771,2191,1174,954,616,1230,554,7,4,259,173,0,0,259,173,173,0,173,356,657,393,585,356,7,3,49,30,16,37,37,38,31
S02001391,Helensburgh East,Middle Super Output Areas and Intermediate Zones,MSOAIZ,G,4155,1758,2714,1133,870,503,1839,628,5,2,802,388,0,0,802,388,388,0,388,111,612,223,251,111,225,66,28,12,108,112,112,27,14
S02001392,Lomond Shore,Middle Super Output Areas and Intermediate Zones,MSOAIZ,G,3012,1293,2437,1019,999,502,1438,517,0,0,252,121,0,0,252,121,121,0,121,107,261,121,232,107,9,2,15,11,5,14,14,62,32
S02001393,Tullibody South,Middle Super Output Areas and Intermediate Zones,MSOAIZ,FK,4349,1852,2867,1157,776,401,2090,755,1,1,1164,559,745,358,419,201,201,358,201,93,288,115,238,93,12,3,38,19,0,22,22,30,21
S02001394,Tullibody North and Glenochil,Middle Super Output Areas and Intermediate Zones,MSOAIZ,FK,4753,1923,2871,1169,794,409,2076,759,1,1,1508,598,370,165,1138,433,433,165,433,108,329,131,274,108,7,3,39,17,9,23,23,45,25
S02001395,Menstrie,Middle Super Output Areas and Intermediate Zones,MSOAIZ,FK,2764,1208,2240,958,764,407,1456,541,20,10,305,148,233,110,72,38,38,110,38,67,178,79,154,67,0,0,24,12,0,12,12,41,23
S02001396,Alva,Middle Super Output Areas and Intermediate Zones,MSOAIZ,FK,4770,2244,3317,1479,1292,695,2011,776,14,8,959,508,861,445,98,63,63,445,63,219,458,241,425,219,0,0,32,21,1,22,22,36,16
S02001397,Fishcross; Devon Village and Coalsnaughton,Middle Super Output Areas and Intermediate Zones,MSOAIZ,FK,2076,946,1404,615,504,263,897,350,3,2,494,237,471,228,23,9,9,228,9,67,150,77,135,67,4,2,9,7,2,10,10,28,17
S02001398,Tillicoultry,Middle Super Output Areas and Intermediate Zones,MSOAIZ,FK,4813,2307,3326,1487,1297,675,2018,804,11,8,1146,635,878,474,268,161,161,474,161,142,301,160,273,142,1,1,27,17,0,18,18,40,25
S02001399,Dollar and Muckhart,Middle Super Output Areas and Intermediate Zones,MSOAIZ,KY,3443,1489,2976,1256,1393,717,1579,535,4,4,225,124,189,103,36,21,21,103,21,76,199,84,184,76,1,1,12,6,2,8,8,43,25
S02001400,Clackmannan; Kennet and Forestmill,Middle Super Output Areas and Intermediate Zones,MSOAIZ,FK,4402,1861,3010,1223,1068,535,1934,684,8,4,1064,495,1038,483,26,12,12,483,12,112,300,126,266,112,2,1,24,10,8,14,14,28,17
S02001401,Sauchie,Middle Super Output Areas and Intermediate Zones,MSOAIZ,FK,5127,2297,2931,1225,1024,529,1901,692,6,4,1779,887,1351,692,428,195,195,692,195,147,377,161,351,147,0,0,15,9,11,14,14,40,24
S02001402,Alloa South and East,Middle Super Output Areas and Intermediate Zones,MSOAIZ,FK,4897,2394,1595,743,496,282,1077,450,22,11,2755,1338,2031,953,724,385,385,953,385,284,528,301,489,284,0,0,28,15,11,17,17,19,12
S02001403,Alloa North,Middle Super Output Areas and Intermediate Zones,MSOAIZ,FK,5598,2614,3740,1623,1198,650,2525,964,17,9,1361,744,1115,601,246,143,143,601,143,196,450,220,406,196,3,1,26,17,15,24,24,47,27
S02001404,Alloa West,Middle Super Output Areas and Intermediate Zones,MSOAIZ,FK,3447,1599,2667,1171,826,464,1836,703,5,4,404,229,252,131,152,98,98,131,98,160,346,181,302,160,4,3,28,13,12,21,21,30,18
S02001405,Stranraer West,Middle Super Output Areas and Intermediate Zones,MSOAIZ,DG,3660,1746,2057,948,1045,569,1000,374,12,5,1214,607,0,0,1214,607,607,0,607,141,330,154,301,141,4,2,24,10,1,13,13,59,37
S02001406,Stranraer East,Middle Super Output Areas and Intermediate Zones,MSOAIZ,DG,2781,1387,1695,759,693,380,987,369,15,10,570,344,0,0,570,344,344,0,344,231,476,259,417,231,0,0,52,25,7,28,28,40,25
S02001407,Stranraer South,Middle Super Output Areas and Intermediate Zones,MSOAIZ,DG,3513,1538,2150,928,802,426,1303,479,45,23,1062,482,0,0,1062,482,482,0,482,97,267,107,247,97,0,0,18,9,2,10,10,34,21
S02001408,Rhins North,Middle Super Output Areas and Intermediate Zones,MSOAIZ,DG,3820,1734,2652,1162,1528,758,1110,395,14,9,418,216,0,0,418,216,216,0,216,238,589,275,511,238,29,10,35,21,14,37,37,161,81
S02001409,Rhins South,Middle Super Output Areas and Intermediate Zones,MSOAIZ,DG,2123,971,1234,549,757,374,469,170,8,5,370,183,0,0,370,183,183,0,183,178,421,197,384,178,5,3,32,16,0,19,19,98,42
S02001410,Machars North,Middle Super Output Areas and Intermediate Zones,MSOAIZ,DG,2671,1230,1716,776,1036,534,679,241,1,1,376,190,0,0,376,190,190,0,190,191,488,224,420,191,10,6,49,23,9,33,33,91,40
S02001411,Machars South,Middle Super Output Areas and Intermediate Zones,MSOAIZ,DG,5109,2371,3271,1519,2227,1117,1025,395,19,7,957,445,0,0,957,445,445,0,445,279,651,311,582,279,18,7,42,20,9,32,32,230,96
S02001412,Newton Stewart,Middle Super Output Areas and Intermediate Zones,MSOAIZ,DG,5412,2492,3454,1557,1783,959,1656,591,15,7,1085,520,0,0,1085,520,520,0,520,309,756,362,645,309,27,10,70,34,14,53,53,117,53
S02001413,Gatehouse,Middle Super Output Areas and Intermediate Zones,MSOAIZ,DG,3324,1529,2195,1012,1318,686,858,316,19,10,385,181,0,0,385,181,181,0,181,202,531,240,441,202,48,13,37,21,5,38,38,213,96
S02001414,Kirkcudbright,Middle Super Output Areas and Intermediate Zones,MSOAIZ,DG,5263,2436,3334,1518,1899,1006,1431,509,4,3,765,404,0,0,765,404,404,0,404,352,906,405,790,352,36,12,55,29,25,53,53,258,109
S02001415,Castle Douglas,Middle Super Output Areas and Intermediate Zones,MSOAIZ,DG,4833,2247,3037,1367,1670,875,1358,486,9,6,1039,527,0,0,1039,527,527,0,527,249,647,298,531,249,19,6,86,40,11,49,49,110,55
S02001416,Dalbeattie,Middle Super Output Areas and Intermediate Zones,MSOAIZ,DG,4172,2015,2939,1362,1475,818,1457,539,7,5,767,415,0,0,767,415,415,0,415,169,417,203,348,169,3,2,61,28,5,34,34,49,35
S02001417,Dalbeattie Rural,Middle Super Output Areas and Intermediate Zones,MSOAIZ,DG,2420,1078,1897,847,1165,589,721,251,11,7,85,52,0,0,85,52,52,0,52,111,297,127,259,111,16,5,21,10,1,16,16,141,52
S02001418,Glenkens,Middle Super Output Areas and Intermediate Zones,MSOAIZ,DG,3643,1685,2475,1121,1465,754,993,358,17,9,413,200,0,0,413,200,200,0,200,233,573,276,487,233,26,14,51,25,9,43,43,182,88
S02001419,Upper Nithsdale,Middle Super Output Areas and Intermediate Zones,MSOAIZ,ML,4756,2130,2624,1111,1210,624,1412,486,2,1,1723,842,0,0,1723,842,842,0,842,115,331,140,268,115,5,4,53,17,5,25,25,78,37
S02001420,Thornhill,Middle Super Output Areas and Intermediate Zones,MSOAIZ,ML,4101,1866,2496,1132,1316,708,1177,423,3,1,541,284,0,0,541,284,284,0,284,304,811,337,725,304,47,15,30,14,9,33,33,253,113
S02001421,Mid Nithsdale,Middle Super Output Areas and Intermediate Zones,MSOAIZ,DG,4460,1864,3024,1251,1597,760,1423,489,4,2,387,163,0,0,387,163,163,0,163,316,823,353,737,316,29,11,50,21,7,37,37,226,97
S02001422,Shawhead,Middle Super Output Areas and Intermediate Zones,MSOAIZ,DG,2996,1234,2197,917,854,436,1334,476,9,5,364,146,0,0,364,146,146,0,146,125,353,138,317,125,6,1,22,10,8,13,13,82,33
S02001423,Lochside and Lincluden,Middle Super Output Areas and Intermediate Zones,MSOAIZ,DG,5956,2651,2524,1099,935,510,1570,581,19,8,3010,1368,0,0,3010,1368,1368,0,1368,135,405,172,316,135,2,1,71,30,16,37,37,17,12
S02001424,Summerville,Middle Super Output Areas and Intermediate Zones,MSOAIZ,DG,4719,2204,2654,1198,1126,625,1523,570,5,3,1638,780,0,0,1638,780,780,0,780,172,374,190,339,172,2,1,33,17,0,18,18,53,36
S02001425,Troqueer,Middle Super Output Areas and Intermediate Zones,MSOAIZ,DG,3524,1682,2528,1175,1142,656,1371,507,15,12,435,209,0,0,435,209,209,0,209,247,534,278,482,247,1,1,45,26,6,31,31,27,20
S02001426,New Abbey,Middle Super Output Areas and Intermediate Zones,MSOAIZ,DG,3373,1505,2493,1085,1191,626,1298,457,4,2,309,151,0,0,309,151,151,0,151,201,476,225,436,201,15,8,25,16,0,24,24,95,44
S02001427,Kingholm,Middle Super Output Areas and Intermediate Zones,MSOAIZ,DG,3118,1391,2212,938,983,496,1205,423,24,19,313,180,0,0,313,180,180,0,180,201,497,225,447,201,5,2,36,17,9,24,24,96,48
S02001428,Calside,Middle Super Output Areas and Intermediate Zones,MSOAIZ,DG,2950,1267,2614,1109,1045,525,1536,567,33,17,82,37,0,0,82,37,37,0,37,101,242,114,205,101,5,1,27,11,5,13,13,12,7
S02001429,Georgetown,Middle Super Output Areas and Intermediate Zones,MSOAIZ,DG,2875,1280,2573,1129,1155,604,1416,524,2,1,23,11,0,0,23,11,11,0,11,94,247,121,204,94,0,0,39,24,4,27,27,32,19
S02001430,Dumfries Central,Middle Super Output Areas and Intermediate Zones,MSOAIZ,DG,3327,1849,1462,768,668,401,744,331,50,36,1057,641,0,0,1057,641,641,0,641,388,775,417,714,388,3,2,52,22,6,29,29,33,23
S02001431,Nunholm,Middle Super Output Areas and Intermediate Zones,MSOAIZ,DG,3389,1584,2583,1159,1061,584,1515,570,7,5,291,173,0,0,291,173,173,0,173,208,488,233,434,208,7,2,41,20,6,25,25,27,19
S02001432,Locharbriggs,Middle Super Output Areas and Intermediate Zones,MSOAIZ,DG,3021,1370,2192,989,919,522,1263,460,10,7,556,265,0,0,556,265,265,0,265,93,248,102,230,93,0,0,18,9,0,9,9,25,14
S02001433,Heathhall,Middle Super Output Areas and Intermediate Zones,MSOAIZ,DG,3009,1267,2470,1027,807,430,1651,592,12,5,131,71,0,0,131,71,71,0,71,137,367,153,329,137,6,2,32,14,0,16,16,41,16
S02001434,Collin,Middle Super Output Areas and Intermediate Zones,MSOAIZ,DG,2765,1189,2284,972,1029,525,1246,441,9,6,102,60,0,0,102,60,60,0,60,108,314,130,261,108,6,2,36,15,11,22,22,65,27
S02001435,Lochmaben,Middle Super Output Areas and Intermediate Zones,MSOAIZ,DG,3132,1388,2191,950,1132,570,1044,372,15,8,487,234,0,0,487,234,234,0,234,144,395,167,342,144,5,3,37,15,11,23,23,59,37
S02001436,Lockerbie,Middle Super Output Areas and Intermediate Zones,MSOAIZ,DG,4924,2267,3082,1397,1372,769,1701,625,9,3,1052,511,0,0,1052,511,511,0,511,274,708,313,616,274,26,12,43,19,23,39,39,82,46
S02001437,Moffat,Middle Super Output Areas and Intermediate Zones,MSOAIZ,DG,3913,1811,2675,1211,1412,741,1246,461,17,9,675,329,0,0,675,329,329,0,329,213,508,244,449,213,18,7,25,14,16,31,31,55,27
S02001438,Langholm and Eskdale,Middle Super Output Areas and Intermediate Zones,MSOAIZ,DG,3844,1826,2472,1111,1296,672,1163,432,13,7,380,216,0,0,380,216,216,0,216,380,852,423,760,380,26,11,51,27,15,43,43,140,76
S02001439,Annandale East,Middle Super Output Areas and Intermediate Zones,MSOAIZ,DG,3889,1668,2526,1061,1297,628,1229,433,0,0,538,256,0,0,538,256,256,0,256,261,685,290,625,261,16,6,36,18,8,29,29,140,61
S02001440,Annandale West,Middle Super Output Areas and Intermediate Zones,MSOAIZ,DG,2601,1131,1509,640,844,414,661,224,4,2,205,91,0,0,205,91,91,0,91,333,786,353,745,333,18,6,19,11,4,20,20,101,47
S02001441,Annan West,Middle Super Output Areas and Intermediate Zones,MSOAIZ,DG,3252,1607,1995,916,914,509,1075,405,6,2,794,456,0,0,794,456,456,0,456,176,410,200,360,176,0,0,50,24,0,24,24,53,35
S02001442,Annan East,Middle Super Output Areas and Intermediate Zones,MSOAIZ,DG,5580,2363,3614,1477,1484,746,2103,719,27,12,1444,660,0,0,1444,660,660,0,660,165,458,192,405,165,10,4,40,22,3,27,27,64,34
S02001443,Eastriggs,Middle Super Output Areas and Intermediate Zones,MSOAIZ,DG,2995,1320,2451,1046,1190,597,1256,447,5,2,283,148,0,0,283,148,148,0,148,91,221,104,189,91,4,1,19,9,9,13,13,40,22
S02001444,Gretna,Middle Super Output Areas and Intermediate Zones,MSOAIZ,DG,4128,1807,3078,1320,1409,747,1661,567,8,6,644,308,0,0,644,308,308,0,308,108,327,138,253,108,5,3,62,24,7,30,30,79,41
S02001445,Westend,Middle Super Output Areas and Intermediate Zones,MSOAIZ,DD,5551,2573,3826,1703,1874,983,1934,713,18,7,189,107,46,22,143,85,85,22,85,682,1473,726,1382,682,24,10,62,32,5,44,44,63,37
S02001446,Perth Road,Middle Super Output Areas and Intermediate Zones,MSOAIZ,DD,4944,2500,952,474,324,182,580,273,48,19,1072,676,71,39,1001,637,637,39,637,1239,2879,1320,2678,1239,3,1,167,70,31,81,81,41,30
S02001447,Logie and Blackness,Middle Super Output Areas and Intermediate Zones,MSOAIZ,DD,5546,3152,1906,1017,754,448,1114,551,38,18,1196,774,609,435,587,339,339,435,339,1259,2402,1331,2270,1259,4,2,117,63,11,72,72,42,30
S02001448,City Centre,Middle Super Output Areas and Intermediate Zones,MSOAIZ,DD,4080,2131,1070,518,406,226,639,282,25,10,993,667,729,487,264,180,180,487,180,899,1992,933,1929,899,0,0,63,34,0,34,34,25,13
S02001449,Docks and Wellgate,Middle Super Output Areas and Intermediate Zones,MSOAIZ,DD,4925,2663,1363,726,429,261,895,447,39,18,1383,831,358,190,1025,641,641,190,641,1006,2125,1068,1995,1006,4,1,123,60,3,62,62,54,38
S02001450,Hilltown,Middle Super Output Areas and Intermediate Zones,MSOAIZ,DD,4766,2871,1508,822,448,283,1015,518,45,21,1697,1117,878,634,819,483,483,634,483,853,1529,902,1452,853,3,2,62,41,12,49,49,32,30
S02001451,The Glens,Middle Super Output Areas and Intermediate Zones,MSOAIZ,DD,4643,2847,1687,997,691,449,978,539,18,9,1713,1115,1337,926,376,189,189,926,189,657,1220,718,1110,657,0,0,97,53,13,61,61,23,17
S02001452,Stobswell,Middle Super Output Areas and Intermediate Zones,MSOAIZ,DD,5429,3131,1567,855,432,267,1093,571,42,17,1317,827,298,188,1019,639,639,188,639,1339,2507,1422,2373,1339,0,0,117,69,17,83,83,38,27
S02001453,Baxter Park,Middle Super Output Areas and Intermediate Zones,MSOAIZ,DD,3224,1390,2653,1123,1114,575,1515,540,24,8,145,65,57,27,88,38,38,27,38,160,379,181,340,160,4,1,26,16,9,21,21,47,21
S02001454,Craigie and  Craigiebank,Middle Super Output Areas and Intermediate Zones,MSOAIZ,DD,4301,2287,2694,1310,1232,725,1448,574,14,11,1004,679,630,471,374,208,208,471,208,248,572,275,513,248,0,0,59,27,0,27,27,31,23
S02001455,Douglas West,Middle Super Output Areas and Intermediate Zones,MSOAIZ,DD,4426,2258,2037,937,629,360,1407,576,1,1,1938,1120,1793,1036,145,84,84,1036,84,163,408,179,379,163,0,0,25,12,4,16,16,43,22
S02001456,West Ferry,Middle Super Output Areas and Intermediate Zones,MSOAIZ,DD,2929,1332,2596,1195,1304,732,1252,433,40,30,92,50,30,8,62,42,42,8,42,66,224,78,172,66,0,0,51,11,1,12,12,17,9
S02001457,Douglas East,Middle Super Output Areas and Intermediate Zones,MSOAIZ,DD,2925,1370,1364,616,496,284,866,331,2,1,1324,657,1245,628,79,29,29,628,29,80,226,91,198,80,0,0,28,11,0,11,11,11,6
S02001458,Broughty Ferry West,Middle Super Output Areas and Intermediate Zones,MSOAIZ,DD,4888,2576,3665,1812,1937,1112,1721,696,7,4,209,151,60,41,149,110,110,41,110,531,962,577,891,531,4,2,66,43,1,46,46,52,36
S02001459,Broughty Ferry East,Middle Super Output Areas and Intermediate Zones,MSOAIZ,DD,3782,1727,3297,1429,1444,784,1852,644,1,1,264,196,244,186,20,10,10,186,10,71,198,87,167,71,0,0,27,14,4,16,16,23,15
S02001460,Barnhill,Middle Super Output Areas and Intermediate Zones,MSOAIZ,DD,4325,2094,3465,1598,1642,909,1822,688,1,1,365,244,204,137,161,107,107,137,107,202,457,231,406,202,0,0,39,20,12,29,29,38,21
S02001461,West Pitkerro,Middle Super Output Areas and Intermediate Zones,MSOAIZ,DD,6309,2443,5620,2140,1138,564,4476,1572,6,4,226,96,42,24,184,72,72,24,72,158,421,185,372,158,0,0,47,26,2,27,27,42,22
S02001462,Whitfield,Middle Super Output Areas and Intermediate Zones,MSOAIZ,DD,6261,2635,2032,885,659,371,1326,498,47,16,3715,1532,846,449,2869,1083,1083,449,1083,181,496,209,440,181,0,0,47,22,9,28,28,18,9
S02001463,Fintry,Middle Super Output Areas and Intermediate Zones,MSOAIZ,DD,6012,2480,3791,1475,1015,512,2773,962,3,1,1658,797,520,276,1138,521,521,276,521,170,548,200,478,170,0,0,70,30,0,30,30,15,8
S02001464,Linlathen and Midcraigie,Middle Super Output Areas and Intermediate Zones,MSOAIZ,DD,5161,2238,1962,820,558,284,1398,532,6,4,2784,1260,1865,857,919,403,403,857,403,136,404,152,370,136,2,1,23,11,9,16,16,11,6
S02001465,Caird Park,Middle Super Output Areas and Intermediate Zones,MSOAIZ,DD,3357,1329,2423,953,724,370,1699,583,0,0,724,300,585,248,139,52,52,248,52,61,197,71,181,61,2,1,14,9,0,10,10,13,5
S02001466,Kirkton,Middle Super Output Areas and Intermediate Zones,MSOAIZ,DD,3941,1531,2210,881,723,374,1483,506,4,1,1491,566,1128,431,363,135,135,431,135,59,222,72,193,59,3,1,26,12,0,13,13,18,12
S02001467,Downfield,Middle Super Output Areas and Intermediate Zones,MSOAIZ,DD,4914,2148,3901,1685,1522,814,2376,869,3,2,647,301,544,245,103,56,56,245,56,134,358,155,317,134,0,0,38,20,3,21,21,8,7
S02001468,Fairmuir,Middle Super Output Areas and Intermediate Zones,MSOAIZ,DD,3592,1681,2643,1172,1031,567,1554,579,58,26,579,307,257,154,322,153,153,154,153,152,326,174,287,152,2,1,34,19,3,22,22,44,28
S02001469,Law,Middle Super Output Areas and Intermediate Zones,MSOAIZ,DD,4735,2827,2222,1216,1070,650,1126,556,26,10,1754,1180,1308,929,446,251,251,929,251,354,714,397,634,354,9,3,68,38,3,43,43,45,34
S02001470,Balgay,Middle Super Output Areas and Intermediate Zones,MSOAIZ,DD,3582,1775,2685,1274,1155,653,1487,590,43,31,466,295,396,253,70,42,42,253,42,168,404,191,363,168,0,0,41,23,0,23,23,27,15
S02001471,Menzieshill,Middle Super Output Areas and Intermediate Zones,MSOAIZ,DD,4411,2312,1958,945,717,430,1239,513,2,2,1735,1038,1613,981,122,57,57,981,57,277,693,310,625,277,4,3,61,28,3,33,33,25,19
S02001472,Charleston,Middle Super Output Areas and Intermediate Zones,MSOAIZ,DD,4317,2061,1825,848,633,362,1184,480,8,6,2083,1033,1777,894,306,139,139,894,139,140,380,163,336,140,2,1,40,20,2,23,23,29,17
S02001473,Lochee,Middle Super Output Areas and Intermediate Zones,MSOAIZ,DD,5439,2747,2557,1157,1059,580,1483,573,15,4,2316,1305,1744,969,572,336,336,969,336,239,544,272,475,239,2,2,48,19,19,33,33,22,13
S02001474,Ardler and St Marys,Middle Super Output Areas and Intermediate Zones,MSOAIZ,DD,5884,2738,2565,1119,777,453,1756,647,32,19,2975,1471,1296,631,1679,840,840,631,840,119,331,139,291,119,0,0,34,16,6,20,20,13,9
S02001475,Western Edge,Middle Super Output Areas and Intermediate Zones,MSOAIZ,DD,3502,1346,3091,1183,847,407,2237,773,7,3,98,40,71,30,27,10,10,30,10,103,296,112,271,103,7,2,18,7,0,9,9,17,11
S02001476,Doon Valley South,Middle Super Output Areas and Intermediate Zones,MSOAIZ,KA,3241,1468,1580,672,665,325,914,346,1,1,1409,682,1204,578,205,104,104,578,104,76,219,99,168,76,6,2,22,13,23,23,23,33,15
S02001477,Doon Valley North,Middle Super Output Areas and Intermediate Zones,MSOAIZ,KA,4052,1777,2528,1071,866,444,1661,626,1,1,1302,612,975,482,327,130,130,482,130,72,192,79,171,72,3,1,6,3,12,7,7,30,15
S02001478,Mauchline Rural,Middle Super Output Areas and Intermediate Zones,MSOAIZ,KA,5147,2257,3432,1403,1329,638,2096,761,7,4,1187,613,1029,535,158,78,78,535,78,190,448,207,416,190,3,1,27,15,2,17,17,80,34
S02001479,Drongan,Middle Super Output Areas and Intermediate Zones,MSOAIZ,KA,3205,1363,1947,797,619,313,1326,483,2,1,1117,503,661,325,456,178,178,325,178,45,131,56,109,45,1,1,16,8,5,11,11,10,7
S02001480,Mauchline,Middle Super Output Areas and Intermediate Zones,MSOAIZ,KA,4082,1786,2979,1248,1142,588,1831,657,6,3,675,349,544,278,131,71,71,278,71,149,395,167,353,149,3,2,32,12,7,18,18,33,22
S02001481,Cumnock Rural,Middle Super Output Areas and Intermediate Zones,MSOAIZ,KA,4809,2053,2895,1174,1324,624,1568,547,3,3,1327,631,1111,550,216,81,81,550,81,193,505,211,458,193,21,5,17,9,9,18,18,82,37
S02001482,New Cumnock,Middle Super Output Areas and Intermediate Zones,MSOAIZ,KA,2860,1347,1576,696,651,348,923,346,2,2,1093,576,804,452,289,124,124,452,124,63,173,67,164,63,0,0,9,4,0,4,4,18,8
S02001483,Cumnock South and Craigens,Middle Super Output Areas and Intermediate Zones,MSOAIZ,KA,5072,2233,2963,1224,974,508,1989,716,0,0,1678,830,1057,547,621,283,283,547,283,155,404,167,382,155,0,0,19,9,3,12,12,27,12
S02001484,Cumnock North,Middle Super Output Areas and Intermediate Zones,MSOAIZ,KA,3911,1762,2890,1215,1053,548,1830,662,7,5,771,427,706,377,65,50,50,377,50,91,215,99,196,91,0,0,17,6,2,8,8,35,21
S02001485,Auchinleck,Middle Super Output Areas and Intermediate Zones,MSOAIZ,KA,3741,1650,2046,862,731,379,1312,481,3,2,1438,677,1354,642,84,35,35,642,35,85,239,100,216,85,3,1,19,13,1,15,15,18,11
S02001486,Northern and Irvine Valley Rural,Middle Super Output Areas and Intermediate Zones,MSOAIZ,KA,5001,1971,4151,1598,1618,747,2525,849,8,2,479,216,418,183,61,33,33,183,33,110,299,131,255,110,9,4,32,16,3,21,21,72,26
S02001487,Stewarton East,Middle Super Output Areas and Intermediate Zones,MSOAIZ,KA,4236,1813,3373,1346,1089,561,2284,785,0,0,407,243,301,176,106,67,67,176,67,184,433,210,383,184,1,1,47,24,2,26,26,23,14
S02001488,Stewarton West,Middle Super Output Areas and Intermediate Zones,MSOAIZ,KA,2695,1219,1871,810,657,348,1212,460,2,2,599,298,553,275,46,23,23,275,23,88,200,94,181,88,0,0,17,5,2,6,6,25,17
S02001489,Darvel,Middle Super Output Areas and Intermediate Zones,MSOAIZ,KA,3770,1722,2778,1181,917,501,1861,680,0,0,603,360,568,342,35,18,18,342,18,145,332,153,317,145,0,0,14,7,1,8,8,57,28
S02001490,Newmilns,Middle Super Output Areas and Intermediate Zones,MSOAIZ,KA,3046,1470,1958,852,743,399,1215,453,0,0,815,463,698,386,117,77,77,386,77,127,254,143,227,127,0,0,23,12,4,16,16,19,12
S02001491,Galston,Middle Super Output Areas and Intermediate Zones,MSOAIZ,KA,4670,2139,3176,1368,1038,552,2129,813,9,3,1118,588,938,515,180,73,73,515,73,142,335,155,305,142,0,0,23,11,7,13,13,41,28
S02001492,Earlston and Hurlford Rural,Middle Super Output Areas and Intermediate Zones,MSOAIZ,KA,5475,2411,3374,1420,1163,583,2211,837,0,0,1701,808,1586,738,115,70,70,738,70,132,320,150,287,132,0,0,31,17,2,18,18,80,33
S02001493,Shortlees,Middle Super Output Areas and Intermediate Zones,MSOAIZ,KA,4583,1926,1704,725,501,265,1202,459,1,1,2540,1078,1417,621,1123,457,457,621,457,100,328,114,303,100,1,1,13,7,11,14,14,11,9
S02001494,Bellfield and Kirkstyle,Middle Super Output Areas and Intermediate Zones,MSOAIZ,KA,4338,2041,2689,1182,816,437,1872,744,1,1,1359,712,1256,656,103,56,56,656,56,107,258,124,228,107,0,0,27,15,3,17,17,32,23
S02001495,Kilmarnock South Central and Caprington,Middle Super Output Areas and Intermediate Zones,MSOAIZ,KA,2958,1561,1904,912,728,411,1175,500,1,1,794,493,767,482,27,11,11,482,11,126,238,139,220,126,0,0,16,11,2,13,13,22,17
S02001496,Piersland,Middle Super Output Areas and Intermediate Zones,MSOAIZ,KA,3281,1612,2543,1192,950,519,1590,671,3,2,342,206,271,154,71,52,52,154,52,184,374,197,351,184,3,1,18,11,2,13,13,22,17
S02001497,New Farm Loch South,Middle Super Output Areas and Intermediate Zones,MSOAIZ,KA,3039,1383,1915,828,743,397,1170,430,2,1,932,486,798,419,134,67,67,419,67,52,173,61,154,52,0,0,17,8,2,9,9,19,8
S02001498,Dean and New Farm Loch North,Middle Super Output Areas and Intermediate Zones,MSOAIZ,KA,3802,1516,2678,1056,683,343,1972,704,23,9,742,314,333,148,409,166,166,148,166,131,376,143,345,131,4,1,25,10,2,12,12,6,3
S02001499,Southcraig and Beansburn,Middle Super Output Areas and Intermediate Zones,MSOAIZ,KA,5816,2197,5312,2010,1473,702,3837,1307,2,1,180,62,139,50,41,12,12,50,12,108,315,120,284,108,0,0,31,12,0,12,12,9,5
S02001500,Altonhill North and Onthank,Middle Super Output Areas and Intermediate Zones,MSOAIZ,KA,4432,1864,1925,744,402,204,1509,534,14,6,2128,985,1921,882,207,103,103,882,103,114,356,123,306,114,5,1,14,6,31,9,9,23,12
S02001501,Altonhill South; Longpark and Hillhead,Middle Super Output Areas and Intermediate Zones,MSOAIZ,KA,4519,2247,1643,744,382,220,1261,524,0,0,2324,1228,1233,742,1091,486,486,742,486,248,538,266,505,248,3,2,19,11,11,18,18,14,9
S02001502,Bonnyton and Town Centre,Middle Super Output Areas and Intermediate Zones,MSOAIZ,KA,3544,2016,2119,1078,703,416,1409,659,7,3,669,461,658,453,11,8,8,453,8,406,721,454,646,406,2,1,69,44,4,48,48,35,23
S02001503,Grange; Howard and Gargieston,Middle Super Output Areas and Intermediate Zones,MSOAIZ,KA,5513,2267,4992,2023,1808,912,3182,1109,2,2,106,45,99,42,7,3,3,42,3,156,369,176,333,156,4,1,30,17,2,20,20,46,23
S02001504,Crosshouse; Gatehead and Kilmaurs Rural,Middle Super Output Areas and Intermediate Zones,MSOAIZ,KA,3643,1592,2735,1114,904,453,1822,658,9,3,593,314,561,292,32,22,22,292,22,113,268,138,225,113,11,6,26,14,6,25,25,47,26
S02001505,Kilmaurs,Middle Super Output Areas and Intermediate Zones,MSOAIZ,KA,2825,1256,2043,853,738,377,1304,475,1,1,604,319,553,288,51,31,31,288,31,61,158,69,145,61,1,1,12,7,0,8,8,20,15
S02001506,West Clober and Mains Estate,Middle Super Output Areas and Intermediate Zones,MSOAIZ,G,2896,1067,2707,989,907,409,1800,580,0,0,86,36,49,19,37,17,17,19,17,30,76,32,72,30,0,0,3,1,1,2,2,27,10
S02001507,East Clober and Mains Estate,Middle Super Output Areas and Intermediate Zones,MSOAIZ,G,3487,1419,2399,940,758,385,1639,554,2,1,903,400,777,331,126,69,69,331,69,55,162,65,141,55,3,1,18,9,0,10,10,23,14
S02001508,Barloch,Middle Super Output Areas and Intermediate Zones,MSOAIZ,G,3225,1463,2884,1273,1390,748,1491,523,3,2,128,74,86,57,42,17,17,57,17,87,187,99,168,87,4,1,14,10,1,12,12,26,17
S02001509,Keystone and Dougalston,Middle Super Output Areas and Intermediate Zones,MSOAIZ,G,3954,1863,3356,1502,1705,941,1644,557,7,4,348,224,311,199,37,25,25,199,25,80,186,94,165,80,2,1,19,13,0,14,14,64,43
S02001510,Kilmardinny East,Middle Super Output Areas and Intermediate Zones,MSOAIZ,G,2941,1173,2806,1113,1160,583,1646,530,0,0,31,14,29,13,2,1,1,13,1,34,87,38,80,34,0,0,7,4,0,4,4,17,8
S02001511,Kilmardinny West,Middle Super Output Areas and Intermediate Zones,MSOAIZ,G,3509,1477,3198,1285,1404,716,1785,567,9,2,156,118,118,90,38,28,28,90,28,53,127,57,118,53,2,1,7,3,0,4,4,28,17
S02001512,North Castlehill and Thorn,Middle Super Output Areas and Intermediate Zones,MSOAIZ,G,4052,1544,3833,1467,1344,668,2488,798,1,1,37,12,27,9,10,3,3,9,3,44,151,54,127,44,1,1,23,9,0,10,10,31,11
S02001513,South Castlehill and Thorn,Middle Super Output Areas and Intermediate Zones,MSOAIZ,G,4196,1608,3721,1406,1491,718,2229,687,1,1,293,127,289,124,4,3,3,124,3,55,166,67,142,55,0,0,24,12,0,12,12,16,8
S02001514,Westerton West,Middle Super Output Areas and Intermediate Zones,MSOAIZ,G,2724,1125,2576,1049,976,498,1600,551,0,0,34,24,32,23,2,1,1,23,1,43,107,47,98,43,0,0,9,4,0,4,4,7,5
S02001515,Westerton East,Middle Super Output Areas and Intermediate Zones,MSOAIZ,G,3527,1439,3283,1327,1328,678,1952,647,3,2,47,22,47,22,0,0,0,22,0,67,165,77,143,67,5,1,11,7,6,10,10,32,13
S02001516,Kessington West,Middle Super Output Areas and Intermediate Zones,MSOAIZ,G,3220,1341,3027,1257,1487,765,1537,491,3,1,39,21,37,19,2,2,2,19,2,53,141,56,136,53,0,0,5,3,0,3,3,13,7
S02001517,Kessington East,Middle Super Output Areas and Intermediate Zones,MSOAIZ,G,2845,1112,2693,1056,1188,577,1502,477,3,2,31,12,24,9,7,3,3,9,3,37,113,39,108,37,0,0,2,1,3,2,2,8,5
S02001518,Torrance and Balmore,Middle Super Output Areas and Intermediate Zones,MSOAIZ,G,2917,1110,2565,956,947,444,1614,511,4,1,168,81,152,73,16,8,8,73,8,57,161,61,151,57,8,2,2,2,0,4,4,23,12
S02001519,Bishopbriggs North and Kenmure,Middle Super Output Areas and Intermediate Zones,MSOAIZ,G,5299,2121,5003,1972,2257,1127,2742,842,4,3,79,47,66,43,13,4,4,43,4,68,182,79,164,68,4,3,14,8,0,11,11,35,23
S02001520,Bishopbriggs West and Cadder,Middle Super Output Areas and Intermediate Zones,MSOAIZ,G,5836,2471,5363,2226,2286,1177,3073,1046,4,3,93,65,43,26,50,39,39,26,39,138,348,159,317,138,0,0,26,17,5,21,21,32,21
S02001521,Auchinairn,Middle Super Output Areas and Intermediate Zones,MSOAIZ,G,4989,2208,3569,1457,957,500,2601,950,11,7,928,514,756,422,172,92,92,422,92,198,464,216,425,198,0,0,34,16,5,18,18,28,21
S02001522,Woodhill East,Middle Super Output Areas and Intermediate Zones,MSOAIZ,G,2476,892,2314,829,793,356,1521,473,0,0,41,15,27,11,14,4,4,11,4,42,116,45,111,42,0,0,5,3,0,3,3,5,3
S02001523,Woodhill West,Middle Super Output Areas and Intermediate Zones,MSOAIZ,G,4174,1660,3916,1547,1702,834,2213,712,1,1,53,21,40,16,13,5,5,16,5,73,186,80,169,73,0,0,12,5,5,7,7,19,12
S02001524,Lenzie North,Middle Super Output Areas and Intermediate Zones,MSOAIZ,G,5329,2123,4561,1791,1786,910,2774,880,1,1,530,225,502,217,28,8,8,217,8,81,214,92,194,81,0,0,17,9,3,11,11,24,15
S02001525,Lenzie South,Middle Super Output Areas and Intermediate Zones,MSOAIZ,G,3432,1358,3222,1268,1369,669,1851,598,2,1,25,7,17,5,8,2,2,5,2,66,170,77,152,66,1,1,17,10,0,11,11,15,6
S02001526,Kirkintilloch South,Middle Super Output Areas and Intermediate Zones,MSOAIZ,G,3215,1432,2391,1012,883,440,1502,570,6,2,539,261,454,225,85,36,36,225,36,137,269,148,242,137,0,0,26,10,1,11,11,16,11
S02001527,Kirkintilloch West,Middle Super Output Areas and Intermediate Zones,MSOAIZ,G,4128,1962,3032,1352,1149,615,1865,723,18,14,540,291,421,227,119,64,64,227,64,272,517,296,474,272,2,1,39,22,2,24,24,39,23
S02001528,Hillhead,Middle Super Output Areas and Intermediate Zones,MSOAIZ,G,4024,1868,1909,833,588,322,1300,499,21,12,1819,881,310,163,1509,718,718,163,718,111,272,135,234,111,5,2,17,9,16,24,24,24,19
S02001529,Rosebank and Waterside,Middle Super Output Areas and Intermediate Zones,MSOAIZ,G,3155,1268,2742,1063,991,477,1751,586,0,0,281,137,265,129,16,8,8,129,8,55,121,62,112,55,0,0,5,4,4,7,7,11,6
S02001530,Twechar and Harestanes East,Middle Super Output Areas and Intermediate Zones,MSOAIZ,G,2842,1213,1859,730,582,286,1276,443,1,1,856,420,815,404,41,16,16,404,16,43,112,54,96,43,0,0,15,10,1,11,11,15,9
S02001531,Harestanes,Middle Super Output Areas and Intermediate Zones,MSOAIZ,G,3409,1573,2269,968,677,371,1586,593,6,4,916,489,465,244,451,245,245,244,245,88,198,101,175,88,2,1,17,8,4,13,13,26,15
S02001532,Milton of Campsie,Middle Super Output Areas and Intermediate Zones,MSOAIZ,G,3958,1609,3373,1357,1247,610,2119,745,7,2,414,179,358,158,56,21,21,158,21,54,155,64,126,54,0,0,29,10,0,10,10,16,9
S02001533,Lennoxtown,Middle Super Output Areas and Intermediate Zones,MSOAIZ,G,4672,1974,3309,1339,920,464,2379,870,10,5,1069,502,912,421,157,81,81,421,81,112,261,117,252,112,5,2,4,3,0,5,5,33,16
S02001534,IZ01,Middle Super Output Areas and Intermediate Zones,MSOAIZ,EH,4981,2071,2927,1169,701,370,2203,786,23,13,1640,725,1170,520,470,205,205,520,205,144,383,161,345,144,13,3,25,14,0,17,17,31,16
S02001535,IZ02,Middle Super Output Areas and Intermediate Zones,MSOAIZ,EH,4538,2045,3501,1508,1136,618,2348,882,17,8,651,337,636,331,15,6,6,331,6,161,347,179,314,161,2,1,29,16,2,18,18,39,21
S02001536,IZ03,Middle Super Output Areas and Intermediate Zones,MSOAIZ,EH,3079,1270,2586,1028,957,485,1605,530,24,13,329,163,291,133,38,30,30,133,30,56,140,66,122,56,0,0,15,8,3,10,10,24,13
S02001537,IZ04,Middle Super Output Areas and Intermediate Zones,MSOAIZ,EH,4621,2549,2832,1510,1031,632,1731,843,70,35,911,552,684,403,227,149,149,403,149,419,832,452,776,419,11,6,45,27,0,33,33,46,35
S02001538,IZ05,Middle Super Output Areas and Intermediate Zones,MSOAIZ,EH,4403,1995,2596,1133,952,505,1628,619,16,9,1316,604,1243,568,73,36,36,568,36,214,455,235,420,214,6,3,29,18,0,21,21,36,23
S02001539,IZ06,Middle Super Output Areas and Intermediate Zones,MSOAIZ,EH,2176,908,1165,460,278,148,860,298,27,14,814,369,622,286,192,83,83,286,83,67,177,70,171,67,0,0,4,2,2,3,3,20,9
S02001540,IZ07,Middle Super Output Areas and Intermediate Zones,MSOAIZ,EH,4957,2186,2569,1134,664,367,1878,751,27,16,2057,894,1749,758,308,136,136,758,136,123,307,144,272,123,0,0,32,19,3,21,21,24,14
S02001541,IZ08,Middle Super Output Areas and Intermediate Zones,MSOAIZ,EH,4183,1841,2576,1095,652,349,1914,741,10,5,1319,621,1178,550,141,71,71,550,71,98,259,109,239,98,2,1,18,10,0,11,11,29,16
S02001542,IZ09,Middle Super Output Areas and Intermediate Zones,MSOAIZ,EH,5945,2528,4706,1918,1586,797,3108,1115,12,6,858,417,658,309,200,108,108,309,108,140,340,161,298,140,0,0,38,18,4,21,21,41,32
S02001543,IZ10,Middle Super Output Areas and Intermediate Zones,MSOAIZ,EH,6231,2595,4066,1634,1179,615,2862,1005,25,14,1751,764,1459,614,292,150,150,614,150,160,376,178,341,160,2,1,29,14,4,18,18,38,19
S02001544,IZ11,Middle Super Output Areas and Intermediate Zones,MSOAIZ,EH,5657,2332,3858,1471,766,390,3068,1064,24,17,1464,704,1074,535,390,169,169,535,169,131,304,140,291,131,0,0,11,8,2,9,9,31,17
S02001545,IZ12,Middle Super Output Areas and Intermediate Zones,MSOAIZ,EH,2925,1317,1807,783,715,378,1083,401,9,4,933,437,726,335,207,102,102,335,102,61,142,72,127,61,2,1,9,7,4,11,11,43,25
S02001546,IZ13,Middle Super Output Areas and Intermediate Zones,MSOAIZ,EH,5459,2347,4044,1660,1705,867,2339,793,0,0,873,441,790,396,83,45,45,396,45,189,454,207,414,189,2,1,21,9,17,18,18,88,39
S02001547,IZ14,Middle Super Output Areas and Intermediate Zones,MSOAIZ,TD,5557,2327,4060,1628,1796,851,2243,766,21,11,675,310,390,197,285,113,113,197,113,284,635,304,591,284,20,7,17,9,7,20,20,187,85
S02001548,IZ15,Middle Super Output Areas and Intermediate Zones,MSOAIZ,EH,4032,1683,3025,1214,1102,571,1917,640,6,3,726,344,566,272,160,72,72,272,72,87,255,110,202,87,7,3,38,17,8,23,23,26,15
S02001549,IZ16,Middle Super Output Areas and Intermediate Zones,MSOAIZ,EH,4747,2218,2802,1265,1018,565,1751,679,33,21,1365,633,1096,497,269,136,136,497,136,261,545,293,491,261,5,2,38,24,11,32,32,35,27
S02001550,IZ17,Middle Super Output Areas and Intermediate Zones,MSOAIZ,EH,4115,1867,2986,1319,1349,753,1626,562,11,4,616,299,414,214,202,85,85,214,85,185,430,207,392,185,16,7,21,14,1,22,22,83,42
S02001551,IZ18,Middle Super Output Areas and Intermediate Zones,MSOAIZ,EH,3084,1535,2475,1177,1284,744,1163,414,28,19,192,140,78,43,114,97,97,43,97,176,372,193,349,176,1,1,14,12,8,17,17,45,25
S02001552,IZ19,Middle Super Output Areas and Intermediate Zones,MSOAIZ,EH,3687,1539,2826,1146,1237,626,1589,520,0,0,497,253,482,246,15,7,7,246,7,107,318,120,290,107,0,0,28,13,0,13,13,46,20
S02001553,IZ20,Middle Super Output Areas and Intermediate Zones,MSOAIZ,TD,4864,2102,3466,1446,1478,736,1988,710,0,0,547,267,397,194,150,73,73,194,73,303,750,341,659,303,25,10,59,25,7,38,38,101,48
S02001554,IZ21,Middle Super Output Areas and Intermediate Zones,MSOAIZ,EH,4006,1730,2520,1030,865,465,1645,560,10,5,1132,542,1008,464,124,78,78,464,78,119,312,134,286,119,4,1,21,13,1,15,15,42,24
S02001555,IZ22,Middle Super Output Areas and Intermediate Zones,MSOAIZ,TD,4572,1920,3358,1346,1099,592,2231,741,28,13,766,355,517,225,249,130,130,225,130,181,412,198,368,181,15,4,28,12,1,17,17,36,21
S02001556,West Neilston and Uplawmoor,Middle Super Output Areas and Intermediate Zones,MSOAIZ,G,6414,2661,5069,1984,1740,860,3311,1119,18,5,995,508,877,447,118,61,61,447,61,131,326,156,264,131,12,4,45,19,5,25,25,24,13
S02001557,Cross Stobbs,Middle Super Output Areas and Intermediate Zones,MSOAIZ,G,3591,1492,3212,1288,1207,603,2002,683,3,2,183,111,148,96,35,15,15,96,15,75,176,82,160,75,0,0,9,5,7,7,7,20,11
S02001558,Dunterlie; East Arthurlie and Dovecothall,Middle Super Output Areas and Intermediate Zones,MSOAIZ,G,5936,2927,3073,1367,842,488,2183,859,48,20,2360,1280,1189,639,1171,641,641,639,641,230,471,265,414,230,0,0,40,25,17,35,35,32,15
S02001559,West Arthurlie and North Neilston,Middle Super Output Areas and Intermediate Zones,MSOAIZ,G,3896,1745,3086,1314,1112,604,1967,707,7,3,581,318,531,301,50,17,17,301,17,95,208,100,198,95,0,0,10,5,0,5,5,21,13
S02001560,Auchenback,Middle Super Output Areas and Intermediate Zones,MSOAIZ,G,4061,1710,2328,965,623,331,1691,629,14,5,1365,605,1044,486,321,119,119,486,119,119,353,128,333,119,3,1,16,7,1,9,9,15,12
S02001561,Crookfur and Fruin,Middle Super Output Areas and Intermediate Zones,MSOAIZ,G,5613,2222,5108,1958,1779,888,3317,1067,12,3,88,54,42,19,46,35,35,19,35,153,362,182,323,153,0,0,15,7,24,29,29,55,28
S02001562,Mearns Village; Westacres and Greenfarm,Middle Super Output Areas and Intermediate Zones,MSOAIZ,G,6211,2296,5399,1879,1345,612,4049,1264,5,3,513,304,443,258,70,46,46,258,46,85,275,100,238,85,4,1,33,14,0,15,15,24,13
S02001563,Whitecraigs and Broom,Middle Super Output Areas and Intermediate Zones,MSOAIZ,G,3659,1392,3530,1332,1583,749,1947,583,0,0,13,7,11,6,2,1,1,6,1,40,100,43,94,40,0,0,5,2,1,3,3,16,10
S02001564,Mearnskirk and South Kirkhill,Middle Super Output Areas and Intermediate Zones,MSOAIZ,G,5983,2464,5597,2268,2389,1251,3197,1011,11,6,62,43,51,39,11,4,4,39,4,108,273,121,241,108,5,2,27,11,0,13,13,51,32
S02001565,Eaglesham and Waterfoot,Middle Super Output Areas and Intermediate Zones,MSOAIZ,G,4647,1970,4087,1661,1460,753,2617,902,10,6,251,157,231,149,20,8,8,149,8,106,273,125,222,106,0,0,42,16,9,19,19,36,27
S02001566,North Kirkhill,Middle Super Output Areas and Intermediate Zones,MSOAIZ,G,3130,1339,2843,1210,1110,561,1722,642,11,7,23,14,23,14,0,0,0,14,0,99,232,100,231,99,0,0,1,1,0,1,1,32,15
S02001567,Busby,Middle Super Output Areas and Intermediate Zones,MSOAIZ,G,3502,1638,2784,1237,934,544,1846,690,4,3,476,285,455,271,21,14,14,271,14,92,217,102,198,92,0,0,18,9,1,10,10,25,14
S02001568,Clarkston and Sheddens,Middle Super Output Areas and Intermediate Zones,MSOAIZ,G,6198,2332,5897,2204,2069,1031,3824,1171,4,2,55,25,37,18,18,7,7,18,7,73,217,86,190,73,0,0,27,13,0,13,13,29,17
S02001569,Williamwood,Middle Super Output Areas and Intermediate Zones,MSOAIZ,G,2958,1102,2912,1077,951,477,1961,600,0,0,8,5,6,4,2,1,1,4,1,14,30,14,30,14,0,0,0,0,0,0,0,8,6
S02001570,Stamperland,Middle Super Output Areas and Intermediate Zones,MSOAIZ,G,3683,1460,3525,1391,1117,558,2408,833,0,0,39,21,32,16,7,5,5,16,5,35,102,41,86,35,0,0,14,5,2,6,6,17,7
S02001571,Netherlee,Middle Super Output Areas and Intermediate Zones,MSOAIZ,G,4599,1891,4342,1734,1905,989,2430,739,7,6,96,77,54,44,42,33,33,44,33,54,137,62,127,54,0,0,10,8,0,8,8,24,18
S02001572,Merrylee and Braidbar,Middle Super Output Areas and Intermediate Zones,MSOAIZ,G,4873,1998,4643,1897,2081,1081,2560,815,2,1,35,24,10,5,25,19,19,5,19,51,172,63,148,51,3,1,20,10,1,12,12,23,14
S02001573,Lower Whitecraigs and South Giffnock,Middle Super Output Areas and Intermediate Zones,MSOAIZ,G,3359,1248,3236,1192,1448,672,1788,520,0,0,25,13,10,8,15,5,5,8,5,28,80,31,74,28,2,1,4,2,0,3,3,18,12
S02001574,North Giffnock and North Thornliebank,Middle Super Output Areas and Intermediate Zones,MSOAIZ,G,3576,1659,2923,1257,1159,648,1738,592,26,17,285,215,144,104,141,111,111,104,111,146,332,167,284,146,11,4,27,12,10,21,21,36,20
S02001575,South Thornliebank and Woodfarm,Middle Super Output Areas and Intermediate Zones,MSOAIZ,G,4099,1679,3392,1309,1245,608,2137,697,10,4,439,254,333,191,106,63,63,191,63,86,233,99,206,86,9,3,18,10,0,13,13,35,17
S02001576,Balerno and Bonnington Village,Middle Super Output Areas and Intermediate Zones,MSOAIZ,EH,5771,2365,5090,2045,2129,1071,2929,947,32,27,219,126,146,78,73,48,48,78,48,141,389,157,353,141,9,4,19,8,8,16,16,73,37
S02001577,Currie West,Middle Super Output Areas and Intermediate Zones,MSOAIZ,EH,3272,1386,2810,1155,1054,561,1750,592,6,2,266,146,206,119,60,27,27,119,27,55,156,62,143,55,0,0,11,6,2,7,7,40,23
S02001578,Currie East,Middle Super Output Areas and Intermediate Zones,MSOAIZ,EH,3050,1273,2788,1142,1281,668,1507,474,0,0,158,79,71,27,87,52,52,27,52,37,88,40,79,37,4,1,4,1,1,3,3,16,12
S02001579,Baberton and Juniper Green,Middle Super Output Areas and Intermediate Zones,MSOAIZ,EH,3918,1694,3508,1483,1540,793,1965,688,3,2,154,87,85,49,69,38,38,49,38,98,230,110,209,98,8,3,13,9,0,12,12,26,14
S02001580,Bonaly and The Pentlands,Middle Super Output Areas and Intermediate Zones,MSOAIZ,EH,4273,1767,3907,1582,1698,842,2201,736,8,4,58,41,22,11,36,30,30,11,30,122,289,134,260,122,5,1,15,8,9,12,12,19,10
S02001581,Colinton and Kingsknowe,Middle Super Output Areas and Intermediate Zones,MSOAIZ,EH,3743,1587,2796,1165,1175,618,1610,539,11,8,294,198,57,23,237,175,175,23,175,90,629,213,206,90,265,71,19,11,139,123,123,24,11
S02001582,Clovenstone and Wester Hailes,Middle Super Output Areas and Intermediate Zones,MSOAIZ,EH,3186,1418,588,257,102,55,449,185,37,17,2276,1033,1116,512,1160,521,521,512,521,113,319,125,294,113,2,2,7,5,16,12,12,3,3
S02001583,The Calders,Middle Super Output Areas and Intermediate Zones,MSOAIZ,EH,4534,2203,1568,746,561,306,969,424,38,16,2321,1193,1474,835,847,358,358,835,358,227,611,245,574,227,0,0,25,15,12,18,18,34,19
S02001584,Murrayburn and Wester Hailes North,Middle Super Output Areas and Intermediate Zones,MSOAIZ,EH,3694,1915,877,422,325,186,540,231,12,5,2524,1356,2218,1230,306,126,126,1230,126,118,286,131,251,118,7,2,27,10,1,13,13,7,6
S02001585,Parkhead and Sighthill,Middle Super Output Areas and Intermediate Zones,MSOAIZ,EH,3121,1407,2229,1031,747,426,1476,601,6,4,120,48,78,33,42,15,15,33,15,297,754,315,713,297,0,0,41,18,0,18,18,18,13
S02001586,Broomhouse and Bankhead,Middle Super Output Areas and Intermediate Zones,MSOAIZ,EH,3492,1383,1477,624,424,228,1047,394,6,2,1355,556,1209,485,146,71,71,485,71,179,647,195,605,179,11,2,26,12,5,16,16,13,8
S02001587,Stenhouse and Saughton Mains,Middle Super Output Areas and Intermediate Zones,MSOAIZ,EH,5726,3070,2609,1429,966,631,1598,778,45,20,1832,1050,1368,792,464,258,258,792,258,500,1242,554,1128,500,2,1,90,44,22,54,54,43,37
S02001588,Longstone and Saughton,Middle Super Output Areas and Intermediate Zones,MSOAIZ,EH,3957,1766,2497,1102,935,505,1554,593,8,4,753,386,626,308,127,78,78,308,78,206,680,258,505,206,90,23,24,13,61,52,52,27,20
S02001589,Slateford and Chesser,Middle Super Output Areas and Intermediate Zones,MSOAIZ,EH,4817,2612,2947,1600,1086,665,1830,918,31,17,667,429,477,310,190,119,119,310,119,489,1144,545,1035,489,3,1,98,50,8,56,56,59,38
S02001590,Gorgie West,Middle Super Output Areas and Intermediate Zones,MSOAIZ,EH,4272,2609,1794,1157,448,312,1173,751,173,94,679,403,142,72,537,331,331,72,331,959,1778,1033,1653,959,7,3,102,61,16,74,74,21,16
S02001591,Gorgie East,Middle Super Output Areas and Intermediate Zones,MSOAIZ,EH,3555,2213,1162,771,268,189,842,557,52,25,580,408,58,40,522,368,368,40,368,932,1787,1018,1634,932,5,2,122,72,26,86,86,26,16
S02001592,Shandon,Middle Super Output Areas and Intermediate Zones,MSOAIZ,EH,4829,2517,3154,1673,984,609,2149,1050,21,14,115,68,19,8,96,60,60,8,60,709,1538,761,1433,709,4,1,99,50,2,52,52,22,15
S02001593,Craiglockhart,Middle Super Output Areas and Intermediate Zones,MSOAIZ,EH,4798,2074,4339,1877,1913,1018,2422,856,4,3,58,22,24,8,34,14,14,8,14,136,376,162,329,136,5,3,39,20,3,26,26,25,13
S02001594,Morningside and Craighouse,Middle Super Output Areas and Intermediate Zones,MSOAIZ,EH,4290,2127,3096,1506,1286,767,1802,733,8,6,84,56,27,20,57,36,36,20,36,488,1070,540,984,488,0,0,75,46,11,52,52,40,25
S02001595,Greenbank and The Braids,Middle Super Output Areas and Intermediate Zones,MSOAIZ,EH,4286,1757,3907,1604,1740,876,2159,725,8,3,33,12,20,7,13,5,5,7,5,106,308,119,280,106,3,1,21,11,4,13,13,38,22
S02001596,Colinton Mains and Firrhill,Middle Super Output Areas and Intermediate Zones,MSOAIZ,EH,3930,1907,2260,1083,759,451,1488,624,13,8,946,516,371,217,575,299,299,217,299,251,693,287,617,251,19,7,30,19,27,36,36,31,21
S02001597,Oxgangs,Middle Super Output Areas and Intermediate Zones,MSOAIZ,EH,2639,1325,1562,759,579,348,979,409,4,2,763,428,707,391,56,37,37,391,37,109,301,129,250,109,15,4,20,12,16,20,20,13,9
S02001598,Comiston and Swanston,Middle Super Output Areas and Intermediate Zones,MSOAIZ,EH,5451,2241,4571,1943,2229,1163,2336,777,6,3,164,53,59,26,105,27,27,26,27,82,684,228,242,82,231,71,12,8,199,146,146,32,17
S02001599,Fairmilehead,Middle Super Output Areas and Intermediate Zones,MSOAIZ,EH,4925,1806,4676,1709,1745,814,2929,894,2,1,19,8,11,5,8,3,3,5,3,65,210,77,183,65,2,1,21,10,4,12,12,20,12
S02001600,Gilmerton South and the Murrays,Middle Super Output Areas and Intermediate Zones,MSOAIZ,EH,2793,1210,2276,971,497,270,1776,699,3,2,175,93,98,58,77,35,35,58,35,131,324,135,317,131,1,1,6,3,0,4,4,18,11
S02001601,Mortonhall and Anwickhill,Middle Super Output Areas and Intermediate Zones,MSOAIZ,EH,2643,1225,2305,1071,905,508,1391,556,9,7,105,49,36,11,69,38,38,11,38,86,222,98,205,86,2,1,14,10,1,12,12,11,7
S02001602,Gracemount; Southhouse and Burdiehouse,Middle Super Output Areas and Intermediate Zones,MSOAIZ,EH,5244,2348,2161,1009,676,405,1463,596,22,8,2467,1075,1746,776,721,299,299,776,299,204,563,234,512,204,3,2,43,25,5,30,30,53,30
S02001603,Hyvots and Gilmerton,Middle Super Output Areas and Intermediate Zones,MSOAIZ,EH,3568,1580,1819,802,458,266,1357,534,4,2,1352,609,525,238,827,371,371,238,371,130,355,145,324,130,0,0,31,15,0,15,15,42,24
S02001604,Fernieside and Moredun South,Middle Super Output Areas and Intermediate Zones,MSOAIZ,EH,4116,1801,2501,1086,721,413,1735,650,45,23,1080,514,661,309,419,205,205,309,205,175,519,185,493,175,0,0,19,8,7,10,10,16,16
S02001605,Moredun and Craigour,Middle Super Output Areas and Intermediate Zones,MSOAIZ,EH,3090,1495,1429,639,540,304,885,332,4,3,1296,708,949,537,347,171,171,537,171,119,342,137,312,119,10,7,18,9,2,18,18,23,11
S02001606,Liberton East,Middle Super Output Areas and Intermediate Zones,MSOAIZ,EH,3167,1335,2795,1164,975,502,1814,660,6,2,89,39,45,18,44,21,21,18,21,109,270,122,237,109,0,0,29,12,4,13,13,13,10
S02001607,Liberton West and Braid Hills,Middle Super Output Areas and Intermediate Zones,MSOAIZ,EH,2714,1216,2375,1048,1170,618,1196,426,9,4,85,54,31,13,54,41,41,13,41,80,228,95,199,80,7,1,17,11,5,15,15,26,19
S02001608,The Inch,Middle Super Output Areas and Intermediate Zones,MSOAIZ,EH,4893,2305,2810,1312,978,574,1821,734,11,4,1163,620,1013,538,150,82,82,538,82,300,884,340,793,300,0,0,80,36,11,40,40,36,33
S02001609,Blackford; West Mains and Mayfield Road,Middle Super Output Areas and Intermediate Zones,MSOAIZ,EH,5982,2665,4713,2072,2039,1146,2666,921,8,5,253,145,138,73,115,72,72,73,72,368,956,416,850,368,11,4,82,40,13,48,48,60,32
S02001610,Prestonfield,Middle Super Output Areas and Intermediate Zones,MSOAIZ,EH,3386,1680,1884,905,828,468,1033,425,23,12,553,376,387,249,166,127,127,249,127,333,909,374,833,333,0,0,71,39,5,41,41,40,25
S02001611,Newington and Dalkeith Road,Middle Super Output Areas and Intermediate Zones,MSOAIZ,EH,4123,1853,1908,901,767,429,1076,442,65,30,215,135,68,38,147,97,97,38,97,699,1934,784,1715,699,16,6,122,53,81,85,85,66,33
S02001612,The Grange,Middle Super Output Areas and Intermediate Zones,MSOAIZ,EH,5410,2477,3921,1774,1948,1056,1935,691,38,27,140,107,13,9,127,98,98,9,98,502,1272,555,1163,502,17,5,87,45,5,53,53,77,41
S02001613,Marchmont East and Sciennes,Middle Super Output Areas and Intermediate Zones,MSOAIZ,EH,4944,2236,1889,918,831,480,1027,424,31,14,169,115,22,10,147,105,105,10,105,1057,2830,1165,2594,1057,2,1,191,91,43,108,108,56,38
S02001614,Marchmont West,Middle Super Output Areas and Intermediate Zones,MSOAIZ,EH,5059,1856,1973,915,855,474,1054,420,64,21,37,19,10,3,27,16,16,3,16,817,3001,898,2771,817,5,1,187,65,38,81,81,48,24
S02001615,Morningside,Middle Super Output Areas and Intermediate Zones,MSOAIZ,EH,5357,2522,3776,1736,1793,964,1972,767,11,5,145,122,15,9,130,113,113,9,113,568,1370,626,1267,568,4,3,89,49,10,58,58,66,38
S02001616,Merchiston and Greenhill,Middle Super Output Areas and Intermediate Zones,MSOAIZ,EH,4730,2186,3182,1517,1529,866,1638,645,15,6,87,51,26,10,61,41,41,10,41,541,1401,582,1315,541,14,6,62,31,10,41,41,60,36
S02001617,Bruntsfield,Middle Super Output Areas and Intermediate Zones,MSOAIZ,EH,5668,2618,2709,1360,942,558,1726,784,41,18,242,185,23,11,219,174,174,11,174,936,2665,1040,2440,936,2,1,213,98,10,104,104,52,33
S02001618,Polwarth,Middle Super Output Areas and Intermediate Zones,MSOAIZ,EH,4408,2512,2046,1198,588,390,1440,795,18,13,218,167,21,13,197,154,154,13,154,1061,2123,1130,2001,1061,4,3,110,62,8,69,69,21,17
S02001619,Dalry and Fountainbridge,Middle Super Output Areas and Intermediate Zones,MSOAIZ,EH,5878,3655,1722,1101,497,345,1176,727,49,29,1283,944,113,86,1170,858,858,86,858,1467,2801,1566,2636,1467,3,2,141,87,21,99,99,72,44
S02001620,Tollcross,Middle Super Output Areas and Intermediate Zones,MSOAIZ,EH,5502,2957,1388,859,487,328,861,510,40,21,907,596,171,104,736,492,492,104,492,1369,3149,1466,2943,1369,14,3,180,89,12,97,97,58,36
S02001621,Meadows and Southside,Middle Super Output Areas and Intermediate Zones,MSOAIZ,EH,5888,2653,1668,921,740,461,874,438,54,22,420,236,108,59,312,177,177,59,177,1301,3707,1425,3420,1301,1,1,209,89,77,124,124,93,71
S02001622,Old Town; Princes Street and Leith Street,Middle Super Output Areas and Intermediate Zones,MSOAIZ,EH,4508,2586,944,600,386,275,539,316,19,9,793,576,188,137,605,439,439,137,439,1238,2711,1370,2454,1238,3,1,130,69,124,132,132,60,40
S02001623,Canongate; Southside and Dumbiedykes,Middle Super Output Areas and Intermediate Zones,MSOAIZ,EH,5125,2894,1194,719,485,321,669,378,40,20,1613,1067,745,495,868,572,572,495,572,979,2273,1074,2066,979,20,7,95,53,92,95,95,45,34
S02001624,Abbeyhill,Middle Super Output Areas and Intermediate Zones,MSOAIZ,EH,2410,1461,911,577,209,142,646,395,56,40,517,350,23,14,494,336,336,14,336,485,969,524,897,485,2,2,68,36,2,39,39,13,10
S02001625,Meadowbank and Abbeyhill North,Middle Super Output Areas and Intermediate Zones,MSOAIZ,EH,4014,2439,2119,1289,643,431,1440,835,36,23,348,252,54,30,294,222,222,30,222,820,1519,879,1423,820,0,0,93,57,3,59,59,28,19
S02001626,Willowbrae and Duddingston Village,Middle Super Output Areas and Intermediate Zones,MSOAIZ,EH,5399,2540,4133,1905,1657,908,2468,990,8,7,291,174,234,145,57,29,29,145,29,412,948,442,893,412,3,1,50,28,2,30,30,27,19
S02001627,Craigmillar,Middle Super Output Areas and Intermediate Zones,MSOAIZ,EH,3135,1511,874,400,177,98,604,261,93,41,1704,830,403,251,1301,579,579,251,579,247,537,264,505,247,0,0,23,12,9,17,17,20,17
S02001628,Niddrie,Middle Super Output Areas and Intermediate Zones,MSOAIZ,EH,4261,1942,1157,464,255,135,861,314,41,15,2610,1293,722,460,1888,833,833,460,833,157,475,172,435,157,3,1,10,5,27,15,15,19,13
S02001629,Bingham; Magdalene and The Christians,Middle Super Output Areas and Intermediate Zones,MSOAIZ,EH,3535,1750,1609,737,577,332,1024,402,8,3,1544,845,1393,742,151,103,103,742,103,137,363,154,326,137,4,1,26,14,7,17,17,19,14
S02001630,Jewel; Brunstane and Newcraighall,Middle Super Output Areas and Intermediate Zones,MSOAIZ,EH,3270,1376,2621,1101,701,369,1910,727,10,5,139,64,101,45,38,19,19,45,19,193,500,205,467,193,8,2,21,9,4,12,12,10,6
S02001631,Joppa,Middle Super Output Areas and Intermediate Zones,MSOAIZ,EH,4975,2175,4246,1775,1645,877,2596,896,5,2,352,225,161,110,191,115,115,110,115,145,341,157,318,145,1,1,17,8,5,12,12,36,18
S02001632,Portobello,Middle Super Output Areas and Intermediate Zones,MSOAIZ,EH,3919,1956,2653,1272,808,469,1820,790,25,13,425,242,255,147,170,95,95,147,95,394,804,421,757,394,1,1,46,26,0,27,27,37,21
S02001633,Duddingston and Portobello South,Middle Super Output Areas and Intermediate Zones,MSOAIZ,EH,3849,1579,3490,1424,1558,812,1901,591,31,21,121,69,66,40,55,29,29,40,29,63,217,73,192,63,0,0,18,9,7,10,10,21,13
S02001634,Mountcastle,Middle Super Output Areas and Intermediate Zones,MSOAIZ,EH,2549,1142,2257,992,1067,572,1186,417,4,3,122,77,99,69,23,8,8,69,8,61,160,65,152,61,0,0,8,4,0,4,4,10,8
S02001635,Northfield and Piershill,Middle Super Output Areas and Intermediate Zones,MSOAIZ,EH,3500,1817,1995,1042,743,457,1241,576,11,9,763,421,700,382,63,39,39,382,39,296,710,329,652,296,1,1,49,28,8,33,33,32,25
S02001636,Craigentinny,Middle Super Output Areas and Intermediate Zones,MSOAIZ,EH,2854,1232,2595,1128,1252,673,1337,451,6,4,94,32,55,21,39,11,11,21,11,49,145,58,130,49,3,1,11,7,1,9,9,20,14
S02001637,Restalrig (Loganlea) and Craigentinny West,Middle Super Output Areas and Intermediate Zones,MSOAIZ,EH,3476,1980,1659,909,536,347,1076,540,47,22,1073,707,865,568,208,139,139,568,139,325,716,345,686,325,0,0,26,18,4,20,20,28,19
S02001638,Restalrig and Lochend,Middle Super Output Areas and Intermediate Zones,MSOAIZ,EH,4364,2376,1873,941,569,347,1267,576,37,18,1691,1063,1288,834,403,229,229,834,229,324,772,351,721,324,0,0,36,22,15,27,27,28,21
S02001639,Leith (Hermitage and Prospect Bank),Middle Super Output Areas and Intermediate Zones,MSOAIZ,EH,4652,2112,3814,1702,1269,708,2535,987,10,7,244,136,141,84,103,52,52,84,52,227,561,255,514,227,5,3,41,24,1,28,28,33,19
S02001640,Western Harbour and Leith Docks,Middle Super Output Areas and Intermediate Zones,MSOAIZ,EH,2789,1478,1345,737,319,203,980,509,46,25,358,182,64,27,294,155,155,27,155,505,1068,543,991,505,7,3,66,33,4,38,38,18,16
S02001641,North Leith and Newhaven,Middle Super Output Areas and Intermediate Zones,MSOAIZ,EH,4944,2808,2483,1319,783,464,1622,811,78,44,1242,821,578,398,664,423,423,398,423,614,1192,650,1131,614,0,0,56,33,5,36,36,27,18
S02001642,The Shore and Constitution Street,Middle Super Output Areas and Intermediate Zones,MSOAIZ,EH,4886,2829,1924,1155,337,223,1493,879,94,53,836,521,58,35,778,486,486,35,486,1066,2102,1140,1987,1066,3,2,99,62,13,74,74,24,13
S02001643,Great Junction Street,Middle Super Output Areas and Intermediate Zones,MSOAIZ,EH,4980,2750,1768,1000,481,295,1252,685,35,20,1375,831,767,438,608,393,393,438,393,825,1797,894,1677,825,2,2,113,62,5,69,69,40,25
S02001644,South Leith,Middle Super Output Areas and Intermediate Zones,MSOAIZ,EH,5244,2992,2302,1302,660,396,1529,839,113,67,968,632,201,139,767,493,493,139,493,987,1951,1042,1875,987,1,1,68,49,7,55,55,23,16
S02001645,Easter Road and Hawkhill Avenue,Middle Super Output Areas and Intermediate Zones,MSOAIZ,EH,3419,2057,1427,929,351,245,1045,664,31,20,330,228,139,103,191,125,125,103,125,830,1638,884,1545,830,6,2,85,50,2,54,54,24,16
S02001646,Leith (Albert Street),Middle Super Output Areas and Intermediate Zones,MSOAIZ,EH,3068,1855,1050,686,301,200,733,478,16,8,544,347,91,62,453,285,285,62,285,766,1455,809,1384,766,7,5,55,35,9,43,43,19,13
S02001647,Hillside and Calton Hill,Middle Super Output Areas and Intermediate Zones,MSOAIZ,EH,5143,2795,2464,1361,800,478,1652,876,12,7,316,214,65,43,251,171,171,43,171,1110,2322,1189,2181,1110,7,2,125,71,9,79,79,41,31
S02001648,Pilrig,Middle Super Output Areas and Intermediate Zones,MSOAIZ,EH,3227,1789,1505,844,478,290,996,535,31,19,609,387,88,56,521,331,331,56,331,500,1081,539,997,500,7,2,69,33,8,39,39,32,19
S02001649,Bonnington,Middle Super Output Areas and Intermediate Zones,MSOAIZ,EH,3357,1780,1816,926,503,274,1304,646,9,6,679,408,49,29,630,379,379,29,379,403,844,433,789,403,4,1,47,28,4,30,30,18,13
S02001650,Trinity East and The Dudleys,Middle Super Output Areas and Intermediate Zones,MSOAIZ,EH,3635,1632,3050,1348,1116,617,1925,726,9,5,111,52,58,30,53,22,22,30,22,200,456,221,423,200,2,2,29,18,2,21,21,18,11
S02001651,Trinity,Middle Super Output Areas and Intermediate Zones,MSOAIZ,EH,4408,2080,3612,1637,1619,896,1985,736,8,5,248,164,35,21,213,143,143,21,143,245,517,264,485,245,2,1,25,15,5,19,19,31,15
S02001652,Inverleith; Goldenacre and Warriston,Middle Super Output Areas and Intermediate Zones,MSOAIZ,EH,3573,1802,2835,1408,1333,767,1491,637,11,4,137,84,53,26,84,58,58,26,58,247,533,270,492,247,8,3,22,15,11,23,23,68,40
S02001653,Broughton North and Powderhall,Middle Super Output Areas and Intermediate Zones,MSOAIZ,EH,3723,2198,2066,1201,715,450,1347,748,4,3,277,209,141,94,136,115,115,94,115,716,1337,758,1264,716,0,0,69,40,4,42,42,43,30
S02001654,Broughton South,Middle Super Output Areas and Intermediate Zones,MSOAIZ,EH,4099,2053,2133,1140,658,399,1449,725,26,16,165,87,24,14,141,73,73,14,73,735,1748,797,1638,735,4,1,103,58,3,62,62,53,29
S02001655,New Town East and Gayfield,Middle Super Output Areas and Intermediate Zones,MSOAIZ,EH,2996,1453,1405,726,618,359,772,362,15,5,103,74,20,13,83,61,61,13,61,592,1465,635,1372,592,1,1,85,40,7,43,43,23,18
S02001656,New Town West,Middle Super Output Areas and Intermediate Zones,MSOAIZ,EH,3558,1934,1735,978,931,574,796,399,8,5,170,143,7,6,163,137,137,6,137,732,1583,769,1505,732,20,6,57,30,1,37,37,70,44
S02001657,Canonmills and New Town North,Middle Super Output Areas and Intermediate Zones,MSOAIZ,EH,3206,1751,1554,895,641,406,905,484,8,5,41,25,21,9,20,16,16,9,16,772,1572,809,1510,772,2,1,49,28,11,37,37,39,22
S02001658,Stockbridge,Middle Super Output Areas and Intermediate Zones,MSOAIZ,EH,5671,3276,3187,1779,1473,903,1699,867,15,9,260,192,109,74,151,118,118,74,118,1178,2148,1252,2035,1178,2,1,106,68,5,74,74,76,53
S02001659,Comely Bank,Middle Super Output Areas and Intermediate Zones,MSOAIZ,EH,3169,1753,1984,1144,931,617,1049,523,4,4,26,14,9,5,17,9,9,5,9,514,1050,543,995,514,0,0,49,25,6,29,29,109,52
S02001660,Deans Village,Middle Super Output Areas and Intermediate Zones,MSOAIZ,EH,5899,3184,3306,1825,1538,947,1746,865,22,13,195,140,23,11,172,129,129,11,129,1084,2296,1152,2164,1084,12,5,115,60,5,68,68,102,67
S02001661,Balgreen and Roseburn,Middle Super Output Areas and Intermediate Zones,MSOAIZ,EH,4274,2197,3186,1622,1338,834,1816,760,32,28,278,169,202,122,76,47,47,122,47,345,769,373,723,345,2,1,43,26,1,28,28,41,33
S02001662,Murrayfield and Ravelston,Middle Super Output Areas and Intermediate Zones,MSOAIZ,EH,3959,1688,3583,1515,1807,920,1773,593,3,2,23,12,12,5,11,7,7,5,7,126,292,134,279,126,6,3,7,5,0,8,8,61,27
S02001663,Craigleith; Orchard Brae and Crewe Toll,Middle Super Output Areas and Intermediate Zones,MSOAIZ,EH,4183,2060,3478,1698,1585,910,1890,785,3,3,72,38,35,17,37,21,21,17,21,270,589,294,550,270,6,3,31,19,2,24,24,44,30
S02001664,Blackhall,Middle Super Output Areas and Intermediate Zones,MSOAIZ,EH,5578,2367,4959,2080,2157,1146,2800,932,2,2,139,83,49,18,90,65,65,18,65,167,454,185,422,167,3,2,27,14,2,18,18,26,19
S02001665,Drylaw,Middle Super Output Areas and Intermediate Zones,MSOAIZ,EH,4611,2126,2662,1208,960,530,1695,675,7,3,1317,669,979,504,338,165,165,504,165,211,604,229,565,211,0,0,33,17,6,18,18,28,20
S02001666,West Pilton,Middle Super Output Areas and Intermediate Zones,MSOAIZ,EH,4611,1997,1429,681,416,234,974,424,39,23,2129,931,1601,741,528,190,190,741,190,348,1033,371,980,348,3,1,42,20,8,23,23,20,14
S02001667,Boswall and Pilton,Middle Super Output Areas and Intermediate Zones,MSOAIZ,EH,5047,2229,3549,1564,1074,604,2455,950,20,10,262,125,192,98,70,27,27,98,27,480,1197,517,1125,480,3,2,66,32,3,37,37,39,23
S02001668,Granton South and Wardieburn,Middle Super Output Areas and Intermediate Zones,MSOAIZ,EH,2894,1529,746,364,256,165,479,195,11,4,1814,1021,1701,937,113,84,84,937,84,131,329,139,308,131,4,1,13,5,4,8,8,5,5
S02001669,Granton and Royston Mains,Middle Super Output Areas and Intermediate Zones,MSOAIZ,EH,3364,1755,1360,671,374,219,974,448,12,4,1202,686,944,495,258,191,191,495,191,367,785,390,741,367,1,1,31,17,12,23,23,17,8
S02001670,Granton West and Salvesen,Middle Super Output Areas and Intermediate Zones,MSOAIZ,EH,3688,1594,1567,694,298,150,1238,528,31,16,1289,562,343,134,946,428,428,134,428,314,823,333,787,314,0,0,20,11,16,19,19,9,5
S02001671,Muirhouse,Middle Super Output Areas and Intermediate Zones,MSOAIZ,EH,4814,2288,1364,603,315,195,1040,402,9,6,2780,1411,1433,819,1347,592,592,819,592,240,651,263,601,240,0,0,35,19,15,23,23,19,11
S02001672,Siverknowes and Davidson's Mains,Middle Super Output Areas and Intermediate Zones,MSOAIZ,EH,4288,1821,3835,1628,1730,928,2103,698,2,2,70,30,22,12,48,18,18,12,18,120,344,142,304,120,0,0,35,20,5,22,22,39,21
S02001673,Cramond,Middle Super Output Areas and Intermediate Zones,MSOAIZ,EH,2434,1023,2177,912,967,498,1208,412,2,2,39,18,5,3,34,15,15,3,15,75,192,82,178,75,7,2,7,5,0,7,7,26,11
S02001674,Barnton; Cammo and Cramond South,Middle Super Output Areas and Intermediate Zones,MSOAIZ,EH,3770,1574,3500,1470,1708,891,1791,578,1,1,43,11,26,6,17,5,5,6,5,66,200,76,181,66,0,0,12,7,7,10,10,27,17
S02001675,Clermiston and Drumbrae,Middle Super Output Areas and Intermediate Zones,MSOAIZ,EH,5925,2812,4046,1811,1342,769,2683,1032,21,10,1150,682,1065,626,85,56,56,626,56,254,686,284,620,254,0,0,62,28,4,30,30,43,35
S02001676,East Craigs North,Middle Super Output Areas and Intermediate Zones,MSOAIZ,EH,4106,1901,2964,1305,990,530,1960,768,14,7,698,395,21,9,677,386,386,9,386,175,423,190,397,175,0,0,24,13,2,15,15,21,11
S02001677,East Craigs South,Middle Super Output Areas and Intermediate Zones,MSOAIZ,EH,4887,2055,4452,1869,1783,936,2668,932,1,1,90,42,20,8,70,34,34,8,34,122,325,131,302,122,4,1,14,7,5,9,9,20,13
S02001678,Corstorphine North,Middle Super Output Areas and Intermediate Zones,MSOAIZ,EH,3130,1288,2903,1185,1247,645,1654,539,2,1,87,40,45,22,42,18,18,22,18,42,129,55,100,42,2,1,23,9,4,13,13,11,8
S02001679,Corstorphine,Middle Super Output Areas and Intermediate Zones,MSOAIZ,EH,5240,2411,4328,1952,1863,1034,2456,911,9,7,298,194,119,65,179,129,129,65,129,211,568,241,512,211,5,3,51,27,0,30,30,46,24
S02001680,Carrick Knowe,Middle Super Output Areas and Intermediate Zones,MSOAIZ,EH,2762,1150,2075,865,651,342,1416,519,8,4,75,34,36,16,39,18,18,16,18,227,599,244,565,227,0,0,32,16,2,17,17,13,7
S02001681,Corstorphine South,Middle Super Output Areas and Intermediate Zones,MSOAIZ,EH,4146,1878,3270,1500,1195,684,2064,810,11,6,81,42,30,16,51,26,26,16,26,314,782,327,754,314,0,0,28,13,0,13,13,13,9
S02001682,South Gyle,Middle Super Output Areas and Intermediate Zones,MSOAIZ,EH,4650,2168,3707,1702,1283,713,2401,975,23,14,168,83,120,55,48,28,28,55,28,353,754,372,723,353,2,1,25,14,4,19,19,21,11
S02001683,Ratho; Ingliston and Gogar,Middle Super Output Areas and Intermediate Zones,MSOAIZ,EH,3264,1416,2429,1032,974,492,1447,534,8,6,386,180,334,150,52,30,30,150,30,144,378,174,311,144,34,13,23,12,10,30,30,71,30
S02001684,Dalmeny; Kirkliston and Newbridge,Middle Super Output Areas and Intermediate Zones,MSOAIZ,EH,5064,2122,3656,1469,1243,641,2399,822,14,6,647,317,536,248,111,69,69,248,69,229,663,290,520,229,67,26,35,17,41,61,61,98,46
S02001685,Queensferry East,Middle Super Output Areas and Intermediate Zones,MSOAIZ,EH,4753,2044,3910,1630,1429,738,2474,890,7,2,379,185,245,125,134,60,60,125,60,194,436,209,412,194,3,1,19,12,2,15,15,28,20
S02001686,Queensferry West,Middle Super Output Areas and Intermediate Zones,MSOAIZ,EH,4011,1634,3352,1328,976,469,2369,857,7,2,314,157,142,69,172,88,88,69,88,129,341,146,306,129,2,1,28,13,5,17,17,4,3
S02001687,Barra and South Uist,Middle Super Output Areas and Intermediate Zones,MSOAIZ,PA,3121,1441,2238,1005,1299,663,937,340,2,2,578,288,0,0,578,288,288,0,288,80,245,115,171,80,7,3,54,23,13,35,35,60,33
S02001688,Benbecula and North Uist,Middle Super Output Areas and Intermediate Zones,MSOAIZ,PA,2928,1378,2182,996,1208,646,974,350,0,0,452,232,0,0,452,232,232,0,232,100,238,121,195,100,9,4,24,10,10,21,21,56,29
S02001689,Harris,Middle Super Output Areas and Intermediate Zones,MSOAIZ,PA,1867,911,1411,683,986,532,420,148,5,3,304,151,0,0,304,151,151,0,151,31,96,46,68,31,12,7,15,7,1,15,15,56,31
S02001690,South Lewis,Middle Super Output Areas and Intermediate Zones,MSOAIZ,PA,2578,1217,2165,1005,1350,707,809,295,6,3,205,114,0,0,205,114,114,0,114,45,104,54,77,45,3,1,24,8,0,9,9,104,44
S02001691,Northwest Lewis,Middle Super Output Areas and Intermediate Zones,MSOAIZ,PA,4056,1853,3361,1503,2142,1056,1217,445,2,2,387,197,0,0,387,197,197,0,197,76,198,96,153,76,5,1,39,18,1,20,20,110,57
S02001692,Broadbay,Middle Super Output Areas and Intermediate Zones,MSOAIZ,PA,3603,1468,2833,1136,1360,645,1467,490,6,1,505,227,0,0,505,227,227,0,227,67,212,86,170,67,0,0,42,19,0,19,19,53,19
S02001693,Stornoway West,Middle Super Output Areas and Intermediate Zones,MSOAIZ,PA,3203,1594,1944,892,947,499,985,386,12,7,867,494,0,0,867,494,494,0,494,134,304,172,227,134,13,4,55,28,9,38,38,88,36
S02001694,Stornoway East,Middle Super Output Areas and Intermediate Zones,MSOAIZ,PA,2839,1393,1826,864,932,508,888,354,6,2,770,395,0,0,770,395,395,0,395,78,178,93,149,78,5,3,22,11,2,15,15,65,41
S02001695,Point,Middle Super Output Areas and Intermediate Zones,MSOAIZ,PA,3123,1321,2667,1107,1323,638,1344,469,0,0,245,114,0,0,245,114,114,0,114,56,161,75,124,56,0,0,33,17,4,19,19,50,25
S02001696,Dunipace,Middle Super Output Areas and Intermediate Zones,MSOAIZ,FK,3249,1475,2164,917,688,346,1474,570,2,1,914,469,895,462,19,7,7,462,7,59,151,72,121,59,0,0,22,10,8,13,13,20,17
S02001697,Fankerton; Stoneywood and Denny Town,Middle Super Output Areas and Intermediate Zones,MSOAIZ,FK,4142,1780,2851,1141,704,352,2140,784,7,5,1015,517,789,398,226,119,119,398,119,93,250,105,212,93,12,3,22,8,4,12,12,26,17
S02001698,Denny - Nethermains,Middle Super Output Areas and Intermediate Zones,MSOAIZ,FK,4152,1826,2756,1171,887,474,1857,694,12,3,1204,563,946,431,258,132,132,431,132,67,178,82,142,67,0,0,35,14,1,15,15,14,10
S02001699,Head of Muir and Dennyloanhead,Middle Super Output Areas and Intermediate Zones,MSOAIZ,FK,3016,1206,2576,1004,678,342,1892,659,6,3,288,130,279,126,9,4,4,126,4,53,143,67,109,53,0,0,33,13,1,14,14,9,5
S02001700,Banknock; Haggs and Longcroft,Middle Super Output Areas and Intermediate Zones,MSOAIZ,G,3796,1582,2581,1033,841,395,1739,637,1,1,1032,463,990,444,42,19,19,444,19,55,147,66,131,55,0,0,16,11,0,11,11,36,20
S02001701,Bonnybridge,Middle Super Output Areas and Intermediate Zones,MSOAIZ,FK,4846,2085,3288,1337,960,488,2327,848,1,1,1353,657,1342,651,11,6,6,651,6,62,187,77,154,62,0,0,31,14,2,15,15,18,14
S02001702,High Bonnybridge and Greenhill,Middle Super Output Areas and Intermediate Zones,MSOAIZ,FK,3384,1358,2398,893,523,245,1871,646,4,2,768,358,740,338,28,20,20,338,20,77,191,90,164,77,0,0,24,11,3,13,13,27,17
S02001703,Larbert - North Broomage and Inches,Middle Super Output Areas and Intermediate Zones,MSOAIZ,FK,5286,2091,4268,1611,1032,496,3231,1112,5,3,577,268,444,206,133,62,62,206,62,176,406,195,366,176,0,0,36,17,4,19,19,35,17
S02001704,Larbert - South Broomage and Village,Middle Super Output Areas and Intermediate Zones,MSOAIZ,FK,3796,1571,3221,1262,1045,527,2174,733,2,2,314,170,261,133,53,37,37,133,37,118,250,132,230,118,1,1,16,11,3,14,14,11,7
S02001705,Stenhousemuir West,Middle Super Output Areas and Intermediate Zones,MSOAIZ,FK,3254,1467,1601,685,491,271,1110,414,0,0,1460,679,1336,583,124,96,96,583,96,76,180,92,152,76,0,0,25,13,3,16,16,13,11
S02001706,Stenhousemuir East,Middle Super Output Areas and Intermediate Zones,MSOAIZ,FK,3537,1532,2678,1113,887,465,1787,646,4,2,607,305,555,283,52,22,22,283,22,86,241,105,202,86,0,0,33,17,6,19,19,11,9
S02001707,Stenhousemuir - Antonshill,Middle Super Output Areas and Intermediate Zones,MSOAIZ,FK,3399,1449,3010,1256,1099,569,1910,686,1,1,215,107,185,91,30,16,16,91,16,62,157,75,133,62,0,0,22,12,2,13,13,17,11
S02001708,Carron,Middle Super Output Areas and Intermediate Zones,MSOAIZ,FK,2684,1134,2323,937,690,342,1626,591,7,4,237,121,190,94,47,27,27,94,27,56,103,62,90,56,4,1,7,3,2,6,6,21,14
S02001709,Carronshore,Middle Super Output Areas and Intermediate Zones,MSOAIZ,FK,2771,1136,1938,756,471,226,1467,530,0,0,690,306,665,295,25,11,11,295,11,59,127,66,111,59,0,0,15,6,1,7,7,16,8
S02001710,Carse and Grangemouth Old Town,Middle Super Output Areas and Intermediate Zones,MSOAIZ,FK,3547,1530,2569,1063,772,383,1794,679,3,1,739,343,697,330,42,13,13,330,13,91,201,102,175,91,2,1,18,7,6,11,11,38,22
S02001711,Falkirk - Bainsford and Langlees,Middle Super Output Areas and Intermediate Zones,MSOAIZ,FK,3640,1753,1546,665,448,244,1050,402,48,19,1855,964,1553,809,302,155,155,809,155,102,230,116,207,102,2,2,19,10,2,14,14,9,8
S02001712,Falkirk - Merchiston and New Carron Village,Middle Super Output Areas and Intermediate Zones,MSOAIZ,FK,4181,1781,3195,1289,695,362,2475,914,25,13,473,240,430,217,43,23,23,217,23,221,472,232,443,221,6,3,23,8,0,11,11,41,20
S02001713,Falkirk - Grahamston,Middle Super Output Areas and Intermediate Zones,MSOAIZ,FK,3347,1881,1878,929,620,363,1231,547,27,19,914,603,216,123,698,480,480,123,480,322,547,341,510,322,2,1,23,12,12,19,19,8,8
S02001714,Falkirk - Middlefield,Middle Super Output Areas and Intermediate Zones,MSOAIZ,FK,4754,2145,2708,1172,848,447,1856,724,4,1,1501,700,1394,630,107,70,70,630,70,223,515,250,459,223,0,0,49,23,7,27,27,30,23
S02001715,Falkirk - Town Centre and Callendar Park,Middle Super Output Areas and Intermediate Zones,MSOAIZ,FK,3575,2160,1773,912,777,471,992,439,4,2,1126,836,1119,832,7,4,4,832,4,357,641,389,591,357,5,2,40,26,5,32,32,35,23
S02001716,Falkirk - Bantaskin,Middle Super Output Areas and Intermediate Zones,MSOAIZ,FK,3393,1562,2714,1218,1112,624,1598,591,4,3,295,147,281,140,14,7,7,140,7,154,340,170,318,154,0,0,20,15,2,16,16,44,27
S02001717,Falkirk - Camelon East,Middle Super Output Areas and Intermediate Zones,MSOAIZ,FK,2950,1595,1403,684,513,296,885,386,5,2,1154,679,925,509,229,170,170,509,170,188,362,209,326,188,0,0,31,19,5,21,21,31,23
S02001718,Falkirk - Camelon West,Middle Super Output Areas and Intermediate Zones,MSOAIZ,FK,2857,1228,1413,581,425,229,985,351,3,1,1259,565,1090,497,169,68,68,497,68,62,170,69,152,62,0,0,18,7,0,7,7,15,13
S02001719,Falkirk - Tamfourhill,Middle Super Output Areas and Intermediate Zones,MSOAIZ,FK,2721,1296,1787,788,688,362,1091,422,8,4,745,420,730,413,15,7,7,413,7,77,185,84,174,77,0,0,10,6,1,7,7,4,4
S02001720,Falkirk - Lochgreen and Lionthorn,Middle Super Output Areas and Intermediate Zones,MSOAIZ,FK,3743,1459,3493,1343,1145,546,2344,796,4,1,77,31,51,20,26,11,11,20,11,68,154,76,141,68,0,0,13,8,0,8,8,19,9
S02001721,Hallglen and Glen Village,Middle Super Output Areas and Intermediate Zones,MSOAIZ,FK,3227,1397,1953,794,571,282,1376,509,6,3,1072,521,955,467,117,54,54,467,54,58,177,68,157,58,0,0,19,9,1,10,10,25,14
S02001722,Shieldhill,Middle Super Output Areas and Intermediate Zones,MSOAIZ,FK,2594,1047,2039,804,595,289,1439,511,5,4,447,196,436,192,11,4,4,192,4,29,88,34,79,29,0,0,7,4,2,5,5,20,13
S02001723,Braes Villages,Middle Super Output Areas and Intermediate Zones,MSOAIZ,FK,4734,1976,2762,1110,926,465,1835,644,1,1,1746,766,1692,743,54,23,23,743,23,68,180,75,169,68,0,0,11,7,0,7,7,46,25
S02001724,Reddingmuirhead and Overton,Middle Super Output Areas and Intermediate Zones,MSOAIZ,FK,2476,923,2248,826,446,217,1800,608,2,1,125,53,122,52,3,1,1,52,1,36,99,40,89,36,0,0,10,4,0,4,4,4,4
S02001725,Brightons and Wallacestone,Middle Super Output Areas and Intermediate Zones,MSOAIZ,FK,4098,1681,3548,1427,1157,577,2372,838,19,12,303,145,286,139,17,6,6,139,6,81,214,89,197,81,4,2,13,6,0,8,8,33,20
S02001726,Maddiston and Rumford,Middle Super Output Areas and Intermediate Zones,MSOAIZ,FK,4420,1757,3247,1241,897,444,2346,795,4,2,970,433,919,409,51,24,24,409,24,60,187,73,154,60,0,0,32,12,1,13,13,16,10
S02001727,Polmont,Middle Super Output Areas and Intermediate Zones,MSOAIZ,FK,4066,1876,3617,1626,1452,761,2162,863,3,2,184,92,123,65,61,27,27,65,27,125,235,140,201,125,2,1,30,13,2,15,15,30,18
S02001728,Redding,Middle Super Output Areas and Intermediate Zones,MSOAIZ,FK,3265,1374,2259,922,733,374,1513,542,13,6,842,379,770,346,72,33,33,346,33,52,147,63,121,52,0,0,26,11,0,11,11,17,10
S02001729,Laurieston and Westquarter,Middle Super Output Areas and Intermediate Zones,MSOAIZ,FK,3256,1510,2014,881,754,397,1257,481,3,3,1076,546,1016,504,60,42,42,504,42,53,137,60,126,53,0,0,10,6,1,7,7,29,23
S02001730,Grangemouth - Newlands,Middle Super Output Areas and Intermediate Zones,MSOAIZ,FK,4920,2350,3009,1362,1135,628,1835,719,39,15,1609,829,1412,722,197,107,107,722,107,102,240,119,201,102,0,0,36,16,3,17,17,62,40
S02001731,Grangemouth - Town Centre,Middle Super Output Areas and Intermediate Zones,MSOAIZ,FK,3286,1717,2287,1096,881,488,1396,604,10,4,657,421,509,322,148,99,99,322,99,151,301,170,267,151,2,1,27,15,5,19,19,41,30
S02001732,Grangemouth - Kersiebank,Middle Super Output Areas and Intermediate Zones,MSOAIZ,FK,4420,2111,2561,1167,1064,594,1489,569,8,4,1611,812,697,376,914,436,436,376,436,94,204,106,186,94,0,0,13,10,5,12,12,44,26
S02001733,Grangemouth - Bowhouse,Middle Super Output Areas and Intermediate Zones,MSOAIZ,FK,3884,1916,2226,973,829,456,1393,515,4,2,1513,866,1236,689,277,177,177,689,177,55,127,68,105,55,0,0,21,12,1,13,13,18,9
S02001734,Bo'ness - Douglas,Middle Super Output Areas and Intermediate Zones,MSOAIZ,FK,4455,1908,3313,1380,1155,593,2150,785,8,2,802,388,297,147,505,241,241,147,241,100,302,115,265,100,0,0,28,11,9,15,15,38,25
S02001735,Bo'ness - Newtown,Middle Super Output Areas and Intermediate Zones,MSOAIZ,EH,3167,1337,2270,926,762,392,1507,533,1,1,743,346,609,295,134,51,51,295,51,52,145,58,137,52,0,0,8,6,0,6,6,9,7
S02001736,Bo'ness - Kinneil,Middle Super Output Areas and Intermediate Zones,MSOAIZ,EH,3049,1538,1604,769,646,370,948,394,10,5,1083,554,952,487,131,67,67,487,67,193,342,199,334,193,1,1,7,5,0,6,6,20,16
S02001737,Blackness; Bo'ness - Carriden and Grahamsdyke,Middle Super Output Areas and Intermediate Zones,MSOAIZ,EH,4855,2232,3255,1418,1044,559,2203,856,8,3,1172,607,1022,529,150,78,78,529,78,176,408,194,375,176,1,1,32,17,0,18,18,20,13
S02001738,Kincardine,Middle Super Output Areas and Intermediate Zones,MSOAIZ,FK,2951,1358,2241,998,968,511,1271,485,2,2,409,211,318,158,91,53,53,158,53,114,265,132,233,114,3,1,29,17,0,18,18,36,17
S02001739,Oakley Comrie and Blairhall,Middle Super Output Areas and Intermediate Zones,MSOAIZ,KY,4078,1701,2583,1062,819,432,1759,628,5,2,1249,533,797,342,452,191,191,342,191,71,230,94,179,71,3,1,42,20,6,23,23,16,12
S02001740,Saline and Gowkhall,Middle Super Output Areas and Intermediate Zones,MSOAIZ,KY,3092,1301,2656,1113,1184,576,1471,536,1,1,209,85,148,60,61,25,25,60,25,75,183,86,157,75,2,1,20,8,4,11,11,44,17
S02001741,Valleyfield Culross and Torryburn,Middle Super Output Areas and Intermediate Zones,MSOAIZ,KY,3604,1645,2213,965,846,436,1359,525,8,4,1086,525,565,268,521,257,257,268,257,113,269,133,232,113,1,1,27,13,9,20,20,36,22
S02001742,Cairneyhill and Crombie,Middle Super Output Areas and Intermediate Zones,MSOAIZ,KY,2909,1192,2621,1052,843,425,1767,622,11,5,109,53,35,18,74,35,35,18,35,63,160,76,135,63,3,1,22,12,0,13,13,19,11
S02001743,Crossford Charlestown and Limekilns,Middle Super Output Areas and Intermediate Zones,MSOAIZ,KY,4079,1822,3636,1598,1677,905,1955,691,4,2,97,51,74,40,23,11,11,40,11,140,307,150,287,140,4,3,16,7,0,10,10,39,23
S02001744,Dunfermline Milesmark and Wellwood,Middle Super Output Areas and Intermediate Zones,MSOAIZ,KY,3683,1496,3191,1265,1003,490,2185,773,3,2,284,139,266,131,18,8,8,131,8,74,198,86,173,74,0,0,25,12,0,12,12,10,6
S02001745,Dunfermline Baldridgeburn,Middle Super Output Areas and Intermediate Zones,MSOAIZ,KY,3374,1875,1823,917,564,339,1241,564,18,14,1027,669,797,510,230,159,159,510,159,254,509,278,459,254,2,1,43,20,5,24,24,15,11
S02001746,Dunfermline Headwell,Middle Super Output Areas and Intermediate Zones,MSOAIZ,KY,4356,2144,2843,1307,898,509,1909,780,36,18,959,529,816,446,143,83,83,446,83,261,527,291,481,261,0,0,41,28,5,30,30,27,17
S02001747,Dunfermline Central,Middle Super Output Areas and Intermediate Zones,MSOAIZ,KY,3109,1647,2131,1039,868,471,1246,560,17,8,250,165,135,83,115,82,82,83,82,404,713,433,673,404,4,2,33,25,3,29,29,15,10
S02001748,Dunfermline Brucefield,Middle Super Output Areas and Intermediate Zones,MSOAIZ,KY,3211,1453,2047,903,676,364,1364,535,7,4,797,354,641,260,156,94,94,260,94,171,338,180,317,171,0,0,19,8,2,9,9,29,16
S02001749,Dunfermline Garvock Hill,Middle Super Output Areas and Intermediate Zones,MSOAIZ,KY,3118,1336,2893,1214,1166,604,1703,594,24,16,63,37,11,5,52,32,32,5,32,62,133,70,115,62,0,0,13,7,5,8,8,29,15
S02001750,Dunfermline Bellyeoman and Townhill,Middle Super Output Areas and Intermediate Zones,MSOAIZ,KY,5239,2361,4271,1853,1454,780,2766,1051,51,22,634,350,425,250,209,100,100,250,100,119,299,135,268,119,0,0,25,12,6,16,16,35,23
S02001751,Dunfermline Duloch North and Lynebank,Middle Super Output Areas and Intermediate Zones,MSOAIZ,KY,3068,1136,2552,944,444,203,2095,735,13,6,253,88,131,51,122,37,37,51,37,93,259,102,243,93,0,0,14,8,2,9,9,4,2
S02001752,Dunfermline Touch and Woodmill,Middle Super Output Areas and Intermediate Zones,MSOAIZ,KY,2801,1320,1527,667,495,267,1024,396,8,4,952,510,775,409,177,101,101,409,101,113,316,139,257,113,15,5,43,20,1,26,26,6,4
S02001753,Dunfermline Abbeyview North,Middle Super Output Areas and Intermediate Zones,MSOAIZ,KY,3500,1663,1685,787,506,297,1154,480,25,10,1551,761,1092,577,459,184,184,577,184,88,239,101,211,88,0,0,28,13,0,13,13,25,14
S02001754,Dunfermline Abbeyview South,Middle Super Output Areas and Intermediate Zones,MSOAIZ,KY,2888,1242,1992,859,584,323,1408,536,0,0,583,265,312,147,271,118,118,147,118,104,301,110,289,104,0,0,12,6,0,6,6,12,8
S02001755,Dunfermline Duloch South,Middle Super Output Areas and Intermediate Zones,MSOAIZ,KY,3899,1346,3404,1148,379,170,2967,946,58,32,154,51,25,8,129,43,43,8,43,135,337,145,312,135,0,0,21,9,4,10,10,4,2
S02001756,Dunfermline Masterton,Middle Super Output Areas and Intermediate Zones,MSOAIZ,KY,2125,734,1927,668,193,89,1727,576,7,3,7,3,7,3,0,0,0,3,0,51,174,55,163,51,0,0,9,3,2,4,4,17,8
S02001757,Dunfermline Pitcorthie East,Middle Super Output Areas and Intermediate Zones,MSOAIZ,KY,3813,1490,3470,1351,1023,504,2415,828,32,19,57,20,36,12,21,8,8,12,8,99,265,112,231,99,7,2,27,11,0,13,13,21,7
S02001758,Dunfermline Pitcorthie West,Middle Super Output Areas and Intermediate Zones,MSOAIZ,KY,2618,1135,2291,980,887,475,1402,504,2,1,114,55,92,45,22,10,10,45,10,84,201,92,187,84,0,0,14,8,0,8,8,12,8
S02001759,Rosyth North,Middle Super Output Areas and Intermediate Zones,MSOAIZ,KY,3016,1326,2280,974,736,391,1533,578,11,5,452,221,213,108,239,113,113,108,113,98,269,120,221,98,6,2,38,18,4,22,22,15,11
S02001760,Rosyth East,Middle Super Output Areas and Intermediate Zones,MSOAIZ,KY,3161,1385,2134,936,725,387,1404,546,5,3,739,318,361,139,378,179,179,139,179,91,265,114,218,91,0,0,44,21,3,23,23,23,17
S02001761,Rosyth Central,Middle Super Output Areas and Intermediate Zones,MSOAIZ,KY,3540,1657,2186,948,696,375,1486,571,4,2,1065,573,436,262,629,311,311,262,311,109,279,127,243,109,3,1,33,17,0,18,18,10,9
S02001762,Rosyth South,Middle Super Output Areas and Intermediate Zones,MSOAIZ,KY,3500,1298,2237,840,277,149,1956,690,4,1,714,255,69,25,645,230,230,25,230,155,541,200,384,155,67,19,31,13,59,45,45,8,3
S02001763,North Queensferry and Inverkeithing West,Middle Super Output Areas and Intermediate Zones,MSOAIZ,KY,3297,1568,2242,1029,769,425,1470,602,3,2,625,298,569,268,56,30,30,268,30,201,406,226,370,201,0,0,36,25,0,25,25,24,15
S02001764,Inverkeithing East,Middle Super Output Areas and Intermediate Zones,MSOAIZ,KY,3105,1422,1710,769,658,350,1042,416,10,3,1040,468,831,365,209,103,103,365,103,161,344,176,306,161,0,0,38,15,0,15,15,11,9
S02001765,Dalgety Bay West and Hillend,Middle Super Output Areas and Intermediate Zones,MSOAIZ,KY,2739,987,2547,908,500,240,2042,666,5,2,14,5,14,5,0,0,0,5,0,65,168,70,153,65,1,1,14,4,0,5,5,10,4
S02001766,Dalgety Bay Central,Middle Super Output Areas and Intermediate Zones,MSOAIZ,KY,4400,2006,3794,1695,1539,828,2244,859,11,8,66,26,36,11,30,15,15,11,15,235,517,269,458,235,0,0,59,34,0,34,34,23,16
S02001767,Dalgety Bay East,Middle Super Output Areas and Intermediate Zones,MSOAIZ,KY,2683,1108,2440,999,933,488,1498,508,9,3,100,50,88,45,12,5,5,45,5,44,126,49,114,44,2,1,6,3,4,5,5,17,10
S02001768,Crossgates and Halbeath,Middle Super Output Areas and Intermediate Zones,MSOAIZ,KY,3092,1352,2283,975,773,407,1499,564,11,4,516,227,496,219,20,8,8,219,8,116,265,135,226,116,6,3,29,14,4,19,19,28,15
S02001769,Hill of Beath and Kingseat,Middle Super Output Areas and Intermediate Zones,MSOAIZ,KY,3265,1430,1839,769,635,325,1202,443,2,1,1213,565,1030,464,183,101,101,464,101,79,198,84,184,79,0,0,14,5,0,5,5,15,12
S02001770,Cowdenbeath South,Middle Super Output Areas and Intermediate Zones,MSOAIZ,KY,3045,1425,1648,724,618,322,1023,399,7,3,1171,591,1039,528,132,63,63,528,63,74,198,96,158,74,0,0,30,20,10,22,22,28,14
S02001771,Cowdenbeath North,Middle Super Output Areas and Intermediate Zones,MSOAIZ,KY,4371,1966,3046,1294,970,523,2071,767,5,4,877,455,757,399,120,56,56,399,56,172,412,199,351,172,5,3,50,22,6,27,27,36,18
S02001772,Kelty West,Middle Super Output Areas and Intermediate Zones,MSOAIZ,KY,2738,1162,1446,619,496,270,940,346,10,3,1162,482,1152,478,10,4,4,478,4,46,119,52,103,46,2,1,14,5,0,6,6,11,9
S02001773,Kelty East,Middle Super Output Areas and Intermediate Zones,MSOAIZ,KY,3606,1699,2431,1054,696,397,1712,645,23,12,899,491,793,425,106,66,66,425,66,117,254,137,218,117,6,1,30,19,0,20,20,22,17
S02001774,Lochore and Crosshill,Middle Super Output Areas and Intermediate Zones,MSOAIZ,KY,2701,1244,1463,632,597,312,866,320,0,0,981,492,791,408,190,84,84,408,84,83,232,99,198,83,0,0,30,14,4,16,16,25,21
S02001775,Ballingry,Middle Super Output Areas and Intermediate Zones,MSOAIZ,KY,2950,1246,1212,487,393,196,806,286,13,5,1589,695,1547,673,42,22,22,673,22,46,135,55,117,46,1,1,15,7,2,9,9,14,9
S02001776,Cardenden,Middle Super Output Areas and Intermediate Zones,MSOAIZ,KY,5877,2614,3165,1320,1030,542,2123,770,12,8,2258,1087,1400,697,858,390,390,697,390,158,411,182,367,158,0,0,38,19,6,24,24,43,25
S02001777,Lochgelly East,Middle Super Output Areas and Intermediate Zones,MSOAIZ,KY,4324,1908,2907,1194,961,508,1937,681,9,5,1108,560,906,458,202,102,102,458,102,106,278,133,221,106,7,4,34,19,16,27,27,31,21
S02001778,Lochgelly West and Lumphinnans,Middle Super Output Areas and Intermediate Zones,MSOAIZ,KY,3094,1496,1517,696,560,309,953,385,4,2,1283,648,918,480,365,168,168,480,168,129,276,139,260,129,0,0,16,10,0,10,10,18,13
S02001779,Aberdour and Auchtertool,Middle Super Output Areas and Intermediate Zones,MSOAIZ,KY,2976,1395,2306,1019,1039,550,1264,467,3,2,275,162,270,160,5,2,2,160,2,156,347,186,293,156,12,5,34,21,8,30,30,48,28
S02001780,Burntisland West,Middle Super Output Areas and Intermediate Zones,MSOAIZ,KY,3650,1681,2317,988,739,418,1572,566,6,4,992,503,912,454,80,49,49,454,49,154,326,179,264,154,2,1,60,24,0,25,25,15,11
S02001781,Burntisland East,Middle Super Output Areas and Intermediate Zones,MSOAIZ,KY,2687,1209,2205,981,923,498,1278,481,4,2,337,153,277,129,60,24,24,129,24,47,119,58,99,47,3,1,17,10,0,11,11,26,17
S02001782,Kinghorn,Middle Super Output Areas and Intermediate Zones,MSOAIZ,KY,2782,1340,2156,992,901,513,1252,478,3,1,411,225,362,191,49,34,34,191,34,97,191,106,171,97,2,1,18,8,0,9,9,24,17
S02001783,Kirkcaldy Linktown & Seafield,Middle Super Output Areas and Intermediate Zones,MSOAIZ,KY,4457,2107,2292,962,752,407,1533,550,7,5,1431,787,1249,669,182,118,118,669,118,328,691,339,667,328,0,0,23,10,1,11,11,43,19
S02001784,Kirkcaldy Central,Middle Super Output Areas and Intermediate Zones,MSOAIZ,KY,3132,1678,2126,1066,876,518,1232,538,18,10,405,282,232,159,173,123,123,159,123,277,552,301,506,277,5,3,39,20,2,24,24,49,29
S02001785,Kirkcaldy Bennochy East,Middle Super Output Areas and Intermediate Zones,MSOAIZ,KY,2942,1651,1932,1054,756,473,1172,579,4,2,267,156,258,151,9,5,5,151,5,394,720,426,671,394,2,2,38,27,9,32,32,23,15
S02001786,Kirkcaldy Bennochy West,Middle Super Output Areas and Intermediate Zones,MSOAIZ,KY,2930,1327,1990,862,843,448,1141,412,6,2,684,345,521,286,163,59,59,286,59,86,231,101,206,86,4,2,17,10,4,15,15,25,19
S02001787,Kirkcaldy Raith,Middle Super Output Areas and Intermediate Zones,MSOAIZ,KY,2639,1128,2354,1003,935,475,1418,527,1,1,38,19,34,16,4,3,3,16,3,81,219,90,202,81,2,2,13,6,2,9,9,28,16
S02001788,Kirkcaldy Newliston and Redcraigs,Middle Super Output Areas and Intermediate Zones,MSOAIZ,KY,3179,1430,2431,1064,981,525,1448,538,2,1,525,271,446,239,79,32,32,239,32,67,207,85,165,67,0,0,38,16,4,18,18,16,10
S02001789,Kirkcaldy Templehall West,Middle Super Output Areas and Intermediate Zones,MSOAIZ,KY,2984,1409,1591,707,500,287,1083,417,8,3,1191,618,1151,594,40,24,24,594,24,69,187,76,174,69,0,0,12,6,1,7,7,15,8
S02001790,Kirkcaldy Templehall East,Middle Super Output Areas and Intermediate Zones,MSOAIZ,KY,5018,2181,2321,958,696,370,1614,583,11,5,2326,1080,1852,876,474,204,204,876,204,113,354,132,313,113,0,0,34,17,7,19,19,17,11
S02001791,Kirkcaldy Dunnikier,Middle Super Output Areas and Intermediate Zones,MSOAIZ,KY,3349,1398,3137,1314,1348,692,1785,620,4,2,67,25,53,20,14,5,5,20,5,41,130,48,114,41,0,0,15,6,1,7,7,15,11
S02001792,Kirkcaldy Chapel,Middle Super Output Areas and Intermediate Zones,MSOAIZ,KY,4819,1950,3732,1422,937,454,2794,967,1,1,682,369,616,328,66,41,41,328,41,118,377,140,316,118,1,1,58,20,2,22,22,28,19
S02001793,Kirkcaldy Hayfield and Smeaton,Middle Super Output Areas and Intermediate Zones,MSOAIZ,KY,3667,1597,1756,781,642,358,1091,414,23,9,1410,601,1174,525,236,76,76,525,76,182,487,203,447,182,0,0,32,17,8,21,21,14,12
S02001794,Kirkcaldy Pathhead,Middle Super Output Areas and Intermediate Zones,MSOAIZ,KY,2919,1606,1890,963,835,498,1047,459,8,6,396,281,328,238,68,43,43,238,43,330,608,345,584,330,0,0,22,14,2,15,15,25,17
S02001795,Kirkcaldy Gallatown and Sinclairtown,Middle Super Output Areas and Intermediate Zones,MSOAIZ,KY,3842,2033,1487,765,554,325,919,432,14,8,1892,1021,1787,946,105,75,75,946,75,219,441,228,419,219,0,0,22,9,0,9,9,22,19
S02001796,Dysart,Middle Super Output Areas and Intermediate Zones,MSOAIZ,KY,3475,1757,1948,903,659,377,1277,520,12,6,1205,667,1010,568,195,99,99,568,99,150,303,173,271,150,0,0,31,22,1,23,23,19,14
S02001797,Wemyss,Middle Super Output Areas and Intermediate Zones,MSOAIZ,KY,2856,1412,1579,715,571,310,1006,403,2,2,808,464,582,337,226,127,127,337,127,194,442,213,410,194,1,1,25,15,6,19,19,27,20
S02001798,Thornton and Kinglassie,Middle Super Output Areas and Intermediate Zones,MSOAIZ,KY,3972,1760,2587,1113,948,489,1632,620,7,4,974,463,853,418,121,45,45,418,45,124,364,160,284,124,22,9,54,25,4,36,36,47,24
S02001799,Leslie and Newcastle,Middle Super Output Areas and Intermediate Zones,MSOAIZ,KY,4148,1931,2701,1191,1013,537,1687,653,1,1,979,519,937,495,42,24,24,495,24,164,432,197,360,164,9,6,50,23,13,33,33,36,24
S02001800,Glenrothes Macedonia and Tanshall,Middle Super Output Areas and Intermediate Zones,MSOAIZ,KY,4256,1912,2164,963,721,397,1443,566,0,0,1423,669,1182,571,241,98,98,571,98,238,660,273,573,238,14,6,63,26,10,35,35,9,7
S02001801,Glenrothes South Parks,Middle Super Output Areas and Intermediate Zones,MSOAIZ,KY,2189,1004,1561,698,648,367,913,331,0,0,328,185,322,182,6,3,3,182,3,98,282,109,252,98,0,0,26,10,4,11,11,18,12
S02001802,Glenrothes Caskieberran and Rimbleton,Middle Super Output Areas and Intermediate Zones,MSOAIZ,KY,4647,2027,3185,1360,1066,576,2115,781,4,3,818,420,735,385,83,35,35,385,35,208,619,233,562,208,4,1,53,24,0,25,25,25,14
S02001803,Glenrothes Auchmuty,Middle Super Output Areas and Intermediate Zones,MSOAIZ,KY,3429,1572,1734,777,616,348,1111,427,7,2,1106,564,1075,548,31,16,16,548,16,209,574,221,549,209,1,1,20,9,4,12,12,15,10
S02001804,Glenrothes Stenton and Finglassie,Middle Super Output Areas and Intermediate Zones,MSOAIZ,KY,3499,1463,2530,1008,832,393,1692,612,6,3,686,341,276,135,410,206,206,135,206,99,270,108,257,99,2,1,8,6,3,9,9,13,6
S02001805,Glenrothes Pitteuchar,Middle Super Output Areas and Intermediate Zones,MSOAIZ,KY,5021,2129,3712,1530,1147,621,2565,909,0,0,752,378,653,325,99,53,53,325,53,183,521,205,475,183,2,1,43,20,1,22,22,36,16
S02001806,Glenrothes Woodside,Middle Super Output Areas and Intermediate Zones,MSOAIZ,KY,2615,1162,1884,816,677,373,1205,442,2,1,520,255,506,247,14,8,8,247,8,70,187,78,171,70,0,0,16,8,0,8,8,24,13
S02001807,Glenrothes Balgeddie and Town Park,Middle Super Output Areas and Intermediate Zones,MSOAIZ,KY,3696,1480,3433,1358,1092,564,2340,793,1,1,81,35,75,31,6,4,4,31,4,67,161,75,144,67,2,1,12,6,3,8,8,21,12
S02001808,Glenrothes Collydean,Middle Super Output Areas and Intermediate Zones,MSOAIZ,KY,2322,1019,958,373,205,107,746,264,7,2,1164,560,817,377,347,183,183,377,183,77,193,82,181,77,0,0,12,5,0,5,5,7,4
S02001809,Glenrothes Cadham and Pitcoudie,Middle Super Output Areas and Intermediate Zones,MSOAIZ,KY,2194,1029,1142,494,255,142,887,352,0,0,774,412,697,358,77,54,54,358,54,101,266,115,239,101,2,1,17,10,8,14,14,12,8
S02001810,Glenrothes Balfarg Pitcairn and Coul,Middle Super Output Areas and Intermediate Zones,MSOAIZ,KY,2952,1250,2085,819,512,250,1549,556,24,13,673,360,312,175,361,185,185,175,185,55,185,65,165,55,0,0,16,7,4,10,10,9,6
S02001811,Markinch and Star,Middle Super Output Areas and Intermediate Zones,MSOAIZ,KY,3989,1789,3161,1374,1134,615,2022,756,5,3,405,220,300,161,105,59,59,161,59,156,386,174,345,156,0,0,36,17,5,18,18,37,21
S02001812,Windygates and Coaltown,Middle Super Output Areas and Intermediate Zones,MSOAIZ,KY,3412,1471,2766,1149,1061,535,1702,613,3,1,354,174,276,145,78,29,29,145,29,117,249,127,234,117,0,0,13,9,2,10,10,43,21
S02001813,Buckhaven; Denbeath and Muiredge,Middle Super Output Areas and Intermediate Zones,MSOAIZ,KY,4956,2465,2724,1265,1114,622,1604,639,6,4,1680,918,1189,659,491,259,259,659,259,232,501,253,468,232,0,0,27,17,6,21,21,51,29
S02001814,Methil Methilhill,Middle Super Output Areas and Intermediate Zones,MSOAIZ,KY,4682,1994,2456,1035,925,486,1529,548,2,1,1870,811,1300,595,570,216,216,595,216,103,320,127,267,103,0,0,49,22,4,24,24,36,21
S02001815,Methil West,Middle Super Output Areas and Intermediate Zones,MSOAIZ,KY,2475,1262,926,435,391,227,530,204,5,4,1233,654,1078,574,155,80,80,574,80,154,310,167,288,154,3,3,12,7,7,13,13,6,6
S02001816,Methil East,Middle Super Output Areas and Intermediate Zones,MSOAIZ,KY,3232,1567,1674,791,617,352,1044,431,13,8,1090,538,927,446,163,92,92,446,92,211,441,225,411,211,0,0,29,13,1,14,14,27,13
S02001817,Leven East,Middle Super Output Areas and Intermediate Zones,MSOAIZ,KY,3021,1649,1972,968,891,522,1074,442,7,4,610,425,369,264,241,161,161,264,161,200,397,228,354,200,0,0,35,24,8,28,28,42,28
S02001818,Leven West,Middle Super Output Areas and Intermediate Zones,MSOAIZ,KY,3202,1420,2132,906,718,383,1406,521,8,2,876,417,692,348,184,69,69,348,69,65,162,78,136,65,0,0,24,11,2,13,13,32,19
S02001819,Leven North,Middle Super Output Areas and Intermediate Zones,MSOAIZ,KY,2664,1188,1983,873,847,454,1133,417,3,2,560,264,323,163,237,101,101,163,101,40,105,42,101,40,0,0,3,1,1,2,2,16,9
S02001820,Largo,Middle Super Output Areas and Intermediate Zones,MSOAIZ,KY,2786,1329,2293,1060,1203,669,1078,386,12,5,196,108,167,82,29,26,26,82,26,121,256,139,221,121,11,5,21,11,3,18,18,41,22
S02001821,Kennoway and Bonnybank,Middle Super Output Areas and Intermediate Zones,MSOAIZ,KY,5414,2347,3469,1448,1326,673,2119,767,24,8,1568,740,1315,599,253,141,141,599,141,106,315,123,282,106,0,0,27,12,6,17,17,62,36
S02001822,Kettle and Ladybank,Middle Super Output Areas and Intermediate Zones,MSOAIZ,KY,4181,1808,3225,1342,1336,685,1882,654,7,3,486,241,409,191,77,50,50,191,50,166,390,182,356,166,7,3,21,9,6,16,16,80,43
S02001823,Falkland and Freuchie,Middle Super Output Areas and Intermediate Zones,MSOAIZ,KY,2472,1085,1929,829,737,403,1192,426,0,0,243,110,220,100,23,10,10,100,10,107,261,127,224,107,0,0,22,12,15,20,20,39,19
S02001824,Auchtermuchty and Gateside,Middle Super Output Areas and Intermediate Zones,MSOAIZ,PH,4176,1833,3115,1301,1241,633,1849,658,25,10,587,301,532,270,55,31,31,270,31,168,397,191,347,168,8,4,36,16,6,23,23,77,40
S02001825,Newburgh,Middle Super Output Areas and Intermediate Zones,MSOAIZ,KY,2875,1331,1998,866,873,446,1121,417,4,3,483,263,410,221,73,42,42,221,42,168,360,180,342,168,0,0,15,9,3,12,12,34,22
S02001826,Cupar West and Springfield,Middle Super Output Areas and Intermediate Zones,MSOAIZ,KY,3640,1546,2745,1134,1023,528,1718,604,4,2,409,201,329,168,80,33,33,168,33,162,431,183,379,162,12,4,24,12,16,21,21,55,28
S02001827,Cupar Central,Middle Super Output Areas and Intermediate Zones,MSOAIZ,KY,3355,1632,1646,751,530,313,1109,432,7,6,1018,559,882,485,136,74,74,485,74,257,663,305,526,257,61,17,31,16,45,48,48,28,17
S02001828,Cupar East,Middle Super Output Areas and Intermediate Zones,MSOAIZ,KY,3940,1796,3273,1474,1552,858,1679,598,42,18,252,124,174,76,78,48,48,76,48,145,364,168,311,145,14,5,31,14,8,23,23,51,30
S02001829,Dairsie Ceres and Dunino,Middle Super Output Areas and Intermediate Zones,MSOAIZ,KY,2834,1267,2208,952,1046,534,1159,416,3,2,166,98,136,85,30,13,13,85,13,157,397,183,347,157,6,4,38,19,6,26,26,63,34
S02001830,Elie Colinsburgh and Largoward,Middle Super Output Areas and Intermediate Zones,MSOAIZ,KY,2174,1027,1489,698,870,462,608,232,11,4,280,144,191,95,89,49,49,95,49,131,327,146,288,131,8,2,29,12,2,15,15,78,39
S02001831,St Monans and Pittenweem,Middle Super Output Areas and Intermediate Zones,MSOAIZ,KY,2843,1383,1948,916,990,556,946,355,12,5,599,307,504,254,95,53,53,254,53,123,263,136,241,123,2,1,19,11,1,13,13,33,24
S02001832,Anstruther,Middle Super Output Areas and Intermediate Zones,MSOAIZ,KY,3764,1734,2735,1191,1208,636,1518,548,9,7,515,285,353,202,162,83,83,202,83,198,473,230,411,198,14,7,42,22,6,32,32,41,28
S02001833,Crail and Boarhills,Middle Super Output Areas and Intermediate Zones,MSOAIZ,KY,2440,1231,1739,835,1002,561,724,267,13,7,274,150,189,96,85,54,54,96,54,190,366,210,334,190,4,3,21,12,7,20,20,61,36
S02001834,St Andrews South East,Middle Super Output Areas and Intermediate Zones,MSOAIZ,KY,3700,1704,1868,895,957,540,891,347,20,8,957,477,839,421,118,56,56,421,56,281,838,313,762,281,10,4,52,22,14,32,32,37,19
S02001835,St Andrews Central,Middle Super Output Areas and Intermediate Zones,MSOAIZ,KY,4245,1865,984,511,570,334,373,163,41,14,491,303,440,273,51,30,30,273,30,963,2734,1028,2548,963,14,6,96,33,76,65,65,36,23
S02001836,St Andrews South West,Middle Super Output Areas and Intermediate Zones,MSOAIZ,KY,4105,1805,2857,1327,1629,887,1141,405,87,35,302,116,90,32,212,84,84,32,84,297,878,331,783,297,17,7,52,18,26,34,34,68,31
S02001837,St Andrews North and Strathkinness,Middle Super Output Areas and Intermediate Zones,MSOAIZ,KY,2811,1271,1898,878,1095,595,788,277,15,6,96,60,60,31,36,29,29,31,29,289,771,311,710,289,12,5,30,12,19,22,22,46,22
S02001838,Leuchars and Guardbridge,Middle Super Output Areas and Intermediate Zones,MSOAIZ,KY,3087,1219,1217,522,429,215,774,300,14,7,551,229,240,115,311,114,114,115,114,137,1299,453,312,137,610,192,18,8,359,316,316,20,15
S02001839,Balmullo and Gauldry,Middle Super Output Areas and Intermediate Zones,MSOAIZ,KY,3774,1629,2997,1273,1363,674,1610,583,24,16,150,71,105,49,45,22,22,49,22,208,517,232,440,208,32,8,28,12,17,24,24,110,53
S02001840,Tayport,Middle Super Output Areas and Intermediate Zones,MSOAIZ,DD,3770,1734,2708,1202,1026,554,1667,639,15,9,616,312,528,258,88,54,54,258,54,168,404,193,347,168,6,2,51,23,0,25,25,42,27
S02001841,Newport and Wormit,Middle Super Output Areas and Intermediate Zones,MSOAIZ,DD,4159,1848,3450,1494,1496,790,1927,692,27,12,349,186,271,138,78,48,48,138,48,138,334,154,307,138,0,0,27,16,0,16,16,26,14
S02001842,Darnley East,Middle Super Output Areas and Intermediate Zones,MSOAIZ,G,4970,2123,2437,984,664,324,1740,648,33,12,2243,1000,0,0,2243,1000,1000,0,1000,115,270,127,238,115,0,0,32,12,0,12,12,20,12
S02001843,Darnley North,Middle Super Output Areas and Intermediate Zones,MSOAIZ,G,2716,1131,1690,605,239,104,1422,487,29,14,824,438,0,0,824,438,438,0,438,69,196,84,164,69,2,1,24,11,6,15,15,6,4
S02001844,Darnley West,Middle Super Output Areas and Intermediate Zones,MSOAIZ,G,4642,1680,3831,1311,523,228,3266,1067,42,16,377,193,0,0,377,193,193,0,193,153,423,170,378,153,0,0,43,16,2,17,17,11,6
S02001845,Nitshill,Middle Super Output Areas and Intermediate Zones,MSOAIZ,G,5764,2590,1753,736,411,213,1316,510,26,13,3550,1619,0,0,3550,1619,1619,0,1619,208,441,226,398,208,0,0,37,14,6,18,18,20,9
S02001846,Crookston South,Middle Super Output Areas and Intermediate Zones,MSOAIZ,G,3342,1439,1002,428,383,187,599,232,20,9,2201,943,0,0,2201,943,943,0,943,51,138,67,102,51,0,0,19,8,17,16,16,1,1
S02001847,Crookston North,Middle Super Output Areas and Intermediate Zones,MSOAIZ,G,3018,1343,1820,789,648,359,1165,425,7,5,953,437,0,0,953,437,437,0,437,94,228,105,208,94,0,0,17,10,3,11,11,17,12
S02001848,Pollok South and West,Middle Super Output Areas and Intermediate Zones,MSOAIZ,G,5467,2096,4905,1866,1087,554,3812,1310,6,2,140,66,0,0,140,66,66,0,66,139,400,153,371,139,3,2,11,7,15,14,14,22,11
S02001849,Pollok North and East,Middle Super Output Areas and Intermediate Zones,MSOAIZ,G,5999,2515,2858,1179,704,361,2147,813,7,5,2663,1122,0,0,2663,1122,1122,0,1122,172,448,198,391,172,0,0,46,19,11,26,26,30,16
S02001850,Cardonald South and East,Middle Super Output Areas and Intermediate Zones,MSOAIZ,G,3410,1673,1892,849,598,338,1272,503,22,8,1014,609,0,0,1014,609,609,0,609,186,478,203,451,186,4,2,20,13,3,17,17,26,12
S02001851,Cardonald North,Middle Super Output Areas and Intermediate Zones,MSOAIZ,G,4256,2046,2076,923,673,365,1373,546,30,12,1813,964,0,0,1813,964,964,0,964,126,333,138,300,126,0,0,21,8,12,12,12,34,21
S02001852,Cardonald West and Central,Middle Super Output Areas and Intermediate Zones,MSOAIZ,G,5270,2442,4209,1850,1586,867,2617,981,6,2,594,400,0,0,594,400,400,0,400,157,435,173,399,157,0,0,36,16,0,16,16,32,19
S02001853,Penilee,Middle Super Output Areas and Intermediate Zones,MSOAIZ,G,5261,2300,2917,1202,792,424,2121,775,4,3,1909,925,0,0,1909,925,925,0,925,138,411,157,368,138,5,2,37,16,1,19,19,24,16
S02001854,Hillington,Middle Super Output Areas and Intermediate Zones,MSOAIZ,G,3519,1628,2394,1056,744,409,1650,647,0,0,407,274,0,0,407,274,274,0,274,254,695,287,623,254,0,0,70,31,2,33,33,23,11
S02001855,Drumoyne and Shieldhall,Middle Super Output Areas and Intermediate Zones,MSOAIZ,G,6191,3173,3125,1452,830,501,2199,900,96,51,2526,1445,0,0,2526,1445,1445,0,1445,229,509,258,452,229,2,1,49,24,6,29,29,31,18
S02001856,Govan and Linthouse,Middle Super Output Areas and Intermediate Zones,MSOAIZ,G,4822,2687,898,428,241,142,589,252,68,34,3507,2039,0,0,3507,2039,2039,0,2039,177,374,201,341,177,0,0,23,14,10,24,24,43,19
S02001857,Craigton,Middle Super Output Areas and Intermediate Zones,MSOAIZ,G,3303,1770,1909,984,715,442,1187,539,7,3,1024,601,0,0,1024,601,601,0,601,152,354,172,321,152,0,0,25,17,8,20,20,16,13
S02001858,Mosspark,Middle Super Output Areas and Intermediate Zones,MSOAIZ,G,5231,2337,3509,1500,1060,599,2448,900,1,1,1206,632,0,0,1206,632,632,0,632,153,471,179,411,153,0,0,36,17,24,26,26,45,26
S02001859,Ibrox,Middle Super Output Areas and Intermediate Zones,MSOAIZ,G,2982,1607,681,344,216,124,422,196,43,24,1834,1021,0,0,1834,1021,1021,0,1021,204,435,225,398,204,2,1,24,16,11,21,21,32,17
S02001860,Ibrox East and Cessnock,Middle Super Output Areas and Intermediate Zones,MSOAIZ,G,2839,1630,932,517,307,181,624,335,1,1,930,520,0,0,930,520,520,0,520,541,947,572,888,541,3,1,46,26,10,31,31,30,21
S02001861,Kinning Park and Festival Park,Middle Super Output Areas and Intermediate Zones,MSOAIZ,G,3649,1901,1817,922,488,260,1322,658,7,4,451,287,0,0,451,287,287,0,287,620,1346,669,1254,620,0,0,90,47,2,49,49,35,23
S02001862,Kingston West and Dumbreck,Middle Super Output Areas and Intermediate Zones,MSOAIZ,G,3665,1894,2026,895,821,411,1197,480,8,4,930,633,0,0,930,633,633,0,633,318,668,345,614,318,2,1,44,21,8,27,27,41,21
S02001863,Pollokshields West,Middle Super Output Areas and Intermediate Zones,MSOAIZ,G,4697,1831,2772,1015,1087,459,1661,546,24,10,1023,443,0,0,1023,443,443,0,443,326,851,353,794,326,5,2,43,23,9,27,27,51,20
S02001864,Pollokshields East,Middle Super Output Areas and Intermediate Zones,MSOAIZ,G,4939,1916,2799,1023,852,290,1916,715,31,18,369,173,0,0,369,173,173,0,173,643,1703,694,1593,643,8,7,94,42,8,51,51,68,26
S02001865,Govanhill West,Middle Super Output Areas and Intermediate Zones,MSOAIZ,G,5386,2736,1799,894,544,290,1236,594,19,10,1665,875,0,0,1665,875,875,0,875,893,1882,946,1797,893,2,2,66,39,17,53,53,40,21
S02001866,Govanhill East and Aikenhead,Middle Super Output Areas and Intermediate Zones,MSOAIZ,G,4050,2110,1474,702,497,292,965,403,12,7,1893,1067,0,0,1893,1067,1067,0,1067,312,669,329,636,312,3,1,24,12,6,17,17,14,12
S02001867,Battlefield,Middle Super Output Areas and Intermediate Zones,MSOAIZ,G,4974,2642,3134,1603,862,482,2269,1119,3,2,461,305,0,0,461,305,305,0,305,652,1320,704,1236,652,0,0,80,48,4,52,52,59,30
S02001868,Strathbungo,Middle Super Output Areas and Intermediate Zones,MSOAIZ,G,5520,2951,3160,1584,887,471,2257,1102,16,11,350,202,0,0,350,202,202,0,202,1091,1968,1140,1877,1091,4,2,79,42,8,49,49,42,25
S02001869,Maxwell Park,Middle Super Output Areas and Intermediate Zones,MSOAIZ,G,5834,2330,5048,1971,2122,991,2920,977,6,3,147,75,0,0,147,75,75,0,75,240,584,258,551,240,3,1,28,16,2,18,18,55,26
S02001870,Shawlands West,Middle Super Output Areas and Intermediate Zones,MSOAIZ,G,3573,2123,1863,1177,608,406,1250,768,5,3,244,122,0,0,244,122,122,0,122,760,1434,803,1358,760,0,0,73,41,3,43,43,32,21
S02001871,Shawlands East,Middle Super Output Areas and Intermediate Zones,MSOAIZ,G,3293,1930,1840,1067,496,322,1324,730,20,15,188,118,0,0,188,118,118,0,118,682,1244,728,1168,682,2,1,67,41,7,46,46,21,17
S02001872,Langside,Middle Super Output Areas and Intermediate Zones,MSOAIZ,G,4027,2238,2771,1513,776,486,1991,1024,4,3,187,122,0,0,187,122,122,0,122,548,1039,583,984,548,2,1,51,33,2,35,35,30,20
S02001873,Pollokshaws,Middle Super Output Areas and Intermediate Zones,MSOAIZ,G,4473,2589,1701,868,498,301,1083,498,120,69,2084,1361,0,0,2084,1361,1361,0,1361,317,652,344,598,317,0,0,32,18,22,27,27,36,16
S02001874,Carnwadric West,Middle Super Output Areas and Intermediate Zones,MSOAIZ,G,4634,2189,1903,739,524,258,1330,459,49,22,2390,1322,0,0,2390,1322,1322,0,1322,104,318,119,280,104,3,1,22,11,13,15,15,23,9
S02001875,Carnwadric East,Middle Super Output Areas and Intermediate Zones,MSOAIZ,G,3144,1458,1869,826,625,335,1234,487,10,4,864,442,0,0,864,442,442,0,442,147,379,172,331,147,0,0,43,24,5,25,25,32,18
S02001876,Newlands,Middle Super Output Areas and Intermediate Zones,MSOAIZ,G,5383,2197,4222,1607,1565,759,2637,843,20,5,769,418,0,0,769,418,418,0,418,135,354,150,326,135,7,2,21,13,0,15,15,38,22
S02001877,Merrylee and Millbrae,Middle Super Output Areas and Intermediate Zones,MSOAIZ,G,3373,1436,2836,1171,1102,556,1727,612,7,3,196,104,0,0,196,104,104,0,104,124,293,136,277,124,0,0,15,11,1,12,12,48,25
S02001878,Muirend and Old Cathcart,Middle Super Output Areas and Intermediate Zones,MSOAIZ,G,4951,2220,4020,1722,1649,870,2371,852,0,0,275,159,0,0,275,159,159,0,159,294,618,316,575,294,7,3,36,19,0,22,22,38,23
S02001879,Carmunnock North,Middle Super Output Areas and Intermediate Zones,MSOAIZ,G,2903,1205,2698,1094,1072,541,1624,552,2,1,73,48,0,0,73,48,48,0,48,51,117,53,112,51,3,1,2,1,0,2,2,15,10
S02001880,Carmunnock South,Middle Super Output Areas and Intermediate Zones,MSOAIZ,G,3710,1692,1894,785,575,317,1309,465,10,3,1596,815,0,0,1596,815,815,0,815,67,202,83,178,67,6,3,16,11,2,16,16,18,9
S02001881,Glenwood South,Middle Super Output Areas and Intermediate Zones,MSOAIZ,G,5056,2487,1163,461,221,114,913,333,29,14,3704,1947,0,0,3704,1947,1947,0,1947,70,182,75,174,70,0,0,4,3,4,5,5,7,4
S02001882,Glenwood North,Middle Super Output Areas and Intermediate Zones,MSOAIZ,G,4231,1890,1171,446,163,85,971,345,37,16,2851,1356,0,0,2851,1356,1356,0,1356,73,201,85,173,73,5,1,8,3,15,12,12,8,3
S02001883,Castlemilk,Middle Super Output Areas and Intermediate Zones,MSOAIZ,G,4900,2341,2400,1064,628,343,1742,709,30,12,1943,1028,0,0,1943,1028,1028,0,1028,217,544,241,502,217,2,1,28,16,12,24,24,13,8
S02001884,Kingspark South,Middle Super Output Areas and Intermediate Zones,MSOAIZ,G,4157,1727,3181,1328,910,469,2271,859,0,0,84,44,0,0,84,44,44,0,44,304,845,338,780,304,7,3,42,23,16,34,34,47,17
S02001885,Kingspark North,Middle Super Output Areas and Intermediate Zones,MSOAIZ,G,4368,1774,3622,1439,1208,594,2406,840,8,5,104,62,0,0,104,62,62,0,62,240,626,262,579,240,0,0,37,19,10,22,22,16,11
S02001886,Cathcart,Middle Super Output Areas and Intermediate Zones,MSOAIZ,G,4797,2780,3219,1754,1022,628,2189,1124,8,2,513,320,0,0,513,320,320,0,320,646,1043,691,968,646,0,0,63,38,12,45,45,22,15
S02001887,Mount Florida,Middle Super Output Areas and Intermediate Zones,MSOAIZ,G,4147,2264,2775,1388,829,496,1945,891,1,1,443,347,0,0,443,347,347,0,347,482,894,513,838,482,2,1,46,27,8,31,31,35,16
S02001888,Toryglen and Oatlands,Middle Super Output Areas and Intermediate Zones,MSOAIZ,G,5645,2812,2129,960,662,374,1444,572,23,14,2980,1604,0,0,2980,1604,1604,0,1604,208,506,232,468,208,0,0,26,16,12,24,24,30,16
S02001889,Gorbals and Hutchesontown,Middle Super Output Areas and Intermediate Zones,MSOAIZ,G,5794,3288,1642,914,470,301,1119,584,53,29,3297,1955,0,0,3297,1955,1955,0,1955,345,812,400,704,345,0,0,97,46,11,55,55,43,19
S02001890,Laurieston and Tradeston,Middle Super Output Areas and Intermediate Zones,MSOAIZ,G,4449,2546,1127,683,330,203,780,473,17,7,1557,926,0,0,1557,926,926,0,926,838,1714,909,1592,838,3,1,110,65,9,71,71,51,28
S02001891,Calton and Gallowgate,Middle Super Output Areas and Intermediate Zones,MSOAIZ,G,3951,2403,1410,811,383,233,944,529,83,49,1228,821,0,0,1228,821,821,0,821,683,1274,745,1177,683,0,0,93,58,4,62,62,39,26
S02001892,Bridgeton,Middle Super Output Areas and Intermediate Zones,MSOAIZ,G,3515,1979,1061,587,255,157,779,413,27,17,1311,748,0,0,1311,748,748,0,748,562,1113,628,1010,562,5,2,81,53,17,66,66,30,16
S02001893,Dalmarnock,Middle Super Output Areas and Intermediate Zones,MSOAIZ,G,2525,1453,581,320,225,142,310,152,46,26,1706,980,0,0,1706,980,980,0,980,129,227,145,197,129,0,0,27,13,3,16,16,11,8
S02001894,Parkhead West and Barrowfield,Middle Super Output Areas and Intermediate Zones,MSOAIZ,G,5492,2827,1111,546,307,170,625,289,179,87,3523,1816,0,0,3523,1816,1816,0,1816,412,826,446,773,412,4,1,28,20,21,34,34,32,19
S02001895,Parkhead East and Braidfauld North,Middle Super Output Areas and Intermediate Zones,MSOAIZ,G,3144,1649,1034,527,287,165,653,325,94,37,1560,817,0,0,1560,817,817,0,817,273,523,295,488,273,0,0,30,20,5,22,22,27,10
S02001896,Braidfauld,Middle Super Output Areas and Intermediate Zones,MSOAIZ,G,5570,2797,2018,953,575,320,1386,606,57,27,2695,1430,0,0,2695,1430,1430,0,1430,370,829,395,787,370,0,0,33,20,9,25,25,28,19
S02001897,Shettleston South,Middle Super Output Areas and Intermediate Zones,MSOAIZ,G,3863,1664,3279,1329,1027,518,2238,803,14,8,391,236,0,0,391,236,236,0,236,74,174,83,154,74,0,0,20,9,0,9,9,19,16
S02001898,Carmyle and Mount Vernon South,Middle Super Output Areas and Intermediate Zones,MSOAIZ,G,2635,1187,1859,814,646,340,1208,471,5,3,601,301,0,0,601,301,301,0,301,58,169,68,143,58,0,0,18,7,8,10,10,6,4
S02001899,Mount Vernon North and Sandyhills,Middle Super Output Areas and Intermediate Zones,MSOAIZ,G,3760,1569,3373,1382,1397,701,1971,679,5,2,115,44,0,0,115,44,44,0,44,112,240,122,224,112,5,2,10,7,1,10,10,32,21
S02001900,Baillieston West,Middle Super Output Areas and Intermediate Zones,MSOAIZ,G,3842,1762,2811,1214,1034,549,1771,663,6,2,802,441,0,0,802,441,441,0,441,79,216,97,176,79,0,0,35,16,5,18,18,13,10
S02001901,Baillieston East,Middle Super Output Areas and Intermediate Zones,MSOAIZ,G,5251,2270,3720,1479,833,437,2885,1040,2,2,894,455,0,0,894,455,455,0,455,289,590,305,561,289,0,0,26,15,3,16,16,47,31
S02001902,Garrowhill West,Middle Super Output Areas and Intermediate Zones,MSOAIZ,G,4292,1710,3965,1557,1516,756,2443,798,6,3,137,80,0,0,137,80,80,0,80,62,169,65,163,62,0,0,6,3,0,3,3,21,8
S02001903,Garrowhill East and Swinton,Middle Super Output Areas and Intermediate Zones,MSOAIZ,G,4273,1627,3941,1478,857,430,3080,1046,4,2,116,50,0,0,116,50,50,0,50,81,197,88,185,81,0,0,11,6,1,7,7,19,11
S02001904,Easterhouse East,Middle Super Output Areas and Intermediate Zones,MSOAIZ,G,3105,1488,1450,637,294,154,1102,461,54,22,1164,608,0,0,1164,608,608,0,608,225,481,236,463,225,0,0,7,4,11,11,11,10,7
S02001905,Central Easterhouse,Middle Super Output Areas and Intermediate Zones,MSOAIZ,G,2740,1296,415,182,125,66,210,88,80,28,2253,1074,0,0,2253,1074,1074,0,1074,31,70,38,58,31,2,1,2,1,8,7,7,2,2
S02001906,Garthamlock; Auchinlea and Gartloch,Middle Super Output Areas and Intermediate Zones,MSOAIZ,G,3633,1498,1946,740,275,115,1660,618,11,7,1330,603,0,0,1330,603,603,0,603,140,348,150,324,140,0,0,20,9,4,10,10,9,5
S02001907,North Barlanark and Easterhouse South,Middle Super Output Areas and Intermediate Zones,MSOAIZ,G,3366,1449,359,150,76,41,270,104,13,5,2904,1256,0,0,2904,1256,1256,0,1256,31,97,39,81,31,0,0,11,5,5,8,8,6,4
S02001908,Barlanark,Middle Super Output Areas and Intermediate Zones,MSOAIZ,G,4904,2212,1736,744,329,182,1343,535,64,27,2853,1330,0,0,2853,1330,1330,0,1330,115,287,122,268,115,3,1,9,4,7,7,7,28,16
S02001909,Greenfield,Middle Super Output Areas and Intermediate Zones,MSOAIZ,G,5162,2536,3021,1386,1181,655,1832,725,8,6,1680,934,0,0,1680,934,934,0,934,169,422,191,383,169,1,1,25,13,13,22,22,39,25
S02001910,Shettleston North,Middle Super Output Areas and Intermediate Zones,MSOAIZ,G,4492,2626,1852,952,634,383,1188,551,30,18,1987,1319,0,0,1987,1319,1319,0,1319,308,628,336,582,308,0,0,45,27,1,28,28,25,19
S02001911,Tollcross,Middle Super Output Areas and Intermediate Zones,MSOAIZ,G,3554,1854,1496,741,450,270,1005,453,41,18,1460,806,0,0,1460,806,806,0,806,276,581,294,547,276,2,1,25,14,7,18,18,17,13
S02001912,Old Shettleston and Parkhead North,Middle Super Output Areas and Intermediate Zones,MSOAIZ,G,3465,1735,1188,577,397,223,722,314,69,40,1862,941,0,0,1862,941,941,0,941,197,402,209,388,197,2,2,10,9,2,12,12,13,8
S02001913,Carntyne,Middle Super Output Areas and Intermediate Zones,MSOAIZ,G,3291,1710,1957,955,794,480,1161,474,2,1,988,585,0,0,988,585,585,0,585,149,330,158,314,149,0,0,13,8,3,9,9,16,12
S02001914,Cranhill; Lightburn and Queenslie South,Middle Super Output Areas and Intermediate Zones,MSOAIZ,G,6126,2810,2337,1006,787,422,1511,569,39,15,3469,1666,0,0,3469,1666,1666,0,1666,112,301,127,269,112,0,0,16,9,16,15,15,19,11
S02001915,Craigend and Ruchazie,Middle Super Output Areas and Intermediate Zones,MSOAIZ,G,5052,2457,1823,824,574,302,1240,517,9,5,2791,1434,0,0,2791,1434,1434,0,1434,163,412,183,370,163,0,0,28,14,14,20,20,26,16
S02001916,Riddrie and Hogganfield,Middle Super Output Areas and Intermediate Zones,MSOAIZ,G,5037,2353,2275,1050,751,453,1496,583,28,14,2399,1139,0,0,2399,1139,1139,0,1139,131,330,147,296,131,0,0,26,12,8,16,16,33,17
S02001917,Blackhill and Barmulloch East,Middle Super Output Areas and Intermediate Zones,MSOAIZ,G,4415,1981,2059,924,672,364,1371,553,16,7,2061,913,0,0,2061,913,913,0,913,109,273,132,225,109,0,0,31,17,17,23,23,22,12
S02001918,Robroyston and Millerston,Middle Super Output Areas and Intermediate Zones,MSOAIZ,G,6023,2322,5415,2045,990,447,4416,1594,9,4,149,60,0,0,149,60,60,0,60,159,415,197,343,159,0,0,58,25,14,38,38,44,20
S02001919,Balornock,Middle Super Output Areas and Intermediate Zones,MSOAIZ,G,3458,1408,1843,762,656,351,1177,408,10,3,1420,577,0,0,1420,577,577,0,577,51,183,61,157,51,3,1,18,6,5,10,10,12,8
S02001920,Barmulloch,Middle Super Output Areas and Intermediate Zones,MSOAIZ,G,2637,1155,1201,483,419,209,779,271,3,3,1324,626,0,0,1324,626,626,0,626,27,90,36,73,27,5,2,8,4,4,9,9,22,10
S02001921,Petershill,Middle Super Output Areas and Intermediate Zones,MSOAIZ,G,4307,2101,1599,769,368,205,1167,529,64,35,1817,916,0,0,1817,916,916,0,916,220,528,263,443,220,1,1,38,24,46,43,43,363,153
S02001922,Springburn,Middle Super Output Areas and Intermediate Zones,MSOAIZ,G,4577,2371,1941,927,731,396,1206,528,4,3,2220,1221,0,0,2220,1221,1221,0,1221,188,380,204,347,188,0,0,27,14,6,16,16,36,19
S02001923,Springburn East and Cowlairs,Middle Super Output Areas and Intermediate Zones,MSOAIZ,G,4265,2242,1466,699,447,245,1015,452,4,2,2369,1312,0,0,2369,1312,1312,0,1312,192,397,216,355,192,8,3,28,18,6,24,24,33,15
S02001924,Cowlairs and Port Dundas,Middle Super Output Areas and Intermediate Zones,MSOAIZ,G,3477,1904,781,446,197,128,556,299,28,19,2221,1203,0,0,2221,1203,1203,0,1203,212,460,246,391,212,2,1,52,28,15,34,34,15,9
S02001925,Sighthill,Middle Super Output Areas and Intermediate Zones,MSOAIZ,G,2320,1119,396,180,112,53,248,108,36,19,1782,856,0,0,1782,856,856,0,856,63,121,74,99,63,2,1,17,8,3,11,11,21,9
S02001926,Roystonhill; Blochairn; and Provanmill,Middle Super Output Areas and Intermediate Zones,MSOAIZ,G,5720,2944,1042,474,291,165,732,297,19,12,4428,2344,0,0,4428,2344,2344,0,2344,102,233,115,201,102,4,1,16,6,12,13,13,17,11
S02001927,Dennistoun North,Middle Super Output Areas and Intermediate Zones,MSOAIZ,G,3917,2194,1949,1100,626,391,1300,697,23,12,408,236,0,0,408,236,236,0,236,754,1508,825,1387,754,0,0,117,68,4,71,71,52,33
S02001928,Alexandra Parade,Middle Super Output Areas and Intermediate Zones,MSOAIZ,G,2461,1445,927,553,341,213,561,328,25,12,905,554,0,0,905,554,554,0,554,310,612,329,580,310,0,0,26,17,6,19,19,17,9
S02001929,Carntyne West and Haghill,Middle Super Output Areas and Intermediate Zones,MSOAIZ,G,5068,2803,1197,645,373,223,797,409,27,13,3042,1639,0,0,3042,1639,1639,0,1639,464,790,497,730,464,0,0,53,29,7,33,33,39,22
S02001930,Dennistoun,Middle Super Output Areas and Intermediate Zones,MSOAIZ,G,4183,2227,1889,1010,550,322,1320,677,19,11,555,324,0,0,555,324,324,0,324,777,1689,865,1519,777,0,0,156,81,14,88,88,50,28
S02001931,Gallowgate North and Bellgrove,Middle Super Output Areas and Intermediate Zones,MSOAIZ,G,4132,2371,824,465,224,130,483,270,117,65,1995,1146,0,0,1995,1146,1146,0,1146,696,1284,741,1195,696,0,0,74,37,15,45,45,29,19
S02001932,City Centre East,Middle Super Output Areas and Intermediate Zones,MSOAIZ,G,5800,3766,1550,1012,624,411,861,570,65,31,1834,1306,0,0,1834,1306,1306,0,1306,1250,2299,1367,2108,1250,2,2,179,108,10,117,117,117,81
S02001933,City Centre West,Middle Super Output Areas and Intermediate Zones,MSOAIZ,G,4208,2436,1109,643,430,270,649,358,30,15,1061,741,0,0,1061,741,741,0,741,905,1941,979,1802,905,0,0,131,72,8,74,74,97,73
S02001934,City Centre South,Middle Super Output Areas and Intermediate Zones,MSOAIZ,G,2796,1811,709,461,191,136,494,315,24,10,559,442,0,0,559,442,442,0,442,803,1470,868,1352,803,16,5,101,59,1,65,65,58,40
S02001935,Anderston,Middle Super Output Areas and Intermediate Zones,MSOAIZ,G,4419,2464,1190,716,351,214,799,483,40,19,1361,692,0,0,1361,692,692,0,692,941,1808,1012,1687,941,7,4,111,65,3,71,71,60,44
S02001936,Finnieston and Kelvinhaugh,Middle Super Output Areas and Intermediate Zones,MSOAIZ,G,5775,3100,1828,1010,494,297,1302,699,32,14,1099,682,0,0,1099,682,682,0,682,1248,2795,1374,2533,1248,0,0,249,117,13,126,126,53,34
S02001937,Woodlands,Middle Super Output Areas and Intermediate Zones,MSOAIZ,G,6323,2914,2338,1139,787,408,1453,686,98,45,893,438,0,0,893,438,438,0,438,1190,2995,1296,2757,1190,10,4,208,95,20,106,106,97,41
S02001938,Woodside,Middle Super Output Areas and Intermediate Zones,MSOAIZ,G,3334,1961,903,486,362,213,508,259,33,14,1511,981,0,0,1511,981,981,0,981,420,896,482,784,420,0,0,110,61,2,62,62,24,12
S02001939,Firhill,Middle Super Output Areas and Intermediate Zones,MSOAIZ,G,5624,3088,1936,1062,582,357,1257,653,97,52,1917,1102,0,0,1917,1102,1102,0,1102,771,1667,864,1467,771,4,2,179,85,17,93,93,104,60
S02001940,Keppochhill,Middle Super Output Areas and Intermediate Zones,MSOAIZ,G,4287,2327,678,330,163,97,459,208,56,25,3224,1778,0,0,3224,1778,1778,0,1778,182,339,201,311,182,0,0,17,11,11,19,19,46,18
S02001941,Ruchill,Middle Super Output Areas and Intermediate Zones,MSOAIZ,G,5757,3236,2206,1194,600,363,1564,813,42,18,1798,1102,0,0,1798,1102,1102,0,1102,786,1672,891,1495,786,2,1,154,87,21,105,105,81,49
S02001942,Possil Park,Middle Super Output Areas and Intermediate Zones,MSOAIZ,G,5694,2872,2159,984,813,453,1336,525,10,6,3098,1667,0,0,3098,1667,1667,0,1667,191,422,212,382,191,4,1,26,16,10,21,21,15,9
S02001943,Milton West,Middle Super Output Areas and Intermediate Zones,MSOAIZ,G,4183,2018,1945,915,594,352,1315,550,36,13,1864,917,0,0,1864,917,917,0,917,151,341,167,305,151,6,2,29,13,1,16,16,33,19
S02001944,Milton East,Middle Super Output Areas and Intermediate Zones,MSOAIZ,G,3516,1642,1381,590,555,275,815,312,11,3,1965,980,0,0,1965,980,980,0,980,50,160,63,132,50,2,1,18,8,8,13,13,10,9
S02001945,Summerston Central and West,Middle Super Output Areas and Intermediate Zones,MSOAIZ,G,4093,1848,2719,1098,648,328,2064,768,7,2,1174,641,0,0,1174,641,641,0,641,91,196,106,175,91,0,0,19,14,2,15,15,4,3
S02001946,Summerston North,Middle Super Output Areas and Intermediate Zones,MSOAIZ,G,3763,1802,2195,977,765,383,1428,592,2,2,1264,690,0,0,1264,690,690,0,690,113,287,125,256,113,8,2,22,9,1,12,12,17,10
S02001947,Maryhill East,Middle Super Output Areas and Intermediate Zones,MSOAIZ,G,3295,1711,1003,475,322,180,672,291,9,4,2029,1111,0,0,2029,1111,1111,0,1111,114,260,124,232,114,0,0,14,5,14,10,10,3,1
S02001948,Maryhill West,Middle Super Output Areas and Intermediate Zones,MSOAIZ,G,2742,1425,1083,517,297,176,746,321,40,20,1307,733,0,0,1307,733,733,0,733,155,341,167,315,155,0,0,25,11,1,12,12,11,8
S02001949,Wyndford,Middle Super Output Areas and Intermediate Zones,MSOAIZ,G,3619,2261,738,373,308,185,425,184,5,4,2605,1749,0,0,2605,1749,1749,0,1749,96,245,119,200,96,0,0,28,14,17,23,23,31,20
S02001950,Kelvindale,Middle Super Output Areas and Intermediate Zones,MSOAIZ,G,5371,2544,4319,2006,1741,953,2560,1044,18,9,165,84,0,0,165,84,84,0,84,377,841,426,750,377,0,0,83,45,8,49,49,46,28
S02001951,North Kelvin,Middle Super Output Areas and Intermediate Zones,MSOAIZ,G,3774,1863,2236,1062,763,411,1450,643,23,8,287,179,0,0,287,179,179,0,179,532,1199,590,1076,532,8,2,114,55,1,58,58,52,32
S02001952,Kelvingrove and University,Middle Super Output Areas and Intermediate Zones,MSOAIZ,G,5732,2669,2424,1172,872,473,1487,673,65,26,438,252,0,0,438,252,252,0,252,1102,2821,1212,2594,1102,15,6,189,90,23,110,110,49,33
S02001953,Hillhead,Middle Super Output Areas and Intermediate Zones,MSOAIZ,G,5696,3315,1704,1028,542,357,1146,661,16,10,1542,944,0,0,1542,944,944,0,944,1181,2384,1299,2180,1181,2,1,199,115,3,118,118,66,44
S02001954,Glasgow Harbour and Partick South,Middle Super Output Areas and Intermediate Zones,MSOAIZ,G,4594,2925,1730,1099,411,275,1276,798,43,26,905,529,0,0,905,529,529,0,529,1188,1905,1256,1789,1188,4,2,99,61,13,68,68,54,41
S02001955,Partick,Middle Super Output Areas and Intermediate Zones,MSOAIZ,G,3830,2372,1470,888,524,338,926,540,20,10,1133,778,0,0,1133,778,778,0,778,622,1182,680,1064,622,2,1,108,53,8,58,58,45,26
S02001956,Partickhill and Hyndland,Middle Super Output Areas and Intermediate Zones,MSOAIZ,G,5479,2935,3343,1786,1311,785,2011,992,21,9,258,205,0,0,258,205,205,0,205,847,1835,914,1692,847,2,1,136,63,5,67,67,43,30
S02001957,Dowanhill,Middle Super Output Areas and Intermediate Zones,MSOAIZ,G,4281,2176,2728,1383,1111,636,1599,739,18,8,96,61,0,0,96,61,61,0,61,665,1411,704,1339,665,7,2,57,31,8,39,39,46,28
S02001958,Kelvinside and Jordanhill,Middle Super Output Areas and Intermediate Zones,MSOAIZ,G,5491,2391,4441,1831,1803,910,2625,917,13,4,311,196,0,0,311,196,196,0,196,302,673,333,607,302,15,4,45,25,6,31,31,66,31
S02001959,Broomhill,Middle Super Output Areas and Intermediate Zones,MSOAIZ,G,4317,2224,3063,1482,1183,692,1864,781,16,9,514,345,0,0,514,345,345,0,345,332,700,370,634,332,6,2,58,34,2,38,38,40,27
S02001960,Victoria Park,Middle Super Output Areas and Intermediate Zones,MSOAIZ,G,2684,1119,2325,908,940,473,1383,433,2,2,181,120,0,0,181,120,120,0,120,67,156,79,139,67,0,0,15,10,2,12,12,22,12
S02001961,Whiteinch,Middle Super Output Areas and Intermediate Zones,MSOAIZ,G,3405,1988,1057,585,302,188,742,387,13,10,1820,1089,0,0,1820,1089,1089,0,1089,274,513,305,463,274,0,0,48,30,2,31,31,15,9
S02001962,Scotstoun North and East,Middle Super Output Areas and Intermediate Zones,MSOAIZ,G,4304,1915,2781,1134,924,471,1848,659,9,4,1244,663,0,0,1244,663,663,0,663,85,229,101,188,85,3,1,25,11,13,16,16,50,17
S02001963,Scotstoun South and West,Middle Super Output Areas and Intermediate Zones,MSOAIZ,G,3718,1857,1016,501,276,159,722,336,18,6,2291,1150,0,0,2291,1150,1150,0,1150,171,378,193,338,171,0,0,37,21,3,22,22,33,13
S02001964,Yoker South,Middle Super Output Areas and Intermediate Zones,MSOAIZ,G,4558,2344,1837,943,372,220,1454,717,11,6,2140,1072,0,0,2140,1072,1072,0,1072,287,555,317,502,287,0,0,41,26,12,30,30,26,12
S02001965,Yoker North,Middle Super Output Areas and Intermediate Zones,MSOAIZ,G,2850,1153,1901,735,564,278,1334,456,3,1,716,333,0,0,716,333,333,0,333,63,210,72,187,63,3,1,10,6,10,9,9,23,13
S02001966,Knightswood West,Middle Super Output Areas and Intermediate Zones,MSOAIZ,G,2666,1251,1578,676,463,255,1114,420,1,1,838,481,0,0,838,481,481,0,481,85,242,90,227,85,0,0,10,4,5,5,5,8,4
S02001967,Knightswood East,Middle Super Output Areas and Intermediate Zones,MSOAIZ,G,3878,2008,2096,973,695,411,1397,559,4,3,1476,888,0,0,1476,888,888,0,888,113,271,124,251,113,0,0,18,9,2,11,11,35,23
S02001968,Knightswood Park West,Middle Super Output Areas and Intermediate Zones,MSOAIZ,G,3459,1926,1718,869,629,398,1076,465,13,6,1510,946,0,0,1510,946,946,0,946,80,210,94,176,80,0,0,31,13,3,14,14,21,17
S02001969,Knightswood Park East,Middle Super Output Areas and Intermediate Zones,MSOAIZ,G,3692,1793,1967,915,634,375,1329,538,4,2,1409,741,0,0,1409,741,741,0,741,107,296,126,266,107,0,0,23,15,7,19,19,20,11
S02001970,Anniesland East,Middle Super Output Areas and Intermediate Zones,MSOAIZ,G,4171,2207,2995,1539,1037,638,1939,889,19,12,245,162,0,0,245,162,162,0,162,424,880,481,771,424,0,0,87,50,22,57,57,51,25
S02001971,Anniesland West,Middle Super Output Areas and Intermediate Zones,MSOAIZ,G,5890,3097,3707,1968,1104,687,2545,1245,58,36,1040,551,0,0,1040,551,551,0,551,470,1065,526,962,470,19,6,75,45,9,56,56,78,52
S02001972,Blairdardie East,Middle Super Output Areas and Intermediate Zones,MSOAIZ,G,5676,2818,3196,1496,898,539,2290,953,8,4,2012,1104,0,0,2012,1104,1104,0,1104,168,434,195,378,168,0,0,50,24,6,27,27,34,23
S02001973,Blairdardie West,Middle Super Output Areas and Intermediate Zones,MSOAIZ,G,2926,1199,2372,948,743,399,1627,547,2,2,408,191,0,0,408,191,191,0,191,38,124,44,108,38,3,1,11,3,2,6,6,22,16
S02001974,Drumchapel South,Middle Super Output Areas and Intermediate Zones,MSOAIZ,G,2503,1096,792,357,204,117,569,234,19,6,1570,679,0,0,1570,679,679,0,679,45,118,52,104,45,0,0,4,2,10,7,7,23,8
S02001975,Drumchapel North,Middle Super Output Areas and Intermediate Zones,MSOAIZ,G,3686,1650,621,242,106,59,485,174,30,9,2927,1359,0,0,2927,1359,1359,0,1359,33,120,42,102,33,0,0,5,3,13,9,9,18,7
S02001976,Drumry East,Middle Super Output Areas and Intermediate Zones,MSOAIZ,G,3204,1481,530,211,92,51,371,133,67,27,2571,1225,0,0,2571,1225,1225,0,1225,34,97,42,80,34,0,0,7,3,10,8,8,6,3
S02001977,Drumry West,Middle Super Output Areas and Intermediate Zones,MSOAIZ,G,3464,1480,1136,457,156,89,933,343,47,25,2192,963,0,0,2192,963,963,0,963,45,131,56,105,45,0,0,14,6,12,11,11,5,4
S02001978,Lochaber West,Middle Super Output Areas and Intermediate Zones,MSOAIZ,PH,4595,2058,3118,1354,1733,858,1366,486,19,10,672,321,284,154,388,167,167,154,167,219,592,285,434,219,88,31,34,19,36,66,66,213,98
S02001979,Fort William North,Middle Super Output Areas and Intermediate Zones,MSOAIZ,PH,4523,1927,2972,1225,1090,570,1833,629,49,26,1226,554,861,389,365,165,165,389,165,84,264,114,198,84,14,5,45,20,7,30,30,61,34
S02001980,Fort William South,Middle Super Output Areas and Intermediate Zones,MSOAIZ,PH,5739,2497,3193,1393,1244,658,1809,665,140,70,1813,787,1044,434,769,353,353,434,353,214,617,264,508,214,17,10,79,36,13,50,50,116,53
S02001981,Lochaber East and North,Middle Super Output Areas and Intermediate Zones,MSOAIZ,PH,4758,2138,3293,1434,1580,812,1703,617,10,5,785,397,572,297,213,100,100,297,100,171,488,225,384,171,39,17,45,24,20,54,54,192,82
S02001982,Badenoch and Strathspey South,Middle Super Output Areas and Intermediate Zones,MSOAIZ,PH,3754,1692,2557,1124,1369,695,1177,424,11,5,517,253,297,136,220,117,117,136,117,196,487,225,424,196,29,12,32,15,2,29,29,193,90
S02001983,Badenoch and Strathspey Central,Middle Super Output Areas and Intermediate Zones,MSOAIZ,PH,4807,2220,2946,1336,1296,683,1567,618,83,35,915,442,398,217,517,225,225,217,225,339,839,387,733,339,54,18,44,25,8,48,48,107,55
S02001984,Badenoch and Strathspey North,Middle Super Output Areas and Intermediate Zones,MSOAIZ,PH,4558,2039,3181,1376,1561,817,1596,549,24,10,560,292,392,189,168,103,103,189,103,238,632,286,533,238,36,13,42,24,21,48,48,185,85
S02001985,Nairn Rural,Middle Super Output Areas and Intermediate Zones,MSOAIZ,PH,4242,1763,3036,1245,1300,654,1715,583,21,8,323,132,196,84,127,48,48,84,48,324,803,347,751,324,21,8,27,12,4,23,23,80,39
S02001986,Nairn East,Middle Super Output Areas and Intermediate Zones,MSOAIZ,IV,4067,1919,2517,1178,1031,591,1438,559,48,28,934,456,780,369,154,87,87,369,87,221,545,253,470,221,24,8,39,19,12,32,32,71,32
S02001987,Nairn West,Middle Super Output Areas and Intermediate Zones,MSOAIZ,IV,4492,2013,3447,1490,1648,871,1779,611,20,8,678,362,434,232,244,130,130,232,130,115,326,136,278,115,10,3,36,17,2,21,21,41,25
S02001988,Inverness East Rural,Middle Super Output Areas and Intermediate Zones,MSOAIZ,IV,4849,1985,3462,1384,1367,664,2081,716,14,4,676,271,481,207,195,64,64,207,64,234,569,263,492,234,60,23,15,5,2,29,29,142,67
S02001989,Inverness Culloden and Balloch,Middle Super Output Areas and Intermediate Zones,MSOAIZ,IV,4192,1802,3387,1436,1198,620,2179,812,10,4,368,158,328,144,40,14,14,144,14,180,417,194,389,180,0,0,20,12,8,14,14,20,14
S02001990,Inverness Smithton,Middle Super Output Areas and Intermediate Zones,MSOAIZ,IV,3248,1430,2231,935,629,314,1585,616,17,5,586,257,515,218,71,39,39,218,39,201,399,218,363,201,0,0,29,14,7,17,17,32,20
S02001991,Inverness Westhill,Middle Super Output Areas and Intermediate Zones,MSOAIZ,IV,5839,2406,4747,1912,1403,696,3227,1161,117,55,425,194,106,50,319,144,144,50,144,260,641,283,596,260,15,5,26,16,4,23,23,26,17
S02001992,Inverness Inshes,Middle Super Output Areas and Intermediate Zones,MSOAIZ,IV,4321,1719,3267,1282,755,372,2412,862,100,48,305,101,53,16,252,85,85,16,85,294,722,321,656,294,8,5,50,18,8,27,27,27,15
S02001993,Inverness Slackbuie,Middle Super Output Areas and Intermediate Zones,MSOAIZ,IV,2519,988,1829,698,349,159,1445,523,35,16,193,78,31,12,162,66,66,12,66,175,415,191,382,175,17,8,10,5,6,16,16,82,21
S02001994,Inverness Lochardil and Holm Mains,Middle Super Output Areas and Intermediate Zones,MSOAIZ,IV,4910,2186,4232,1860,1903,1011,2303,832,26,17,155,71,67,25,88,46,46,25,46,205,474,230,431,205,7,3,33,20,3,25,25,49,25
S02001995,Inverness Drummond,Middle Super Output Areas and Intermediate Zones,MSOAIZ,IV,3544,1583,2361,1045,1005,547,1341,491,15,7,783,356,468,205,315,151,151,205,151,133,355,156,301,133,5,3,43,18,6,23,23,45,26
S02001996,Inverness Hilton,Middle Super Output Areas and Intermediate Zones,MSOAIZ,IV,3770,1800,2433,1097,776,429,1637,660,20,8,782,425,506,300,276,125,125,300,125,249,535,270,496,249,10,3,26,16,3,21,21,20,8
S02001997,Inverness Drakies,Middle Super Output Areas and Intermediate Zones,MSOAIZ,IV,2516,1026,2242,911,918,450,1319,459,5,2,47,18,27,11,20,7,7,11,7,69,205,86,163,69,2,1,30,13,10,17,17,22,11
S02001998,Inverness Central; Raigmore and Longman,Middle Super Output Areas and Intermediate Zones,MSOAIZ,IV,4198,1974,1795,833,654,363,1085,443,56,27,940,499,668,373,272,126,126,373,126,438,1410,605,909,438,258,74,54,27,189,167,167,53,37
S02001999,Inverness Crown and Haugh,Middle Super Output Areas and Intermediate Zones,MSOAIZ,PA,4175,2019,3101,1440,1572,848,1519,590,10,2,271,161,160,97,111,64,64,97,64,353,761,389,690,353,17,7,44,24,10,36,36,42,29
S02002000,Inverness Ballifeary and Dalneigh,Middle Super Output Areas and Intermediate Zones,MSOAIZ,IV,4598,2155,2406,1128,987,568,1384,547,35,13,1563,731,1313,634,250,97,97,634,97,230,576,263,510,230,12,6,47,24,7,33,33,53,33
S02002001,Inverness Muirtown,Middle Super Output Areas and Intermediate Zones,MSOAIZ,IV,4025,2121,2163,1094,873,511,1239,559,51,24,843,505,580,344,263,161,161,344,161,445,956,492,860,445,18,7,61,33,17,47,47,63,30
S02002002,Inverness Merkinch,Middle Super Output Areas and Intermediate Zones,MSOAIZ,IV,3399,1615,929,422,305,158,545,233,79,31,2204,1077,1918,890,286,187,187,890,187,90,259,111,212,90,1,1,25,12,21,21,21,7,5
S02002003,Inverness Scorguie,Middle Super Output Areas and Intermediate Zones,MSOAIZ,IV,3026,1457,2474,1158,1023,572,1426,573,25,13,153,85,85,44,68,41,41,44,41,176,370,199,331,176,1,1,35,19,3,23,23,29,15
S02002004,Inverness Kinmylies and South West,Middle Super Output Areas and Intermediate Zones,MSOAIZ,IV,3182,1448,2314,1002,727,379,1533,600,54,23,483,267,304,168,179,99,99,168,99,136,365,165,294,136,10,2,57,25,4,29,29,20,14
S02002005,Inverness West Rural,Middle Super Output Areas and Intermediate Zones,MSOAIZ,IV,6288,2665,4962,2054,2286,1123,2651,916,25,15,516,241,403,192,113,49,49,192,49,271,700,309,614,271,33,11,39,19,14,38,38,110,61
S02002006,Loch Ness,Middle Super Output Areas and Intermediate Zones,MSOAIZ,PH,4489,1974,3414,1475,1691,860,1707,608,16,7,408,197,258,124,150,73,73,124,73,204,548,238,471,204,31,12,44,20,2,34,34,119,64
S02002007,Lochlash,Middle Super Output Areas and Intermediate Zones,MSOAIZ,IV,2656,1212,1909,838,983,508,896,318,30,12,461,225,235,117,226,108,108,117,108,78,177,101,133,78,16,7,26,14,2,23,23,109,48
S02002008,Skye South,Middle Super Output Areas and Intermediate Zones,MSOAIZ,PH,3304,1503,2374,1053,1272,639,1083,406,19,8,529,257,238,118,291,139,139,118,139,126,319,157,247,126,8,4,58,24,6,31,31,82,36
S02002009,Skye North East,Middle Super Output Areas and Intermediate Zones,MSOAIZ,IV,3349,1555,2196,966,1000,534,1117,398,79,34,867,442,332,176,535,266,266,176,266,91,223,119,165,91,4,2,45,19,9,28,28,63,28
S02002010,Skye North West,Middle Super Output Areas and Intermediate Zones,MSOAIZ,IV,3284,1476,2673,1189,1542,777,1118,406,13,6,280,128,143,69,137,59,59,69,59,100,246,121,208,100,3,2,30,17,5,21,21,85,38
S02002011,Ross and Cromarty South West,Middle Super Output Areas and Intermediate Zones,MSOAIZ,IV,2941,1401,2199,1040,1366,729,820,304,13,7,329,179,188,109,141,70,70,109,70,106,291,130,242,106,10,5,34,16,5,24,24,122,52
S02002012,Ross and Cromarty North West,Middle Super Output Areas and Intermediate Zones,MSOAIZ,IV,3131,1448,2246,1013,1232,645,997,361,17,7,414,213,246,131,168,82,82,131,82,123,333,155,250,123,32,12,49,19,2,32,32,138,67
S02002013,Ross and Cromarty Central,Middle Super Output Areas and Intermediate Zones,MSOAIZ,IV,3506,1502,2617,1086,1271,620,1334,462,12,4,334,147,246,113,88,34,34,113,34,191,455,213,416,191,11,4,25,15,3,22,22,100,56
S02002014,Ross and Cromarty East,Middle Super Output Areas and Intermediate Zones,MSOAIZ,IV,3236,1357,2484,1025,1084,540,1391,482,9,3,315,129,181,79,134,50,50,79,50,138,325,156,283,138,8,3,33,14,1,18,18,112,47
S02002015,Muir of Ord,Middle Super Output Areas and Intermediate Zones,MSOAIZ,IV,3274,1397,2392,988,973,479,1390,493,29,16,588,268,343,172,245,96,96,172,96,113,258,121,235,113,7,1,16,7,0,8,8,36,20
S02002016,Conon,Middle Super Output Areas and Intermediate Zones,MSOAIZ,IV,3511,1451,2679,1083,1167,581,1502,499,10,3,576,251,452,199,124,52,52,199,52,72,203,87,170,72,15,6,12,7,6,15,15,53,30
S02002017,Dingwall,Middle Super Output Areas and Intermediate Zones,MSOAIZ,IV,5371,2420,3485,1518,1433,744,2000,746,52,28,1235,604,1027,501,208,103,103,501,103,206,560,249,470,206,9,4,64,32,17,43,43,91,49
S02002018,Black Isle South,Middle Super Output Areas and Intermediate Zones,MSOAIZ,IV,6262,2693,4965,2077,2457,1224,2475,837,33,16,572,282,440,228,132,54,54,228,54,246,608,272,550,246,14,5,42,20,2,26,26,117,62
S02002019,Black Isle North,Middle Super Output Areas and Intermediate Zones,MSOAIZ,IV,3625,1458,2976,1169,1456,677,1518,491,2,1,245,107,235,101,10,6,6,101,6,134,332,147,303,134,4,1,22,9,3,13,13,72,35
S02002020,Alness,Middle Super Output Areas and Intermediate Zones,MSOAIZ,IV,5888,2514,3152,1323,1185,616,1917,687,50,20,2326,1008,2174,930,152,78,78,930,78,115,328,136,287,115,5,3,33,16,3,21,21,82,47
S02002021,Invergordon,Middle Super Output Areas and Intermediate Zones,MSOAIZ,IV,4224,1876,2436,1070,1097,577,1322,485,17,8,1492,645,691,310,801,335,335,310,335,113,265,137,216,113,3,2,43,20,3,24,24,31,24
S02002022,Seaboard,Middle Super Output Areas and Intermediate Zones,MSOAIZ,IV,4457,1959,2929,1276,1454,753,1462,516,13,7,878,377,683,291,195,86,86,291,86,212,531,246,446,212,18,8,62,25,5,34,34,119,60
S02002023,Tain,Middle Super Output Areas and Intermediate Zones,MSOAIZ,IV,3783,1707,2374,1035,999,548,1344,476,31,11,975,480,615,307,360,173,173,307,173,131,367,155,308,131,12,5,38,15,9,24,24,67,37
S02002024,Sutherland South,Middle Super Output Areas and Intermediate Zones,MSOAIZ,IV,5979,2816,4288,1966,2516,1315,1761,644,11,7,814,436,660,362,154,74,74,362,74,251,632,306,517,251,36,17,59,26,20,55,55,245,108
S02002025,Sutherland East,Middle Super Output Areas and Intermediate Zones,MSOAIZ,KW,4270,2037,2821,1312,1621,878,1195,431,5,3,921,479,752,383,169,96,96,383,96,143,376,171,315,143,10,4,49,22,2,28,28,152,75
S02002026,Caithness South,Middle Super Output Areas and Intermediate Zones,MSOAIZ,KW,2886,1303,2259,974,1277,620,974,351,8,3,323,174,308,162,15,12,12,162,12,81,196,98,161,81,6,3,25,13,4,17,17,108,57
S02002027,Wick South,Middle Super Output Areas and Intermediate Zones,MSOAIZ,KW,3632,1741,2235,990,1013,541,1213,445,9,4,1121,599,899,481,222,118,118,481,118,99,225,121,184,99,5,3,33,17,3,22,22,51,31
S02002028,Wick North,Middle Super Output Areas and Intermediate Zones,MSOAIZ,KW,3220,1469,2251,963,910,488,1332,471,9,4,746,377,703,357,43,20,20,357,20,90,176,101,163,90,3,3,8,7,2,11,11,47,28
S02002029,Caithness North East,Middle Super Output Areas and Intermediate Zones,MSOAIZ,KW,3767,1601,3026,1231,1629,768,1395,461,2,2,393,204,371,197,22,7,7,197,7,113,287,130,260,113,4,2,16,9,7,17,17,61,36
S02002030,Caithness North West,Middle Super Output Areas and Intermediate Zones,MSOAIZ,KW,5059,2204,4018,1672,2030,967,1964,695,24,10,529,279,460,254,69,25,25,254,25,180,433,209,378,180,5,3,38,19,12,29,29,79,44
S02002031,Thurso East,Middle Super Output Areas and Intermediate Zones,MSOAIZ,KW,2895,1507,1856,901,884,499,956,394,16,8,777,453,522,311,255,142,142,311,142,106,205,122,165,106,5,3,28,11,7,16,16,57,31
S02002032,Thurso West,Middle Super Output Areas and Intermediate Zones,MSOAIZ,KW,4793,2200,3077,1386,1505,786,1558,594,14,6,1360,622,485,257,875,365,365,257,365,135,312,164,241,135,13,8,44,16,14,29,29,44,28
S02002033,Sutherland North and West,Middle Super Output Areas and Intermediate Zones,MSOAIZ,KW,3438,1665,2422,1135,1562,810,859,324,1,1,499,265,330,183,169,82,82,183,82,122,301,164,216,122,26,13,44,19,15,42,42,216,101
S02002034,Kilmacolm Central,Middle Super Output Areas and Intermediate Zones,MSOAIZ,PA,2553,1176,2189,973,941,524,1248,449,0,0,82,52,0,0,82,52,52,0,52,111,242,127,221,111,0,0,19,14,2,16,16,40,24
S02002035,Kilmacolm; Quarriers; Greenock Upper East/Central,Middle Super Output Areas and Intermediate Zones,MSOAIZ,PA,3026,1263,2529,1030,973,489,1487,516,69,25,157,79,0,0,157,79,79,0,79,122,315,140,288,122,4,2,16,12,7,18,18,25,14
S02002036,Inverkip and Wemyss Bay,Middle Super Output Areas and Intermediate Zones,MSOAIZ,PA,5759,2244,5173,1938,1334,665,3833,1270,6,3,192,98,0,0,192,98,98,0,98,168,373,192,332,168,5,3,26,17,10,24,24,21,16
S02002037,West Braeside; East Inverkip and West Gourock,Middle Super Output Areas and Intermediate Zones,MSOAIZ,PA,3193,1324,2993,1221,1155,588,1827,628,11,5,36,13,0,0,36,13,13,0,13,71,148,83,126,71,6,2,15,9,1,12,12,16,7
S02002038,Gourock Upper and West Central and Upper Larkfield,Middle Super Output Areas and Intermediate Zones,MSOAIZ,PA,4240,2032,3531,1645,1375,802,2143,837,13,6,263,136,0,0,263,136,136,0,136,219,435,245,399,219,3,2,25,16,8,26,26,11,6
S02002039,Gourock Central; Upper East and IRH,Middle Super Output Areas and Intermediate Zones,MSOAIZ,PA,4243,2123,3137,1437,1151,643,1956,782,30,12,582,369,0,0,582,369,369,0,369,287,512,311,468,287,0,0,39,19,5,24,24,12,6
S02002040,Braeside; Branchton; Lower Larkfield and Ravenscraig,Middle Super Output Areas and Intermediate Zones,MSOAIZ,PA,6318,2615,3730,1520,1064,547,2660,969,6,4,2184,941,0,0,2184,941,941,0,941,125,380,141,342,125,0,0,25,10,13,16,16,24,13
S02002041,Lower Bow and Larkfield; Fancy Farm; Mallard Bowl,Middle Super Output Areas and Intermediate Zones,MSOAIZ,PA,4985,2290,2977,1280,813,455,2076,788,88,37,1699,853,0,0,1699,853,853,0,853,123,298,147,255,123,1,1,32,18,10,24,24,11,10
S02002042,Gourock East; Greenock West and Lyle Road,Middle Super Output Areas and Intermediate Zones,MSOAIZ,PA,4753,2105,4173,1787,1951,1032,2214,752,8,3,249,144,0,0,249,144,144,0,144,128,290,148,254,128,4,2,20,10,12,20,20,41,26
S02002043,Greenock West and Central,Middle Super Output Areas and Intermediate Zones,MSOAIZ,PA,5872,3042,3656,1735,1290,750,2330,960,36,25,1041,681,0,0,1041,681,681,0,681,543,1106,596,1016,543,3,1,78,43,9,53,53,69,30
S02002044,Bow Farm; Barrs Cottage; Cowdenknowes and Overton,Middle Super Output Areas and Intermediate Zones,MSOAIZ,PA,4372,1991,3352,1421,1159,614,2173,791,20,16,730,416,0,0,730,416,416,0,416,124,266,138,239,124,0,0,21,11,6,14,14,24,16
S02002045,Greenock Upper Central,Middle Super Output Areas and Intermediate Zones,MSOAIZ,PA,4230,2438,1746,876,634,366,1101,500,11,10,1964,1225,0,0,1964,1225,1225,0,1225,296,510,328,455,296,2,1,39,22,14,32,32,10,9
S02002046,Greenock Town Centre and East Central,Middle Super Output Areas and Intermediate Zones,MSOAIZ,PA,5006,2932,2013,1064,792,456,1212,599,9,9,2381,1495,0,0,2381,1495,1495,0,1495,331,592,356,544,331,0,0,43,21,5,25,25,20,17
S02002047,Greenock East,Middle Super Output Areas and Intermediate Zones,MSOAIZ,PA,6202,2801,3094,1300,811,401,2237,875,46,24,2604,1261,0,0,2604,1261,1261,0,1261,205,498,235,436,205,8,2,32,16,22,30,30,6,5
S02002048,Port Glasgow Upper; West and Central,Middle Super Output Areas and Intermediate Zones,MSOAIZ,PA,5557,2601,3822,1567,1144,581,2675,985,3,1,1088,677,0,0,1088,677,677,0,677,298,626,342,562,298,0,0,50,31,14,44,44,21,15
S02002049,Port Glasgow Mid; East and Central,Middle Super Output Areas and Intermediate Zones,MSOAIZ,PA,4847,2228,2658,1151,909,479,1749,672,0,0,1701,799,0,0,1701,799,799,0,799,242,466,266,417,242,0,0,36,19,13,24,24,22,12
S02002050,Port Glasgow Upper East,Middle Super Output Areas and Intermediate Zones,MSOAIZ,PA,5105,2229,2936,1219,930,484,2000,732,6,3,1791,854,0,0,1791,854,854,0,854,134,368,147,340,134,4,1,21,10,3,13,13,10,9
S02002051,Rural South Midlothian,Middle Super Output Areas and Intermediate Zones,MSOAIZ,EH,2616,1113,1822,732,592,302,1221,427,9,3,351,184,207,105,144,79,79,105,79,155,382,171,342,155,14,5,12,7,14,16,16,61,26
S02002052,Penicuik Southeast,Middle Super Output Areas and Intermediate Zones,MSOAIZ,EH,3898,1843,2779,1226,1112,592,1645,621,22,13,781,442,610,302,171,140,140,302,140,131,317,160,268,131,1,1,41,24,7,29,29,21,15
S02002053,Penicuik Southwest,Middle Super Output Areas and Intermediate Zones,MSOAIZ,EH,3914,1597,3159,1267,1211,611,1943,654,5,2,565,256,448,206,117,50,50,206,50,55,176,65,154,55,0,0,15,9,7,10,10,14,9
S02002054,Penicuik East,Middle Super Output Areas and Intermediate Zones,MSOAIZ,EH,2560,1096,1568,642,453,244,1110,396,5,2,839,392,819,382,20,10,10,382,10,49,144,56,129,49,0,0,12,6,3,7,7,9,6
S02002055,Penicuik North,Middle Super Output Areas and Intermediate Zones,MSOAIZ,EH,3500,1406,2818,1122,898,478,1913,641,7,3,503,215,175,78,328,137,137,78,137,53,168,64,137,53,7,2,16,7,8,11,11,11,5
S02002056,Pentland,Middle Super Output Areas and Intermediate Zones,MSOAIZ,EH,2226,855,1403,569,559,266,839,301,5,2,236,83,109,44,127,39,39,44,39,64,523,176,144,64,224,65,12,8,143,112,112,64,27
S02002057,Roslin and Bilston,Middle Super Output Areas and Intermediate Zones,MSOAIZ,EH,3301,1432,2277,971,887,465,1388,505,2,1,741,320,469,202,272,118,118,202,118,95,246,117,206,95,11,8,21,10,8,22,22,37,24
S02002058,Straiton,Middle Super Output Areas and Intermediate Zones,MSOAIZ,EH,2519,1155,1926,874,886,501,1013,358,27,15,432,206,382,184,50,22,22,184,22,55,153,68,124,55,0,0,25,11,4,13,13,8,7
S02002059,Loanhead,Middle Super Output Areas and Intermediate Zones,MSOAIZ,EH,3589,1626,2511,1120,1011,552,1489,562,11,6,766,361,644,290,122,71,71,290,71,107,267,118,242,107,0,0,25,11,0,11,11,45,27
S02002060,Bonnyrigg South,Middle Super Output Areas and Intermediate Zones,MSOAIZ,EH,4797,1955,3039,1224,982,497,2026,714,31,13,1458,609,1285,540,173,69,69,540,69,86,277,107,232,86,1,1,40,18,4,21,21,23,15
S02002061,Bonnyrigg North,Middle Super Output Areas and Intermediate Zones,MSOAIZ,EH,5521,2491,3717,1617,1449,783,2265,832,3,2,1328,636,1038,495,290,141,141,495,141,175,417,205,348,175,10,2,39,19,20,30,30,59,33
S02002062,Newbattle and Dalhousie,Middle Super Output Areas and Intermediate Zones,MSOAIZ,EH,5913,2157,5072,1807,1007,484,4056,1318,9,5,496,211,381,163,115,48,48,163,48,104,318,122,276,104,0,0,31,14,11,18,18,27,17
S02002063,Eskbank,Middle Super Output Areas and Intermediate Zones,MSOAIZ,EH,4365,1833,3894,1602,1597,813,2297,789,0,0,186,103,87,42,99,61,61,42,61,103,264,116,227,103,9,2,25,10,3,13,13,21,12
S02002064,Shawfair,Middle Super Output Areas and Intermediate Zones,MSOAIZ,EH,3504,1461,2375,974,765,393,1602,578,8,3,871,380,611,277,260,103,103,277,103,79,223,91,193,79,4,1,26,11,0,12,12,35,16
S02002065,Thornybank,Middle Super Output Areas and Intermediate Zones,MSOAIZ,EH,3637,1593,2068,890,621,329,1430,554,17,7,1294,580,1159,531,135,49,49,531,49,89,246,102,209,89,3,1,22,8,12,13,13,29,21
S02002066,Dalkeith,Middle Super Output Areas and Intermediate Zones,MSOAIZ,EH,2835,1458,1171,585,419,263,739,316,13,6,1366,698,1183,581,183,117,117,581,117,149,272,158,260,149,0,0,12,9,0,9,9,26,17
S02002067,Pathhead and Rural East Midlothian,Middle Super Output Areas and Intermediate Zones,MSOAIZ,EH,5284,2203,3653,1450,1194,587,2443,857,16,6,1044,486,842,369,202,117,117,369,117,209,504,227,470,209,6,3,22,12,6,18,18,83,40
S02002068,Easthouses,Middle Super Output Areas and Intermediate Zones,MSOAIZ,EH,3057,1236,1664,703,515,272,1137,426,12,5,1205,460,287,118,918,342,342,118,342,45,171,63,127,45,0,0,37,16,7,18,18,17,10
S02002069,Mayfield,Middle Super Output Areas and Intermediate Zones,MSOAIZ,EH,4719,1987,2379,969,633,349,1733,615,13,5,2142,924,1418,605,724,319,319,605,319,66,185,85,145,66,5,2,26,12,9,19,19,13,9
S02002070,Newtongrange,Middle Super Output Areas and Intermediate Zones,MSOAIZ,EH,4117,1816,2394,1015,755,383,1630,627,9,5,1423,649,638,277,785,372,372,277,372,111,273,130,236,111,0,0,29,15,8,19,19,27,22
S02002071,North Gorebridge,Middle Super Output Areas and Intermediate Zones,MSOAIZ,EH,2630,1138,1172,500,310,159,855,336,7,5,1249,533,862,359,387,174,174,359,174,87,194,95,182,87,1,1,9,5,2,8,8,15,10
S02002072,Gorebridge and Middleton,Middle Super Output Areas and Intermediate Zones,MSOAIZ,EH,3755,1527,2087,843,617,310,1470,533,0,0,1468,589,834,380,634,209,209,380,209,77,172,82,159,77,0,0,10,4,3,5,5,28,13
S02002073,South Speyside and the Cabrach,Middle Super Output Areas and Intermediate Zones,MSOAIZ,AB,4312,1889,2910,1262,1471,743,1436,517,3,2,567,273,416,199,151,74,74,199,74,191,576,234,463,191,41,13,28,15,44,43,43,259,120
S02002074,North Speyside,Middle Super Output Areas and Intermediate Zones,MSOAIZ,IV,3741,1656,2625,1122,1261,645,1355,471,9,6,570,294,513,254,57,40,40,254,40,140,392,167,340,140,25,13,25,13,2,27,27,154,73
S02002075,Rural Keith and Strathisla,Middle Super Output Areas and Intermediate Zones,MSOAIZ,AB,3117,1236,2417,953,1337,600,1077,352,3,1,209,76,197,73,12,3,3,73,3,137,366,159,309,137,15,5,30,14,12,22,22,125,48
S02002076,Keith and Fife Keith,Middle Super Output Areas and Intermediate Zones,MSOAIZ,AB,4653,2181,3144,1377,1569,827,1565,543,10,7,1109,582,904,466,205,116,116,466,116,147,318,172,276,147,1,1,39,23,2,25,25,82,50
S02002077,Cullen; Portknockie; Findochty; Drybridge and Berryhillock,Middle Super Output Areas and Intermediate Zones,MSOAIZ,AB,5366,2331,3946,1708,1938,981,2000,723,8,4,941,403,703,297,238,106,106,297,106,144,395,170,334,144,9,4,31,11,21,26,26,84,50
S02002078,Buckie Central East,Middle Super Output Areas and Intermediate Zones,MSOAIZ,AB,3520,1573,2189,941,984,510,1200,429,5,2,1113,540,1059,500,54,40,40,500,40,61,183,75,140,61,5,1,26,10,12,14,14,35,17
S02002079,Buckie West and Mains of Buckie,Middle Super Output Areas and Intermediate Zones,MSOAIZ,AB,4436,2036,3347,1447,1504,796,1842,650,1,1,746,409,543,281,203,128,128,281,128,124,282,140,253,124,7,4,20,11,2,16,16,61,40
S02002080,Mosstodloch; Portgordon and seaward,Middle Super Output Areas and Intermediate Zones,MSOAIZ,IV,3674,1595,2903,1233,1382,698,1514,531,7,4,425,209,360,180,65,29,29,180,29,100,282,124,224,100,3,1,24,9,31,24,24,64,29
S02002081,Fochabers; Aultmore; Clochan and Ordiquish,Middle Super Output Areas and Intermediate Zones,MSOAIZ,IV,2346,1067,1637,729,799,419,835,309,3,1,394,198,240,125,154,73,73,125,73,91,267,122,196,91,11,4,36,14,24,31,31,48,18
S02002082,Heldon West; Fogwatt to Inchberry,Middle Super Output Areas and Intermediate Zones,MSOAIZ,IV,2967,1194,2185,873,916,432,1239,429,30,12,331,127,69,26,262,101,101,26,101,137,364,155,320,137,23,10,10,5,11,18,18,87,39
S02002083,Lhanbryde; Urquhart; Pitgavney and seaward,Middle Super Output Areas and Intermediate Zones,MSOAIZ,IV,3298,1421,2177,917,844,435,1320,477,13,5,655,296,627,281,28,15,15,281,15,173,411,184,385,173,10,4,11,5,5,11,11,55,24
S02002084,Elgin Cathedral to Ashgrove and Pinefield,Middle Super Output Areas and Intermediate Zones,MSOAIZ,IV,4203,1940,1800,864,736,430,1058,431,6,3,1443,685,933,475,510,210,210,475,210,257,936,377,561,257,240,73,27,13,108,120,120,24,14
S02002085,New Elgin East,Middle Super Output Areas and Intermediate Zones,MSOAIZ,IV,3867,1650,2394,997,688,370,1693,622,13,5,1018,471,685,329,333,142,142,329,142,149,432,166,378,149,6,2,31,9,17,17,17,23,16
S02002086,New Elgin West,Middle Super Output Areas and Intermediate Zones,MSOAIZ,IV,4075,1750,2995,1257,1106,571,1887,684,2,2,730,345,540,285,190,60,60,285,60,99,320,130,247,99,36,12,28,15,9,31,31,30,18
S02002087,Elgin Central West,Middle Super Output Areas and Intermediate Zones,MSOAIZ,IV,3207,1473,2610,1165,1319,701,1275,455,16,9,130,90,80,50,50,40,40,50,40,162,415,188,366,162,10,6,27,14,12,26,26,52,30
S02002088,Elgin Bishopmill East and Ladyhill,Middle Super Output Areas and Intermediate Zones,MSOAIZ,IV,3441,1602,2026,908,695,390,1314,511,17,7,879,449,536,277,343,172,172,277,172,208,505,226,456,208,13,4,16,8,20,18,18,31,19
S02002089,Elgin Bishopmill West and Newfield,Middle Super Output Areas and Intermediate Zones,MSOAIZ,IV,3317,1330,1706,722,625,338,1073,380,8,4,521,266,431,233,90,33,33,233,33,88,1079,334,236,88,527,150,32,12,284,246,246,11,8
S02002090,Lossiemouth East and Seatown,Middle Super Output Areas and Intermediate Zones,MSOAIZ,IV,3464,1620,2523,1132,1065,582,1453,547,5,3,438,214,327,162,111,52,52,162,52,218,451,248,393,218,10,3,30,20,18,30,30,52,26
S02002091,Lossiemouth West,Middle Super Output Areas and Intermediate Zones,MSOAIZ,IV,3640,1467,1947,789,648,323,1298,465,1,1,943,409,520,251,423,158,158,251,158,117,735,260,284,117,269,82,37,15,145,143,143,15,9
S02002092,Burghead; Roseisle and Laich,Middle Super Output Areas and Intermediate Zones,MSOAIZ,IV,4965,2058,3845,1569,1591,807,2243,757,11,5,468,202,291,128,177,74,74,128,74,196,524,226,458,196,31,11,30,16,5,30,30,128,61
S02002093,Findhorn; Kinloss and Pluscarden Valley,Middle Super Output Areas and Intermediate Zones,MSOAIZ,IV,3189,1328,1764,778,811,412,949,364,4,2,256,113,132,59,124,54,54,59,54,204,1091,394,461,204,330,100,34,14,266,190,190,78,43
S02002094,Forres Central East and seaward,Middle Super Output Areas and Intermediate Zones,MSOAIZ,IV,3695,1917,2721,1315,1381,774,1327,535,13,6,517,338,343,217,174,121,121,217,121,215,421,239,374,215,0,0,26,17,21,24,24,36,25
S02002095,Forres South West and Mannachie,Middle Super Output Areas and Intermediate Zones,MSOAIZ,IV,5352,2368,3174,1390,1302,698,1866,689,6,3,1539,698,971,488,568,210,210,488,210,210,608,258,494,210,16,4,85,38,13,48,48,31,22
S02002096,Rafford; Dallas; Dyke to Dava,Middle Super Output Areas and Intermediate Zones,MSOAIZ,IV,3358,1380,2400,961,997,488,1403,473,0,0,198,66,70,26,128,40,40,26,40,275,656,308,586,275,22,12,23,11,25,33,33,104,45
S02002097,Arran,Middle Super Output Areas and Intermediate Zones,MSOAIZ,KA,4448,2126,3324,1571,2084,1114,1222,448,18,9,496,263,63,33,433,230,230,33,230,187,517,227,417,187,35,10,60,26,5,40,40,111,65
S02002098,Springside and Rural,Middle Super Output Areas and Intermediate Zones,MSOAIZ,KA,2621,1143,1743,737,713,356,1015,377,15,4,579,290,494,257,85,33,33,257,33,85,288,109,212,85,29,9,17,7,30,24,24,11,7
S02002099,Irvine Tarryholme,Middle Super Output Areas and Intermediate Zones,MSOAIZ,KA,2984,1285,2465,1020,885,467,1580,553,0,0,380,198,341,183,39,15,15,183,15,48,119,56,105,48,0,0,14,8,0,8,8,20,11
S02002100,Dreghorn,Middle Super Output Areas and Intermediate Zones,MSOAIZ,KA,3562,1614,2531,1090,836,447,1684,639,11,4,723,371,619,317,104,54,54,317,54,110,269,129,235,110,6,4,25,13,3,19,19,39,24
S02002101,Irvine Broomlands,Middle Super Output Areas and Intermediate Zones,MSOAIZ,KA,2908,1196,1531,624,312,163,1216,460,3,1,1020,433,791,341,229,92,92,341,92,119,342,130,316,119,0,0,26,11,0,11,11,15,9
S02002102,Irvine Bourtreehill,Middle Super Output Areas and Intermediate Zones,MSOAIZ,KA,2398,998,1170,470,288,151,882,319,0,0,968,437,646,320,322,117,117,320,117,80,257,88,238,80,0,0,10,5,9,8,8,3,3
S02002103,Irvine Girdle Toll and Staneca,Middle Super Output Areas and Intermediate Zones,MSOAIZ,KA,4312,1954,3087,1320,872,462,2199,852,16,6,902,485,696,378,206,107,107,378,107,126,310,141,279,126,0,0,29,13,2,15,15,13,8
S02002104,Irvine Perceton and Lawthorn,Middle Super Output Areas and Intermediate Zones,MSOAIZ,KA,5182,1979,4027,1451,796,368,3191,1065,40,18,928,444,414,202,514,242,242,202,242,70,222,80,202,70,3,1,12,8,5,10,10,5,4
S02002105,Irvine Castlepark North,Middle Super Output Areas and Intermediate Zones,MSOAIZ,KA,3526,1483,1802,743,561,302,1216,433,25,8,1284,563,754,337,530,226,226,337,226,157,422,168,403,157,2,1,15,8,2,11,11,18,9
S02002106,Irvine Castlepark South,Middle Super Output Areas and Intermediate Zones,MSOAIZ,KA,3166,1439,1511,652,476,260,1035,392,0,0,1339,640,1121,529,218,111,111,529,111,125,306,138,282,125,5,2,18,10,1,13,13,10,9
S02002107,Irvine East,Middle Super Output Areas and Intermediate Zones,MSOAIZ,KA,3086,1472,1908,856,616,356,1291,499,1,1,924,486,706,375,218,111,111,375,111,102,235,118,212,102,2,2,13,8,8,16,16,19,12
S02002108,Irvine Central,Middle Super Output Areas and Intermediate Zones,MSOAIZ,KA,3145,1629,1876,905,786,445,1088,458,2,2,842,484,599,363,243,121,121,363,121,207,405,224,384,207,0,0,18,14,3,17,17,22,16
S02002109,Irvine Fullarton,Middle Super Output Areas and Intermediate Zones,MSOAIZ,KA,2874,1597,937,479,373,218,554,255,10,6,1691,969,1237,736,454,233,233,736,233,130,229,139,212,130,0,0,11,5,6,9,9,17,10
S02002110,Stevenston Ardeer,Middle Super Output Areas and Intermediate Zones,MSOAIZ,KA,2322,1093,1160,525,424,224,733,299,3,2,953,457,839,383,114,74,74,383,74,100,199,104,193,100,2,1,3,2,1,4,4,10,7
S02002111,Saltcoats Central,Middle Super Output Areas and Intermediate Zones,MSOAIZ,KA,3777,2113,1871,923,723,424,1143,497,5,2,1305,797,823,532,482,265,265,532,265,364,587,383,562,364,3,2,20,15,2,19,19,14,10
S02002112,Ardrossan Central,Middle Super Output Areas and Intermediate Zones,MSOAIZ,KA,3111,1783,1363,652,516,290,841,358,6,4,1305,866,851,532,454,334,334,532,334,235,415,247,393,235,0,0,19,11,3,12,12,28,18
S02002113,Ardrossan North West,Middle Super Output Areas and Intermediate Zones,MSOAIZ,KA,3094,1421,2562,1149,1007,547,1549,599,6,3,242,125,210,107,32,18,18,107,18,114,274,135,234,114,4,3,35,17,1,21,21,16,12
S02002114,Ardrossan North East,Middle Super Output Areas and Intermediate Zones,MSOAIZ,KA,4589,1925,2525,1016,702,355,1802,654,21,7,1761,772,1396,631,365,141,141,631,141,106,279,123,248,106,0,0,26,15,5,17,17,24,14
S02002115,Saltcoats North West,Middle Super Output Areas and Intermediate Zones,MSOAIZ,KA,3731,1572,3195,1290,1095,585,2098,704,2,1,341,187,254,137,87,50,50,137,50,73,183,89,154,73,2,1,23,13,4,16,16,12,6
S02002116,Saltcoats North East,Middle Super Output Areas and Intermediate Zones,MSOAIZ,KA,5040,2074,2679,1102,741,387,1927,709,11,6,1940,793,1629,677,311,116,116,677,116,148,405,166,360,148,7,2,33,13,5,18,18,16,13
S02002117,Stevenston North West,Middle Super Output Areas and Intermediate Zones,MSOAIZ,KA,2914,1437,1769,817,816,439,952,377,1,1,804,448,704,391,100,57,57,391,57,146,324,163,294,146,0,0,28,15,2,17,17,17,9
S02002118,Stevenston Hayocks,Middle Super Output Areas and Intermediate Zones,MSOAIZ,KA,4206,1796,2077,867,601,323,1464,540,12,4,1720,749,1653,725,67,24,24,725,24,162,402,174,382,162,3,1,16,10,1,12,12,7,6
S02002119,Kilwinning Whitehirst Park and Woodside,Middle Super Output Areas and Intermediate Zones,MSOAIZ,KA,5304,2069,4755,1805,1158,573,3593,1231,4,1,243,120,103,42,140,78,78,42,78,120,285,132,264,120,1,1,20,11,0,12,12,21,12
S02002120,Kilwinning Pennyburn,Middle Super Output Areas and Intermediate Zones,MSOAIZ,KA,3013,1250,1479,632,445,231,1032,400,2,1,1315,530,254,107,1061,423,423,107,423,77,216,86,196,77,0,0,15,8,5,9,9,3,2
S02002121,Kilwinning West and Blacklands,Middle Super Output Areas and Intermediate Zones,MSOAIZ,KA,4231,2014,2218,1003,774,439,1440,562,4,2,1742,892,1519,784,223,108,108,784,108,91,241,106,213,91,0,0,26,14,2,15,15,30,13
S02002122,Kilwinning Central and North,Middle Super Output Areas and Intermediate Zones,MSOAIZ,KA,3816,1756,2174,958,838,452,1330,503,6,3,1355,652,1121,536,234,116,116,536,116,109,264,128,227,109,0,0,37,19,0,19,19,23,18
S02002123,Dalry East and Rural,Middle Super Output Areas and Intermediate Zones,MSOAIZ,KA,2994,1451,1948,864,845,439,1103,425,0,0,786,456,724,425,62,31,31,425,31,102,235,117,203,102,3,1,27,13,2,15,15,25,14
S02002124,Dalry West,Middle Super Output Areas and Intermediate Zones,MSOAIZ,KA,3131,1333,2047,846,697,362,1346,482,4,2,844,371,651,303,193,68,68,303,68,88,223,103,199,88,0,0,24,15,0,15,15,17,13
S02002125,Fairlie and Rural,Middle Super Output Areas and Intermediate Zones,MSOAIZ,KA,2320,1048,1930,858,977,509,947,347,6,2,104,56,93,52,11,4,4,52,4,93,235,104,211,93,5,3,19,8,0,11,11,51,30
S02002126,West Kilbride and Seamill,Middle Super Output Areas and Intermediate Zones,MSOAIZ,KA,4759,2132,3826,1654,1668,890,2146,758,12,6,540,268,503,245,37,23,23,245,23,168,359,187,324,168,3,2,27,15,5,19,19,34,23
S02002127,Largs South,Middle Super Output Areas and Intermediate Zones,MSOAIZ,KA,3645,1865,3148,1572,1576,962,1566,607,6,3,144,84,129,75,15,9,9,75,9,160,318,183,285,160,0,0,30,20,3,23,23,35,26
S02002128,Largs Central and Cumbrae,Middle Super Output Areas and Intermediate Zones,MSOAIZ,KA,4829,2575,3294,1656,1449,896,1826,749,19,11,722,415,505,286,217,129,129,286,129,431,757,468,696,431,4,2,56,34,1,37,37,56,36
S02002129,Largs North,Middle Super Output Areas and Intermediate Zones,MSOAIZ,KA,4009,1915,3576,1678,1852,1041,1714,632,10,5,115,66,96,59,19,7,7,59,7,131,273,144,250,131,2,1,20,11,1,13,13,45,27
S02002130,Skelmorlie and Rural,Middle Super Output Areas and Intermediate Zones,MSOAIZ,PA,2939,1288,2453,1044,1157,579,1294,464,2,1,182,92,171,88,11,4,4,88,4,120,276,133,250,120,3,1,22,11,1,13,13,28,19
S02002131,Kilbirnie North,Middle Super Output Areas and Intermediate Zones,MSOAIZ,KA,3337,1450,2006,835,654,348,1344,483,8,4,1036,485,868,392,168,93,93,392,93,115,288,126,259,115,12,2,17,9,0,11,11,7,4
S02002132,Kilbirnie South and Longbar,Middle Super Output Areas and Intermediate Zones,MSOAIZ,KA,4224,2064,2324,1038,818,451,1504,585,2,2,1669,891,1544,813,125,78,78,813,78,113,218,126,199,113,0,0,17,11,2,13,13,13,9
S02002133,Beith West,Middle Super Output Areas and Intermediate Zones,MSOAIZ,KA,3198,1419,2251,934,751,377,1500,557,0,0,784,410,724,383,60,27,27,383,27,55,146,66,123,55,0,0,20,10,3,11,11,17,9
S02002134,Beith East and Rural,Middle Super Output Areas and Intermediate Zones,MSOAIZ,KA,3864,1740,2894,1235,1097,564,1786,668,11,3,730,378,676,350,54,28,28,350,28,88,212,112,165,88,0,0,47,24,0,24,24,28,15
S02002135,Overtown,Middle Super Output Areas and Intermediate Zones,MSOAIZ,ML,3984,1804,2355,905,673,331,1657,565,25,9,1458,822,997,590,461,232,232,590,232,57,157,65,137,57,0,0,10,5,10,8,8,14,12
S02002136,Netherton and Kirkhill,Middle Super Output Areas and Intermediate Zones,MSOAIZ,ML,3450,1546,2451,1013,673,369,1762,633,16,11,790,438,640,347,150,91,91,347,91,72,193,83,168,72,0,0,25,11,0,11,11,16,12
S02002137,Muirhouse,Middle Super Output Areas and Intermediate Zones,MSOAIZ,ML,4057,1892,2183,820,408,208,1750,601,25,11,1635,968,1287,823,348,145,145,823,145,94,233,99,217,94,0,0,13,3,3,5,5,6,5
S02002138,Muirhouse and Knowetop,Middle Super Output Areas and Intermediate Zones,MSOAIZ,ML,6059,2872,4001,1663,1246,649,2685,983,70,31,1691,1025,1515,932,176,93,93,932,93,142,331,164,301,142,0,0,19,11,11,22,22,36,20
S02002139,Craigneuk Wishaw,Middle Super Output Areas and Intermediate Zones,MSOAIZ,ML,4306,2023,1377,586,360,193,1017,393,0,0,2582,1251,2410,1153,172,98,98,1153,98,167,337,179,317,167,3,1,15,10,2,12,12,10,7
S02002140,Pather,Middle Super Output Areas and Intermediate Zones,MSOAIZ,ML,3984,1733,2157,875,466,234,1663,627,28,14,1498,697,1250,558,248,139,139,558,139,139,308,147,289,139,0,0,19,8,0,8,8,21,14
S02002141,Wishaw South,Middle Super Output Areas and Intermediate Zones,MSOAIZ,ML,4954,2323,2764,1149,752,410,2005,734,7,5,1869,997,1339,658,530,339,339,658,339,145,294,159,273,145,1,1,16,10,4,14,14,27,18
S02002142,Wishaw North,Middle Super Output Areas and Intermediate Zones,MSOAIZ,ML,6077,2903,4170,1883,1537,862,2608,1009,25,12,1437,775,1264,664,173,111,111,664,111,172,413,203,355,172,4,2,42,24,12,31,31,57,42
S02002143,Coltness,Middle Super Output Areas and Intermediate Zones,MSOAIZ,ML,3832,1689,2543,1096,878,483,1661,610,4,3,1168,540,873,425,295,115,115,425,115,37,111,43,99,37,0,0,12,6,0,6,6,10,10
S02002144,Wishaw East,Middle Super Output Areas and Intermediate Zones,MSOAIZ,ML,2879,1243,2268,911,650,310,1616,600,2,1,449,262,417,243,32,19,19,243,19,49,139,57,124,49,2,1,12,6,1,8,8,23,13
S02002145,Newmains,Middle Super Output Areas and Intermediate Zones,MSOAIZ,ML,5725,2444,3328,1367,1009,519,2316,847,3,1,1936,883,1731,806,205,77,77,806,77,157,422,176,379,157,2,1,28,15,13,19,19,39,18
S02002146,Allanton - Newmains Rural,Middle Super Output Areas and Intermediate Zones,MSOAIZ,ML,2804,1142,2187,842,646,307,1537,534,4,1,476,238,458,234,18,4,4,234,4,47,119,53,102,47,8,3,9,3,0,6,6,22,9
S02002147,Shotts,Middle Super Output Areas and Intermediate Zones,MSOAIZ,ML,4439,1960,2584,1099,812,435,1770,663,2,1,1611,737,1529,712,82,25,25,712,25,109,234,117,217,109,0,0,15,7,2,8,8,10,7
S02002148,Stane,Middle Super Output Areas and Intermediate Zones,MSOAIZ,ML,2920,1339,1649,680,449,225,1199,454,1,1,1066,553,1049,544,17,9,9,544,9,89,189,94,179,89,4,1,3,2,3,5,5,16,12
S02002149,Harthill and Salsburgh,Middle Super Output Areas and Intermediate Zones,MSOAIZ,ML,5388,2446,3100,1333,1075,568,2021,763,4,2,1979,969,1720,851,259,118,118,851,118,124,292,133,272,124,5,1,14,7,1,9,9,17,11
S02002150,Cleland,Middle Super Output Areas and Intermediate Zones,MSOAIZ,ML,3717,1473,2579,937,722,331,1855,605,2,1,863,415,850,410,13,5,5,410,5,96,254,110,231,96,4,4,19,10,0,14,14,21,11
S02002151,Newarthill,Middle Super Output Areas and Intermediate Zones,MSOAIZ,ML,3223,1393,2075,870,676,353,1399,517,0,0,937,425,829,378,108,47,47,378,47,77,189,86,171,77,0,0,18,9,0,9,9,22,12
S02002152,Carfin North,Middle Super Output Areas and Intermediate Zones,MSOAIZ,ML,3898,1532,2579,968,465,232,2105,731,9,5,1122,481,1098,469,24,12,12,469,12,68,183,74,175,68,4,2,3,3,1,6,6,14,9
S02002153,Clydesdale and New Stevenston,Middle Super Output Areas and Intermediate Zones,MSOAIZ,ML,3045,1335,2009,804,463,237,1539,562,7,5,798,412,720,360,78,52,52,360,52,101,230,113,209,101,0,0,6,4,15,12,12,8,6
S02002154,Carfin and Cleekhimin,Middle Super Output Areas and Intermediate Zones,MSOAIZ,ML,5122,2112,3090,1156,569,282,2506,867,15,7,1608,758,1444,691,164,67,67,691,67,175,404,190,379,175,0,0,20,12,5,15,15,20,8
S02002155,Motherwell South,Middle Super Output Areas and Intermediate Zones,MSOAIZ,ML,3814,2293,1350,655,500,279,840,370,10,6,2131,1456,1957,1336,174,120,120,1336,120,153,316,172,279,153,7,3,21,11,9,19,19,17,10
S02002156,Ladywell,Middle Super Output Areas and Intermediate Zones,MSOAIZ,ML,4200,1822,3736,1592,1458,778,2276,813,2,1,129,60,80,33,49,27,27,33,27,133,302,152,265,133,0,0,33,18,4,19,19,33,18
S02002157,Motherwell West,Middle Super Output Areas and Intermediate Zones,MSOAIZ,ML,4068,1733,2423,984,689,337,1720,640,14,7,1367,624,1256,552,111,72,72,552,72,102,255,111,237,102,0,0,17,8,1,9,9,23,14
S02002158,Motherwell North,Middle Super Output Areas and Intermediate Zones,MSOAIZ,ML,3099,1208,1506,562,305,149,1177,406,24,7,1442,582,543,233,899,349,349,233,349,50,136,58,124,50,0,0,12,8,0,8,8,15,6
S02002159,Forgewood,Middle Super Output Areas and Intermediate Zones,MSOAIZ,ML,4965,2309,2380,1016,530,291,1809,708,41,17,2050,1040,1335,683,715,357,357,683,357,225,523,243,488,225,2,1,26,14,7,18,18,12,10
S02002160,Holytown,Middle Super Output Areas and Intermediate Zones,MSOAIZ,ML,5254,2195,3710,1448,1009,476,2688,968,13,4,1231,598,1103,540,128,58,58,540,58,118,289,132,255,118,0,0,30,13,4,14,14,24,17
S02002161,Milnwood,Middle Super Output Areas and Intermediate Zones,MSOAIZ,ML,5031,2257,2959,1236,842,440,2117,796,0,0,1692,822,1567,746,125,76,76,746,76,166,357,179,328,166,0,0,21,11,8,13,13,23,20
S02002162,Orbiston,Middle Super Output Areas and Intermediate Zones,MSOAIZ,ML,5314,2342,2913,1201,758,398,2141,795,14,8,2098,989,1826,843,272,146,146,843,146,127,280,140,252,127,1,1,24,10,3,13,13,23,12
S02002163,Bellshill South,Middle Super Output Areas and Intermediate Zones,MSOAIZ,ML,4866,2223,2625,1098,678,354,1940,738,7,6,1829,893,1498,701,331,192,192,701,192,205,383,214,364,205,3,1,16,8,0,9,9,29,18
S02002164,Hattonrigg,Middle Super Output Areas and Intermediate Zones,MSOAIZ,ML,2595,1060,2002,769,506,259,1496,510,0,0,419,212,388,200,31,12,12,200,12,68,160,74,151,68,0,0,9,6,0,6,6,14,5
S02002165,Bellshill Central,Middle Super Output Areas and Intermediate Zones,MSOAIZ,ML,3550,1727,2024,898,614,343,1400,551,10,4,1269,707,1121,621,148,86,86,621,86,100,229,107,213,100,0,0,10,4,6,7,7,28,15
S02002166,Fallside,Middle Super Output Areas and Intermediate Zones,MSOAIZ,ML,4765,2140,3188,1331,888,460,2298,870,2,1,1319,681,1032,558,287,123,123,558,123,102,246,120,219,102,0,0,23,16,4,18,18,12,8
S02002167,Viewpark,Middle Super Output Areas and Intermediate Zones,MSOAIZ,ML,5711,2371,3044,1200,720,376,2320,822,4,2,2473,1078,2308,1013,165,65,65,1013,65,71,178,79,164,71,0,0,14,8,0,8,8,16,14
S02002168,Birkenshaw,Middle Super Output Areas and Intermediate Zones,MSOAIZ,G,4868,1874,4329,1611,1273,606,3032,995,24,10,347,174,166,91,181,83,83,91,83,61,166,71,148,61,2,1,16,9,0,10,10,26,18
S02002169,Kirkwood and Bargeddie,Middle Super Output Areas and Intermediate Zones,MSOAIZ,ML,6309,2537,3941,1509,871,454,3049,1046,21,9,2052,888,2002,867,50,21,21,867,21,118,300,131,275,118,0,0,24,12,1,13,13,16,9
S02002170,Kirkshaws,Middle Super Output Areas and Intermediate Zones,MSOAIZ,ML,6056,2480,3323,1298,796,400,2502,887,25,11,2381,1037,1340,623,1041,414,414,623,414,120,336,130,315,120,0,0,21,10,0,10,10,16,15
S02002171,Dundyvan,Middle Super Output Areas and Intermediate Zones,MSOAIZ,ML,6076,2799,3562,1458,790,429,2757,1024,15,5,2033,1089,1913,1034,120,55,55,1034,55,216,449,232,419,216,0,0,30,16,0,16,16,32,20
S02002172,Drumpellier and Langloan,Middle Super Output Areas and Intermediate Zones,MSOAIZ,ML,2617,1096,1877,725,542,275,1335,450,0,0,554,286,526,263,28,23,23,263,23,67,173,78,149,67,0,0,24,11,0,11,11,13,7
S02002173,Coatbridge West,Middle Super Output Areas and Intermediate Zones,MSOAIZ,ML,4007,1908,2525,1079,759,393,1758,683,8,3,1122,647,1046,609,76,38,38,609,38,150,341,167,306,150,0,0,33,15,2,17,17,19,15
S02002174,Townhead,Middle Super Output Areas and Intermediate Zones,MSOAIZ,ML,4796,2015,2749,1101,816,417,1928,682,5,2,1719,761,1231,562,488,199,199,562,199,128,309,143,288,128,0,0,19,14,2,15,15,19,10
S02002175,Sunnyside and Cliftonville,Middle Super Output Areas and Intermediate Zones,MSOAIZ,ML,3961,1957,2564,1180,772,415,1789,763,3,2,826,457,778,429,48,28,28,429,28,292,553,308,530,292,0,0,22,15,1,16,16,18,12
S02002176,Cliftonville,Middle Super Output Areas and Intermediate Zones,MSOAIZ,ML,3193,1614,1790,760,485,264,1295,489,10,7,1101,713,1069,690,32,23,23,690,23,114,293,133,263,114,0,0,29,18,1,19,19,9,8
S02002177,Shawhead and Whifflet,Middle Super Output Areas and Intermediate Zones,MSOAIZ,ML,2939,1378,1628,699,523,287,1092,408,13,4,1153,595,1097,569,56,26,26,569,26,61,133,65,126,61,0,0,7,4,0,4,4,25,19
S02002178,Greenend and Carnbroe,Middle Super Output Areas and Intermediate Zones,MSOAIZ,ML,5572,2243,3955,1472,755,358,3194,1111,6,3,1241,606,1027,510,214,96,96,510,96,135,353,152,316,135,3,2,34,15,0,17,17,23,13
S02002179,Calderbank and Brownsburn,Middle Super Output Areas and Intermediate Zones,MSOAIZ,ML,2538,1064,1810,731,656,319,1154,412,0,0,537,256,522,247,15,9,9,247,9,58,180,69,159,58,0,0,21,11,0,11,11,11,8
S02002180,Chapelhall West,Middle Super Output Areas and Intermediate Zones,MSOAIZ,ML,2544,1071,1883,770,435,227,1447,542,1,1,486,219,450,202,36,17,17,202,17,67,167,76,146,67,0,0,21,9,0,9,9,8,6
S02002181,Chapelhall East,Middle Super Output Areas and Intermediate Zones,MSOAIZ,ML,3952,1518,3228,1193,570,279,2653,912,5,2,454,213,285,145,169,68,68,145,68,98,263,107,245,98,0,0,18,9,0,9,9,7,5
S02002182,Craigneuk Airdrie,Middle Super Output Areas and Intermediate Zones,MSOAIZ,ML,3784,1439,3068,1145,724,345,2307,788,37,12,509,205,377,142,132,63,63,142,63,72,185,75,180,72,0,0,5,3,0,3,3,22,14
S02002183,Petersburn,Middle Super Output Areas and Intermediate Zones,MSOAIZ,ML,4005,1645,1766,703,461,232,1249,448,56,23,1977,830,1381,570,596,260,260,570,260,93,249,103,228,93,1,1,13,6,7,10,10,13,9
S02002184,Gartlea,Middle Super Output Areas and Intermediate Zones,MSOAIZ,ML,3153,1351,1726,724,572,291,1152,432,2,1,1173,511,984,413,189,98,98,413,98,97,249,112,217,97,1,1,31,14,0,15,15,5,4
S02002185,Cairnhill,Middle Super Output Areas and Intermediate Zones,MSOAIZ,ML,4680,1973,3870,1537,1266,637,2604,900,0,0,523,305,277,151,246,154,154,151,154,113,268,121,249,113,0,0,19,8,0,8,8,19,10
S02002186,Coatdyke and Whinhall,Middle Super Output Areas and Intermediate Zones,MSOAIZ,ML,5472,2445,3499,1487,1063,576,2431,909,5,2,1371,662,1300,624,71,38,38,624,38,248,552,269,517,248,1,1,28,18,6,21,21,50,27
S02002187,Thrashbush,Middle Super Output Areas and Intermediate Zones,MSOAIZ,ML,5474,2558,3206,1363,988,514,2211,845,7,4,1785,955,1620,866,165,89,89,866,89,187,442,211,402,187,6,3,32,19,2,24,24,41,29
S02002188,Airdrie North,Middle Super Output Areas and Intermediate Zones,MSOAIZ,ML,5473,2522,2401,1019,619,332,1767,680,15,7,2621,1290,2346,1138,275,152,152,1138,152,178,424,200,382,178,0,0,37,20,5,22,22,27,13
S02002189,Drumgelloch,Middle Super Output Areas and Intermediate Zones,MSOAIZ,ML,4077,1833,2686,1169,892,497,1770,664,24,8,1034,497,973,465,61,32,32,465,32,129,332,150,288,129,5,2,38,18,1,21,21,25,17
S02002190,Caldercruix and Plains,Middle Super Output Areas and Intermediate Zones,MSOAIZ,ML,5626,2363,3431,1329,939,451,2484,875,8,3,1783,831,1726,794,57,37,37,794,37,172,392,189,363,172,2,2,21,10,6,17,17,20,14
S02002191,Glenmavis and Greengairs,Middle Super Output Areas and Intermediate Zones,MSOAIZ,ML,4602,1856,3556,1366,961,460,2589,902,6,4,754,358,736,349,18,9,9,349,9,101,262,115,237,101,1,1,24,13,0,14,14,30,17
S02002192,Gartcosh and Marnock,Middle Super Output Areas and Intermediate Zones,MSOAIZ,ML,5621,2223,4381,1651,919,437,3457,1212,5,2,868,418,824,400,44,18,18,400,18,120,356,143,301,120,2,1,53,22,0,23,23,16,11
S02002193,Cardowan and Millerston,Middle Super Output Areas and Intermediate Zones,MSOAIZ,G,4410,1761,3730,1422,980,480,2747,939,3,3,456,235,422,219,34,16,16,219,16,73,192,90,150,73,0,0,41,16,1,17,17,32,14
S02002194,Stepps,Middle Super Output Areas and Intermediate Zones,MSOAIZ,G,2380,1034,1971,835,766,399,1205,436,0,0,237,109,160,80,77,29,29,80,29,74,164,83,148,74,0,0,13,7,3,9,9,8,7
S02002195,Chryston and Muirhead,Middle Super Output Areas and Intermediate Zones,MSOAIZ,G,4125,1773,3203,1310,1018,541,2181,767,4,2,684,346,526,276,158,70,70,276,70,85,201,95,187,85,0,0,14,10,0,10,10,37,22
S02002196,Moodiesburn West,Middle Super Output Areas and Intermediate Zones,MSOAIZ,G,3665,1631,2237,971,692,366,1545,605,0,0,1247,569,1120,520,127,49,49,520,49,68,170,82,144,68,0,0,23,12,3,14,14,11,9
S02002197,Moodiesburn East,Middle Super Output Areas and Intermediate Zones,MSOAIZ,G,3626,1425,3106,1175,637,316,2469,859,0,0,309,163,292,157,17,6,6,157,6,68,204,81,178,68,0,0,23,12,3,13,13,7,6
S02002198,Westfield,Middle Super Output Areas and Intermediate Zones,MSOAIZ,G,6234,2405,5282,1995,1138,558,4137,1434,7,3,556,255,342,182,214,73,73,182,73,124,383,148,337,124,0,0,39,21,7,24,24,13,7
S02002199,Condorrat,Middle Super Output Areas and Intermediate Zones,MSOAIZ,G,4943,2129,3987,1660,1422,713,2553,942,12,5,660,324,638,314,22,10,10,314,10,117,267,125,250,117,0,0,17,8,0,8,8,29,20
S02002200,Greenfaulds,Middle Super Output Areas and Intermediate Zones,MSOAIZ,G,4000,1700,2965,1203,991,502,1972,700,2,1,464,254,128,77,336,177,177,77,177,200,550,233,471,200,0,0,51,25,28,33,33,21,10
S02002201,Seafar,Middle Super Output Areas and Intermediate Zones,MSOAIZ,G,3497,1590,2244,980,770,411,1453,557,21,12,907,448,227,111,680,337,337,111,337,145,334,152,325,145,0,0,9,7,0,7,7,12,10
S02002202,Cumbernauld Central,Middle Super Output Areas and Intermediate Zones,MSOAIZ,G,4738,2233,2296,1085,725,430,1562,653,9,2,1541,735,397,176,1144,559,559,176,559,373,872,395,828,373,2,1,25,13,17,22,22,29,18
S02002203,Kildrum,Middle Super Output Areas and Intermediate Zones,MSOAIZ,G,4310,2095,2851,1357,852,495,1969,843,30,19,805,423,233,119,572,304,304,119,304,255,615,291,537,255,0,0,41,22,37,36,36,39,24
S02002204,Abronhill South,Middle Super Output Areas and Intermediate Zones,MSOAIZ,G,4119,1805,2964,1201,792,406,2172,795,0,0,669,382,456,263,213,119,119,263,119,193,456,210,432,193,0,0,22,15,2,17,17,30,12
S02002205,Abronhill North,Middle Super Output Areas and Intermediate Zones,MSOAIZ,G,4410,1871,3316,1361,788,420,2528,941,0,0,691,330,427,204,264,126,126,204,126,150,385,171,342,150,0,0,43,21,0,21,21,18,9
S02002206,Village and Castlecary,Middle Super Output Areas and Intermediate Zones,MSOAIZ,G,3470,1724,2281,1061,764,443,1509,614,8,4,779,449,405,228,374,221,221,228,221,184,392,205,358,184,4,2,29,18,1,21,21,18,9
S02002207,Carrickstone,Middle Super Output Areas and Intermediate Zones,MSOAIZ,G,5070,1729,4567,1511,747,334,3820,1177,0,0,313,135,71,26,242,109,109,26,109,61,173,73,151,61,4,2,17,9,1,12,12,17,10
S02002208,Balloch West,Middle Super Output Areas and Intermediate Zones,MSOAIZ,G,3595,1378,3264,1192,689,353,2575,839,0,0,131,75,33,13,98,62,62,13,62,98,192,105,176,98,5,1,9,5,2,7,7,8,6
S02002209,Balloch East,Middle Super Output Areas and Intermediate Zones,MSOAIZ,G,2924,1222,2225,900,622,322,1601,576,2,2,529,249,251,134,278,115,115,134,115,61,161,66,149,61,0,0,7,2,5,5,5,9,7
S02002210,Kilsyth East and Croy,Middle Super Output Areas and Intermediate Zones,MSOAIZ,G,6095,2709,4158,1675,1396,701,2755,969,7,5,1521,805,1338,690,183,115,115,690,115,168,384,204,315,168,2,1,60,31,7,36,36,32,25
S02002211,Kilsyth Bogside,Middle Super Output Areas and Intermediate Zones,MSOAIZ,G,3297,1470,2132,885,712,384,1420,501,0,0,897,448,870,439,27,9,9,439,9,109,236,121,216,109,0,0,19,11,1,12,12,32,16
S02002212,Balmalloch,Middle Super Output Areas and Intermediate Zones,MSOAIZ,G,3919,1668,2577,1067,832,429,1739,635,6,3,1088,491,1051,475,37,16,16,475,16,81,237,99,191,81,0,0,46,18,0,18,18,17,11
S02002213,Stromness; Sandwick and Stenness,Middle Super Output Areas and Intermediate Zones,MSOAIZ,KW,3089,1464,2201,1003,1230,645,929,338,42,20,478,231,280,139,198,92,92,139,92,156,342,189,274,156,9,5,56,27,3,33,33,68,41
S02002214,West Mainland,Middle Super Output Areas and Intermediate Zones,MSOAIZ,KW,3999,1713,3318,1383,1841,884,1443,479,34,20,229,112,66,39,163,73,73,39,73,119,331,152,252,119,7,4,66,28,6,33,33,121,66
S02002215,East Mainland,Middle Super Output Areas and Intermediate Zones,MSOAIZ,KW,3635,1467,3133,1212,1566,706,1490,474,77,32,187,78,48,21,139,57,57,21,57,106,235,123,196,106,0,0,37,16,2,17,17,80,54
S02002216,West Kirkwall,Middle Super Output Areas and Intermediate Zones,MSOAIZ,KW,3788,1876,2395,1099,1025,545,1239,486,131,68,808,434,349,206,459,228,228,206,228,232,465,272,390,232,4,2,66,34,5,40,40,120,71
S02002217,East Kirkwall,Middle Super Output Areas and Intermediate Zones,MSOAIZ,KW,2498,1201,1576,712,706,378,857,326,13,8,551,286,423,222,128,64,64,222,64,140,327,173,263,140,12,5,50,27,2,33,33,44,30
S02002218,Isles,Middle Super Output Areas and Intermediate Zones,MSOAIZ,KW,4142,2004,3237,1504,2224,1134,1001,363,12,7,367,204,234,130,133,74,74,130,74,149,358,186,277,149,24,8,41,20,16,37,37,180,110
S02002219,Powmill; Cleish and Scotlandwell,Middle Super Output Areas and Intermediate Zones,MSOAIZ,KY,3516,1405,3120,1230,1334,624,1776,599,10,7,113,47,82,35,31,12,12,35,12,84,218,96,191,84,10,3,12,7,5,12,12,65,32
S02002220,Kinross,Middle Super Output Areas and Intermediate Zones,MSOAIZ,KY,4683,2054,3659,1554,1448,759,2198,789,13,6,584,302,437,232,147,70,70,232,70,153,406,176,357,153,10,3,31,16,8,23,23,34,22
S02002221,Milnathort and Crook of Devon,Middle Super Output Areas and Intermediate Zones,MSOAIZ,KY,3459,1477,2742,1136,1256,626,1479,505,7,5,315,155,207,109,108,46,46,109,46,117,316,140,263,117,2,2,40,17,11,23,23,86,46
S02002222,Muthill; Greenloaning and Gleneagles,Middle Super Output Areas and Intermediate Zones,MSOAIZ,PH,3511,1517,2533,1068,1113,552,1414,513,6,3,312,151,228,116,84,35,35,116,35,222,548,245,494,222,12,5,30,14,12,23,23,118,53
S02002223,Auchterarder,Middle Super Output Areas and Intermediate Zones,MSOAIZ,PH,3968,1793,2845,1244,1219,669,1615,568,11,7,592,321,374,196,218,125,125,196,125,178,483,199,437,178,13,6,33,15,0,21,21,48,29
S02002224,Comrie; Gilmerton and St Fillans,Middle Super Output Areas and Intermediate Zones,MSOAIZ,PH,3625,1699,2371,1114,1383,756,985,356,3,2,406,207,231,121,175,86,86,121,86,281,685,300,642,281,30,11,9,5,4,19,19,163,78
S02002225,Crieff North,Middle Super Output Areas and Intermediate Zones,MSOAIZ,PH,2998,1359,2498,1109,1294,688,1193,417,11,4,199,119,99,52,100,67,67,52,67,89,255,109,214,89,5,2,24,15,12,20,20,46,22
S02002226,Crieff South,Middle Super Output Areas and Intermediate Zones,MSOAIZ,PH,4097,1925,2615,1167,1112,607,1427,530,76,30,884,448,518,282,366,166,166,282,166,247,554,281,486,247,9,3,52,29,7,34,34,44,29
S02002227,Aberuthven and Almondbank,Middle Super Output Areas and Intermediate Zones,MSOAIZ,PH,4142,1749,2929,1206,1217,582,1640,595,72,29,342,162,201,109,141,53,53,109,53,297,751,326,663,297,53,18,32,9,3,29,29,120,55
S02002228,Glenfarg; Dunning and Rhynd,Middle Super Output Areas and Intermediate Zones,MSOAIZ,PH,3572,1498,2615,1058,1288,592,1319,462,8,4,200,106,153,85,47,21,21,85,21,233,549,250,515,233,8,3,25,13,1,17,17,208,84
S02002229,Bridge of Earn and Abernethy,Middle Super Output Areas and Intermediate Zones,MSOAIZ,PH,4760,2067,3656,1571,1386,741,2210,804,60,26,581,270,295,146,286,124,124,146,124,155,414,176,365,155,9,4,40,17,0,21,21,109,50
S02002230,Moncrieffe and Friarton,Middle Super Output Areas and Intermediate Zones,MSOAIZ,PH,3806,1707,2622,1100,998,526,1596,560,28,14,751,405,515,267,236,138,138,267,138,152,394,179,335,152,6,2,47,21,6,27,27,39,23
S02002231,Viewlands; Craigie and Wellshill,Middle Super Output Areas and Intermediate Zones,MSOAIZ,PH,5745,2702,4396,2000,1821,1000,2541,984,34,16,390,212,321,171,69,41,41,171,41,409,884,447,812,409,6,3,61,31,5,38,38,75,43
S02002232,Burghmuir and Oakbank,Middle Super Output Areas and Intermediate Zones,MSOAIZ,PH,4267,1859,3898,1674,1784,964,2106,707,8,3,65,34,35,16,30,18,18,16,18,118,264,128,244,118,2,1,13,6,5,10,10,40,23
S02002233,Western Edge,Middle Super Output Areas and Intermediate Zones,MSOAIZ,PH,4101,1694,3604,1494,1057,558,2442,880,105,56,110,47,72,31,38,16,16,31,16,131,367,143,333,131,3,1,27,10,4,12,12,20,10
S02002234,Letham,Middle Super Output Areas and Intermediate Zones,MSOAIZ,PH,5795,2602,2809,1216,848,460,1946,750,15,6,2560,1191,2142,1016,418,175,175,1016,175,139,387,167,336,139,3,2,43,23,5,28,28,39,28
S02002235,Hillyland; Tulloch and Inveralmond,Middle Super Output Areas and Intermediate Zones,MSOAIZ,PH,5671,2543,2802,1183,724,367,1951,747,127,69,2389,1143,1353,665,1036,478,478,665,478,168,438,194,392,168,6,3,25,15,15,26,26,42,23
S02002236,North Muirton and Old Scone,Middle Super Output Areas and Intermediate Zones,MSOAIZ,PH,3301,1534,1945,846,609,333,1332,511,4,2,986,542,963,534,23,8,8,534,8,115,344,132,310,115,9,4,24,12,1,17,17,26,14
S02002237,Muirton,Middle Super Output Areas and Intermediate Zones,MSOAIZ,PH,2968,1414,1398,679,477,269,901,398,20,12,816,382,251,135,565,247,247,135,247,308,726,333,678,308,2,1,37,20,9,25,25,28,20
S02002238,North Inch,Middle Super Output Areas and Intermediate Zones,MSOAIZ,PH,2139,1247,840,484,326,211,474,254,40,19,422,293,189,120,233,173,173,120,173,434,852,455,806,434,2,2,37,17,7,21,21,25,15
S02002239,Central and South Inch,Middle Super Output Areas and Intermediate Zones,MSOAIZ,PH,4464,2841,1405,882,545,387,827,473,33,22,1121,779,567,419,554,360,360,419,360,1078,1902,1153,1796,1078,4,3,81,56,21,75,75,36,27
S02002240,Gannochy and Walnut Grove,Middle Super Output Areas and Intermediate Zones,MSOAIZ,PH,3532,1619,2391,1018,1283,636,1106,381,2,1,510,307,250,164,260,143,143,164,143,249,598,275,545,249,6,3,4,4,43,26,26,33,19
S02002241,Scone,Middle Super Output Areas and Intermediate Zones,MSOAIZ,PH,4944,2268,3935,1734,1870,1015,2056,713,9,6,514,305,409,237,105,68,68,237,68,173,439,194,393,173,14,4,28,14,4,21,21,56,35
S02002242,Guildtown; Balbeggie and St Madoes,Middle Super Output Areas and Intermediate Zones,MSOAIZ,PH,3689,1563,2657,1081,1155,573,1499,506,3,2,223,119,158,93,65,26,26,93,26,279,684,310,614,279,39,13,22,11,9,31,31,125,53
S02002243,Errol and Inchture,Middle Super Output Areas and Intermediate Zones,MSOAIZ,PH,3722,1584,2933,1209,958,486,1953,710,22,13,256,132,148,81,108,51,51,81,51,184,433,201,396,184,20,9,13,6,4,17,17,100,42
S02002244,Invergowrie; Longforgan and Abernyte,Middle Super Output Areas and Intermediate Zones,MSOAIZ,PH,3630,1630,2825,1238,1228,653,1595,584,2,1,291,155,225,117,66,38,38,117,38,197,482,218,435,197,16,8,31,13,0,21,21,32,19
S02002245,Coupar Angus and Meigle,Middle Super Output Areas and Intermediate Zones,MSOAIZ,PH,5085,2259,3449,1500,1502,781,1919,707,28,12,804,360,638,283,166,77,77,283,77,299,688,324,648,299,13,9,26,15,1,25,25,144,75
S02002246,Alyth,Middle Super Output Areas and Intermediate Zones,MSOAIZ,PH,3035,1411,2029,905,950,516,1069,384,10,5,539,281,408,200,131,81,81,200,81,172,416,193,374,172,13,7,25,12,4,21,21,51,32
S02002247,Blair Atholl; Strathardle and Glenshee,Middle Super Output Areas and Intermediate Zones,MSOAIZ,PH,3873,1740,2457,1056,1291,642,1141,404,25,10,228,120,139,74,89,46,46,74,46,385,912,443,775,385,97,38,32,16,8,58,58,276,121
S02002248,Blairgowrie East (Rattray),Middle Super Output Areas and Intermediate Zones,MSOAIZ,PH,2950,1331,1663,721,666,364,971,348,26,9,986,471,806,369,180,102,102,369,102,101,275,121,237,101,8,3,21,12,9,20,20,26,18
S02002249,Blairgowrie West,Middle Super Output Areas and Intermediate Zones,MSOAIZ,PH,5415,2575,4241,1947,2168,1194,1968,709,105,44,506,281,397,215,109,66,66,215,66,268,597,298,542,268,4,3,51,27,0,30,30,71,49
S02002250,Stanley and Murthly,Middle Super Output Areas and Intermediate Zones,MSOAIZ,PH,4502,2005,3176,1360,1280,664,1888,691,8,5,566,284,394,200,172,84,84,200,84,274,655,306,599,274,15,7,34,22,7,32,32,105,55
S02002251,Luncarty and Dunkeld,Middle Super Output Areas and Intermediate Zones,MSOAIZ,PH,5110,2291,3679,1563,1672,842,1988,715,19,6,604,328,413,244,191,84,84,244,84,285,646,316,580,285,35,12,26,16,5,31,31,181,84
S02002252,Pitlochry,Middle Super Output Areas and Intermediate Zones,MSOAIZ,PH,3415,1681,2165,1049,1198,670,938,360,29,19,602,326,231,138,371,188,188,138,188,238,579,268,501,238,42,16,32,12,4,30,30,69,38
S02002253,Rannoch and Aberfeldy,Middle Super Output Areas and Intermediate Zones,MSOAIZ,PH,4649,2134,2885,1298,1498,792,1376,498,11,8,689,335,392,201,297,134,134,201,134,322,827,378,707,322,77,31,35,20,8,56,56,248,123
S02002254,Lochwinnoch,Middle Super Output Areas and Intermediate Zones,MSOAIZ,PA,2769,1246,2186,911,726,374,1442,527,18,10,391,233,303,175,88,58,58,175,58,74,168,88,146,74,2,2,20,12,0,14,14,24,14
S02002255,Renfrewshire Rural South and Howwood,Middle Super Output Areas and Intermediate Zones,MSOAIZ,PA,3557,1401,3129,1193,836,395,2284,795,9,3,245,114,211,98,34,16,16,98,16,62,161,78,131,62,3,1,27,15,0,16,16,22,16
S02002256,Renfrewshire Rural North and Langbank,Middle Super Output Areas and Intermediate Zones,MSOAIZ,PA,3440,1415,2899,1165,1239,588,1659,576,1,1,112,47,44,22,68,25,25,22,25,169,385,183,347,169,12,4,20,7,6,14,14,44,20
S02002257,Kilbarchan,Middle Super Output Areas and Intermediate Zones,MSOAIZ,PA,3390,1575,2798,1238,1151,600,1647,638,0,0,349,206,322,192,27,14,14,192,14,108,220,113,211,108,1,1,8,4,0,5,5,23,18
S02002258,Johnstone South West,Middle Super Output Areas and Intermediate Zones,MSOAIZ,PA,5399,2262,3226,1343,922,497,2299,841,5,5,1822,775,1113,480,709,295,295,480,295,117,331,131,306,117,0,0,21,12,4,14,14,20,13
S02002259,Johnstone North West,Middle Super Output Areas and Intermediate Zones,MSOAIZ,PA,3564,1813,1649,772,495,298,1141,470,13,4,1492,825,1006,594,486,231,231,594,231,177,408,205,359,177,3,1,40,23,6,28,28,15,11
S02002260,Johnstone North East,Middle Super Output Areas and Intermediate Zones,MSOAIZ,PA,3848,1975,2328,1060,615,346,1702,707,11,7,1163,718,627,420,536,298,298,420,298,175,336,186,312,175,0,0,19,8,5,11,11,21,11
S02002261,Johnstone South East,Middle Super Output Areas and Intermediate Zones,MSOAIZ,PA,4251,2190,2412,1142,779,442,1631,699,2,1,1471,858,1047,637,424,221,221,637,221,155,351,175,312,155,0,0,35,17,4,20,20,17,15
S02002262,Elderslie and Phoenix,Middle Super Output Areas and Intermediate Zones,MSOAIZ,PA,5007,2239,3926,1687,1368,740,2537,936,21,11,659,354,545,278,114,76,76,278,76,175,408,187,386,175,0,0,16,10,6,12,12,14,11
S02002263,Paisley Ferguslie,Middle Super Output Areas and Intermediate Zones,MSOAIZ,PA,4227,1964,1347,591,229,107,1102,472,16,12,2598,1251,863,485,1735,766,766,485,766,107,277,117,241,107,0,0,35,9,1,10,10,5,5
S02002264,Paisley North West,Middle Super Output Areas and Intermediate Zones,MSOAIZ,PA,3569,2183,1318,677,344,213,969,461,5,3,1383,953,954,698,429,255,255,698,255,525,850,542,817,525,0,0,24,10,9,17,17,18,11
S02002265,Paisley West,Middle Super Output Areas and Intermediate Zones,MSOAIZ,PA,5509,2524,3580,1522,725,400,2850,1120,5,2,1489,748,962,504,527,244,244,504,244,219,419,238,395,219,2,2,21,16,1,19,19,21,16
S02002266,Paisley Foxbar,Middle Super Output Areas and Intermediate Zones,MSOAIZ,PA,4939,2444,3034,1362,925,517,2100,841,9,4,1627,942,1076,659,551,283,283,659,283,111,262,128,234,111,1,1,25,15,2,17,17,16,12
S02002267,Paisley South West,Middle Super Output Areas and Intermediate Zones,MSOAIZ,PA,4795,2069,4366,1845,1581,827,2785,1018,0,0,180,93,154,82,26,11,11,82,11,107,228,122,201,107,2,1,24,13,1,15,15,21,9
S02002268,Paisley Glenburn West,Middle Super Output Areas and Intermediate Zones,MSOAIZ,PA,4042,1702,2658,1098,669,354,1984,741,5,3,1168,520,1076,469,92,51,51,469,51,69,209,80,184,69,0,0,24,10,1,11,11,7,4
S02002269,Paisley Glenburn East,Middle Super Output Areas and Intermediate Zones,MSOAIZ,PA,3469,1548,2431,1029,736,382,1688,645,7,2,844,419,658,337,186,82,82,337,82,76,175,87,159,76,0,0,15,10,1,11,11,19,13
S02002270,Paisley South,Middle Super Output Areas and Intermediate Zones,MSOAIZ,PA,3786,1613,3144,1303,896,466,2230,826,18,11,204,109,131,64,73,45,45,64,45,139,412,189,283,139,70,24,26,15,33,50,50,26,12
S02002271,Paisley South East,Middle Super Output Areas and Intermediate Zones,MSOAIZ,PA,5629,3250,3384,1772,1235,796,2133,967,16,9,1536,1032,1180,825,356,207,207,825,207,393,685,425,631,393,7,3,43,27,4,32,32,24,21
S02002272,Paisley Dykebar,Middle Super Output Areas and Intermediate Zones,MSOAIZ,PA,3476,1404,3079,1205,814,421,2264,783,1,1,248,125,214,109,34,16,16,109,16,66,147,72,138,66,2,1,5,3,2,6,6,2,2
S02002273,Paisley East,Middle Super Output Areas and Intermediate Zones,MSOAIZ,PA,4045,1956,2413,1085,771,403,1630,676,12,6,1217,626,672,313,545,313,313,313,313,208,389,229,355,208,0,0,25,17,9,21,21,26,16
S02002274,Paisley Central,Middle Super Output Areas and Intermediate Zones,MSOAIZ,PA,6179,3803,2989,1701,828,551,2153,1145,8,5,1430,960,881,644,549,316,316,644,316,1045,1707,1104,1608,1045,4,2,79,48,16,59,59,53,38
S02002275,Paisley North East,Middle Super Output Areas and Intermediate Zones,MSOAIZ,PA,5837,3282,3406,1744,1300,781,2103,961,3,2,1512,982,599,418,913,564,564,418,564,483,868,521,819,483,3,3,46,35,0,38,38,51,35
S02002276,Paisley Ralston,Middle Super Output Areas and Intermediate Zones,MSOAIZ,PA,4900,2031,4605,1890,1969,1036,2632,852,4,2,115,55,63,29,52,26,26,29,26,58,150,72,127,58,1,1,10,5,12,14,14,30,14
S02002277,Paisley Gallowhill and Hillington,Middle Super Output Areas and Intermediate Zones,MSOAIZ,PA,5570,2796,2676,1260,817,458,1851,799,8,3,2301,1249,2186,1189,115,60,60,1189,60,233,556,259,504,233,0,0,40,20,12,26,26,37,28
S02002278,Paisley North,Middle Super Output Areas and Intermediate Zones,MSOAIZ,PA,4523,2545,2231,1104,557,333,1667,767,7,4,1569,999,476,338,1093,661,661,338,661,379,686,418,628,379,0,0,56,37,2,39,39,37,24
S02002279,Renfrew West,Middle Super Output Areas and Intermediate Zones,MSOAIZ,PA,6657,3082,4308,1885,1117,616,3172,1256,19,13,1619,836,1123,590,496,246,246,590,246,307,707,351,633,307,6,3,63,39,5,44,44,23,10
S02002280,Renfrew South,Middle Super Output Areas and Intermediate Zones,MSOAIZ,PA,5065,2470,4025,1874,1553,904,2470,968,2,2,707,426,662,403,45,23,23,403,23,128,299,142,275,128,0,0,24,14,0,14,14,34,28
S02002281,Renfrew East,Middle Super Output Areas and Intermediate Zones,MSOAIZ,PA,5623,2465,4887,2059,1732,894,3151,1164,4,1,345,215,328,208,17,7,7,208,7,156,369,176,334,156,1,1,34,19,0,20,20,22,15
S02002282,Renfrew North,Middle Super Output Areas and Intermediate Zones,MSOAIZ,PA,4338,2351,2761,1376,718,416,2033,954,10,6,781,506,688,437,93,69,69,437,69,414,775,455,710,414,0,0,59,38,6,41,41,21,14
S02002283,Erskine East and Inchinnan,Middle Super Output Areas and Intermediate Zones,MSOAIZ,PA,5851,2204,5421,1995,1300,637,4085,1341,36,17,236,123,125,71,111,52,52,71,52,67,178,76,163,67,4,2,11,7,0,9,9,16,10
S02002284,Erskine Central,Middle Super Output Areas and Intermediate Zones,MSOAIZ,PA,5102,2174,4092,1652,1118,573,2968,1075,6,4,754,413,66,39,688,374,374,39,374,85,240,98,207,85,0,0,24,10,9,13,13,16,11
S02002285,Erskine West,Middle Super Output Areas and Intermediate Zones,MSOAIZ,PA,5820,2421,4714,1868,1411,713,3298,1153,5,2,747,404,60,32,687,372,372,32,372,122,347,141,301,122,0,0,44,18,2,19,19,12,8
S02002286,Bishopton,Middle Super Output Areas and Intermediate Zones,MSOAIZ,PA,4708,1941,4376,1765,1764,893,2612,872,0,0,177,103,158,95,19,8,8,95,8,56,136,59,129,56,0,0,7,3,0,3,3,19,14
S02002287,Linwood South,Middle Super Output Areas and Intermediate Zones,MSOAIZ,PA,3939,2011,2042,966,662,369,1341,580,39,17,1517,852,708,362,809,490,490,362,490,160,353,173,334,160,3,1,12,10,4,13,13,27,20
S02002288,Linwood North,Middle Super Output Areas and Intermediate Zones,MSOAIZ,PA,4652,1951,3243,1330,854,460,2374,859,15,11,1089,494,264,128,825,366,366,128,366,102,301,116,270,102,0,0,25,11,6,14,14,19,11
S02002289,Houston South,Middle Super Output Areas and Intermediate Zones,MSOAIZ,PA,3294,1322,3082,1229,914,462,2167,766,1,1,14,9,9,6,5,3,3,6,3,72,192,80,175,72,2,1,15,7,0,8,8,6,4
S02002290,Houston North,Middle Super Output Areas and Intermediate Zones,MSOAIZ,PA,3102,1204,2828,1061,967,465,1861,596,0,0,98,51,86,48,12,3,3,48,3,77,160,86,141,77,0,0,19,9,0,9,9,16,6
S02002291,Bridge of Weir,Middle Super Output Areas and Intermediate Zones,MSOAIZ,PA,4846,2076,3969,1639,1588,793,2380,845,1,1,479,248,447,234,32,14,14,234,14,149,370,172,327,149,12,4,29,18,2,23,23,28,17
S02002292,Tweeddale West Area,Middle Super Output Areas and Intermediate Zones,MSOAIZ,ML,5523,2284,4227,1679,1808,873,2376,787,43,19,388,185,0,0,388,185,185,0,185,270,664,313,573,270,56,22,28,17,7,43,43,244,107
S02002293,Peebles North,Middle Super Output Areas and Intermediate Zones,MSOAIZ,EH,4258,2172,2750,1316,1227,716,1496,582,27,18,878,505,0,0,878,505,505,0,505,268,577,313,496,268,8,4,57,33,16,45,45,53,38
S02002294,Peebles South,Middle Super Output Areas and Intermediate Zones,MSOAIZ,EH,4015,1681,3260,1337,1381,719,1875,616,4,2,511,249,0,0,511,249,249,0,249,67,223,84,177,67,5,2,39,13,2,17,17,21,11
S02002295,Tweeddale East Area,Middle Super Output Areas and Intermediate Zones,MSOAIZ,TD,5374,2447,3737,1637,1419,766,2310,869,8,2,982,472,0,0,982,472,472,0,472,250,550,280,497,250,17,7,36,23,0,30,30,105,58
S02002296,Earlston Stow and Clovernfords Area,Middle Super Output Areas and Intermediate Zones,MSOAIZ,TD,4839,2097,3435,1425,1423,707,1999,712,13,6,519,264,0,0,519,264,264,0,264,272,658,302,604,272,14,6,36,21,4,30,30,227,106
S02002297,Galashiels North,Middle Super Output Areas and Intermediate Zones,MSOAIZ,TD,3676,1827,2244,1021,731,401,1504,614,9,6,767,426,0,0,767,426,426,0,426,330,648,368,578,330,6,1,39,23,25,38,38,17,12
S02002298,Galashiels West,Middle Super Output Areas and Intermediate Zones,MSOAIZ,TD,3098,1588,1715,823,645,367,1067,454,3,2,762,406,0,0,762,406,406,0,406,308,585,335,543,308,0,0,32,21,10,27,27,36,24
S02002299,Galashiels South,Middle Super Output Areas and Intermediate Zones,MSOAIZ,TD,3095,1537,2050,921,961,527,1087,392,2,2,648,413,0,0,648,413,413,0,413,153,356,177,319,153,7,4,19,13,11,24,24,41,26
S02002300,Langlee,Middle Super Output Areas and Intermediate Zones,MSOAIZ,TD,2798,1349,1067,492,492,272,575,220,0,0,1530,757,0,0,1530,757,757,0,757,54,173,85,121,54,0,0,14,9,38,31,31,28,15
S02002301,Melrose and Tweedbank Area,Middle Super Output Areas and Intermediate Zones,MSOAIZ,TD,5178,2328,3790,1636,1551,843,2197,771,42,22,769,387,0,0,769,387,387,0,387,236,544,256,502,236,2,1,36,16,4,20,20,75,49
S02002302,Lauder and Area,Middle Super Output Areas and Intermediate Zones,MSOAIZ,TD,2907,1214,2200,881,792,385,1389,487,19,9,218,113,0,0,218,113,113,0,113,148,370,167,333,148,4,2,20,12,13,19,19,119,53
S02002303,Berwickshire Central,Middle Super Output Areas and Intermediate Zones,MSOAIZ,TD,4032,1743,2571,1080,1265,630,1300,447,6,3,446,208,0,0,446,208,208,0,208,302,725,334,665,302,30,16,30,16,0,32,32,290,121
S02002304,Duns,Middle Super Output Areas and Intermediate Zones,MSOAIZ,TD,2745,1298,1661,725,794,419,856,300,11,6,790,436,0,0,790,436,436,0,436,109,277,125,251,109,6,1,17,12,3,16,16,17,12
S02002305,Berwickshire East,Middle Super Output Areas and Intermediate Zones,MSOAIZ,TD,3730,1719,2664,1189,1371,721,1281,462,12,6,526,257,0,0,526,257,257,0,257,192,433,214,385,192,19,8,26,12,3,22,22,107,59
S02002306,Eyemouth,Middle Super Output Areas and Intermediate Zones,MSOAIZ,TD,3512,1618,2001,892,871,478,1111,407,19,7,1223,599,0,0,1223,599,599,0,599,88,250,103,219,88,1,1,27,13,3,15,15,38,24
S02002307,Chirnside and Area,Middle Super Output Areas and Intermediate Zones,MSOAIZ,TD,4077,1814,2647,1145,1346,688,1297,454,4,3,527,230,0,0,527,230,230,0,230,338,732,359,683,338,13,4,22,11,14,21,21,171,80
S02002308,Coldstream and Area,Middle Super Output Areas and Intermediate Zones,MSOAIZ,TD,2721,1342,1532,742,877,485,649,254,6,3,585,310,0,0,585,310,310,0,310,225,500,244,471,225,6,3,21,14,2,19,19,104,46
S02002309,Cheviot East,Middle Super Output Areas and Intermediate Zones,MSOAIZ,TD,4576,2106,2840,1293,1474,782,1343,501,23,10,379,190,0,0,379,190,190,0,190,470,1091,494,1031,470,25,9,29,13,6,24,24,266,129
S02002310,Kelso North,Middle Super Output Areas and Intermediate Zones,MSOAIZ,TD,3252,1507,2097,912,867,472,1213,435,17,5,873,454,0,0,873,454,454,0,454,86,222,103,185,86,5,1,27,13,5,17,17,60,38
S02002311,Kelso South,Middle Super Output Areas and Intermediate Zones,MSOAIZ,TD,2308,1227,1278,660,664,406,595,243,19,11,622,340,0,0,622,340,340,0,340,178,375,199,339,178,8,4,22,13,6,21,21,33,28
S02002312,Cheviot West,Middle Super Output Areas and Intermediate Zones,MSOAIZ,TD,2802,1255,1670,716,848,417,815,295,7,4,212,102,0,0,212,102,102,0,102,328,739,356,687,328,21,9,23,11,8,28,28,181,81
S02002313,St Boswells and Newtown Area,Middle Super Output Areas and Intermediate Zones,MSOAIZ,TD,3549,1667,2335,1041,1008,533,1306,500,21,8,627,342,0,0,627,342,342,0,342,200,476,219,432,200,14,7,25,9,5,19,19,111,65
S02002314,Jedburgh,Middle Super Output Areas and Intermediate Zones,MSOAIZ,TD,4000,1915,2379,1076,912,521,1456,550,11,5,1183,597,0,0,1183,597,597,0,597,166,375,198,319,166,2,1,46,25,8,32,32,63,44
S02002315,Denholm and Hermitage,Middle Super Output Areas and Intermediate Zones,MSOAIZ,TD,3841,1780,2714,1251,1614,818,1094,428,6,5,300,156,0,0,300,156,156,0,156,248,620,280,551,248,23,9,36,19,10,32,32,207,93
S02002316,Burnfoot,Middle Super Output Areas and Intermediate Zones,MSOAIZ,TD,3068,1272,922,407,349,194,557,207,16,6,1958,777,0,0,1958,777,777,0,777,71,172,78,152,71,0,0,13,5,7,7,7,16,10
S02002317,Hawick Central,Middle Super Output Areas and Intermediate Zones,MSOAIZ,TD,4329,2326,2993,1477,1430,834,1558,640,5,3,578,386,0,0,578,386,386,0,386,367,686,417,585,367,10,3,65,37,26,50,50,72,46
S02002318,Hawick West End,Middle Super Output Areas and Intermediate Zones,MSOAIZ,TD,3271,1638,2276,1030,1012,554,1262,475,2,1,703,439,0,0,703,439,439,0,439,124,246,135,227,124,0,0,15,9,4,11,11,46,34
S02002319,Hawick North,Middle Super Output Areas and Intermediate Zones,MSOAIZ,TD,3567,1760,2301,1044,946,529,1355,515,0,0,1000,554,0,0,1000,554,554,0,554,120,233,138,201,120,1,1,24,14,7,18,18,33,24
S02002320,Ettrick Yarrow and Liliesleaf Area,Middle Super Output Areas and Intermediate Zones,MSOAIZ,TD,2737,1208,1804,773,980,488,824,285,0,0,227,92,0,0,227,92,92,0,92,242,545,268,489,242,18,8,26,12,12,26,26,161,75
S02002321,Selkirk,Middle Super Output Areas and Intermediate Zones,MSOAIZ,TD,5711,2779,3707,1680,1683,902,2013,772,11,6,1464,804,0,0,1464,804,804,0,804,217,492,268,407,217,3,2,74,43,8,51,51,48,27
S02002322,Shetland South,Middle Super Output Areas and Intermediate Zones,MSOAIZ,ZE,3272,1359,2537,1021,1177,571,1354,446,6,4,445,203,292,148,153,55,55,148,55,86,221,106,179,86,8,2,25,13,9,20,20,69,29
S02002323,Lerwick South,Middle Super Output Areas and Intermediate Zones,MSOAIZ,ZE,3442,1392,2336,879,974,444,1281,414,81,21,890,413,576,275,314,138,138,275,138,65,185,82,148,65,18,8,17,8,2,17,17,31,18
S02002324,Lerwick North,Middle Super Output Areas and Intermediate Zones,MSOAIZ,ZE,4905,2410,2797,1267,1394,716,1343,518,60,33,1439,824,1176,672,263,152,152,672,152,215,571,267,451,215,22,9,78,34,20,52,52,98,52
S02002325,Central Shetland,Middle Super Output Areas and Intermediate Zones,MSOAIZ,ZE,3179,1343,2428,986,1116,533,1306,449,6,4,389,190,276,134,113,56,56,134,56,116,298,137,243,116,2,1,47,18,6,21,21,64,30
S02002326,East and West Mainland,Middle Super Output Areas and Intermediate Zones,MSOAIZ,ZE,2777,1156,2110,818,1070,480,1037,336,3,2,396,202,331,172,65,30,30,172,30,89,210,105,178,89,6,2,24,13,2,16,16,61,31
S02002327,North Mainland,Middle Super Output Areas and Intermediate Zones,MSOAIZ,ZE,2637,1111,1693,674,825,386,866,287,2,1,737,327,657,289,80,38,38,289,38,50,142,71,92,50,7,3,36,14,7,21,21,65,39
S02002328,North and East Isles,Middle Super Output Areas and Intermediate Zones,MSOAIZ,ZE,2769,1179,2141,861,1291,597,839,259,11,5,397,197,321,168,76,29,29,168,29,77,175,86,153,77,4,2,9,4,9,9,9,56,35
S02002329,Carrick South,Middle Super Output Areas and Intermediate Zones,MSOAIZ,KA,5407,2390,3537,1528,1937,953,1595,574,5,1,894,412,675,322,219,90,90,322,90,314,777,354,689,314,37,14,43,21,8,40,40,199,96
S02002330,Girvan Glendoune,Middle Super Output Areas and Intermediate Zones,MSOAIZ,KA,3405,1544,1917,827,772,410,1140,415,5,2,1235,614,1160,585,75,29,29,585,29,78,233,89,206,78,0,0,27,11,0,11,11,20,14
S02002331,Girvan Ailsa,Middle Super Output Areas and Intermediate Zones,MSOAIZ,KA,3221,1612,2368,1120,1182,656,1182,461,4,3,473,289,320,198,153,91,91,198,91,160,340,178,302,160,4,2,34,16,0,18,18,40,25
S02002332,Maybole,Middle Super Output Areas and Intermediate Zones,MSOAIZ,KA,4809,2162,3036,1293,1171,614,1861,677,4,2,1306,634,1174,564,132,70,70,564,70,196,441,215,408,196,1,1,31,17,1,19,19,26,20
S02002333,Carrick North,Middle Super Output Areas and Intermediate Zones,MSOAIZ,KA,3834,1598,3005,1216,1222,601,1773,612,10,3,446,195,258,124,188,71,71,124,71,137,321,153,290,137,0,0,27,14,4,16,16,62,34
S02002334,Coylton,Middle Super Output Areas and Intermediate Zones,MSOAIZ,KA,3677,1541,3053,1252,1181,572,1865,676,7,4,324,154,204,98,120,56,56,98,56,97,267,119,230,97,1,1,36,21,0,22,22,33,16
S02002335,Alloway and Doonfoot,Middle Super Output Areas and Intermediate Zones,MSOAIZ,KA,5956,2577,5529,2410,2925,1546,2600,862,4,2,85,34,72,29,13,5,5,29,5,91,304,111,256,91,16,6,22,11,10,20,20,38,22
S02002336,Castlehill and Kincaidston,Middle Super Output Areas and Intermediate Zones,MSOAIZ,KA,4487,1946,3135,1332,1065,554,2056,773,14,5,891,422,803,380,88,42,42,380,42,159,439,176,400,159,0,0,34,15,5,17,17,22,16
S02002337,Belmont,Middle Super Output Areas and Intermediate Zones,MSOAIZ,KA,5493,2466,4524,2009,2112,1144,2410,864,2,1,491,231,259,143,232,88,88,143,88,169,427,192,385,169,1,1,35,19,6,23,23,51,34
S02002338,Holmston and Forehill,Middle Super Output Areas and Intermediate Zones,MSOAIZ,KA,5041,2223,4064,1756,1652,891,2403,861,9,4,502,269,292,150,210,119,119,150,119,151,431,170,387,151,3,1,36,16,5,19,19,44,28
S02002339,Ayr South Harbour and Town Centre,Middle Super Output Areas and Intermediate Zones,MSOAIZ,KA,5035,2785,3401,1759,1668,1013,1716,741,17,5,414,316,172,124,242,192,192,124,192,613,1141,660,1059,613,12,6,59,34,11,47,47,79,50
S02002340,Ayr North Harbour; Wallacetown and Newton South,Middle Super Output Areas and Intermediate Zones,MSOAIZ,KA,4728,2683,2001,1036,732,434,1260,597,9,5,1732,1070,1562,960,170,110,110,960,110,520,964,555,904,520,2,2,53,30,5,35,35,31,22
S02002341,Craigie,Middle Super Output Areas and Intermediate Zones,MSOAIZ,KA,2536,1288,1485,667,514,288,969,378,2,1,760,496,752,493,8,3,3,493,3,103,275,114,251,103,0,0,17,8,7,11,11,16,11
S02002342,Dalmilling,Middle Super Output Areas and Intermediate Zones,MSOAIZ,KA,2809,1165,1196,524,401,217,795,307,0,0,1399,563,1146,465,253,98,98,465,98,62,190,64,186,62,0,0,4,2,0,2,2,24,14
S02002343,Lochside; Braehead and Whitletts,Middle Super Output Areas and Intermediate Zones,MSOAIZ,KA,4206,1942,1779,798,666,361,1101,433,12,4,2111,986,1801,867,310,119,119,867,119,133,289,143,268,133,3,2,15,7,3,10,10,27,15
S02002344,Newton North,Middle Super Output Areas and Intermediate Zones,MSOAIZ,KA,4232,2075,3316,1537,1228,697,2072,832,16,8,508,319,423,270,85,49,49,270,49,174,374,198,337,174,2,2,34,21,1,24,24,34,21
S02002345,Heathfield,Middle Super Output Areas and Intermediate Zones,MSOAIZ,KA,4353,1942,3135,1322,879,472,2193,824,63,26,814,431,502,286,312,145,145,286,145,160,386,176,355,160,1,1,30,15,0,16,16,18,13
S02002346,Prestwick West,Middle Super Output Areas and Intermediate Zones,MSOAIZ,KA,4097,1916,3493,1594,1610,902,1880,690,3,2,148,74,134,67,14,7,7,67,7,204,411,224,385,204,1,1,23,17,2,20,20,45,24
S02002347,Prestwick East,Middle Super Output Areas and Intermediate Zones,MSOAIZ,KA,5387,2506,4524,2090,1997,1146,2522,941,5,3,433,207,391,181,42,26,26,181,26,157,385,181,342,157,3,2,38,21,2,24,24,45,28
S02002348,Prestwick Airport and Monkton,Middle Super Output Areas and Intermediate Zones,MSOAIZ,KA,2643,1242,1948,875,718,400,1227,473,3,2,295,164,258,148,37,16,16,148,16,152,351,176,312,152,8,5,26,15,5,24,24,49,27
S02002349,Annbank; Mossblown and Tarbolton - the Coalfields,Middle Super Output Areas and Intermediate Zones,MSOAIZ,KA,5860,2539,3924,1665,1557,781,2349,877,18,7,1404,635,1206,560,198,75,75,560,75,172,470,206,383,172,16,5,50,22,21,34,34,62,33
S02002350,Dundonald; Loans and Symington,Middle Super Output Areas and Intermediate Zones,MSOAIZ,KA,5222,2239,4041,1707,1632,828,2403,876,6,3,791,362,646,299,145,63,63,299,63,118,338,141,282,118,12,5,43,17,1,23,23,52,29
S02002351,Muirhead,Middle Super Output Areas and Intermediate Zones,MSOAIZ,KA,5472,2236,4695,1892,1645,831,3042,1057,8,4,397,185,344,157,53,28,28,157,28,122,354,138,313,122,2,1,35,14,4,16,16,26,21
S02002352,Barassie,Middle Super Output Areas and Intermediate Zones,MSOAIZ,KA,4046,2048,2661,1237,1061,603,1591,629,9,5,831,508,702,434,129,74,74,434,74,246,513,273,450,246,17,4,44,21,2,27,27,41,30
S02002353,Troon,Middle Super Output Areas and Intermediate Zones,MSOAIZ,KA,5314,2621,4230,1970,1986,1127,2241,841,3,2,415,265,299,188,116,77,77,188,77,325,623,356,557,325,17,5,48,25,1,31,31,46,30
S02002354,Clydesdale South,Middle Super Output Areas and Intermediate Zones,MSOAIZ,ML,2596,1108,1877,771,826,394,1047,376,4,1,262,137,212,112,50,25,25,112,25,126,347,148,297,126,21,7,19,11,10,22,22,110,52
S02002355,Biggar; Symington; Thankerton and Dolphinton,Middle Super Output Areas and Intermediate Zones,MSOAIZ,ML,5467,2429,4134,1760,1802,901,2314,851,18,8,683,358,535,275,148,83,83,275,83,226,555,256,479,226,19,6,46,17,11,30,30,95,55
S02002356,Carstairs; Carstairs Junction and Carnwath,Middle Super Output Areas and Intermediate Zones,MSOAIZ,ML,4733,2070,3312,1359,1180,590,2116,760,16,9,1090,550,965,495,125,55,55,495,55,119,286,137,253,119,3,3,20,12,10,18,18,45,24
S02002357,Forth; Braehead and Auchengray,Middle Super Output Areas and Intermediate Zones,MSOAIZ,ML,3756,1623,2582,1028,1010,469,1571,558,1,1,941,490,813,437,128,53,53,437,53,62,173,73,145,62,6,2,22,9,0,11,11,60,32
S02002358,Law,Middle Super Output Areas and Intermediate Zones,MSOAIZ,ML,3737,1572,3061,1234,890,461,2169,771,2,2,502,257,460,232,42,25,25,232,25,62,151,68,138,62,0,0,12,5,1,6,6,23,13
S02002359,Carluke West,Middle Super Output Areas and Intermediate Zones,MSOAIZ,ML,2902,1297,2569,1110,951,502,1618,608,0,0,132,72,85,47,47,25,25,47,25,90,174,97,161,90,0,0,13,7,0,7,7,27,18
S02002360,Carluke North,Middle Super Output Areas and Intermediate Zones,MSOAIZ,ML,2387,1181,1506,673,617,317,884,353,5,3,715,422,627,363,88,59,59,363,59,62,140,72,118,62,0,0,22,10,0,10,10,26,14
S02002361,Carluke East,Middle Super Output Areas and Intermediate Zones,MSOAIZ,ML,4074,1727,2704,1068,629,330,2068,736,7,2,1221,587,899,448,322,139,139,448,139,55,131,61,119,55,0,0,8,2,4,6,6,18,11
S02002362,Carluke South,Middle Super Output Areas and Intermediate Zones,MSOAIZ,ML,3229,1388,2358,1009,854,449,1488,553,16,7,716,305,584,247,132,58,58,247,58,62,141,65,135,62,0,0,6,3,0,3,3,14,9
S02002363,Crossford; Braidwood and Yieldshields,Middle Super Output Areas and Intermediate Zones,MSOAIZ,ML,2515,1050,2028,804,813,376,1215,428,0,0,336,174,221,128,115,46,46,128,46,42,109,51,96,42,0,0,13,9,0,9,9,42,21
S02002364,Lanark North West,Middle Super Output Areas and Intermediate Zones,MSOAIZ,ML,2554,1238,2019,895,898,475,1119,418,2,2,383,247,336,212,47,35,35,212,35,67,130,80,105,67,0,0,25,13,0,13,13,22,16
S02002365,Lanark North East,Middle Super Output Areas and Intermediate Zones,MSOAIZ,ML,2366,1133,1608,723,614,337,990,383,4,3,577,307,504,269,73,38,38,269,38,79,157,87,146,79,2,2,8,5,1,8,8,24,16
S02002366,Lanark South,Middle Super Output Areas and Intermediate Zones,MSOAIZ,ML,3673,1703,2518,1048,920,477,1594,568,4,3,803,458,596,328,207,130,130,328,130,155,318,174,283,155,3,2,23,13,9,19,19,34,23
S02002367,Hazelbank and Kirkfieldbank,Middle Super Output Areas and Intermediate Zones,MSOAIZ,ML,3780,1606,2996,1214,1285,601,1703,609,8,4,496,249,410,200,86,49,49,200,49,99,233,113,203,99,9,3,20,10,1,14,14,55,30
S02002368,Douglas; Coalburn and Rigside,Middle Super Output Areas and Intermediate Zones,MSOAIZ,ML,4486,2054,2440,1029,928,493,1505,531,7,5,1648,820,1112,583,536,237,237,583,237,168,363,183,334,168,0,0,16,7,13,15,15,35,22
S02002369,Lesmahagow,Middle Super Output Areas and Intermediate Zones,MSOAIZ,ML,3735,1653,2364,988,793,420,1571,568,0,0,1036,520,687,354,349,166,166,354,166,116,310,129,281,116,0,0,22,10,7,13,13,25,16
S02002370,Kirkmuirhill and Blackwood,Middle Super Output Areas and Intermediate Zones,MSOAIZ,ML,4209,1789,3122,1278,957,481,2160,793,5,4,803,392,674,329,129,63,63,329,63,93,262,108,230,93,0,0,28,12,4,15,15,22,11
S02002371,Ashgill and Netherburn,Middle Super Output Areas and Intermediate Zones,MSOAIZ,ML,2684,1143,1895,757,632,300,1259,455,4,2,583,284,579,281,4,3,3,281,3,83,185,93,167,83,2,1,13,7,3,10,10,21,9
S02002372,Merryton and Meadowhill,Middle Super Output Areas and Intermediate Zones,MSOAIZ,ML,3367,1467,2750,1132,850,440,1898,691,2,1,398,230,392,227,6,3,3,227,3,78,196,91,163,78,3,1,30,12,0,13,13,23,14
S02002373,Larkhall Central; Raploch; Millheugh and Burnhead,Middle Super Output Areas and Intermediate Zones,MSOAIZ,ML,3777,1783,2838,1251,1086,573,1748,676,4,2,577,333,549,319,28,14,14,319,14,160,329,177,297,160,3,2,26,14,3,17,17,33,22
S02002374,Hareleeshill,Middle Super Output Areas and Intermediate Zones,MSOAIZ,ML,4126,1900,2801,1237,1129,596,1672,641,0,0,1092,542,1074,533,18,9,9,533,9,83,211,105,177,83,0,0,32,21,2,22,22,22,16
S02002375,Strutherhill,Middle Super Output Areas and Intermediate Zones,MSOAIZ,ML,3550,1602,1787,747,502,260,1276,483,9,4,1531,757,1236,589,295,168,168,589,168,84,223,91,207,84,0,0,13,6,3,7,7,9,7
S02002376,Stonehouse,Middle Super Output Areas and Intermediate Zones,MSOAIZ,ML,5622,2365,4232,1719,1355,706,2873,1010,4,3,941,447,888,415,53,32,32,415,32,152,404,173,366,152,4,1,31,18,3,21,21,45,26
S02002377,Strathaven South,Middle Super Output Areas and Intermediate Zones,MSOAIZ,ML,4590,2058,3754,1614,1384,755,2363,855,7,4,379,191,355,173,24,18,18,173,18,213,427,231,395,213,6,4,23,12,3,18,18,30,22
S02002378,Strathaven North,Middle Super Output Areas and Intermediate Zones,MSOAIZ,ML,2883,1151,2527,959,854,408,1670,550,3,1,219,129,213,126,6,3,3,126,3,52,127,57,121,52,0,0,6,5,0,5,5,10,6
S02002379,Chapelton; Glengavel and Sandford,Middle Super Output Areas and Intermediate Zones,MSOAIZ,ML,2776,1114,2366,940,1013,459,1352,480,1,1,150,70,113,53,37,17,17,53,17,63,203,75,173,63,6,2,24,10,0,12,12,57,29
S02002380,Glassford; Quarter and Allanton,Middle Super Output Areas and Intermediate Zones,MSOAIZ,ML,3002,1224,2500,992,992,474,1506,517,2,1,232,116,214,109,18,7,7,109,7,91,252,105,216,91,0,0,27,12,9,14,14,18,11
S02002381,Eddlewood,Middle Super Output Areas and Intermediate Zones,MSOAIZ,ML,3743,1410,3064,1100,706,325,2358,775,0,0,514,249,508,247,6,2,2,247,2,42,146,53,123,42,4,2,18,8,1,11,11,19,8
S02002382,Low Waters,Middle Super Output Areas and Intermediate Zones,MSOAIZ,ML,2694,1376,1560,722,518,284,1027,429,15,9,923,534,865,507,58,27,27,507,27,106,192,108,189,106,0,0,3,2,0,2,2,19,12
S02002383,Silvertonhill,Middle Super Output Areas and Intermediate Zones,MSOAIZ,ML,2878,1339,2451,1074,1105,601,1346,473,0,0,220,140,175,106,45,34,34,106,34,99,190,114,170,99,0,0,18,14,2,15,15,17,11
S02002384,Hamilton Centre and Low Parks,Middle Super Output Areas and Intermediate Zones,MSOAIZ,ML,3966,2195,2632,1336,1167,661,1456,670,9,5,446,306,354,247,92,59,59,247,59,484,827,514,786,484,1,1,34,27,6,30,30,61,39
S02002385,Laighstonehall,Middle Super Output Areas and Intermediate Zones,MSOAIZ,ML,3683,1965,2383,1170,823,493,1546,669,14,8,812,512,751,475,61,37,37,475,37,237,463,263,408,237,3,1,47,22,5,26,26,25,20
S02002386,Fairhill,Middle Super Output Areas and Intermediate Zones,MSOAIZ,ML,2163,916,1016,431,315,172,689,252,12,7,1031,434,933,394,98,40,40,394,40,38,103,43,93,38,0,0,10,5,0,5,5,13,8
S02002387,Woodhead and Meikle Earnock,Middle Super Output Areas and Intermediate Zones,MSOAIZ,ML,2868,1239,2013,836,525,279,1486,556,2,1,702,331,541,263,161,68,68,263,68,57,145,66,129,57,0,0,16,9,0,9,9,8,6
S02002388,Little Earnock,Middle Super Output Areas and Intermediate Zones,MSOAIZ,ML,6305,2332,5246,1899,841,399,4393,1495,12,5,656,284,236,106,420,178,178,106,178,123,380,138,344,123,5,1,22,12,9,15,15,23,11
S02002389,Earnock,Middle Super Output Areas and Intermediate Zones,MSOAIZ,ML,3976,1675,3646,1536,1236,625,2406,909,4,2,134,53,101,43,33,10,10,43,10,72,179,79,165,72,2,1,12,6,0,7,7,17,7
S02002390,Hillhouse,Middle Super Output Areas and Intermediate Zones,MSOAIZ,ML,4141,1863,2115,925,667,371,1447,553,1,1,1720,802,1290,615,430,187,187,615,187,115,292,128,263,115,2,1,17,9,10,13,13,14,8
S02002391,High Blantyre,Middle Super Output Areas and Intermediate Zones,MSOAIZ,G,3930,1926,2310,1032,765,406,1540,623,5,3,1399,773,1288,694,111,79,79,694,79,100,207,113,188,100,0,0,14,9,5,13,13,14,8
S02002392,Blantyre South and Wheatlands,Middle Super Output Areas and Intermediate Zones,MSOAIZ,G,4309,1976,2708,1167,849,451,1852,713,7,3,1268,650,1078,546,190,104,104,546,104,119,302,142,259,119,2,1,39,20,2,23,23,31,17
S02002393,Low Blantyre and Bardykes,Middle Super Output Areas and Intermediate Zones,MSOAIZ,G,3357,1325,2699,1033,815,400,1882,632,2,1,545,240,462,210,83,30,30,210,30,44,105,48,96,44,0,0,7,3,2,4,4,8,4
S02002394,Blantytre North and Coatshill,Middle Super Output Areas and Intermediate Zones,MSOAIZ,G,3082,1441,2135,949,632,348,1502,600,1,1,730,374,691,355,39,19,19,355,19,93,195,106,166,93,0,0,27,12,2,13,13,22,12
S02002395,Burnbank North,Middle Super Output Areas and Intermediate Zones,MSOAIZ,ML,4862,2184,3068,1287,612,328,2444,950,12,9,1464,723,1155,574,309,149,149,574,149,146,314,163,280,146,8,2,26,15,0,17,17,16,11
S02002396,Burnbank Central and Udston,Middle Super Output Areas and Intermediate Zones,MSOAIZ,ML,4658,2387,2448,1151,660,383,1785,766,3,2,1741,985,1560,885,181,100,100,885,100,226,454,242,428,226,0,0,26,16,0,16,16,15,9
S02002397,Burnbank South and Chantinghall,Middle Super Output Areas and Intermediate Zones,MSOAIZ,ML,3504,1693,2549,1157,840,459,1707,697,2,1,618,352,328,206,290,146,146,206,146,145,309,166,269,145,0,0,36,18,4,21,21,28,18
S02002398,Whitehill,Middle Super Output Areas and Intermediate Zones,MSOAIZ,ML,3731,1803,1967,921,525,304,1420,610,22,7,1281,639,1149,579,132,60,60,579,60,210,457,229,426,210,2,2,25,15,4,19,19,26,14
S02002399,Bothwell South,Middle Super Output Areas and Intermediate Zones,MSOAIZ,G,3430,1579,2981,1310,1300,688,1677,618,4,4,107,73,72,46,35,27,27,46,27,154,297,169,266,154,5,1,26,14,0,15,15,45,27
S02002400,Bothwell North,Middle Super Output Areas and Intermediate Zones,MSOAIZ,G,3066,1295,2269,914,724,361,1543,551,2,2,579,292,559,284,20,8,8,284,8,74,204,80,190,74,0,0,14,6,0,6,6,14,9
S02002401,Uddingston and Gardenside,Middle Super Output Areas and Intermediate Zones,MSOAIZ,G,5414,2516,4235,1795,1638,829,2586,959,11,7,689,429,370,204,319,225,225,204,225,244,450,268,422,244,1,1,26,22,1,24,24,40,24
S02002402,Halfway; Hallside and Drumsagard,Middle Super Output Areas and Intermediate Zones,MSOAIZ,G,5459,2063,4600,1659,719,334,3874,1321,7,4,441,218,270,149,171,69,69,149,69,144,390,171,339,144,6,3,44,23,1,27,27,28,15
S02002403,Westburn and Newton,Middle Super Output Areas and Intermediate Zones,MSOAIZ,G,5981,2426,4145,1571,579,295,3544,1267,22,9,1352,630,678,366,674,264,264,366,264,199,468,215,441,199,0,0,26,15,1,16,16,16,10
S02002404,Vicarland and Cairns,Middle Super Output Areas and Intermediate Zones,MSOAIZ,G,3998,1872,2485,1100,847,443,1615,645,23,12,1270,653,968,537,302,116,116,537,116,85,219,102,185,85,0,0,27,14,7,17,17,24,17
S02002405,Whitlawburn and Greenlees,Middle Super Output Areas and Intermediate Zones,MSOAIZ,G,4841,2198,3157,1232,727,358,2422,869,8,5,1497,873,473,276,1024,597,597,276,597,67,175,86,141,67,0,0,25,13,9,19,19,12,7
S02002406,Cambuslang Central,Middle Super Output Areas and Intermediate Zones,MSOAIZ,G,3834,1703,3037,1218,1116,544,1913,671,8,3,534,342,434,283,100,59,59,283,59,105,238,120,212,105,0,0,23,13,3,15,15,25,23
S02002407,Burgh; Eastfield and Silverbank,Middle Super Output Areas and Intermediate Zones,MSOAIZ,G,5876,2635,4802,2097,1717,925,3078,1168,7,4,512,263,435,226,77,37,37,226,37,224,529,256,463,224,0,0,53,27,13,32,32,33,19
S02002408,Farme Cross and Gallowflat North,Middle Super Output Areas and Intermediate Zones,MSOAIZ,G,3177,1838,1921,999,592,359,1310,628,19,12,872,594,536,386,336,208,208,386,208,206,362,227,327,206,4,1,31,20,0,21,21,22,18
S02002409,Shawfield and Clincarthill,Middle Super Output Areas and Intermediate Zones,MSOAIZ,G,3479,1966,2040,1029,701,426,1311,588,28,15,1040,674,706,464,334,210,210,464,210,236,381,250,358,236,2,1,21,13,0,14,14,18,13
S02002410,Burnhill and Bankhead North,Middle Super Output Areas and Intermediate Zones,MSOAIZ,G,3348,1738,1934,935,642,371,1265,551,27,13,1154,653,1120,630,34,23,23,630,23,112,240,134,200,112,0,0,40,22,0,22,22,20,16
S02002411,Bankhead South,Middle Super Output Areas and Intermediate Zones,MSOAIZ,G,3257,1490,2638,1187,884,493,1750,692,4,2,183,109,171,101,12,8,8,101,8,165,420,181,390,165,0,0,30,16,0,16,16,16,13
S02002412,Spittal,Middle Super Output Areas and Intermediate Zones,MSOAIZ,G,2877,1362,1861,823,560,316,1299,506,2,1,848,453,788,428,60,25,25,428,25,68,154,78,137,68,0,0,14,9,3,10,10,14,8
S02002413,High Crosshill,Middle Super Output Areas and Intermediate Zones,MSOAIZ,G,3378,1476,3057,1317,1237,673,1810,638,10,6,135,59,64,23,71,36,36,23,36,74,163,85,145,74,0,0,14,8,4,11,11,23,15
S02002414,Burnside and Springhall,Middle Super Output Areas and Intermediate Zones,MSOAIZ,G,4522,2220,3144,1386,1257,667,1878,713,9,6,1142,705,787,506,355,199,199,506,199,103,207,112,189,103,4,1,14,8,0,9,9,29,17
S02002415,Fernhill and Cathkin,Middle Super Output Areas and Intermediate Zones,MSOAIZ,G,3993,1832,2404,1044,677,366,1715,670,12,8,1393,699,1075,555,318,144,144,555,144,75,189,84,166,75,5,1,18,8,0,9,9,7,5
S02002416,Nerston and EK Landward Area,Middle Super Output Areas and Intermediate Zones,MSOAIZ,G,4452,1958,3203,1228,831,425,2369,801,3,2,940,597,739,499,201,98,98,499,98,89,255,112,203,89,11,3,27,12,14,23,23,54,21
S02002417,Calderwood East,Middle Super Output Areas and Intermediate Zones,MSOAIZ,G,3686,1738,2512,1150,759,437,1752,712,1,1,756,367,457,246,299,121,121,246,121,195,407,212,372,195,0,0,34,16,1,17,17,11,9
S02002418,Calderwood Central,Middle Super Output Areas and Intermediate Zones,MSOAIZ,G,3901,2102,2636,1300,845,514,1783,783,8,3,854,582,805,551,49,31,31,551,31,184,395,207,357,184,3,1,35,22,0,23,23,16,13
S02002419,Calderwood West and Nerston,Middle Super Output Areas and Intermediate Zones,MSOAIZ,G,4186,1953,3107,1381,1041,576,2058,800,8,5,604,335,577,322,27,13,13,322,13,194,450,217,405,194,0,0,43,21,2,23,23,25,20
S02002420,St Leonards North,Middle Super Output Areas and Intermediate Zones,MSOAIZ,G,4600,2118,3726,1648,1367,751,2357,896,2,1,467,259,368,204,99,55,55,204,55,174,386,196,343,174,2,1,33,18,8,22,22,21,15
S02002421,St Leonards South,Middle Super Output Areas and Intermediate Zones,MSOAIZ,G,4716,2108,3909,1663,1350,727,2555,934,4,2,334,200,301,181,33,19,19,181,19,213,456,234,423,213,0,0,33,21,0,21,21,17,11
S02002422,East Mains,Middle Super Output Areas and Intermediate Zones,MSOAIZ,G,3021,1510,2149,998,757,446,1390,551,2,1,503,305,475,283,28,22,22,283,22,171,344,188,317,171,2,1,25,16,0,17,17,25,19
S02002423,West Mains,Middle Super Output Areas and Intermediate Zones,MSOAIZ,G,3013,1388,2190,981,726,421,1462,558,2,2,516,247,435,214,81,33,33,214,33,131,275,142,251,131,3,1,21,10,0,11,11,32,18
S02002424,Stewartfield East,Middle Super Output Areas and Intermediate Zones,MSOAIZ,G,2829,1048,2666,960,817,373,1846,586,3,1,67,48,66,47,1,1,1,47,1,32,86,34,79,32,0,0,7,2,0,2,2,10,6
S02002425,Stewartfield West,Middle Super Output Areas and Intermediate Zones,MSOAIZ,G,4102,1592,3511,1316,882,422,2627,893,2,1,274,139,258,131,16,8,8,131,8,121,293,126,286,121,0,0,7,5,0,5,5,24,11
S02002426,Thorntonhall; Jackton and Gardenhall,Middle Super Output Areas and Intermediate Zones,MSOAIZ,G,3767,1345,3572,1266,988,439,2584,827,0,0,64,21,44,16,20,5,5,16,5,48,118,52,105,48,0,0,13,4,0,4,4,13,6
S02002427,Hairmyres and Westwood West,Middle Super Output Areas and Intermediate Zones,MSOAIZ,G,3628,1583,2984,1209,899,463,2084,745,1,1,315,211,255,172,60,39,39,172,39,134,310,150,284,134,3,1,23,15,0,16,16,19,13
S02002428,Mossneuk and Newlandsmuir,Middle Super Output Areas and Intermediate Zones,MSOAIZ,G,2846,1099,2417,935,617,291,1796,643,4,1,304,114,185,77,119,37,37,77,37,38,116,46,99,38,5,1,12,7,0,8,8,9,4
S02002429,Crosshouse and Lindsayfield,Middle Super Output Areas and Intermediate Zones,MSOAIZ,G,4632,1726,3702,1330,692,332,3008,997,2,1,575,267,477,213,98,54,54,213,54,108,336,120,313,108,0,0,22,11,1,12,12,19,9
S02002430,Whitehills West,Middle Super Output Areas and Intermediate Zones,MSOAIZ,G,3918,1645,2539,1036,622,340,1892,686,25,10,1087,489,705,332,382,157,157,332,157,103,288,118,267,103,0,0,18,12,3,15,15,4,2
S02002431,Greenhills,Middle Super Output Areas and Intermediate Zones,MSOAIZ,G,3307,1340,2216,865,508,257,1708,608,0,0,818,374,700,321,118,53,53,321,53,82,260,96,232,82,4,1,21,12,3,14,14,13,5
S02002432,Westwood South,Middle Super Output Areas and Intermediate Zones,MSOAIZ,G,4392,1976,3486,1514,980,545,2503,966,3,3,514,274,464,250,50,24,24,250,24,156,378,177,335,156,3,1,40,20,0,21,21,14,11
S02002433,Westwood East,Middle Super Output Areas and Intermediate Zones,MSOAIZ,G,3282,1622,2389,1128,798,482,1589,644,2,2,557,326,539,316,18,10,10,316,10,133,320,155,280,133,0,0,39,21,1,22,22,16,13
S02002434,The Murray,Middle Super Output Areas and Intermediate Zones,MSOAIZ,G,3759,1912,2546,1213,875,531,1666,679,5,3,718,453,669,420,49,33,33,420,33,212,475,231,441,212,4,2,29,16,1,19,19,20,15
S02002435,Birniehill; Kelvin and Whitehills East,Middle Super Output Areas and Intermediate Zones,MSOAIZ,G,4108,1743,3064,1253,687,367,2372,883,5,3,714,336,703,331,11,5,5,331,5,127,315,140,290,127,3,1,20,11,2,13,13,15,14
S02002436,Blane Valley,Middle Super Output Areas and Intermediate Zones,MSOAIZ,G,5194,2138,4387,1765,2031,985,2349,778,7,2,267,130,253,124,14,6,6,124,6,188,459,210,412,188,18,7,20,10,9,22,22,81,33
S02002437,Balfron and Drymen,Middle Super Output Areas and Intermediate Zones,MSOAIZ,G,4048,1725,3027,1237,1275,644,1725,579,27,14,532,272,339,169,193,103,103,169,103,148,411,174,346,148,5,3,55,21,5,26,26,78,42
S02002438,Kippen and Fintry,Middle Super Output Areas and Intermediate Zones,MSOAIZ,G,3163,1299,2536,1007,1116,518,1402,480,18,9,347,170,205,102,142,68,68,102,68,80,225,94,196,80,9,4,12,6,8,14,14,55,28
S02002439,Cambusbarron,Middle Super Output Areas and Intermediate Zones,MSOAIZ,FK,3639,1518,2850,1145,1081,547,1763,592,6,6,430,203,280,137,150,66,66,137,66,126,308,140,282,126,0,0,15,9,11,14,14,51,30
S02002440,Plean and Rural SE,Middle Super Output Areas and Intermediate Zones,MSOAIZ,FK,2937,1234,1830,746,641,299,1182,443,7,4,859,379,731,304,128,75,75,304,75,74,184,84,165,74,10,4,6,4,3,10,10,64,25
S02002441,Cowie,Middle Super Output Areas and Intermediate Zones,MSOAIZ,FK,2649,1094,1571,631,404,201,1164,428,3,2,904,395,824,360,80,35,35,360,35,52,168,65,133,52,6,1,22,10,7,13,13,6,3
S02002442,Fallin,Middle Super Output Areas and Intermediate Zones,MSOAIZ,FK,2832,1152,1616,639,399,197,1206,438,11,4,1052,449,966,404,86,45,45,404,45,46,142,53,117,46,6,1,14,5,5,7,7,22,11
S02002443,Bannockburn,Middle Super Output Areas and Intermediate Zones,MSOAIZ,FK,3426,1476,2537,1025,865,416,1668,607,4,2,587,298,515,249,72,49,49,249,49,121,267,131,247,121,3,1,16,8,1,10,10,35,22
S02002444,Hillpark,Middle Super Output Areas and Intermediate Zones,MSOAIZ,FK,3538,1410,2126,843,613,298,1512,544,1,1,1137,454,1067,429,70,25,25,429,25,63,239,88,183,63,2,1,43,19,11,25,25,36,25
S02002445,Broomridge,Middle Super Output Areas and Intermediate Zones,MSOAIZ,FK,5518,2606,3986,1771,1282,696,2696,1071,8,4,992,550,787,414,205,136,136,414,136,220,484,256,414,220,5,3,52,29,13,36,36,56,29
S02002446,Borestone,Middle Super Output Areas and Intermediate Zones,MSOAIZ,FK,3745,1654,2276,975,729,392,1509,562,38,21,1184,547,773,363,411,184,184,363,184,92,264,114,212,92,2,1,39,15,11,22,22,21,18
S02002447,King's Park and Torbrex,Middle Super Output Areas and Intermediate Zones,MSOAIZ,FK,3693,1769,3098,1459,1610,918,1484,538,4,3,101,67,34,18,67,49,49,18,49,184,446,215,381,184,25,8,26,14,14,31,31,48,28
S02002448,Braehead,Middle Super Output Areas and Intermediate Zones,MSOAIZ,FK,2420,1148,1520,648,509,276,1007,370,4,2,562,334,484,291,78,43,43,291,43,138,320,153,288,138,3,2,26,12,3,15,15,18,13
S02002449,City Centre,Middle Super Output Areas and Intermediate Zones,MSOAIZ,FK,3627,1812,811,423,284,162,494,248,33,13,773,467,581,335,192,132,132,335,132,846,2001,898,1874,846,12,4,108,44,7,52,52,42,24
S02002450,Raploch,Middle Super Output Areas and Intermediate Zones,MSOAIZ,FK,2841,1362,730,357,267,146,457,209,6,2,1868,893,1582,754,286,139,139,754,139,84,227,100,198,84,0,0,27,15,2,16,16,16,12
S02002451,Cornton,Middle Super Output Areas and Intermediate Zones,MSOAIZ,FK,2808,1097,1662,613,461,207,1199,405,2,1,829,375,439,209,390,166,166,209,166,91,304,104,275,91,9,1,20,12,0,13,13,13,5
S02002452,Causewayhead,Middle Super Output Areas and Intermediate Zones,MSOAIZ,FK,2329,1049,1913,849,879,472,1029,375,5,2,122,74,68,38,54,36,36,38,36,101,264,111,246,101,0,0,11,6,7,10,10,30,15
S02002453,Bridge of Allan and University,Middle Super Output Areas and Intermediate Zones,MSOAIZ,FK,5056,2275,3858,1670,1864,982,1986,684,8,4,429,222,322,142,107,80,80,142,80,303,695,336,636,303,24,10,29,20,6,33,33,74,47
S02002454,Forth,Middle Super Output Areas and Intermediate Zones,MSOAIZ,FK,2613,1266,1434,704,656,365,761,330,17,9,287,135,112,52,175,83,83,52,83,381,865,414,808,381,7,4,47,28,3,33,33,27,13
S02002455,Dunblane East,Middle Super Output Areas and Intermediate Zones,MSOAIZ,FK,4762,1866,4117,1562,1561,762,2553,798,3,2,150,75,140,70,10,5,5,70,5,160,443,200,349,160,50,18,25,14,19,40,40,52,29
S02002456,Dunblane West,Middle Super Output Areas and Intermediate Zones,MSOAIZ,FK,4332,1873,3755,1536,1463,771,2271,748,21,17,320,193,279,162,41,31,31,162,31,104,223,119,192,104,0,0,31,15,0,15,15,34,25
S02002457,Carse of Stirling,Middle Super Output Areas and Intermediate Zones,MSOAIZ,FK,4149,1729,3198,1280,1503,714,1692,564,3,2,356,182,313,160,43,22,22,160,22,181,494,214,424,181,19,9,43,19,8,33,33,101,53
S02002458,Callander and Trossachs,Middle Super Output Areas and Intermediate Zones,MSOAIZ,FK,3516,1625,2508,1119,1128,616,1360,491,20,12,610,311,307,162,303,149,149,162,149,147,348,164,318,147,10,4,17,10,3,17,17,50,31
S02002459,Highland,Middle Super Output Areas and Intermediate Zones,MSOAIZ,G,3039,1389,1963,874,947,492,1006,376,10,6,590,294,208,111,382,183,183,111,183,130,342,154,302,130,11,6,18,12,11,24,24,144,67
S02002460,IZ01,Middle Super Output Areas and Intermediate Zones,MSOAIZ,G,4442,2175,2122,953,668,353,1399,563,55,37,2096,1106,1720,881,376,225,225,881,225,95,204,103,190,95,0,0,13,7,1,8,8,20,13
S02002461,IZ02,Middle Super Output Areas and Intermediate Zones,MSOAIZ,G,4430,2403,1731,823,350,195,1332,589,49,39,2296,1356,1012,593,1284,763,763,593,763,198,390,213,369,198,0,0,19,14,2,15,15,13,11
S02002462,IZ03,Middle Super Output Areas and Intermediate Zones,MSOAIZ,G,5682,2586,2827,1163,1079,534,1727,622,21,7,2628,1307,2048,1029,580,278,278,1029,278,88,209,104,181,88,2,1,23,12,3,16,16,18,12
S02002463,IZ04,Middle Super Output Areas and Intermediate Zones,MSOAIZ,G,4416,2226,2308,1053,752,432,1521,601,35,20,1876,1067,1058,565,818,502,502,565,502,77,224,100,179,77,4,1,40,21,1,23,23,8,6
S02002464,IZ05,Middle Super Output Areas and Intermediate Zones,MSOAIZ,G,3719,1770,2795,1262,940,536,1837,717,18,9,645,368,582,342,63,26,26,342,26,106,264,129,222,106,0,0,41,22,1,23,23,15,11
S02002465,IZ06,Middle Super Output Areas and Intermediate Zones,MSOAIZ,G,5535,2419,2185,901,620,327,1549,567,16,7,3130,1407,383,203,2747,1204,1204,203,1204,80,190,93,167,80,0,0,21,11,2,13,13,30,18
S02002466,IZ07,Middle Super Output Areas and Intermediate Zones,MSOAIZ,G,4522,1933,3555,1435,1278,626,2273,806,4,3,736,394,666,356,70,38,38,356,38,72,196,87,171,72,0,0,21,14,4,15,15,35,17
S02002467,IZ08,Middle Super Output Areas and Intermediate Zones,MSOAIZ,G,5516,2776,2743,1167,847,461,1873,688,23,18,2490,1479,1770,1090,720,389,389,1090,389,90,257,112,211,90,1,1,44,20,1,22,22,26,18
S02002468,IZ09,Middle Super Output Areas and Intermediate Zones,MSOAIZ,G,5249,2254,4275,1733,1028,544,3231,1178,16,11,684,366,543,286,141,80,80,286,80,117,277,145,230,117,0,0,39,25,8,28,28,13,10
S02002469,IZ10,Middle Super Output Areas and Intermediate Zones,MSOAIZ,G,4229,1895,3351,1394,1222,613,2126,778,3,3,619,358,573,333,46,25,25,333,25,108,221,119,202,108,2,1,14,9,3,11,11,38,24
S02002470,IZ11,Middle Super Output Areas and Intermediate Zones,MSOAIZ,G,5188,2272,3135,1241,895,459,2235,778,5,4,1828,924,712,357,1116,567,567,357,567,79,203,90,171,79,0,0,32,11,0,11,11,22,17
S02002471,IZ12,Middle Super Output Areas and Intermediate Zones,MSOAIZ,G,6093,3087,4615,2140,1465,805,3099,1297,51,38,683,454,560,361,123,93,93,361,93,425,759,472,687,425,3,2,65,41,4,47,47,36,21
S02002472,IZ13,Middle Super Output Areas and Intermediate Zones,MSOAIZ,G,5651,2641,3103,1307,972,504,2131,803,0,0,2243,1184,2013,1073,230,111,111,1073,111,124,287,138,264,124,0,0,22,13,1,14,14,18,12
S02002473,IZ14,Middle Super Output Areas and Intermediate Zones,MSOAIZ,G,5096,2314,3637,1498,1088,557,2501,923,48,18,1119,615,546,335,573,280,280,335,280,162,321,186,282,162,2,1,33,20,4,24,24,19,15
S02002474,IZ15,Middle Super Output Areas and Intermediate Zones,MSOAIZ,G,5789,2542,3215,1326,798,399,2365,910,52,17,2172,1021,1553,720,619,301,301,720,301,172,396,191,356,172,6,3,32,15,2,19,19,6,4
S02002475,IZ16,Middle Super Output Areas and Intermediate Zones,MSOAIZ,G,3954,1895,2167,938,583,295,1564,632,20,11,1540,826,1352,681,188,145,145,681,145,110,228,119,214,110,0,0,9,7,5,9,9,19,12
S02002476,IZ17,Middle Super Output Areas and Intermediate Zones,MSOAIZ,G,6119,2984,4255,1923,1585,844,2627,1058,43,21,1364,751,1154,654,210,97,97,654,97,240,449,276,389,240,0,0,59,35,1,36,36,51,34
S02002477,IZ18,Middle Super Output Areas and Intermediate Zones,MSOAIZ,G,4398,1995,2744,1150,968,497,1771,650,5,3,1417,725,830,473,587,252,252,473,252,88,205,100,184,88,4,2,15,8,2,12,12,32,20
S02002478,Fauldhouse,Middle Super Output Areas and Intermediate Zones,MSOAIZ,EH,4793,2106,2874,1161,895,451,1970,705,9,5,1460,751,1175,599,285,152,152,599,152,159,435,176,398,159,0,0,34,16,3,17,17,24,18
S02002479,Breich Valley,Middle Super Output Areas and Intermediate Zones,MSOAIZ,ML,4505,1904,2501,986,813,394,1687,591,1,1,1636,746,1360,629,276,117,117,629,117,132,328,152,289,132,4,2,25,13,10,20,20,40,20
S02002480,West Calder and Polbeth,Middle Super Output Areas and Intermediate Zones,MSOAIZ,EH,5454,2417,3377,1383,1163,579,2199,797,15,7,1557,782,1019,492,538,290,290,492,290,195,475,220,430,195,0,0,42,23,3,25,25,45,32
S02002481,Bellsquarry; Adambrae and Kirkton,Middle Super Output Areas and Intermediate Zones,MSOAIZ,EH,4654,1692,3925,1371,875,382,3045,986,5,3,363,179,169,86,194,93,93,86,93,121,339,128,321,121,0,0,18,7,0,7,7,27,14
S02002482,Bankton and Murieston,Middle Super Output Areas and Intermediate Zones,MSOAIZ,EH,5217,1905,4869,1754,1170,550,3691,1202,8,2,50,17,35,12,15,5,5,12,5,106,276,118,253,106,0,0,19,9,4,12,12,22,16
S02002483,Dedridge East,Middle Super Output Areas and Intermediate Zones,MSOAIZ,EH,5427,2251,2888,1140,635,332,2243,804,10,4,1611,754,1306,607,305,147,147,607,147,318,912,346,846,318,2,1,63,26,1,28,28,16,11
S02002484,Mid Calder and Kirknewton,Middle Super Output Areas and Intermediate Zones,MSOAIZ,EH,5813,2372,5021,1968,1316,638,3693,1323,12,7,291,159,231,132,60,27,27,132,27,193,447,216,404,193,4,2,38,20,1,23,23,54,29
S02002485,East Calder,Middle Super Output Areas and Intermediate Zones,MSOAIZ,EH,4980,2115,3953,1620,1263,629,2680,987,10,4,631,302,538,250,93,52,52,250,52,149,352,170,313,149,4,1,31,16,4,21,21,44,23
S02002486,Pumpherston and Uphall Station,Middle Super Output Areas and Intermediate Zones,MSOAIZ,EH,2666,1175,1868,787,594,306,1269,480,5,1,549,269,504,248,45,21,21,248,21,86,208,97,187,86,0,0,19,10,2,11,11,41,22
S02002487,Craigshill,Middle Super Output Areas and Intermediate Zones,MSOAIZ,EH,5672,2561,2291,1006,618,337,1657,662,16,7,2705,1272,193,107,2512,1165,1165,107,1165,242,652,264,599,242,5,1,34,17,14,22,22,24,19
S02002488,Howden,Middle Super Output Areas and Intermediate Zones,MSOAIZ,EH,4472,1856,2589,1063,729,387,1853,674,7,2,1201,536,181,87,1020,449,449,87,449,214,659,246,597,214,7,3,52,28,3,32,32,23,11
S02002489,Livingston Village and Eliburn South,Middle Super Output Areas and Intermediate Zones,MSOAIZ,EH,5120,2005,4092,1531,894,429,3189,1098,9,4,534,270,311,164,223,106,106,164,106,172,472,194,431,172,3,2,30,18,8,22,22,22,10
S02002490,Ladywell,Middle Super Output Areas and Intermediate Zones,MSOAIZ,EH,4929,1995,2063,803,455,240,1592,557,16,6,2374,1021,1372,594,1002,427,427,594,427,146,477,165,431,146,4,1,37,17,5,19,19,15,6
S02002491,Knightsridge,Middle Super Output Areas and Intermediate Zones,MSOAIZ,EH,5669,2217,3264,1253,623,307,2634,944,7,2,1568,629,1158,463,410,166,166,463,166,293,807,319,747,293,0,0,49,21,11,26,26,30,16
S02002492,Knightsridge and Deans North,Middle Super Output Areas and Intermediate Zones,MSOAIZ,EH,3825,1486,3283,1249,966,457,2307,790,10,2,124,55,104,47,20,8,8,47,8,157,406,172,375,157,6,2,17,9,8,15,15,12,10
S02002493,Deans,Middle Super Output Areas and Intermediate Zones,MSOAIZ,EH,2871,1216,1490,590,313,167,1157,416,20,7,1076,514,806,385,270,129,129,385,129,96,291,103,277,96,0,0,10,6,4,7,7,14,9
S02002494,Carmondean and Eliburn North,Middle Super Output Areas and Intermediate Zones,MSOAIZ,EH,5848,2385,3986,1542,797,396,3176,1137,13,9,912,436,624,278,288,158,158,278,158,369,935,395,876,369,8,2,50,23,1,26,26,15,12
S02002495,Seafield,Middle Super Output Areas and Intermediate Zones,MSOAIZ,EH,2134,915,1380,548,394,190,978,353,8,5,598,290,475,242,123,48,48,242,48,57,139,67,115,57,0,0,18,7,6,10,10,17,10
S02002496,Blackburn,Middle Super Output Areas and Intermediate Zones,MSOAIZ,EH,4738,2215,2640,1146,876,476,1757,667,7,3,1774,906,1215,628,559,278,278,628,278,134,293,145,275,134,0,0,10,7,8,11,11,31,18
S02002497,Blaeberry Hill and East Whitburn,Middle Super Output Areas and Intermediate Zones,MSOAIZ,EH,6027,2631,4113,1682,1252,629,2853,1049,8,4,1424,741,988,516,436,225,225,516,225,165,451,188,401,165,6,2,40,19,4,23,23,39,20
S02002498,Whitburn Central,Middle Super Output Areas and Intermediate Zones,MSOAIZ,EH,4918,2304,2295,1030,846,461,1445,566,4,3,2111,1034,1550,772,561,262,262,772,262,189,473,208,439,189,2,1,23,14,9,19,19,39,32
S02002499,Whitburn; Croftmalloch and Greenrigg,Middle Super Output Areas and Intermediate Zones,MSOAIZ,ML,2949,1243,2018,793,663,312,1353,480,2,1,747,371,713,354,34,17,17,354,17,64,171,71,147,64,0,0,24,7,0,7,7,13,8
S02002500,Armadale,Middle Super Output Areas and Intermediate Zones,MSOAIZ,EH,5759,2619,3855,1630,1198,640,2622,970,35,20,1531,791,1128,560,403,231,231,560,231,148,344,173,303,148,0,0,36,22,5,25,25,29,25
S02002501,Armadale South,Middle Super Output Areas and Intermediate Zones,MSOAIZ,EH,6073,2447,4218,1574,639,325,3567,1242,12,7,1421,693,1330,642,91,51,51,642,51,158,425,174,398,158,0,0,24,13,3,16,16,9,6
S02002502,Bathgate; Wester Inch and Inchcross,Middle Super Output Areas and Intermediate Zones,MSOAIZ,EH,3983,1610,2928,1146,297,145,2625,998,6,3,423,190,271,128,152,62,62,128,62,261,628,272,605,261,6,2,16,8,1,11,11,4,2
S02002503,Bathgate and Boghall,Middle Super Output Areas and Intermediate Zones,MSOAIZ,EH,4206,1878,2036,886,626,347,1394,533,16,6,1741,802,1380,652,361,150,150,652,150,152,398,168,369,152,6,2,11,9,12,16,16,31,22
S02002504,Bathgate East,Middle Super Output Areas and Intermediate Zones,MSOAIZ,EH,6268,3063,3630,1589,1142,616,2450,945,38,28,1651,973,1241,660,410,313,313,660,313,448,946,475,892,448,3,3,44,21,7,27,27,41,26
S02002505,Bathgate West,Middle Super Output Areas and Intermediate Zones,MSOAIZ,EH,6058,2483,4258,1643,1024,527,3222,1112,12,4,1260,603,572,273,688,330,330,273,330,199,515,221,471,199,2,1,37,19,5,22,22,25,16
S02002506,Blackridge; Westfield and Torphichen,Middle Super Output Areas and Intermediate Zones,MSOAIZ,FK,3506,1483,2496,1003,778,373,1710,624,8,6,754,362,665,305,89,57,57,305,57,84,231,102,198,84,0,0,28,16,5,18,18,25,16
S02002507,Linlithgow South,Middle Super Output Areas and Intermediate Zones,MSOAIZ,EH,5958,2406,4867,1880,1869,899,2985,975,13,6,625,296,517,250,108,46,46,250,46,199,436,216,401,199,0,0,35,17,0,17,17,30,14
S02002508,Linlithgow Bridge,Middle Super Output Areas and Intermediate Zones,MSOAIZ,EH,4330,1902,3343,1352,1154,584,2185,764,4,4,472,290,344,196,128,94,94,196,94,207,467,236,416,207,4,1,43,25,4,29,29,48,24
S02002509,Linlithgow North,Middle Super Output Areas and Intermediate Zones,MSOAIZ,EH,3676,1508,3367,1346,1244,622,2119,721,4,3,50,28,36,18,14,10,10,18,10,115,249,127,227,115,1,1,21,11,0,12,12,10,7
S02002510,Winchburgh; Bridgend and Philpstoun,Middle Super Output Areas and Intermediate Zones,MSOAIZ,EH,4477,2012,2736,1197,910,481,1821,714,5,2,1274,596,1076,495,198,101,101,495,101,179,425,201,385,179,7,3,33,19,0,22,22,42,18
S02002511,Broxburn Kirkhill,Middle Super Output Areas and Intermediate Zones,MSOAIZ,EH,4164,1780,2691,1096,580,317,2099,772,12,7,1062,501,564,264,498,237,237,264,237,146,374,161,340,146,2,1,29,12,3,15,15,37,22
S02002512,Uphall; Dechmont and Ecclesmachan,Middle Super Output Areas and Intermediate Zones,MSOAIZ,EH,5630,2485,4199,1779,1536,814,2658,963,5,2,985,491,561,282,424,209,209,282,209,146,383,177,331,146,4,2,39,24,9,31,31,63,38
S02002513,Broxburn South,Middle Super Output Areas and Intermediate Zones,MSOAIZ,EH,3789,1479,3077,1149,743,364,2315,776,19,9,377,199,281,141,96,58,58,141,58,112,316,122,296,112,0,0,18,9,2,10,10,19,9
S02002514,Broxburn East,Middle Super Output Areas and Intermediate Zones,MSOAIZ,EH,2754,1277,1722,748,573,307,1149,441,0,0,698,373,496,254,202,119,119,254,119,117,307,136,272,117,4,2,27,15,4,19,19,27,20